date,price,bedrooms,bathrooms,sqft_living,sqft_lot,floors,waterfront,view,condition,grade,sqft_above,sqft_basement,yr_built,yr_renovated,zipcode,lat,long,sqft_living15,sqft_lot15,sqft_yard,sqft_yard15,price_per_sqft,norm_price,cost_type
20141013T000000,221900.0,3,1.0,1180,5650,1.0,0,0,3,7,1180,0,1955,0,98178,47.5112,-122.257,1340,5650,4470,4310,39.27433628318584,0.019265573770491803,Very Cheap
20141209T000000,538000.0,3,2.25,2570,7242,2.0,0,0,3,7,2170,400,1951,1991,98125,47.721,-122.319,1690,7639,4672,5949,74.28887047776857,0.06072131147540984,Very Cheap
20150225T000000,180000.0,2,1.0,770,10000,1.0,0,0,3,6,770,0,1933,0,98028,47.7379,-122.233,2720,8062,9230,5342,18.0,0.01377049180327869,Very Cheap
20141209T000000,604000.0,4,3.0,1960,5000,1.0,0,0,5,7,1050,910,1965,0,98136,47.5208,-122.393,1360,5000,3040,3640,120.8,0.06937704918032787,Very Cheap
20150218T000000,510000.0,3,2.0,1680,8080,1.0,0,0,3,8,1680,0,1987,0,98074,47.6168,-122.045,1800,7503,6400,5703,63.118811881188115,0.057049180327868855,Very Cheap
20140512T000000,1225000.0,4,4.5,5420,101930,1.0,0,0,3,11,3890,1530,2001,0,98053,47.6561,-122.005,4760,101930,96510,97170,12.01805160404199,0.15081967213114755,Cheap
20140627T000000,257500.0,3,2.25,1715,6819,2.0,0,0,3,7,1715,0,1995,0,98003,47.3097,-122.327,2238,6819,5104,4581,37.762135210441414,0.023934426229508195,Very Cheap
20150115T000000,291850.0,3,1.5,1060,9711,1.0,0,0,3,7,1060,0,1963,0,98198,47.4095,-122.315,1650,9711,8651,8061,30.053547523427042,0.028439344262295083,Very Cheap
20150415T000000,229500.0,3,1.0,1780,7470,1.0,0,0,3,7,1050,730,1960,0,98146,47.5123,-122.337,1780,8113,5690,6333,30.72289156626506,0.020262295081967214,Very Cheap
20150312T000000,323000.0,3,2.5,1890,6560,2.0,0,0,3,7,1890,0,2003,0,98038,47.3684,-122.031,2390,7570,4670,5180,49.23780487804878,0.03252459016393443,Very Cheap
20150403T000000,662500.0,3,2.5,3560,9796,1.0,0,0,3,8,1860,1700,1965,0,98007,47.6007,-122.145,2210,8925,6236,6715,67.62964475296039,0.07704918032786885,Very Cheap
20140527T000000,468000.0,2,1.0,1160,6000,1.0,0,0,4,7,860,300,1942,0,98115,47.69,-122.292,1330,6000,4840,4670,78.0,0.05154098360655738,Very Cheap
20140528T000000,310000.0,3,1.0,1430,19901,1.5,0,0,4,7,1430,0,1927,0,98028,47.7558,-122.229,1780,12697,18471,10917,15.57710667805638,0.03081967213114754,Very Cheap
20141007T000000,400000.0,3,1.75,1370,9680,1.0,0,0,4,7,1370,0,1977,0,98074,47.6127,-122.045,1370,10208,8310,8838,41.32231404958678,0.04262295081967213,Very Cheap
20150312T000000,530000.0,5,2.0,1810,4850,1.5,0,0,3,7,1810,0,1900,0,98107,47.67,-122.394,1360,4850,3040,3490,109.27835051546391,0.05967213114754098,Very Cheap
20150124T000000,650000.0,4,3.0,2950,5000,2.0,0,3,3,9,1980,970,1979,0,98126,47.5714,-122.375,2140,4000,2050,1860,130.0,0.07540983606557378,Very Cheap
20140731T000000,395000.0,3,2.0,1890,14040,2.0,0,0,3,7,1890,0,1994,0,98019,47.7277,-121.962,1890,14018,12150,12128,28.133903133903132,0.0419672131147541,Very Cheap
20140529T000000,485000.0,4,1.0,1600,4300,1.5,0,0,4,7,1600,0,1916,0,98103,47.6648,-122.343,1610,4300,2700,2690,112.79069767441861,0.05377049180327869,Very Cheap
20141205T000000,189000.0,2,1.0,1200,9850,1.0,0,0,4,7,1200,0,1921,0,98002,47.3089,-122.21,1060,5095,8650,4035,19.18781725888325,0.014950819672131148,Very Cheap
20150424T000000,230000.0,3,1.0,1250,9774,1.0,0,0,4,7,1250,0,1969,0,98003,47.3343,-122.306,1280,8850,8524,7570,23.531819111929607,0.020327868852459016,Very Cheap
20140514T000000,385000.0,4,1.75,1620,4980,1.0,0,0,4,7,860,760,1947,0,98133,47.7025,-122.341,1400,4980,3360,3580,77.30923694779116,0.04065573770491803,Very Cheap
20140826T000000,2000000.0,3,2.75,3050,44867,1.0,0,4,3,9,2330,720,1968,0,98040,47.5316,-122.233,4110,20336,41817,16226,44.57619185592975,0.25245901639344265,Cheap
20140703T000000,285000.0,5,2.5,2270,6300,2.0,0,0,3,8,2270,0,1995,0,98092,47.3266,-122.169,2240,7005,4030,4765,45.23809523809524,0.02754098360655738,Very Cheap
20140516T000000,252700.0,2,1.5,1070,9643,1.0,0,0,3,7,1070,0,1985,0,98030,47.3533,-122.166,1220,8386,8573,7166,26.205537695737842,0.023304918032786885,Very Cheap
20141120T000000,329000.0,3,2.25,2450,6500,2.0,0,0,4,8,2450,0,1985,0,98030,47.3739,-122.172,2200,6865,4050,4665,50.61538461538461,0.03331147540983607,Very Cheap
20141103T000000,233000.0,3,2.0,1710,4697,1.5,0,0,5,6,1710,0,1941,0,98002,47.3048,-122.218,1030,4705,2987,3675,49.60613157334469,0.020721311475409836,Very Cheap
20140626T000000,937000.0,3,1.75,2450,2691,2.0,0,0,3,8,1750,700,1915,0,98119,47.6386,-122.36,1760,3573,241,1813,348.19769602378295,0.11304918032786886,Cheap
20141201T000000,667000.0,3,1.0,1400,1581,1.5,0,0,5,8,1400,0,1909,0,98112,47.6221,-122.314,1860,3861,181,2001,421.88488298545224,0.07763934426229509,Very Cheap
20140624T000000,438000.0,3,1.75,1520,6380,1.0,0,0,3,7,790,730,1948,0,98115,47.695,-122.304,1520,6235,4860,4715,68.65203761755485,0.04760655737704918,Very Cheap
20150302T000000,719000.0,4,2.5,2570,7173,2.0,0,0,3,8,2570,0,2005,0,98052,47.7073,-122.11,2630,6026,4603,3396,100.23699986058831,0.08445901639344262,Very Cheap
20141110T000000,580500.0,3,2.5,2320,3980,2.0,0,0,3,8,2320,0,2003,0,98027,47.5391,-122.07,2580,3980,1660,1400,145.85427135678393,0.06629508196721312,Very Cheap
20141201T000000,280000.0,2,1.5,1190,1265,3.0,0,0,3,7,1190,0,2005,0,98133,47.7274,-122.357,1390,1756,75,366,221.34387351778656,0.026885245901639345,Very Cheap
20140624T000000,687500.0,4,1.75,2330,5000,1.5,0,0,4,7,1510,820,1929,0,98117,47.6823,-122.368,1460,5000,2670,3540,137.5,0.08032786885245902,Very Cheap
20141110T000000,535000.0,3,1.0,1090,3000,1.5,0,0,4,8,1090,0,1929,0,98117,47.6889,-122.375,1570,5080,1910,3510,178.33333333333334,0.06032786885245902,Very Cheap
20141203T000000,322500.0,4,2.75,2060,6659,1.0,0,0,3,7,1280,780,1981,0,98058,47.4276,-122.157,2020,8720,4599,6700,48.43069529959453,0.032459016393442626,Very Cheap
20140613T000000,696000.0,3,2.5,2300,3060,1.5,0,0,3,8,1510,790,1930,2002,98115,47.6827,-122.31,1590,3264,760,1674,227.45098039215685,0.08144262295081967,Very Cheap
20140528T000000,550000.0,4,1.0,1660,34848,1.0,0,0,1,5,930,730,1933,0,98052,47.6621,-122.132,2160,11467,33188,9307,15.782828282828282,0.06229508196721312,Very Cheap
20141230T000000,640000.0,4,2.0,2360,6000,2.0,0,0,4,8,2360,0,1904,0,98107,47.6702,-122.362,1730,4700,3640,2970,106.66666666666667,0.0740983606557377,Very Cheap
20150213T000000,240000.0,4,1.0,1220,8075,1.0,0,0,2,7,890,330,1969,0,98001,47.3341,-122.282,1290,7800,6855,6510,29.721362229102166,0.021639344262295083,Very Cheap
20140620T000000,605000.0,4,2.5,2620,7553,2.0,0,0,3,8,2620,0,1996,0,98056,47.5301,-122.18,2620,11884,4933,9264,80.10062226929696,0.06950819672131148,Very Cheap
20140715T000000,625000.0,4,2.5,2570,5520,2.0,0,0,3,9,2570,0,2000,0,98074,47.6145,-122.027,2470,5669,2950,3199,113.22463768115942,0.07213114754098361,Very Cheap
20140811T000000,775000.0,4,2.25,4220,24186,1.0,0,0,3,8,2600,1620,1984,0,98166,47.445,-122.347,2410,30617,19966,28207,32.04333085255933,0.09180327868852459,Very Cheap
20140707T000000,861990.0,5,2.75,3595,5639,2.0,0,0,3,9,3595,0,2014,0,98053,47.6848,-122.016,3625,5639,2044,2014,152.86220961163326,0.10321180327868852,Cheap
20141028T000000,685000.0,3,1.0,1570,2280,2.0,0,0,3,7,1570,0,1922,0,98119,47.6413,-122.364,1580,2640,710,1060,300.43859649122805,0.08,Very Cheap
20140729T000000,309000.0,3,1.0,1280,9656,1.0,0,0,4,6,920,360,1959,0,98058,47.4485,-122.175,1340,8808,8376,7468,32.00082850041425,0.030688524590163933,Very Cheap
20140718T000000,488000.0,3,2.5,3160,13603,2.0,0,0,3,8,3160,0,2003,0,98019,47.7443,-121.977,3050,9232,10443,6182,35.874439461883405,0.05416393442622951,Very Cheap
20150325T000000,210490.0,3,1.0,990,8528,1.0,0,0,3,6,990,0,1966,0,98023,47.3066,-122.371,1228,8840,7538,7612,24.682223264540337,0.017769180327868853,Very Cheap
20140716T000000,785000.0,4,2.5,2290,13416,2.0,0,0,4,9,2290,0,1981,0,98007,47.6194,-122.151,2680,13685,11126,11005,58.512224209898626,0.09311475409836066,Very Cheap
20150428T000000,450000.0,3,1.75,1250,5963,1.0,0,0,4,7,1250,0,1953,0,98115,47.6796,-122.301,970,5100,4713,4130,75.46536978031192,0.04918032786885246,Very Cheap
20150311T000000,1350000.0,3,2.5,2753,65005,1.0,1,2,5,9,2165,588,1953,0,98070,47.4041,-122.451,2680,72513,62252,69833,20.76763325898008,0.16721311475409836,Cheap
20140916T000000,228000.0,3,1.0,1190,9199,1.0,0,0,3,7,1190,0,1955,0,98148,47.4258,-122.322,1190,9364,8009,8174,24.785302750298946,0.020065573770491802,Very Cheap
20150217T000000,345000.0,5,2.5,3150,9134,1.0,0,0,4,8,1640,1510,1966,0,98056,47.4934,-122.189,1990,9133,5984,7143,37.77096562294723,0.03540983606557377,Very Cheap
20141231T000000,600000.0,3,1.75,1410,4080,1.0,0,0,4,7,1000,410,1950,0,98117,47.6808,-122.384,1410,4080,2670,2670,147.05882352941177,0.06885245901639345,Very Cheap
20150205T000000,585000.0,2,1.75,1980,8550,1.0,0,0,3,7,990,990,1981,0,98117,47.6989,-122.369,1480,6738,6570,5258,68.42105263157895,0.06688524590163934,Very Cheap
20150303T000000,920000.0,5,2.25,2730,6000,1.5,0,0,3,8,2130,600,1927,0,98105,47.6571,-122.281,2730,6000,3270,3270,153.33333333333334,0.11081967213114755,Cheap
20140512T000000,885000.0,4,2.5,2830,5000,2.0,0,0,3,9,2830,0,1995,0,98105,47.6597,-122.29,1950,5000,2170,3050,177.0,0.1062295081967213,Cheap
20140819T000000,292500.0,4,2.5,2250,4495,2.0,0,0,3,7,2250,0,2008,0,98042,47.3663,-122.114,2250,4500,2245,2250,65.07230255839822,0.028524590163934428,Very Cheap
20150407T000000,301000.0,3,2.5,2420,4750,2.0,0,0,3,8,2420,0,2003,0,98042,47.3663,-122.122,2690,4750,2330,2060,63.36842105263158,0.029639344262295083,Very Cheap
20140827T000000,951000.0,5,3.25,3250,14342,2.0,0,4,4,8,3250,0,1968,0,98008,47.588,-122.116,2960,11044,11092,8084,66.30874355041138,0.11488524590163934,Cheap
20150223T000000,430000.0,4,3.0,1850,9976,2.0,0,0,3,8,1850,0,1991,0,98059,47.5059,-122.149,2270,8542,8126,6272,43.10344827586207,0.04655737704918033,Very Cheap
20141210T000000,650000.0,3,2.25,2150,21235,1.0,0,3,4,8,1590,560,1959,0,98166,47.4336,-122.339,2570,18900,19085,16330,30.609842241582292,0.07540983606557378,Very Cheap
20140828T000000,289000.0,3,1.75,1260,8400,1.0,0,0,3,7,1260,0,1954,0,98148,47.4366,-122.335,1290,8750,7140,7460,34.404761904761905,0.028065573770491802,Very Cheap
20141021T000000,505000.0,3,1.75,2519,8690,2.0,0,0,5,8,2519,0,1973,0,98166,47.4428,-122.344,2500,9500,6171,7000,58.11277330264672,0.05639344262295082,Very Cheap
20141207T000000,549000.0,3,1.75,1540,1044,3.0,0,0,3,8,1540,0,2014,0,98115,47.6765,-122.32,1580,3090,-496,1510,525.8620689655172,0.06216393442622951,Very Cheap
20140603T000000,425000.0,3,2.25,1660,6000,1.0,0,0,3,7,1110,550,1979,0,98122,47.6113,-122.297,1440,4080,4340,2640,70.83333333333333,0.04590163934426229,Very Cheap
20141120T000000,317625.0,3,2.75,2770,3809,1.5,0,0,5,7,1770,1000,1925,0,98144,47.5747,-122.304,1440,4000,1039,2560,83.38802835389866,0.031819672131147544,Very Cheap
20140909T000000,975000.0,4,2.5,2720,11049,2.0,0,0,3,10,2720,0,1989,0,98004,47.5815,-122.192,2750,11049,8329,8299,88.24327993483573,0.1180327868852459,Cheap
20141009T000000,287000.0,4,2.5,2240,4648,2.0,0,0,3,7,2240,0,2005,0,98001,47.3378,-122.257,2221,4557,2408,2336,61.74698795180723,0.02780327868852459,Very Cheap
20140825T000000,204000.0,3,1.0,1000,12070,1.0,0,0,4,7,1000,0,1968,0,98042,47.3621,-122.11,1010,12635,11070,11625,16.901408450704224,0.016918032786885247,Very Cheap
20140612T000000,1325000.0,5,2.25,3200,20158,1.0,0,0,3,8,1600,1600,1965,0,98004,47.6303,-122.215,3390,20158,16958,16768,65.73072725468796,0.16393442622950818,Cheap
20140912T000000,1040000.0,5,3.25,4770,50094,1.0,0,0,4,11,3070,1700,1973,0,98005,47.6525,-122.16,3530,38917,45324,35387,20.760969377570166,0.12655737704918033,Cheap
20150105T000000,325000.0,3,2.0,1260,5612,1.0,0,0,4,7,1260,0,1972,0,98034,47.7362,-122.179,1640,4745,4352,3105,57.91161796151105,0.03278688524590164,Very Cheap
20140610T000000,571000.0,4,2.0,2750,7807,1.5,0,0,5,7,2250,500,1916,0,98125,47.7168,-122.287,1510,7807,5057,6297,73.13949020110158,0.06504918032786886,Very Cheap
20140710T000000,360000.0,4,2.5,2380,5000,2.0,0,0,3,8,2380,0,2005,0,98038,47.3608,-122.036,2420,5000,2620,2580,72.0,0.037377049180327866,Very Cheap
20150316T000000,349000.0,3,1.75,1790,50529,1.0,0,0,5,7,1090,700,1965,0,98042,47.3511,-122.073,1940,50529,48739,48589,6.906924736290051,0.035934426229508196,Very Cheap
20141105T000000,832500.0,4,4.0,3430,35102,2.0,0,0,4,10,2390,1040,1986,0,98075,47.5822,-121.987,3240,35020,31672,31780,23.716597344880633,0.09934426229508196,Very Cheap
20141013T000000,380000.0,4,1.75,1760,7300,1.0,0,0,3,7,880,880,1956,0,98008,47.6034,-122.125,1680,7500,5540,5820,52.054794520547944,0.04,Very Cheap
20150420T000000,480000.0,3,1.0,1040,5060,1.0,0,0,3,7,1040,0,1941,0,98116,47.5636,-122.394,890,5060,4020,4170,94.86166007905139,0.05311475409836065,Very Cheap
20140609T000000,410000.0,3,1.0,1410,5060,1.0,0,0,4,7,910,500,1956,0,98133,47.7073,-122.34,1130,5693,3650,4563,81.02766798418972,0.043934426229508196,Very Cheap
20150323T000000,720000.0,4,2.5,3450,39683,2.0,0,0,3,10,3450,0,2002,0,98010,47.342,-122.025,3350,39750,36233,36400,18.143789532041428,0.08459016393442623,Very Cheap
20141202T000000,390000.0,3,2.5,2350,5100,2.0,0,0,3,8,2350,0,2003,0,98038,47.3512,-122.008,2350,5363,2750,3013,76.47058823529412,0.04131147540983607,Very Cheap
20141222T000000,360000.0,4,2.5,1900,5889,2.0,0,0,3,7,1900,0,1992,0,98038,47.349,-122.031,1870,6405,3989,4535,61.130922058074376,0.037377049180327866,Very Cheap
20141028T000000,355000.0,2,1.0,2020,6720,1.0,0,0,3,7,1010,1010,1948,0,98118,47.5474,-122.291,1720,6720,4700,5000,52.82738095238095,0.036721311475409836,Very Cheap
20150128T000000,356000.0,3,1.5,1680,8712,1.0,0,0,3,8,1680,0,1964,0,98059,47.4811,-122.149,1850,8797,7032,6947,40.86317722681359,0.03685245901639344,Very Cheap
20140602T000000,315000.0,3,1.0,960,6634,1.0,0,0,3,6,960,0,1952,0,98125,47.7264,-122.31,1570,7203,5674,5633,47.482665058788065,0.031475409836065574,Very Cheap
20141114T000000,940000.0,3,1.5,2140,3600,2.0,0,0,3,9,1900,240,1925,0,98119,47.6337,-122.365,2020,4800,1460,2780,261.1111111111111,0.11344262295081967,Cheap
20141103T000000,305000.0,5,2.25,2660,8400,1.5,0,0,5,7,2660,0,1961,0,98092,47.2909,-122.189,1590,8165,5740,6575,36.30952380952381,0.03016393442622951,Very Cheap
20140618T000000,461000.0,3,3.25,2770,6278,2.0,0,0,3,9,1980,790,2006,0,98056,47.5228,-122.199,1900,7349,3508,5449,73.43102899012425,0.05062295081967213,Very Cheap
20140519T000000,215000.0,2,2.25,1610,2040,2.0,0,0,4,7,1610,0,1979,0,98056,47.518,-122.194,1950,2025,430,75,105.3921568627451,0.018360655737704918,Very Cheap
20140904T000000,335000.0,2,1.75,1030,1066,2.0,0,0,3,7,765,265,2006,0,98136,47.5394,-122.387,1030,1106,36,76,314.25891181988743,0.03409836065573771,Very Cheap
20140522T000000,243500.0,4,2.5,1980,7403,2.0,0,0,3,7,1980,0,1988,0,98023,47.2897,-122.372,1980,7510,5423,5530,32.89207078211536,0.022098360655737705,Very Cheap
20150311T000000,1099880.0,5,2.75,3520,6353,2.0,0,0,4,10,3520,0,2001,0,98199,47.6506,-122.391,2520,6250,2833,3730,173.12765622540533,0.1344104918032787,Cheap
20150226T000000,153000.0,3,1.0,1200,10500,1.0,0,0,3,7,1200,0,1962,0,98023,47.322,-122.351,1350,10500,9300,9150,14.571428571428571,0.010229508196721311,Very Cheap
20140725T000000,430000.0,3,1.5,1580,5000,1.0,0,0,3,8,1290,290,1939,0,98117,47.687,-122.386,1570,4500,3420,2930,86.0,0.04655737704918033,Very Cheap
20141223T000000,700000.0,3,1.5,1580,5000,1.0,0,0,3,8,1290,290,1939,0,98117,47.687,-122.386,1570,4500,3420,2930,140.0,0.08196721311475409,Very Cheap
20140908T000000,905000.0,4,2.5,3300,10250,1.0,0,0,3,7,2390,910,1946,1991,98040,47.5873,-122.249,1950,6045,6950,4095,88.29268292682927,0.10885245901639344,Cheap
20150330T000000,247500.0,3,1.75,1960,15681,1.0,0,0,3,7,1960,0,1967,0,98032,47.3576,-122.277,1750,15616,13721,13866,15.783432179070212,0.02262295081967213,Very Cheap
20140912T000000,199000.0,4,1.5,1160,6400,1.0,0,0,4,7,1160,0,1975,0,98023,47.3036,-122.378,1160,6400,5240,5240,31.09375,0.016262295081967214,Very Cheap
20140711T000000,314000.0,3,1.75,1810,41800,1.0,0,0,5,7,1210,600,1980,0,98038,47.4109,-121.958,1650,135036,39990,133386,7.511961722488039,0.03134426229508197,Very Cheap
20140516T000000,437500.0,3,2.5,2320,36847,2.0,0,2,3,9,2320,0,1992,0,98045,47.4838,-121.714,2550,35065,34527,32515,11.873422531006595,0.047540983606557376,Very Cheap
20140611T000000,850830.0,3,2.5,2070,13241,1.5,0,0,5,9,1270,800,1910,0,98102,47.6415,-122.315,2200,4500,11171,2300,64.25723132693905,0.10174819672131148,Cheap
20141027T000000,555000.0,3,2.0,1980,3478,1.5,0,0,4,7,1440,540,1929,0,98117,47.6775,-122.372,1610,3478,1498,1868,159.5744680851064,0.06295081967213115,Very Cheap
20141212T000000,699950.0,3,2.25,2190,107593,2.0,0,0,4,8,2190,0,1983,0,98077,47.7731,-122.08,2570,47777,105403,45207,6.505534746684264,0.08196065573770492,Very Cheap
20141007T000000,1088000.0,3,2.5,2920,8113,2.0,0,0,3,8,2920,0,1950,2010,98004,47.5814,-122.196,2370,8113,5193,5743,134.10575619376309,0.13285245901639345,Cheap
20140924T000000,290000.0,3,1.0,1210,33919,1.0,0,0,3,7,1210,0,1954,0,98058,47.4375,-122.184,1640,14910,32709,13270,8.549780359090775,0.02819672131147541,Very Cheap
20150402T000000,375000.0,3,2.5,2340,10005,1.0,0,0,4,8,1460,880,1978,0,98058,47.4431,-122.133,2250,8162,7665,5912,37.481259370314845,0.03934426229508197,Very Cheap
20140523T000000,460000.0,3,1.0,1670,4005,1.5,0,0,4,7,1170,500,1939,0,98117,47.6878,-122.38,1240,4005,2335,2765,114.85642946317104,0.050491803278688525,Very Cheap
20140723T000000,188500.0,2,1.75,1240,2493,1.0,0,0,4,8,1240,0,1985,0,98198,47.3813,-122.322,1270,4966,1253,3696,75.61171279582832,0.014885245901639345,Very Cheap
20150305T000000,680000.0,4,2.5,3140,28037,2.0,0,0,4,10,3140,0,1991,0,98077,47.7304,-122.082,2990,35001,24897,32011,24.253664800085602,0.07934426229508197,Very Cheap
20140827T000000,470000.0,5,1.75,2030,12342,2.0,0,0,4,7,2030,0,1942,0,98052,47.6417,-122.109,2500,9433,10312,6933,38.08134824177605,0.05180327868852459,Very Cheap
20140725T000000,597750.0,4,2.5,2310,9624,2.0,0,0,3,8,2310,0,1984,0,98027,47.5386,-122.053,1940,9636,7314,7696,62.11034912718205,0.06855737704918033,Very Cheap
20150304T000000,570000.0,3,1.75,1260,3328,1.0,0,0,5,6,700,560,1905,0,98103,47.6823,-122.349,1380,3536,2068,2156,171.27403846153845,0.06491803278688525,Very Cheap
20140916T000000,272500.0,3,1.75,1540,12600,1.0,0,0,4,7,1160,380,1980,0,98038,47.3624,-122.031,1540,11656,11060,10116,21.626984126984127,0.025901639344262296,Very Cheap
20141124T000000,329950.0,3,1.75,2080,5969,1.0,0,2,3,7,1080,1000,1971,0,98108,47.5474,-122.295,2090,5500,3889,3410,55.27726587368068,0.03343606557377049,Very Cheap
20141028T000000,480000.0,4,2.5,3230,16171,2.0,0,3,3,9,2520,710,2001,0,98001,47.3183,-122.253,2640,8517,12941,5877,29.682765444313894,0.05311475409836065,Very Cheap
20141121T000000,740500.0,3,3.5,4380,6350,2.0,0,0,3,8,2780,1600,1900,1999,98117,47.6981,-122.368,1830,6350,1970,4520,116.61417322834646,0.08727868852459017,Very Cheap
20140626T000000,518500.0,3,3.5,1590,1102,3.0,0,0,3,8,1590,0,2010,0,98103,47.6824,-122.347,1620,3166,-488,1546,470.508166969147,0.05816393442622951,Very Cheap
20140623T000000,205425.0,2,1.0,880,6780,1.0,0,0,4,6,880,0,1945,0,98178,47.5009,-122.248,1190,6780,5900,5590,30.298672566371682,0.017104918032786885,Very Cheap
20150108T000000,171800.0,4,2.0,1570,9600,1.0,0,0,3,6,1570,0,1950,0,98168,47.4965,-122.303,1880,9000,8030,7120,17.895833333333332,0.012695081967213116,Very Cheap
20150511T000000,535000.0,4,1.0,1610,2982,1.5,0,0,4,7,1610,0,1925,0,98144,47.587,-122.294,1610,4040,1372,2430,179.40979208584844,0.06032786885245902,Very Cheap
20150102T000000,660000.0,3,2.5,2400,6474,1.0,0,2,3,8,1560,840,1964,0,98177,47.7728,-122.386,2340,10856,4074,8516,101.94624652455978,0.07672131147540984,Very Cheap
20141119T000000,391500.0,3,2.0,1450,9132,1.0,0,0,3,7,1450,0,1987,0,98034,47.7288,-122.226,1580,9104,7682,7524,42.8712220762155,0.04150819672131147,Very Cheap
20150406T000000,395000.0,2,1.0,770,6000,1.0,0,0,3,6,770,0,1953,0,98117,47.6999,-122.364,1710,6000,5230,4290,65.83333333333333,0.0419672131147541,Very Cheap
20141104T000000,445000.0,4,1.75,2100,4400,1.5,0,0,5,7,1720,380,1924,0,98118,47.5299,-122.266,1850,4400,2300,2550,101.13636363636364,0.04852459016393443,Very Cheap
20140618T000000,770000.0,3,2.25,2910,10204,2.0,0,0,3,9,2910,0,1990,0,98052,47.6897,-122.098,2700,13992,7294,11292,75.46060368482948,0.09114754098360656,Very Cheap
20150302T000000,1450000.0,4,2.75,2750,17789,1.5,0,0,3,8,1980,770,1914,1992,98004,47.6141,-122.212,3060,11275,15039,8215,81.51104615211648,0.18032786885245902,Cheap
20140717T000000,445000.0,3,2.25,2100,8201,1.0,0,2,3,8,1620,480,1967,0,98178,47.5091,-122.244,2660,8712,6101,6052,54.26167540543836,0.04852459016393443,Very Cheap
20140717T000000,260000.0,4,2.25,2160,8811,1.0,0,0,3,8,1360,800,1978,0,98023,47.3129,-122.39,2090,8400,6651,6310,29.50856883441153,0.024262295081967214,Very Cheap
20140613T000000,822500.0,5,3.5,2320,4960,2.0,0,0,5,7,1720,600,1926,0,98103,47.6763,-122.352,1700,4960,2640,3260,165.8266129032258,0.0980327868852459,Very Cheap
20150406T000000,430000.0,4,2.5,2070,4310,2.0,0,0,3,7,2070,0,2004,0,98065,47.5319,-121.85,1970,3748,2240,1778,99.76798143851508,0.04655737704918033,Very Cheap
20150105T000000,212000.0,3,1.75,1060,7875,1.0,0,0,4,7,1060,0,1986,0,98092,47.2761,-122.152,1420,7680,6815,6260,26.92063492063492,0.017967213114754098,Very Cheap
20150428T000000,660500.0,4,2.25,2010,9603,1.0,0,0,3,8,1440,570,1986,0,98027,47.5343,-122.054,2060,9793,7593,7733,68.7805893991461,0.07678688524590165,Very Cheap
20140612T000000,784000.0,3,3.5,3950,111078,1.5,0,0,3,9,2460,1490,1989,0,98052,47.697,-122.072,2480,88500,107128,86020,7.0581033147878065,0.09298360655737704,Very Cheap
20140512T000000,453246.0,3,2.5,2010,2287,2.0,0,0,3,8,1390,620,2014,0,98029,47.5517,-121.998,1690,1662,277,-28,198.18364669873196,0.049606032786885246,Very Cheap
20150126T000000,675000.0,4,3.5,2140,2278,3.0,0,0,3,9,2140,0,2005,0,98107,47.6734,-122.38,1540,2285,138,745,296.31255487269533,0.07868852459016394,Very Cheap
20140813T000000,199000.0,3,1.75,1320,17390,1.0,0,0,4,7,1320,0,1956,0,98003,47.3257,-122.296,1550,19265,16070,17715,11.44335825186889,0.016262295081967214,Very Cheap
20140805T000000,220000.0,4,1.75,2020,7840,1.0,0,0,3,7,1010,1010,1968,0,98003,47.3309,-122.299,1750,8140,5820,6390,28.06122448979592,0.01901639344262295,Very Cheap
20140529T000000,452000.0,4,2.25,2590,10002,1.0,0,0,4,8,1340,1250,1968,0,98028,47.7689,-122.266,1550,10436,7412,8886,45.19096180763847,0.04944262295081967,Very Cheap
20140707T000000,382500.0,2,1.0,1190,4440,1.0,0,0,3,6,1190,0,1981,0,98125,47.7135,-122.287,1060,5715,3250,4655,86.14864864864865,0.040327868852459016,Very Cheap
20140507T000000,519950.0,3,2.25,1170,1249,3.0,0,0,3,8,1170,0,2014,0,98107,47.6722,-122.381,1350,1310,79,-40,416.293034427542,0.058354098360655735,Very Cheap
20140627T000000,665000.0,2,1.0,1110,3200,1.0,0,0,3,7,1110,0,1925,0,98119,47.6338,-122.358,1170,3600,2090,2430,207.8125,0.07737704918032787,Very Cheap
20140708T000000,527700.0,5,2.5,2820,9375,1.0,0,0,4,8,1550,1270,1968,0,98006,47.5707,-122.128,2820,9375,6555,6555,56.288,0.05937049180327869,Very Cheap
20150508T000000,205000.0,3,1.0,1610,8579,1.0,0,0,4,7,1010,600,1962,0,98058,47.4563,-122.171,1610,8579,6969,6969,23.89555892295139,0.017049180327868854,Very Cheap
20150415T000000,420000.0,3,1.0,1060,8097,1.0,0,0,4,7,940,120,1923,0,98133,47.7144,-122.351,1560,7940,7037,6380,51.871063356798814,0.04524590163934426,Very Cheap
20150227T000000,500000.0,4,2.25,2030,8517,1.0,0,0,4,8,1380,650,1961,0,98006,47.5495,-122.174,2230,8824,6487,6594,58.70611717740989,0.05573770491803279,Very Cheap
20141203T000000,921500.0,4,2.5,3670,315374,2.0,0,0,4,9,3670,0,1994,0,98077,47.7421,-122.026,2840,87991,311704,85151,2.921927616100249,0.11101639344262296,Cheap
20140625T000000,890000.0,4,1.0,2550,4000,2.0,0,0,3,8,2370,180,1905,0,98109,47.6354,-122.353,2200,4000,1450,1800,222.5,0.10688524590163935,Cheap
20140806T000000,430000.0,2,2.5,2420,60984,2.0,0,0,3,7,2420,0,2007,0,98027,47.5262,-121.943,1940,193842,58564,191902,7.051029778302506,0.04655737704918033,Very Cheap
20141030T000000,258000.0,5,2.0,2260,12500,1.0,0,0,4,8,1130,1130,1960,0,98032,47.3887,-122.286,1360,18000,10240,16640,20.64,0.024,Very Cheap
20141104T000000,511000.0,3,1.0,1430,3455,1.0,0,0,3,7,980,450,1947,0,98103,47.6873,-122.336,1450,4599,2025,3149,147.9015918958032,0.05718032786885246,Very Cheap
20140820T000000,532170.0,3,2.0,1360,3090,2.0,0,0,3,8,1360,0,1990,0,98103,47.6838,-122.353,1500,3090,1730,1590,172.2233009708738,0.05995672131147541,Very Cheap
20150409T000000,560000.0,3,1.0,1110,5000,1.5,0,0,3,7,1110,0,1947,0,98107,47.655,-122.359,1420,5000,3890,3580,112.0,0.06360655737704918,Very Cheap
20150331T000000,282950.0,3,1.0,1250,8200,1.0,0,0,4,7,1250,0,1954,0,98003,47.3255,-122.304,1680,8633,6950,6953,34.50609756097561,0.027272131147540984,Very Cheap
20150401T000000,2250000.0,4,3.25,5180,19850,2.0,0,3,3,12,3540,1640,2006,0,98006,47.562,-122.162,3160,9750,14670,6590,113.35012594458438,0.28524590163934427,Cheap
20140516T000000,350000.0,1,1.0,700,5100,1.0,0,0,3,7,700,0,1942,0,98115,47.679,-122.3,1010,5100,4400,4090,68.62745098039215,0.036065573770491806,Very Cheap
20140728T000000,215000.0,3,1.0,1180,7669,1.0,0,0,4,7,1180,0,1967,0,98058,47.4479,-122.176,1190,7669,6489,6479,28.034945886034684,0.018360655737704918,Very Cheap
20141120T000000,650000.0,5,3.5,3960,25245,2.0,0,0,3,9,2500,1460,1996,0,98056,47.525,-122.172,2640,13675,21285,11035,25.747672806496336,0.07540983606557378,Very Cheap
20140807T000000,320000.0,4,2.75,2640,7500,1.0,0,0,3,8,1620,1020,1967,0,98023,47.3135,-122.369,1980,7875,4860,5895,42.666666666666664,0.032131147540983604,Very Cheap
20141113T000000,247000.0,3,2.0,1270,7198,1.5,0,0,3,7,1270,0,1916,2013,98022,47.2086,-121.996,1160,7198,5928,6038,34.31508752431231,0.022557377049180326,Very Cheap
20141003T000000,320000.0,4,1.75,1760,11180,1.0,0,0,4,8,1760,0,1968,0,98059,47.4715,-122.118,1730,11180,9420,9450,28.622540250447226,0.032131147540983604,Very Cheap
20140507T000000,255000.0,5,2.25,2060,8632,1.0,0,0,3,7,1030,1030,1962,0,98146,47.4877,-122.335,1010,11680,6572,10670,29.54124189063948,0.02360655737704918,Very Cheap
20150309T000000,438000.0,3,1.75,1780,9660,1.0,0,0,3,7,1780,0,1962,0,98034,47.7171,-122.193,1200,9660,7880,8460,45.3416149068323,0.04760655737704918,Very Cheap
20150304T000000,900000.0,3,2.5,3400,16603,2.0,0,0,3,10,3400,0,2000,0,98075,47.6012,-122.023,3400,12601,13203,9201,54.207071011263025,0.10819672131147541,Cheap
20140620T000000,441000.0,3,2.75,1910,7280,1.0,0,0,3,7,1160,750,1979,0,98034,47.7319,-122.224,1710,8152,5370,6442,60.57692307692308,0.048,Very Cheap
20140812T000000,420000.0,3,2.0,2020,38332,1.0,0,0,4,7,1010,1010,1975,0,98027,47.4582,-122.023,2110,36590,36312,34480,10.95690284879474,0.04524590163934426,Very Cheap
20141208T000000,370000.0,3,1.75,1580,7000,1.0,0,0,3,7,1180,400,1976,0,98034,47.7209,-122.168,1640,7500,5420,5860,52.857142857142854,0.038688524590163934,Very Cheap
20150219T000000,269950.0,2,1.75,1340,7250,1.0,0,0,5,5,700,640,1949,0,98198,47.408,-122.327,1830,9750,5910,7920,37.234482758620686,0.025567213114754097,Very Cheap
20150324T000000,807100.0,4,2.5,2680,4499,2.0,0,0,3,9,2680,0,1999,0,98006,47.565,-122.125,2920,4500,1819,1580,179.39542120471216,0.09601311475409836,Very Cheap
20140605T000000,653000.0,3,2.5,2680,9750,1.0,0,0,4,8,1610,1070,1979,0,98034,47.7028,-122.231,2480,8750,7070,6270,66.97435897435898,0.07580327868852459,Very Cheap
20140611T000000,371500.0,3,2.0,1370,8336,1.0,0,0,5,7,1370,0,1964,0,98133,47.7458,-122.331,1770,7288,6966,5518,44.56573896353167,0.038885245901639345,Very Cheap
20150316T000000,284000.0,3,1.75,1560,21000,1.0,0,0,3,7,1560,0,1954,0,98166,47.4776,-122.337,1070,7920,19440,6850,13.523809523809524,0.027409836065573772,Very Cheap
20150102T000000,272000.0,3,1.75,2160,7140,1.0,0,0,4,7,1670,490,1978,0,98023,47.3026,-122.374,1930,7350,4980,5420,38.095238095238095,0.02583606557377049,Very Cheap
20140502T000000,313000.0,3,1.5,1340,7912,1.5,0,0,3,7,1340,0,1955,0,98133,47.7658,-122.339,1480,7940,6572,6460,39.56016177957533,0.03121311475409836,Very Cheap
20150116T000000,917500.0,4,2.5,3880,35003,2.0,0,0,3,10,2570,1310,1984,0,98033,47.6477,-122.182,3740,35230,31123,31490,26.21203896808845,0.11049180327868853,Cheap
20140929T000000,673000.0,4,2.25,2590,8190,2.0,0,0,4,8,2590,0,1980,0,98006,47.5619,-122.125,2260,8335,5600,6075,82.17338217338218,0.07842622950819672,Very Cheap
20150210T000000,425000.0,3,2.5,1120,1100,2.0,0,0,3,8,820,300,2008,0,98122,47.6106,-122.31,1590,1795,-20,205,386.3636363636364,0.04590163934426229,Very Cheap
20140709T000000,399950.0,5,2.75,1970,5400,1.0,0,0,3,7,1320,650,1986,0,98144,47.5868,-122.308,1280,2150,3430,870,74.06481481481481,0.04261639344262295,Very Cheap
20140530T000000,385000.0,3,1.0,1220,4800,1.0,0,0,3,6,1220,0,1901,0,98122,47.6101,-122.307,1200,4800,3580,3600,80.20833333333333,0.04065573770491803,Very Cheap
20141117T000000,269950.0,3,1.5,1950,7560,1.0,0,2,4,7,1320,630,1975,0,98022,47.1976,-121.999,1950,8941,5610,6991,35.707671957671955,0.025567213114754097,Very Cheap
20150107T000000,330000.0,2,1.0,1350,8220,1.0,0,0,3,7,1060,290,1949,0,98177,47.7224,-122.358,1540,8280,6870,6740,40.14598540145985,0.03344262295081967,Very Cheap
20140725T000000,260000.0,3,2.5,1670,5797,2.0,0,0,3,7,1670,0,1988,0,98030,47.3505,-122.179,1670,6183,4127,4513,44.850784888735554,0.024262295081967214,Very Cheap
20150414T000000,470000.0,4,3.0,2380,5125,1.5,0,0,4,7,1680,700,1925,0,98126,47.5384,-122.376,1410,5375,2745,3965,91.70731707317073,0.05180327868852459,Very Cheap
20140613T000000,589000.0,4,3.0,2440,9600,2.0,0,0,5,7,2440,0,1961,0,98034,47.7044,-122.2,2290,9600,7160,7310,61.354166666666664,0.06740983606557377,Very Cheap
20140723T000000,163500.0,2,1.5,1050,3419,2.0,0,0,3,7,1050,0,1996,0,98038,47.3848,-122.039,1050,3417,2369,2367,47.821000292483184,0.01160655737704918,Very Cheap
20140905T000000,835000.0,4,2.75,3130,13412,2.0,0,0,3,9,2140,990,1993,0,98052,47.6993,-122.102,2260,9984,10282,7724,62.257679689830006,0.09967213114754099,Very Cheap
20141121T000000,1095000.0,5,3.0,4090,12850,1.0,0,2,4,10,2090,2000,1986,0,98033,47.6627,-122.188,2540,10270,8760,7730,85.21400778210116,0.13377049180327868,Cheap
20150415T000000,269000.0,4,1.75,1490,10000,1.0,0,0,4,8,1100,390,1969,0,98023,47.3099,-122.379,2190,8910,8510,6720,26.9,0.02544262295081967,Very Cheap
20140505T000000,560000.0,3,2.5,1900,8744,2.0,0,0,3,8,1900,0,1987,0,98074,47.62,-122.043,2030,8744,6844,6714,64.04391582799634,0.06360655737704918,Very Cheap
20150418T000000,615000.0,4,1.0,1330,2400,1.5,0,0,4,6,1330,0,1901,0,98103,47.65,-122.34,1330,4400,1070,3070,256.25,0.07081967213114754,Very Cheap
20141205T000000,585188.0,3,2.25,2230,10026,1.0,0,0,3,8,1430,800,1975,0,98052,47.6647,-122.153,2230,9340,7796,7110,58.3670456812288,0.06690990163934427,Very Cheap
20140818T000000,305000.0,3,1.75,1650,9480,1.0,0,0,3,7,1220,430,1977,0,98034,47.726,-122.191,1540,8400,7830,6860,32.17299578059072,0.03016393442622951,Very Cheap
20141105T000000,166950.0,3,1.0,1190,8820,1.0,0,0,3,6,1190,0,1959,0,98058,47.4616,-122.184,1230,7980,7630,6750,18.928571428571427,0.012059016393442623,Very Cheap
20140912T000000,799000.0,3,2.5,2140,9897,1.0,0,0,4,8,2140,0,1959,0,98040,47.5505,-122.219,2680,10083,7757,7403,80.73153480852784,0.09495081967213115,Very Cheap
20140625T000000,400000.0,3,2.5,2180,7508,1.0,0,0,4,7,1420,760,1962,0,98133,47.7606,-122.336,1900,7818,5328,5918,53.27650506126798,0.04262295081967213,Very Cheap
20141201T000000,230000.0,3,1.0,1060,10228,1.0,0,0,3,7,1060,0,1948,0,98155,47.7481,-122.3,1570,10228,9168,8658,22.48728979272585,0.020327868852459016,Very Cheap
20140515T000000,256883.0,3,2.5,1690,5025,2.0,0,0,3,8,1690,0,2003,0,98023,47.2779,-122.347,2550,5001,3335,2451,51.12099502487562,0.023853508196721312,Very Cheap
20141111T000000,423000.0,4,2.0,1970,6480,1.5,0,0,5,7,1130,840,1920,0,98108,47.5511,-122.312,1500,6480,4510,4980,65.27777777777777,0.04563934426229508,Very Cheap
20140723T000000,465000.0,3,2.5,2150,4084,2.0,0,0,3,8,2150,0,2007,0,98126,47.5488,-122.372,1750,2385,1934,635,113.85896180215475,0.051147540983606556,Very Cheap
20150113T000000,440000.0,3,2.5,1910,66211,2.0,0,0,3,7,1910,0,1997,0,98024,47.5385,-121.911,2330,67268,64301,64938,6.645421455649363,0.04786885245901639,Very Cheap
20141014T000000,385000.0,3,1.75,1350,155073,1.0,0,0,4,7,1350,0,1969,0,98038,47.4058,-121.994,1560,50965,153723,49405,2.482701695330586,0.04065573770491803,Very Cheap
20150311T000000,210000.0,3,1.0,860,11725,1.0,0,0,4,6,860,0,1943,0,98056,47.5093,-122.184,1300,9514,10865,8214,17.91044776119403,0.017704918032786884,Very Cheap
20141112T000000,297000.0,3,2.5,1940,14952,2.0,0,0,3,8,1940,0,1994,0,98042,47.3777,-122.165,2030,10450,13012,8420,19.863563402889245,0.029114754098360656,Very Cheap
20140716T000000,470000.0,3,1.0,1010,5000,1.0,0,0,3,7,1010,0,1952,0,98107,47.675,-122.394,1680,5000,3990,3320,94.0,0.05180327868852459,Very Cheap
20140804T000000,226500.0,3,1.5,1300,7370,1.0,0,0,4,7,900,400,1976,0,98023,47.3025,-122.37,1430,7500,6070,6070,30.73270013568521,0.019868852459016394,Very Cheap
20150303T000000,274250.0,3,1.0,910,8450,1.0,0,0,4,6,910,0,1962,0,98059,47.4787,-122.158,1400,8040,7540,6640,32.455621301775146,0.026131147540983606,Very Cheap
20140804T000000,840000.0,4,1.75,2480,11010,1.0,0,0,4,9,1630,850,1966,0,98040,47.5378,-122.219,2770,10744,8530,7974,76.29427792915531,0.10032786885245902,Cheap
20140919T000000,677900.0,3,2.5,2440,4587,2.0,0,0,3,8,2440,0,2010,0,98052,47.7073,-122.114,2750,4587,2147,1837,147.78722476564204,0.07906885245901639,Very Cheap
20150205T000000,425000.0,3,1.0,1010,5864,1.0,0,0,3,7,1010,0,1915,0,98116,47.5733,-122.381,1290,5000,4854,3710,72.47612551159618,0.04590163934426229,Very Cheap
20141123T000000,180250.0,2,0.75,900,9600,1.0,0,0,3,6,900,0,1941,0,98166,47.4604,-122.339,1250,14280,8700,13030,18.776041666666668,0.01380327868852459,Very Cheap
20140717T000000,464000.0,6,3.0,2300,3404,2.0,0,0,3,7,1600,700,1920,1994,98133,47.7067,-122.343,1560,1312,1104,-248,136.310223266745,0.05101639344262295,Very Cheap
20150422T000000,320000.0,4,2.25,1550,7579,2.0,0,0,3,8,1550,0,1993,0,98038,47.354,-122.047,1630,6397,6029,4767,42.22192901438184,0.032131147540983604,Very Cheap
20140717T000000,625504.0,3,2.25,1270,1566,2.0,0,0,3,8,1060,210,2014,0,98105,47.6647,-122.284,1160,1327,296,167,399.4278416347382,0.07219724590163934,Very Cheap
20140515T000000,592500.0,4,2.5,2240,12032,1.0,0,0,3,9,2240,0,1983,0,98074,47.6143,-122.017,2520,12368,9792,9848,49.2436835106383,0.06786885245901639,Very Cheap
20150114T000000,465000.0,3,2.5,2714,17936,2.0,0,0,3,9,2714,0,2005,0,98001,47.3185,-122.275,2590,18386,15222,15796,25.92551293487957,0.051147540983606556,Very Cheap
20140527T000000,477000.0,4,2.75,1720,6270,2.0,0,0,3,8,1720,0,1978,0,98118,47.5458,-122.268,2130,8700,4550,6570,76.07655502392345,0.052721311475409836,Very Cheap
20150115T000000,280000.0,2,1.0,850,16400,1.0,0,0,3,6,850,0,1923,0,98168,47.4889,-122.299,1100,14459,15550,13359,17.073170731707318,0.026885245901639345,Very Cheap
20150221T000000,1505000.0,5,3.0,3300,33474,1.0,0,3,3,9,1870,1430,1957,1991,98040,47.5673,-122.21,3836,20953,30174,17117,44.96026767043078,0.18754098360655738,Cheap
20140703T000000,445838.0,3,2.5,2250,5692,2.0,0,0,3,8,2250,0,2000,0,98146,47.5133,-122.379,1320,5390,3442,4070,78.32712579058328,0.04863449180327869,Very Cheap
20140828T000000,1072000.0,2,2.25,3900,14864,1.0,0,3,3,8,1950,1950,1947,0,98144,47.5884,-122.291,2580,5184,10964,2604,72.1205597416577,0.13075409836065574,Cheap
20141023T000000,467000.0,2,1.5,1320,10800,1.0,0,0,4,8,1320,0,1947,0,98177,47.7145,-122.367,2120,12040,9480,9920,43.24074074074074,0.05140983606557377,Very Cheap
20140822T000000,686000.0,4,2.5,2760,6440,2.0,0,0,3,10,2760,0,1999,0,98075,47.5836,-122.026,3070,8127,3680,5057,106.52173913043478,0.0801311475409836,Very Cheap
20140605T000000,279950.0,3,2.0,1750,9750,1.0,0,0,3,7,1350,400,1961,0,98198,47.398,-122.299,1900,10125,8000,8225,28.712820512820514,0.026878688524590164,Very Cheap
20140904T000000,527000.0,4,2.25,2330,19436,2.0,0,0,3,8,2330,0,1987,0,98011,47.7663,-122.215,1910,10055,17106,8145,27.114632640461,0.059278688524590166,Very Cheap
20140918T000000,325000.0,3,2.25,2220,16020,1.0,0,0,4,8,1780,440,1966,0,98030,47.3758,-122.217,2080,9583,13800,7503,20.287141073657928,0.03278688524590164,Very Cheap
20140903T000000,328000.0,3,2.25,2020,8379,2.0,0,0,3,7,2020,0,1994,0,98038,47.3828,-122.023,2020,8031,6359,6011,39.14548275450531,0.03318032786885246,Very Cheap
20140604T000000,390000.0,3,2.25,1250,7500,1.0,0,0,5,7,1250,0,1942,0,98146,47.5123,-122.373,1280,7392,6250,6112,52.0,0.04131147540983607,Very Cheap
20150309T000000,479950.0,2,2.0,1510,6516,1.0,0,0,3,8,1510,0,2005,0,98053,47.7076,-122.013,1640,6009,5006,4369,73.65715162676489,0.05310819672131147,Very Cheap
20140529T000000,264950.0,4,2.25,1720,9753,1.0,0,0,4,7,1120,600,1978,0,98023,47.2922,-122.371,1510,9753,8033,8243,27.166000205065107,0.024911475409836067,Very Cheap
20150115T000000,235000.0,3,1.0,1430,15246,1.0,0,0,4,7,980,450,1961,0,98031,47.4075,-122.214,1960,13068,13816,11108,15.413879050242686,0.02098360655737705,Very Cheap
20150303T000000,516500.0,3,2.5,1480,4729,2.0,0,0,3,7,1480,0,2004,0,98053,47.6794,-122.034,2250,4729,3249,2479,109.21970818354832,0.0579016393442623,Very Cheap
20150413T000000,655000.0,2,1.75,1450,15798,2.0,1,4,3,7,1230,220,1915,1978,98166,47.4497,-122.375,2030,13193,14348,11163,41.46094442334473,0.0760655737704918,Very Cheap
20140616T000000,500000.0,4,2.75,2280,15347,1.0,0,0,5,7,2280,0,1960,0,98059,47.5218,-122.164,2280,15347,13067,13067,32.579657262005604,0.05573770491803279,Very Cheap
20141121T000000,315000.0,6,2.75,2940,7350,1.0,0,0,3,8,1780,1160,1978,0,98023,47.3103,-122.339,2120,8236,4410,6116,42.857142857142854,0.031475409836065574,Very Cheap
20141120T000000,213000.0,2,1.0,1000,10200,1.0,0,0,3,6,1000,0,1961,0,98024,47.5687,-121.899,1150,13702,9200,12552,20.88235294117647,0.018098360655737705,Very Cheap
20140902T000000,475000.0,3,1.5,2480,5280,1.5,0,0,5,7,1620,860,1947,0,98108,47.5575,-122.303,2090,4800,2800,2710,89.96212121212122,0.05245901639344262,Very Cheap
20140610T000000,1025000.0,5,4.0,3760,28040,2.0,0,0,3,10,3760,0,1983,0,98033,47.6489,-122.183,3430,35096,24280,31666,36.5549215406562,0.12459016393442623,Cheap
20150409T000000,416000.0,3,2.0,2220,94300,1.0,0,0,5,7,1640,580,1976,0,98010,47.3459,-121.95,2070,80100,92080,78030,4.4114528101802755,0.044721311475409836,Very Cheap
20150320T000000,410000.0,4,1.0,1970,4740,1.5,0,0,3,7,1670,300,1904,2005,98122,47.6136,-122.303,1510,4740,2770,3230,86.49789029535864,0.043934426229508196,Very Cheap
20140701T000000,800000.0,3,3.5,3830,221284,2.0,0,0,3,10,3530,300,1993,0,98077,47.7641,-122.023,2920,148539,217454,145619,3.6152636431011733,0.09508196721311475,Very Cheap
20140529T000000,472000.0,6,2.5,4410,14034,1.0,0,2,4,9,2350,2060,1965,0,98003,47.3376,-122.324,2600,13988,9624,11388,33.63260652700584,0.052065573770491806,Very Cheap
20141208T000000,225000.0,3,1.75,1430,8505,1.0,0,0,4,7,1430,0,1968,0,98003,47.3173,-122.319,1190,8640,7075,7450,26.455026455026456,0.019672131147540985,Very Cheap
20141001T000000,210000.0,2,1.0,830,6000,1.0,0,0,3,6,830,0,1940,0,98126,47.5308,-122.376,830,4960,5170,4130,35.0,0.017704918032786884,Very Cheap
20150127T000000,455000.0,2,1.0,1430,5000,1.5,0,0,2,7,1430,0,1925,0,98115,47.6727,-122.299,1450,3750,3570,2300,91.0,0.049836065573770495,Very Cheap
20150427T000000,225000.0,3,1.0,1300,8316,1.0,0,0,4,6,1300,0,1954,0,98002,47.3221,-122.216,1260,8316,7016,7056,27.056277056277057,0.019672131147540985,Very Cheap
20140826T000000,480000.0,2,1.0,1030,3060,1.0,0,2,4,7,790,240,1918,0,98103,47.6779,-122.353,1390,3060,2030,1670,156.86274509803923,0.05311475409836065,Very Cheap
20150212T000000,363000.0,3,2.5,2740,11872,2.0,0,0,3,9,2740,0,1990,0,98023,47.3076,-122.395,2570,10377,9132,7807,30.576145552560646,0.03777049180327869,Very Cheap
20140929T000000,2400000.0,4,2.5,3650,8354,1.0,1,4,3,9,1830,1820,2000,0,98074,47.6338,-122.072,3120,18841,4704,15721,287.28752693320564,0.30491803278688523,Medium
20150226T000000,181000.0,2,1.5,720,5120,1.0,0,0,3,6,720,0,1954,0,98106,47.5218,-122.357,1150,2566,4400,1416,35.3515625,0.013901639344262294,Very Cheap
20150314T000000,250000.0,4,2.0,2010,7312,1.0,0,0,4,7,2010,0,1976,0,98002,47.2785,-122.213,2010,7650,5302,5640,34.19037199124727,0.022950819672131147,Very Cheap
20150422T000000,481000.0,3,1.75,1560,3000,1.0,0,0,4,6,770,790,1918,0,98103,47.6846,-122.345,1390,3000,1440,1610,160.33333333333334,0.05324590163934426,Very Cheap
20140923T000000,260000.0,3,2.0,1810,7209,1.0,0,0,4,7,1240,570,1978,0,98032,47.3656,-122.278,1750,7209,5399,5459,36.06602857539187,0.024262295081967214,Very Cheap
20140513T000000,455000.0,4,2.5,3360,7685,2.0,0,0,3,9,3360,0,2001,0,98058,47.4369,-122.111,3060,6567,4325,3507,59.20624593363696,0.049836065573770495,Very Cheap
20150401T000000,415000.0,3,2.25,1510,36224,2.0,0,0,3,8,1510,0,1991,0,98045,47.4616,-121.711,1730,36224,34714,34494,11.45649293286219,0.04459016393442623,Very Cheap
20150421T000000,349500.0,3,1.0,1400,3538,1.0,0,0,3,7,800,600,1953,0,98118,47.5405,-122.27,1620,6331,2138,4711,98.78462408140192,0.036,Very Cheap
20140929T000000,245000.0,3,2.5,1730,7442,2.0,0,0,3,7,1730,0,1987,0,98030,47.3507,-122.178,1630,6458,5712,4828,32.92125772641763,0.022295081967213116,Very Cheap
20140519T000000,592500.0,2,2.0,1420,9191,1.5,0,2,5,7,1420,0,1928,0,98115,47.6979,-122.32,1420,6816,7771,5396,64.46523773256446,0.06786885245901639,Very Cheap
20141020T000000,385000.0,4,1.75,2360,7620,1.0,0,0,4,7,1180,1180,1955,0,98106,47.5278,-122.345,1910,7620,5260,5710,50.5249343832021,0.04065573770491803,Very Cheap
20150211T000000,315000.0,3,1.75,1580,11455,1.0,0,0,4,7,1200,380,1974,0,98059,47.4756,-122.147,1550,10650,9875,9100,27.49890877346137,0.031475409836065574,Very Cheap
20141124T000000,255000.0,3,1.0,1230,10170,1.0,0,0,3,7,1230,0,1979,0,98045,47.4437,-121.772,1380,10098,8940,8718,25.073746312684367,0.02360655737704918,Very Cheap
20140829T000000,693000.0,4,2.5,2460,4425,2.0,0,0,3,8,2460,0,2006,0,98052,47.7048,-122.109,2990,5659,1965,2669,156.61016949152543,0.08104918032786886,Very Cheap
20141202T000000,780000.0,3,1.0,1660,4400,1.5,0,0,3,8,1460,200,1911,0,98112,47.6362,-122.302,1660,4400,2740,2740,177.27272727272728,0.09245901639344262,Very Cheap
20141024T000000,237000.0,3,1.75,1270,8470,1.0,0,0,4,7,1270,0,1960,0,98198,47.4207,-122.29,1600,8470,7200,6870,27.981109799291616,0.021245901639344263,Very Cheap
20141216T000000,525000.0,3,2.25,2100,40510,2.0,0,0,3,10,1320,780,1979,0,98074,47.6154,-122.047,2380,33450,38410,31070,12.959763021476178,0.05901639344262295,Very Cheap
20150428T000000,425000.0,2,1.0,770,5040,1.0,0,0,3,5,770,0,1930,0,98144,47.5964,-122.299,1330,2580,4270,1250,84.32539682539682,0.04590163934426229,Very Cheap
20141027T000000,369900.0,1,0.75,760,10079,1.0,1,4,5,5,760,0,1936,0,98070,47.4683,-122.438,1230,14267,9319,13037,36.70006945133446,0.03867540983606557,Very Cheap
20140519T000000,290000.0,4,2.5,1700,7280,2.0,0,0,4,7,1700,0,1988,0,98031,47.4045,-122.171,1950,7475,5580,5525,39.83516483516483,0.02819672131147541,Very Cheap
20140929T000000,285000.0,3,1.0,1120,10701,1.0,0,0,3,7,1120,0,1954,0,98106,47.5544,-122.358,1130,6350,9581,5220,26.633024950939166,0.02754098360655738,Very Cheap
20140814T000000,415000.0,2,1.0,1070,4500,1.0,0,0,3,7,1070,0,1937,0,98115,47.6802,-122.29,1320,4465,3430,3145,92.22222222222223,0.04459016393442623,Very Cheap
20150409T000000,272500.0,3,2.5,2070,9900,1.0,0,0,3,8,1420,650,1979,0,98023,47.2988,-122.371,2070,8250,7830,6180,27.525252525252526,0.025901639344262296,Very Cheap
20150504T000000,2900000.0,4,3.25,5050,20100,1.5,0,2,3,11,4750,300,1982,2008,98004,47.6312,-122.223,3890,20060,15050,16170,144.27860696517413,0.3704918032786885,Medium
20141007T000000,1365000.0,4,4.75,5310,57346,2.0,0,0,4,11,5310,0,1989,0,98077,47.7285,-122.042,4180,47443,52036,43263,23.802880758902102,0.16918032786885245,Cheap
20150501T000000,436000.0,2,1.0,1040,7538,1.0,0,0,4,7,1040,0,1939,0,98133,47.7107,-122.352,1440,7530,6498,6090,57.840275935261346,0.047344262295081964,Very Cheap
20141017T000000,210000.0,3,1.0,1700,11390,1.0,0,0,4,7,1700,0,1967,0,98003,47.3271,-122.323,1350,8164,9690,6814,18.437225636523266,0.017704918032786884,Very Cheap
20140925T000000,236000.0,3,1.0,1300,5898,1.0,0,0,3,7,1300,0,1961,0,98178,47.5053,-122.255,1320,7619,4598,6299,40.013563919972874,0.021114754098360656,Very Cheap
20141124T000000,331000.0,3,1.75,1080,1306,1.0,0,0,3,7,580,500,1954,2003,98199,47.6601,-122.4,1440,2225,226,785,253.44563552833077,0.03357377049180328,Very Cheap
20150320T000000,365000.0,3,2.5,2653,4510,2.0,0,0,3,8,2653,0,2006,0,98031,47.4145,-122.166,2653,4927,1857,2274,80.93126385809313,0.0380327868852459,Very Cheap
20150127T000000,450000.0,3,2.0,2290,16258,1.0,0,0,5,8,2290,0,1960,0,98058,47.4672,-122.165,1660,10530,13968,8870,27.678681264608194,0.04918032786885246,Very Cheap
20141113T000000,770000.0,4,2.75,3820,26300,2.0,0,0,3,9,2850,970,2014,0,98028,47.7618,-122.261,1860,12136,22480,10276,29.277566539923953,0.09114754098360656,Very Cheap
20150505T000000,455000.0,4,2.5,2210,49375,1.0,0,0,3,8,2210,0,1997,0,98038,47.3828,-122.071,2670,49385,47165,46715,9.215189873417721,0.049836065573770495,Very Cheap
20150505T000000,405000.0,3,1.75,2390,6000,1.0,0,0,3,6,1240,1150,1908,0,98118,47.5362,-122.268,2020,6000,3610,3980,67.5,0.043278688524590166,Very Cheap
20140703T000000,304900.0,4,1.75,2600,11325,1.0,0,0,4,7,1610,990,1969,0,98031,47.3954,-122.206,1720,11088,8725,9368,26.922737306843267,0.030150819672131148,Very Cheap
20150227T000000,170000.0,2,1.0,860,5265,1.0,0,0,3,6,860,0,1931,0,98178,47.5048,-122.272,1650,8775,4405,7125,32.288698955365625,0.012459016393442624,Very Cheap
20150513T000000,2050000.0,5,3.0,3830,8480,2.0,0,1,5,9,2630,1200,1905,1994,98122,47.6166,-122.287,3050,7556,4650,4506,241.74528301886792,0.25901639344262295,Cheap
20140630T000000,780000.0,4,2.5,3500,7048,2.0,0,0,3,9,3500,0,2005,0,98053,47.6811,-122.025,3920,7864,3548,3944,110.66969353007946,0.09245901639344262,Very Cheap
20150410T000000,330000.0,3,3.0,2420,13959,1.0,0,0,4,8,1740,680,1988,0,98028,47.7486,-122.23,2570,13300,11539,10730,23.64066193853428,0.03344262295081967,Very Cheap
20140905T000000,370000.0,4,2.5,2720,8666,2.0,0,0,3,9,2720,0,1992,0,98030,47.3846,-122.169,2410,8100,5946,5690,42.69559196861297,0.038688524590163934,Very Cheap
20141017T000000,467000.0,5,2.25,2500,13500,1.0,0,0,3,7,1850,650,1979,0,98072,47.7564,-122.144,2300,9750,11000,7450,34.592592592592595,0.05140983606557377,Very Cheap
20150209T000000,405000.0,3,1.75,1670,6720,1.0,0,0,3,7,1140,530,1980,0,98034,47.7198,-122.193,1670,7320,5050,5650,60.267857142857146,0.043278688524590166,Very Cheap
20140702T000000,675000.0,5,2.25,2900,10300,1.0,0,0,3,8,1450,1450,1985,0,98006,47.5461,-122.151,2310,10300,7400,7990,65.53398058252426,0.07868852459016394,Very Cheap
20140812T000000,500000.0,2,1.0,1640,14100,1.0,0,0,4,7,1140,500,1954,0,98006,47.5712,-122.143,1520,13527,12460,12007,35.46099290780142,0.05573770491803279,Very Cheap
20140723T000000,389999.0,4,2.5,1890,15770,2.0,0,0,4,7,1890,0,1968,0,98166,47.4281,-122.343,2410,15256,13880,12846,24.730437539632213,0.04131134426229508,Very Cheap
20150224T000000,630000.0,4,1.75,2950,9025,1.0,0,2,4,8,1780,1170,1975,0,98034,47.7128,-122.223,2120,9600,6075,7480,69.80609418282549,0.07278688524590164,Very Cheap
20141022T000000,360000.0,4,2.5,2160,9528,2.0,0,0,3,9,2160,0,1992,0,98001,47.3341,-122.255,2280,9937,7368,7657,37.78337531486146,0.037377049180327866,Very Cheap
20141002T000000,580000.0,4,3.0,3280,11060,2.0,0,0,3,8,2270,1010,1986,0,98056,47.5399,-122.181,2320,11004,7780,8684,52.44122965641953,0.06622950819672131,Very Cheap
20140709T000000,550000.0,3,2.0,1970,4166,2.0,0,3,5,8,1270,700,1929,0,98126,47.5717,-122.375,2390,4166,2196,1776,132.02112337974077,0.06229508196721312,Very Cheap
20140710T000000,879000.0,4,2.5,3360,22111,2.0,0,0,3,10,3360,0,1994,0,98075,47.5951,-122.017,3150,11374,18751,8224,39.753968612907606,0.10544262295081967,Cheap
20140822T000000,265000.0,3,2.0,1320,8959,1.0,0,0,3,7,1320,0,1993,0,98042,47.3536,-122.144,1740,7316,7639,5576,29.579194106485097,0.024918032786885248,Very Cheap
20150304T000000,446500.0,3,2.5,2650,7286,2.0,0,0,3,8,2650,0,1990,0,98059,47.5084,-122.154,2400,7220,4636,4820,61.28191051331321,0.04872131147540983,Very Cheap
20140602T000000,404000.0,3,1.5,2030,8880,1.0,0,0,3,7,1330,700,1963,0,98108,47.5586,-122.311,2140,5592,6850,3452,45.4954954954955,0.043147540983606555,Very Cheap
20140529T000000,267500.0,3,1.75,1590,11914,1.0,0,2,3,7,1090,500,1957,0,98188,47.4427,-122.274,1630,9052,10324,7422,22.452576800402888,0.025245901639344263,Very Cheap
20140624T000000,3075000.0,4,5.0,4550,18641,1.0,1,4,3,10,2600,1950,2002,0,98074,47.6053,-122.077,4550,19508,14091,14958,164.9589614291079,0.39344262295081966,Medium
20140811T000000,335000.0,3,2.5,2440,7632,2.0,0,0,3,8,2440,0,1998,0,98003,47.3494,-122.301,2510,7903,5192,5393,43.89412997903564,0.03409836065573771,Very Cheap
20140619T000000,576000.0,3,2.5,1940,9000,1.0,0,0,4,7,970,970,1948,0,98117,47.6933,-122.393,2190,7310,7060,5120,64.0,0.06570491803278689,Very Cheap
20150401T000000,208633.0,3,2.5,2040,3810,2.0,0,0,3,8,2040,0,2006,0,98038,47.3537,-122.0,2370,4590,1770,2220,54.75931758530184,0.017525639344262295,Very Cheap
20150115T000000,315000.0,3,2.25,2200,8750,1.0,0,0,4,7,1120,1080,1964,0,98166,47.476,-122.337,1460,10139,6550,8679,36.0,0.031475409836065574,Very Cheap
20150217T000000,725000.0,3,1.75,1920,3300,1.0,0,0,4,8,960,960,1913,0,98112,47.6239,-122.298,1740,4000,1380,2260,219.6969696969697,0.08524590163934426,Very Cheap
20150403T000000,550000.0,4,2.75,1800,7750,1.0,0,0,4,8,1400,400,1965,0,98177,47.7776,-122.384,1800,8275,5950,6475,70.96774193548387,0.06229508196721312,Very Cheap
20140612T000000,610750.0,4,2.25,2180,7297,2.0,0,0,3,8,2180,0,1984,0,98074,47.6459,-122.058,2250,9781,5117,7531,83.69878032067973,0.07026229508196721,Very Cheap
20150228T000000,550700.0,2,1.0,1010,5000,1.5,0,0,4,6,1010,0,1908,0,98105,47.6692,-122.297,1460,5000,3990,3540,110.14,0.06238688524590164,Very Cheap
20150108T000000,665000.0,4,2.75,3320,10574,2.0,0,0,5,8,2220,1100,1960,0,98056,47.5376,-122.18,2720,8330,7254,5610,62.89010781161339,0.07737704918032787,Very Cheap
20150209T000000,834000.0,4,2.5,2370,4000,1.5,0,2,5,8,1980,390,1928,0,98144,47.601,-122.294,2440,5750,1630,3310,208.5,0.09954098360655737,Very Cheap
20141023T000000,201000.0,5,1.75,1660,78408,1.5,0,0,3,6,1660,0,1915,0,98065,47.529,-121.837,1660,78408,76748,76748,2.5635139271502907,0.016524590163934427,Very Cheap
20140502T000000,2384000.0,5,2.5,3650,9050,2.0,0,4,5,10,3370,280,1921,0,98119,47.6345,-122.367,2880,5400,5400,2520,263.42541436464086,0.3028196721311475,Medium
20140618T000000,1384000.0,4,3.25,4290,12103,1.0,0,3,3,11,2690,1600,1997,0,98006,47.5503,-122.102,3860,11244,7813,7384,114.3518135999339,0.17167213114754099,Cheap
20141209T000000,1400000.0,4,3.25,4290,12103,1.0,0,3,3,11,2690,1600,1997,0,98006,47.5503,-122.102,3860,11244,7813,7384,115.6737998843262,0.1737704918032787,Cheap
20141105T000000,305000.0,4,2.25,1950,7700,1.0,0,0,3,8,1350,600,1979,0,98058,47.4441,-122.125,2150,7350,5750,5200,39.61038961038961,0.03016393442622951,Very Cheap
20150408T000000,487000.0,3,2.0,2590,14052,1.0,0,0,5,8,1720,870,1948,0,98133,47.7357,-122.333,1570,8162,11462,6592,34.65698832906348,0.054032786885245904,Very Cheap
20150511T000000,390000.0,3,2.5,1930,64904,1.0,0,0,4,8,1930,0,1988,0,98042,47.346,-122.157,2350,57500,62974,55150,6.00887464563047,0.04131147540983607,Very Cheap
20140723T000000,548000.0,2,1.0,1470,3864,1.0,0,0,4,7,1170,300,1916,0,98103,47.6638,-122.345,1570,3864,2394,2294,141.82194616977225,0.062032786885245904,Very Cheap
20141122T000000,268750.0,4,1.0,800,8775,1.0,0,0,3,6,800,0,1943,0,98166,47.48,-122.336,1310,8775,7975,7465,30.626780626780626,0.02540983606557377,Very Cheap
20140513T000000,819900.0,5,2.75,3150,7119,2.0,0,0,3,9,3150,0,2013,0,98052,47.6759,-122.151,1560,8384,3969,6824,115.17067003792667,0.09769180327868852,Very Cheap
20141023T000000,520000.0,3,2.25,2030,16200,2.0,0,0,3,8,2030,0,1984,0,98027,47.5162,-122.057,2660,17958,14170,15298,32.098765432098766,0.058360655737704915,Very Cheap
20140721T000000,230000.0,3,2.0,1450,11204,1.0,0,0,3,7,1450,0,2003,0,98001,47.2639,-122.252,1520,9518,9754,7998,20.528382720456978,0.020327868852459016,Very Cheap
20150202T000000,240000.0,3,1.75,1510,10248,1.0,0,0,3,7,1510,0,1969,0,98023,47.2929,-122.371,1510,9753,8738,8243,23.4192037470726,0.021639344262295083,Very Cheap
20140905T000000,232000.0,2,1.0,1240,12092,1.0,0,0,3,6,960,280,1922,1984,98146,47.4957,-122.352,1820,7460,10852,5640,19.18623883559378,0.02059016393442623,Very Cheap
20150311T000000,240500.0,2,1.0,1240,12092,1.0,0,0,3,6,960,280,1922,1984,98146,47.4957,-122.352,1820,7460,10852,5640,19.88918293086338,0.021704918032786884,Very Cheap
20141027T000000,274975.0,3,2.5,3030,45004,2.0,0,0,3,9,3030,0,1987,0,98077,47.7721,-122.093,3080,35781,41974,32701,6.11001244333837,0.02622622950819672,Very Cheap
20140905T000000,740000.0,4,2.0,2050,4400,1.5,0,0,4,9,2050,0,1922,0,98102,47.644,-122.319,2320,5500,2350,3180,168.1818181818182,0.08721311475409836,Very Cheap
20150428T000000,186375.0,3,1.0,1000,7636,1.0,0,0,2,7,1000,0,1952,0,98166,47.472,-122.344,1150,7600,6636,6450,24.40741225772656,0.014606557377049181,Very Cheap
20140725T000000,790000.0,3,2.25,2370,10289,1.0,0,0,4,9,1590,780,1977,0,98005,47.592,-122.166,2500,10004,7919,7504,76.78102828263194,0.09377049180327869,Very Cheap
20140916T000000,880000.0,4,3.5,2800,6750,2.0,0,0,3,9,1890,910,1951,2002,98105,47.669,-122.275,2370,6120,3950,3750,130.37037037037038,0.10557377049180328,Cheap
20150416T000000,279000.0,6,1.75,2240,11180,2.0,0,0,4,7,2240,0,1955,0,98198,47.42,-122.323,1590,7955,8940,6365,24.955277280858677,0.02675409836065574,Very Cheap
20140729T000000,295000.0,3,2.0,1810,10530,1.0,0,2,3,8,1810,0,1991,0,98022,47.1913,-122.012,1910,10450,8720,8540,28.01519468186135,0.028852459016393443,Very Cheap
20150408T000000,640000.0,2,1.0,1070,5000,1.0,0,0,3,7,1070,0,1924,0,98103,47.6666,-122.331,1710,5000,3930,3290,128.0,0.0740983606557377,Very Cheap
20140703T000000,940000.0,4,2.0,2490,9525,2.0,0,0,5,9,2490,0,1968,0,98040,47.5639,-122.217,2770,9525,7035,6755,98.68766404199475,0.11344262295081967,Cheap
20141007T000000,260000.0,4,2.5,1960,5238,2.0,0,0,3,7,1960,0,2003,0,98038,47.3483,-122.052,1800,5894,3278,4094,49.63726613211149,0.024262295081967214,Very Cheap
20140602T000000,559900.0,3,2.75,2930,5569,1.0,0,0,3,9,1860,1070,2004,0,98072,47.7648,-122.164,2580,11045,2639,8465,100.53869635482133,0.06359344262295082,Very Cheap
20140722T000000,791500.0,4,2.0,1510,3500,1.5,0,0,5,7,1510,0,1911,0,98103,47.6794,-122.357,1820,3750,1990,1930,226.14285714285714,0.0939672131147541,Very Cheap
20140826T000000,265000.0,3,1.75,1420,8250,1.0,0,0,3,7,1420,0,1954,0,98133,47.7535,-122.354,1740,8000,6830,6260,32.121212121212125,0.024918032786885248,Very Cheap
20150501T000000,245000.0,3,1.75,1740,11547,1.0,0,0,3,7,1740,0,1954,0,98178,47.4945,-122.22,880,78408,9807,77528,21.217632285442107,0.022295081967213116,Very Cheap
20150424T000000,485000.0,4,1.75,2560,43995,2.0,0,0,4,7,2560,0,1962,0,98052,47.6945,-122.093,2560,14764,41435,12204,11.023979997727015,0.05377049180327869,Very Cheap
20141106T000000,684000.0,4,3.5,3040,8414,2.0,0,0,3,9,2420,620,2010,0,98059,47.5222,-122.157,3470,8066,5374,4596,81.29308295697646,0.0798688524590164,Very Cheap
20140909T000000,425000.0,3,1.75,2500,6840,1.0,0,0,3,8,1300,1200,1957,0,98125,47.7222,-122.32,1580,8691,4340,7111,62.134502923976605,0.04590163934426229,Very Cheap
20141017T000000,309600.0,4,1.75,1275,20000,1.0,0,0,4,6,1275,0,1991,0,98070,47.3796,-122.49,1660,20000,18725,18340,15.48,0.030767213114754097,Very Cheap
20140718T000000,552250.0,4,2.5,2580,5823,2.0,0,0,3,8,2580,0,2002,0,98065,47.5374,-121.875,2380,5823,3243,3443,94.83942984715782,0.06259016393442624,Very Cheap
20140723T000000,165000.0,4,1.0,1000,7134,1.0,0,0,3,6,1000,0,1943,0,98178,47.4897,-122.24,1020,7138,6134,6118,23.128679562657695,0.01180327868852459,Very Cheap
20141229T000000,239900.0,4,1.0,1000,7134,1.0,0,0,3,6,1000,0,1943,0,98178,47.4897,-122.24,1020,7138,6134,6118,33.62769834594898,0.02162622950819672,Very Cheap
20141205T000000,320000.0,2,1.0,1070,32633,1.0,0,0,4,6,1070,0,1930,0,98059,47.4716,-122.078,1360,32156,31563,30796,9.806024576349094,0.032131147540983604,Very Cheap
20141021T000000,206600.0,3,2.0,1390,13464,1.0,0,0,4,7,1390,0,1987,0,98030,47.3581,-122.173,1720,12080,12074,10360,15.344622697563874,0.017259016393442624,Very Cheap
20150416T000000,387000.0,4,1.75,2500,7690,1.0,0,0,3,7,1250,1250,1973,0,98155,47.7713,-122.307,2040,8646,5190,6606,50.32509752925878,0.040918032786885244,Very Cheap
20140604T000000,299000.0,1,0.75,560,12120,1.0,0,0,3,4,560,0,1967,0,98014,47.675,-121.854,1300,19207,11560,17907,24.66996699669967,0.02937704918032787,Very Cheap
20140922T000000,855000.0,4,2.75,2270,10460,2.0,0,0,3,9,2270,0,1965,0,98040,47.5603,-122.222,2610,10180,8190,7570,81.73996175908222,0.10229508196721311,Cheap
20150126T000000,315000.0,3,1.0,1900,14400,1.0,0,0,4,7,1300,600,1954,0,98166,47.4147,-122.337,1940,14400,12500,12460,21.875,0.031475409836065574,Very Cheap
20141203T000000,437500.0,2,1.0,990,3120,1.0,0,2,5,7,790,200,1907,0,98103,47.68,-122.353,1930,3120,2130,1190,140.22435897435898,0.047540983606557376,Very Cheap
20150324T000000,252000.0,4,1.5,1550,19800,1.0,0,0,4,7,1050,500,1969,0,98001,47.3117,-122.27,1640,22654,18250,21014,12.727272727272727,0.02321311475409836,Very Cheap
20140604T000000,375000.0,4,1.75,2200,7475,1.0,0,0,5,7,1100,1100,1955,0,98118,47.543,-122.28,1600,5766,5275,4166,50.16722408026756,0.03934426229508197,Very Cheap
20140806T000000,300000.0,4,2.5,1910,4862,2.0,0,0,3,7,1910,0,2005,0,98038,47.3607,-122.034,2010,5091,2952,3081,61.703002879473466,0.029508196721311476,Very Cheap
20141006T000000,420000.0,4,1.0,1750,9600,1.5,0,0,4,7,1750,0,1954,0,98006,47.5759,-122.137,1750,10530,7850,8780,43.75,0.04524590163934426,Very Cheap
20140505T000000,900000.0,3,1.0,1330,77972,1.0,0,0,3,7,1330,0,1928,1954,98033,47.6891,-122.159,1340,17689,76642,16349,11.542605037705844,0.10819672131147541,Cheap
20140805T000000,679900.0,3,2.5,2440,5750,2.0,0,2,3,9,1980,460,2000,0,98116,47.565,-122.381,1520,5750,3310,4230,118.24347826086957,0.07933114754098361,Very Cheap
20140605T000000,463000.0,3,2.5,1640,29970,2.0,0,0,3,7,1640,0,1992,0,98053,47.6359,-121.974,1580,28399,28330,26819,15.448782115448783,0.05088524590163934,Very Cheap
20140828T000000,380000.0,5,2.5,2760,11340,2.0,0,0,4,9,2760,0,1978,0,98059,47.4769,-122.141,2470,11340,8580,8870,33.50970017636684,0.04,Very Cheap
20141210T000000,329500.0,4,2.5,1820,7912,2.0,0,0,3,7,1820,0,1994,0,98038,47.3845,-122.029,1820,8168,6092,6348,41.645601617795755,0.03337704918032787,Very Cheap
20140819T000000,604950.0,3,2.5,2110,5608,1.0,0,0,3,8,1340,770,2013,0,98033,47.6743,-122.184,2040,9363,3498,7323,107.87268188302426,0.06950163934426229,Very Cheap
20140917T000000,795000.0,5,2.5,3040,9570,1.0,0,2,4,8,1640,1400,1966,0,98006,47.5651,-122.164,2920,8800,6530,5880,83.07210031347962,0.09442622950819672,Very Cheap
20150130T000000,465000.0,3,2.0,1840,40438,2.0,0,0,3,7,1840,0,1994,0,98045,47.4853,-121.709,1380,44049,38598,42669,11.499085019041496,0.051147540983606556,Very Cheap
20150326T000000,673000.0,4,2.5,2990,10400,2.0,0,0,3,9,2990,0,2002,0,98166,47.4508,-122.359,2140,17449,7410,15309,64.71153846153847,0.07842622950819672,Very Cheap
20141001T000000,810000.0,4,2.5,3520,15420,2.0,0,0,3,10,3520,0,1991,0,98074,47.6375,-122.016,3400,21455,11900,18055,52.52918287937743,0.09639344262295083,Very Cheap
20150423T000000,785000.0,4,2.75,2440,69415,1.0,0,0,4,8,1910,530,1989,0,98075,47.5944,-122.042,2770,24361,66975,21591,11.308794929049917,0.09311475409836066,Very Cheap
20141120T000000,338000.0,4,3.0,2090,7500,1.0,0,0,3,7,1370,720,1986,0,98056,47.4888,-122.182,1810,7650,5410,5840,45.06666666666667,0.034491803278688525,Very Cheap
20141204T000000,280000.0,3,2.25,1430,7222,2.0,0,0,3,7,1430,0,1993,0,98056,47.5112,-122.19,1430,7220,5792,5790,38.77042370534478,0.026885245901639345,Very Cheap
20141001T000000,315000.0,4,2.25,2180,10754,1.0,0,0,5,7,1100,1080,1954,0,98133,47.7711,-122.341,1810,6929,8574,5119,29.291426445973592,0.031475409836065574,Very Cheap
20150324T000000,530000.0,4,2.25,2180,10754,1.0,0,0,5,7,1100,1080,1954,0,98133,47.7711,-122.341,1810,6929,8574,5119,49.28398735354287,0.05967213114754098,Very Cheap
20141223T000000,380000.0,5,3.0,3450,9914,2.0,0,0,3,9,3450,0,2004,0,98023,47.2813,-122.345,2860,9721,6464,6861,38.32963485979423,0.04,Very Cheap
20140811T000000,297000.0,3,2.25,1450,7562,2.0,0,0,3,7,1450,0,1994,0,98056,47.5038,-122.189,1650,7625,6112,5975,39.275323988362864,0.029114754098360656,Very Cheap
20140520T000000,730000.0,4,2.5,3230,7331,2.0,0,0,3,10,3230,0,2004,0,98075,47.5823,-121.97,3480,7447,4101,3967,99.57713818033011,0.0859016393442623,Very Cheap
20140609T000000,450000.0,3,1.75,1640,13500,1.0,0,0,3,7,1110,530,1940,0,98125,47.7164,-122.304,1770,12600,11860,10830,33.333333333333336,0.04918032786885246,Very Cheap
20141027T000000,275000.0,3,3.0,1590,7750,1.0,0,0,3,7,1060,530,1997,0,98038,47.3624,-122.045,1680,7500,6160,5820,35.483870967741936,0.02622950819672131,Very Cheap
20150429T000000,595000.0,4,2.0,2020,2849,2.0,0,0,3,7,2020,0,1960,0,98115,47.6831,-122.329,1910,3120,829,1210,208.84520884520884,0.06819672131147542,Very Cheap
20150421T000000,435000.0,3,1.5,1300,3348,1.5,0,0,3,7,1300,0,1904,2014,98144,47.592,-122.307,1590,2577,2048,987,129.92831541218638,0.04721311475409836,Very Cheap
20140916T000000,270000.0,2,1.5,1380,209959,1.0,0,0,1,6,1380,0,1954,0,98011,47.7461,-122.195,3130,19868,208579,16738,1.2859653551407655,0.025573770491803278,Very Cheap
20140805T000000,950000.0,3,3.0,4040,14338,2.0,0,0,3,10,3030,1010,1986,0,98077,47.7268,-122.06,3360,14142,10298,10782,66.2574975589343,0.11475409836065574,Cheap
20150313T000000,389000.0,4,2.25,2130,5337,2.0,0,0,3,7,2130,0,2001,0,98019,47.7237,-121.959,2300,6930,3207,4630,72.88738991943039,0.04118032786885246,Very Cheap
20150121T000000,560000.0,4,2.25,2550,7800,1.0,0,0,3,8,1580,970,1968,0,98052,47.6283,-122.095,2420,8050,5250,5630,71.7948717948718,0.06360655737704918,Very Cheap
20140728T000000,1350000.0,5,3.5,4800,14984,2.0,0,2,3,11,3480,1320,1998,0,98006,47.5543,-122.148,4050,19009,10184,14959,90.0961025093433,0.16721311475409836,Cheap
20141111T000000,799000.0,4,2.25,2510,11585,2.0,0,0,4,8,2510,0,1969,0,98040,47.5483,-122.226,2450,9691,9075,7241,68.96849374190764,0.09495081967213115,Very Cheap
20140625T000000,365500.0,3,2.0,1410,9600,1.0,0,0,4,7,1410,0,1983,0,98072,47.7591,-122.146,1410,9600,8190,8190,38.072916666666664,0.038098360655737705,Very Cheap
20140515T000000,252350.0,3,2.0,1650,7352,1.0,0,0,3,7,1160,490,1979,0,98058,47.4612,-122.169,1710,7350,5702,5640,34.32399347116431,0.023259016393442623,Very Cheap
20140905T000000,403950.0,4,2.5,2120,13780,2.0,0,0,3,8,2120,0,1993,0,98146,47.4987,-122.365,1880,12000,11660,10120,29.31422351233672,0.043140983606557375,Very Cheap
20140801T000000,385000.0,4,1.5,2040,10726,1.0,0,0,3,7,1380,660,1954,0,98177,47.772,-122.358,1610,10020,8686,8410,35.89408912921872,0.04065573770491803,Very Cheap
20141210T000000,345000.0,4,1.0,1550,7620,1.5,0,0,3,7,1550,0,1957,0,98106,47.5287,-122.35,1450,7620,6070,6170,45.275590551181104,0.03540983606557377,Very Cheap
20140917T000000,490000.0,3,2.75,1980,3128,2.0,0,0,4,9,1980,0,1979,0,98008,47.6109,-122.114,1950,2856,1148,906,156.64961636828644,0.05442622950819672,Very Cheap
20140618T000000,330000.0,3,2.5,1600,26977,2.0,0,0,3,8,1600,0,2005,0,98019,47.7736,-121.901,1790,27743,25377,25953,12.232642621492383,0.03344262295081967,Very Cheap
20140512T000000,927000.0,4,2.75,3300,12090,2.0,0,0,3,8,3300,0,1953,0,98004,47.6294,-122.218,3180,12239,8790,9059,76.67493796526054,0.11173770491803278,Cheap
20140728T000000,1118000.0,4,2.5,3840,16619,2.0,0,1,4,10,3840,0,1983,0,98040,47.5634,-122.213,3600,16553,12779,12953,67.27239906131537,0.13678688524590163,Cheap
20150430T000000,330000.0,2,1.0,1220,10000,1.0,0,0,5,7,1220,0,1950,0,98028,47.7405,-122.241,2000,9600,8780,7600,33.0,0.03344262295081967,Very Cheap
20150309T000000,530000.0,5,2.25,2720,8800,1.0,0,0,4,7,1500,1220,1958,0,98008,47.5976,-122.118,2110,8800,6080,6690,60.22727272727273,0.05967213114754098,Very Cheap
20140623T000000,365000.0,4,2.0,1940,25600,1.0,0,0,1,8,1940,0,1962,0,98006,47.5722,-122.129,2000,10071,23660,8071,14.2578125,0.0380327868852459,Very Cheap
20140619T000000,378750.0,3,2.5,2160,3000,1.5,0,0,3,7,1260,900,1909,2011,98118,47.5644,-122.289,1060,3500,840,2440,126.25,0.03983606557377049,Very Cheap
20140619T000000,269900.0,4,1.75,1530,8750,1.5,0,0,4,7,1530,0,1968,0,98058,47.4556,-122.157,1390,8750,7220,7360,30.845714285714287,0.02556065573770492,Very Cheap
20150306T000000,557000.0,3,3.5,1710,2096,2.0,0,0,3,8,1290,420,2008,0,98122,47.6055,-122.305,1630,1543,386,-87,265.7442748091603,0.06321311475409835,Very Cheap
20140825T000000,360000.0,4,1.75,3730,16980,1.0,0,0,4,7,2150,1580,1974,0,98022,47.1775,-122.022,1880,16963,13250,15083,21.20141342756184,0.037377049180327866,Very Cheap
20150422T000000,352000.0,2,1.0,940,5000,1.0,0,0,4,7,940,0,1937,0,98117,47.6879,-122.385,1560,4500,4060,2940,70.4,0.03632786885245902,Very Cheap
20150224T000000,437000.0,3,2.5,1750,22357,2.0,0,0,3,8,1750,0,1994,0,98045,47.4807,-121.779,2430,22357,20607,19927,19.546450776043297,0.047475409836065574,Very Cheap
20140618T000000,322500.0,4,2.5,1820,6753,2.0,0,0,3,7,1820,0,1994,0,98038,47.3845,-122.032,1820,7107,4933,5287,47.75655264326966,0.032459016393442626,Very Cheap
20140912T000000,650000.0,3,3.25,1510,2000,2.0,0,0,3,9,1330,180,2001,0,98116,47.5815,-122.402,1510,1352,490,-158,325.0,0.07540983606557378,Very Cheap
20140806T000000,450000.0,3,2.0,1290,1213,3.0,0,0,3,8,1290,0,2001,0,98103,47.6609,-122.344,1290,3235,-77,1945,370.9810387469085,0.04918032786885246,Very Cheap
20150417T000000,278500.0,3,2.0,1570,5250,1.0,0,0,3,7,1570,0,1998,0,98092,47.3163,-122.188,1570,5250,3680,3680,53.04761904761905,0.026688524590163933,Very Cheap
20150427T000000,364950.0,4,2.5,1930,6957,2.0,0,0,3,8,1930,0,1995,0,98055,47.4309,-122.191,2090,6996,5027,4906,52.45795601552393,0.03802622950819672,Very Cheap
20140911T000000,840000.0,4,3.5,2840,40139,1.0,0,4,4,10,2840,0,1986,0,98038,47.401,-122.026,3180,36852,37299,33672,20.927277709957895,0.10032786885245902,Cheap
20150318T000000,268000.0,3,2.5,1550,8134,2.0,0,0,3,7,1550,0,1991,0,98031,47.404,-122.191,1550,8134,6584,6584,32.9481190066388,0.025311475409836064,Very Cheap
20140716T000000,517534.0,2,1.0,833,143947,1.0,0,0,3,5,833,0,2006,0,98070,47.3889,-122.482,1380,143947,143114,142567,3.5953093847040924,0.05803724590163935,Very Cheap
20141104T000000,632925.0,3,2.5,2990,32239,2.0,0,0,4,8,2990,0,1978,0,98077,47.7718,-122.095,2990,36497,29249,33507,19.63227767610658,0.07317049180327868,Very Cheap
20140723T000000,577500.0,3,2.5,2000,7251,2.0,0,0,3,9,2000,0,1995,0,98034,47.7067,-122.2,2450,8118,5251,5668,79.64418700868846,0.0659016393442623,Very Cheap
20150212T000000,339000.0,4,1.5,2390,7480,1.5,0,2,3,7,2390,0,1920,0,98178,47.504,-122.227,2850,6867,5090,4017,45.32085561497326,0.03462295081967213,Very Cheap
20140909T000000,570000.0,3,1.75,2910,37461,1.0,0,0,4,7,1530,1380,1967,0,98052,47.7015,-122.164,2520,18295,34551,15775,15.215824457435733,0.06491803278688525,Very Cheap
20140626T000000,563500.0,4,1.75,2085,174240,1.0,0,0,3,7,1610,475,1964,0,98024,47.5753,-121.95,2690,174240,172155,171550,3.234044995408632,0.06406557377049181,Very Cheap
20150105T000000,423000.0,4,2.25,2200,9351,1.0,0,0,5,7,1290,910,1962,0,98133,47.7448,-122.333,1910,8660,7151,6750,45.23580365736285,0.04563934426229508,Very Cheap
20141223T000000,355000.0,3,2.25,1860,5028,2.0,0,0,3,8,1860,0,2012,0,98019,47.7318,-121.982,2320,5465,3168,3145,70.60461416070008,0.036721311475409836,Very Cheap
20140710T000000,1550000.0,5,4.25,6070,171626,2.0,0,0,3,12,6070,0,1999,0,98024,47.5954,-121.95,4680,211267,165556,206587,9.031265659049328,0.19344262295081968,Cheap
20141203T000000,482000.0,2,1.0,950,3960,1.0,0,0,3,7,950,0,1941,0,98103,47.6885,-122.337,1320,4050,3010,2730,121.71717171717172,0.05337704918032787,Very Cheap
20140730T000000,625000.0,3,1.75,1600,9135,1.0,0,0,5,7,1600,0,1955,0,98006,47.5724,-122.179,1580,9800,7535,8220,68.41817186644772,0.07213114754098361,Very Cheap
20141219T000000,538000.0,3,2.5,2250,11632,2.0,0,0,3,8,2250,0,1988,0,98056,47.5272,-122.169,2360,11632,9382,9272,46.25171939477304,0.06072131147540984,Very Cheap
20150107T000000,380000.0,3,2.5,2280,10255,2.0,0,0,4,8,2280,0,1985,0,98058,47.4334,-122.161,2310,10094,7975,7784,37.05509507557289,0.04,Very Cheap
20140717T000000,375000.0,2,1.0,940,5120,1.0,0,0,3,7,940,0,1909,0,98122,47.6073,-122.308,1300,5120,4180,3820,73.2421875,0.03934426229508197,Very Cheap
20150403T000000,245000.0,3,2.5,1530,8500,1.0,0,0,5,7,1030,500,1996,0,98038,47.3592,-122.046,1850,8140,6970,6290,28.823529411764707,0.022295081967213116,Very Cheap
20141114T000000,310000.0,5,1.75,2190,27260,1.0,0,0,4,7,2190,0,1947,1974,98166,47.4546,-122.337,1620,39480,25070,37860,11.371973587674248,0.03081967213114754,Very Cheap
20150225T000000,1300000.0,3,2.0,2350,15021,1.0,0,0,4,8,1770,580,1976,0,98004,47.6408,-122.219,3530,15715,12671,12185,86.54550296251914,0.16065573770491803,Cheap
20140506T000000,397000.0,4,2.0,1440,7680,1.0,0,0,3,7,1200,240,1971,0,98034,47.7245,-122.2,1460,9660,6240,8200,51.692708333333336,0.04222950819672131,Very Cheap
20150512T000000,365000.0,3,2.5,2200,4052,2.0,0,0,3,8,2200,0,2005,0,98058,47.4362,-122.178,2310,5082,1852,2772,90.07897334649556,0.0380327868852459,Very Cheap
20141028T000000,328500.0,4,3.0,2290,8250,2.0,0,0,3,9,2290,0,1990,0,98042,47.3739,-122.156,2290,8250,5960,5960,39.81818181818182,0.03324590163934426,Very Cheap
20140908T000000,988000.0,4,3.0,4040,19700,2.0,0,0,3,11,4040,0,1987,0,98052,47.7205,-122.127,3930,21887,15660,17957,50.15228426395939,0.11973770491803279,Cheap
20140722T000000,1000000.0,4,2.5,2610,3277,1.5,0,0,5,8,1920,690,1922,0,98103,47.6636,-122.33,1810,3277,667,1467,305.15715593530666,0.12131147540983607,Cheap
20140903T000000,237000.0,3,2.5,1490,2138,2.0,0,0,3,7,1490,0,2005,0,98055,47.4324,-122.197,1490,2094,648,604,110.85126286248831,0.021245901639344263,Very Cheap
20140919T000000,525000.0,4,2.5,2450,5280,2.0,0,0,3,8,2450,0,2003,0,98011,47.7734,-122.224,2300,4674,2830,2374,99.43181818181819,0.05901639344262295,Very Cheap
20140916T000000,749000.0,4,2.5,1710,9627,1.0,0,0,3,9,1440,270,1976,2014,98006,47.559,-122.164,2140,9131,7917,6991,77.80201516567986,0.08839344262295082,Very Cheap
20140821T000000,722500.0,5,2.5,4870,11800,2.0,0,0,3,10,3470,1400,1983,0,98074,47.633,-122.041,3180,11398,6930,8218,61.228813559322035,0.08491803278688524,Very Cheap
20150312T000000,843000.0,3,2.5,3130,8750,2.0,0,0,3,10,3130,0,1991,0,98052,47.6954,-122.103,2860,9003,5620,6143,96.34285714285714,0.10072131147540983,Cheap
20140708T000000,438000.0,2,2.0,1270,1372,3.0,0,0,3,8,1270,0,2000,0,98115,47.6776,-122.318,1610,3090,102,1480,319.24198250728864,0.04760655737704918,Very Cheap
20140916T000000,578000.0,3,1.75,2120,10875,1.0,0,2,3,8,1540,580,1977,0,98146,47.504,-122.382,2460,11760,8755,9300,53.14942528735632,0.06596721311475409,Very Cheap
20140923T000000,227950.0,3,1.5,1670,8230,1.0,0,0,5,7,1670,0,1954,0,98001,47.2613,-122.255,2077,4910,6560,2833,27.69744835965978,0.020059016393442625,Very Cheap
20140722T000000,196000.0,3,2.25,2070,11576,2.0,0,0,3,7,2070,0,1974,0,98001,47.3417,-122.271,1890,7519,9506,5629,16.931582584657914,0.015868852459016394,Very Cheap
20140715T000000,641000.0,2,1.0,1420,5332,1.0,0,0,3,8,1070,350,1953,0,98105,47.6694,-122.275,2400,5406,3912,3006,120.21755438859715,0.0742295081967213,Very Cheap
20150422T000000,350000.0,3,1.5,1250,219978,1.0,0,0,4,6,1250,0,1980,0,98038,47.4056,-121.955,1930,210394,218728,208464,1.5910681977288639,0.036065573770491806,Very Cheap
20140819T000000,205000.0,3,1.0,940,7980,1.0,0,0,4,7,940,0,1960,0,98032,47.3838,-122.289,1150,8050,7040,6900,25.68922305764411,0.017049180327868854,Very Cheap
20141202T000000,400000.0,3,1.75,1920,9102,1.0,0,0,3,7,1920,0,1968,0,98072,47.7487,-122.082,1920,9760,7182,7840,43.946385409800044,0.04262295081967213,Very Cheap
20141110T000000,1030000.0,3,2.5,3545,9816,1.0,0,0,3,10,2610,935,2005,0,98027,47.5534,-122.078,3630,7704,6271,4074,104.93072534637326,0.12524590163934426,Cheap
20150319T000000,505000.0,3,2.0,1260,5460,1.0,0,0,3,7,1260,0,1972,0,98034,47.7355,-122.18,1510,5460,4200,3950,92.4908424908425,0.05639344262295082,Very Cheap
20141009T000000,475000.0,5,2.5,2340,7200,1.0,0,0,3,7,1300,1040,1975,0,98034,47.7206,-122.211,1930,7221,4860,5291,65.97222222222223,0.05245901639344262,Very Cheap
20141105T000000,520000.0,3,2.25,2590,9263,1.0,0,0,5,8,1440,1150,1977,0,98028,47.7691,-122.262,2580,9450,6673,6870,56.13732052250891,0.058360655737704915,Very Cheap
20150502T000000,1450000.0,3,4.5,3970,24920,2.0,0,2,3,10,3260,710,1977,1999,98034,47.7183,-122.258,2610,13838,20950,11228,58.18619582664527,0.18032786885245902,Cheap
20141231T000000,333500.0,3,1.75,1220,9732,1.0,0,0,3,7,1220,0,1965,0,98011,47.7736,-122.214,1630,10007,8512,8377,34.26839293053843,0.033901639344262297,Very Cheap
20150222T000000,232000.0,3,1.0,1400,10403,1.0,0,0,4,6,1400,0,1976,0,98038,47.362,-122.029,1230,10209,9003,8979,22.301259252138806,0.02059016393442623,Very Cheap
20150421T000000,691100.0,3,2.75,2360,16117,1.0,0,0,4,8,1710,650,1983,0,98006,47.5698,-122.121,2120,16117,13757,13997,42.88018862071105,0.0808,Very Cheap
20141014T000000,811000.0,3,1.75,1870,9897,1.0,0,0,4,8,1870,0,1960,0,98040,47.5505,-122.221,1900,10005,8027,8105,81.9440234414469,0.09652459016393443,Very Cheap
20140520T000000,551000.0,3,2.5,2830,5802,2.0,0,0,3,9,2830,0,2001,0,98028,47.7605,-122.234,2500,5788,2972,3288,94.96725267149259,0.06242622950819672,Very Cheap
20150108T000000,496500.0,3,2.5,2260,3640,2.0,0,0,3,8,2260,0,1994,0,98072,47.7356,-122.157,2350,3710,1380,1360,136.4010989010989,0.05527868852459016,Very Cheap
20141126T000000,705000.0,3,3.0,1970,20978,2.0,1,3,4,9,1770,200,1980,0,98070,47.3844,-122.438,2280,75396,19008,73116,33.606635522928784,0.08262295081967214,Very Cheap
20140612T000000,578000.0,4,2.5,3140,9225,1.0,0,2,5,9,1770,1370,1966,0,98055,47.4904,-122.226,2460,9600,6085,7140,62.65582655826558,0.06596721311475409,Very Cheap
20150128T000000,255000.0,3,1.75,1240,8659,1.0,0,0,5,7,1240,0,1986,0,98042,47.3663,-122.089,1490,8223,7419,6733,29.449128074835432,0.02360655737704918,Very Cheap
20140626T000000,1050000.0,4,3.5,3450,7832,2.0,0,0,3,10,3450,0,2007,0,98006,47.5637,-122.123,3220,8567,4382,5347,134.06537282941778,0.12786885245901639,Cheap
20150305T000000,348000.0,3,2.25,2570,8491,2.0,0,0,4,8,2570,0,1989,0,98042,47.3759,-122.125,2400,8049,5921,5649,40.98457189965846,0.03580327868852459,Very Cheap
20141104T000000,230000.0,3,2.0,1510,3413,2.0,0,0,3,7,1510,0,1985,0,98031,47.3912,-122.167,1570,3777,1903,2207,67.38939349545853,0.020327868852459016,Very Cheap
20141209T000000,359500.0,4,2.25,2390,11250,2.0,0,0,3,9,2390,0,1988,0,98023,47.3305,-122.371,2480,11250,8860,8770,31.955555555555556,0.037311475409836065,Very Cheap
20141112T000000,330000.0,3,1.0,980,7000,1.0,0,0,3,6,980,0,1953,0,98133,47.7617,-122.357,1220,7000,6020,5780,47.142857142857146,0.03344262295081967,Very Cheap
20140523T000000,80000.0,1,0.75,430,5050,1.0,0,0,2,4,430,0,1912,0,98014,47.6499,-121.909,1200,7500,4620,6300,15.841584158415841,0.0006557377049180328,Very Cheap
20141201T000000,465000.0,3,1.75,1480,6360,1.0,0,0,3,7,1480,0,1954,0,98133,47.7311,-122.353,1480,6360,4880,4880,73.11320754716981,0.051147540983606556,Very Cheap
20141015T000000,325000.0,4,2.5,1850,7324,2.0,0,0,3,8,1850,0,1997,0,98042,47.3701,-122.107,2100,7329,5474,5229,44.37465865647187,0.03278688524590164,Very Cheap
20150107T000000,340500.0,3,2.0,2270,28025,1.0,0,0,4,7,1920,350,1947,0,98168,47.4857,-122.318,1770,14833,25755,13063,12.149866190900982,0.03481967213114754,Very Cheap
20150106T000000,342500.0,3,2.5,1810,5192,2.0,0,0,3,8,1810,0,1993,0,98038,47.3724,-122.042,1810,6200,3382,4390,65.9668721109399,0.035081967213114754,Very Cheap
20140623T000000,290900.0,2,2.0,1610,17600,2.0,0,0,3,6,1610,0,1930,1983,98178,47.4855,-122.266,1310,12950,15990,11640,16.52840909090909,0.028314754098360657,Very Cheap
20150213T000000,868700.0,3,4.25,3840,6161,2.0,0,0,3,10,3840,0,2000,0,98074,47.6336,-122.064,3230,7709,2321,4479,140.9998376886869,0.10409180327868853,Cheap
20141113T000000,1199000.0,4,2.75,4110,8400,2.0,0,1,3,9,3130,980,1928,2013,98125,47.717,-122.281,2820,8400,4290,5580,142.73809523809524,0.14740983606557376,Cheap
20141014T000000,1150000.0,4,3.25,4190,10259,2.0,0,0,3,11,3150,1040,2000,0,98074,47.6332,-122.066,4300,11919,6069,7619,112.09669558436495,0.14098360655737704,Cheap
20140811T000000,859900.0,4,2.75,3390,6298,2.0,0,0,3,9,3390,0,2011,0,98074,47.5906,-122.062,3390,7111,2908,3721,136.53540806605272,0.1029377049180328,Cheap
20140808T000000,520000.0,4,2.25,1890,3006,2.0,0,0,3,7,1890,0,2003,0,98029,47.5461,-121.998,1580,3000,1116,1420,172.98735861610112,0.058360655737704915,Very Cheap
20140711T000000,460000.0,3,2.5,1610,2527,2.0,0,2,3,9,1080,530,2005,0,98118,47.5674,-122.29,1610,4173,917,2563,182.03403244954492,0.050491803278688525,Very Cheap
20140901T000000,438924.0,3,1.5,1050,4590,1.0,0,0,3,7,850,200,1949,0,98115,47.6943,-122.29,1770,5400,3540,3630,95.62614379084967,0.04772773770491803,Very Cheap
20150406T000000,315000.0,2,1.0,630,6550,1.0,0,0,3,5,630,0,1918,0,98126,47.5486,-122.38,1420,6550,5920,5130,48.091603053435115,0.031475409836065574,Very Cheap
20140718T000000,590000.0,4,2.75,2910,10650,1.0,0,2,3,8,1780,1130,1975,0,98033,47.6658,-122.188,2920,10988,7740,8068,55.39906103286385,0.06754098360655737,Very Cheap
20141104T000000,378500.0,4,1.75,1700,8640,1.0,0,0,3,7,850,850,1955,0,98006,47.5772,-122.153,1620,9000,6940,7380,43.807870370370374,0.03980327868852459,Very Cheap
20140603T000000,328500.0,3,2.5,1950,8130,2.0,0,0,4,9,1950,0,1990,0,98042,47.3875,-122.161,2350,7691,6180,5341,40.40590405904059,0.03324590163934426,Very Cheap
20150325T000000,849950.0,3,3.0,2990,9773,2.0,0,0,4,8,2990,0,1973,0,98005,47.6344,-122.174,2230,11553,6783,9323,86.96920085951089,0.10163278688524591,Cheap
20141027T000000,525000.0,3,1.5,1350,6000,1.0,0,2,3,7,900,450,1950,0,98136,47.5275,-122.391,1730,6012,4650,4282,87.5,0.05901639344262295,Very Cheap
20150410T000000,1385000.0,4,3.25,4860,181319,2.5,0,0,3,9,4860,0,1993,0,98074,47.6179,-122.005,3850,181319,176459,177469,7.63847142329265,0.1718032786885246,Cheap
20150428T000000,295000.0,4,2.5,2160,7725,1.0,0,0,4,8,1460,700,1978,0,98023,47.3078,-122.378,2060,8250,5565,6190,38.18770226537217,0.028852459016393443,Very Cheap
20140711T000000,1067000.0,6,3.5,4860,11793,2.0,0,0,3,11,3860,1000,1998,0,98006,47.5521,-122.137,3600,11793,6933,8193,90.47740184855422,0.1300983606557377,Cheap
20140721T000000,207950.0,2,2.0,890,5000,1.0,0,0,3,6,890,0,1917,0,98118,47.5158,-122.264,1860,5000,4110,3140,41.59,0.017436065573770494,Very Cheap
20141216T000000,699900.0,4,2.75,2810,7302,2.0,0,0,3,9,2810,0,2002,0,98075,47.5985,-121.977,2820,7302,4492,4482,95.85045193097781,0.08195409836065574,Very Cheap
20150210T000000,1280000.0,5,2.5,3400,9500,2.0,0,1,4,8,3400,0,1977,0,98027,47.5645,-122.082,3080,11081,6100,8001,134.73684210526315,0.1580327868852459,Cheap
20141120T000000,452000.0,4,1.5,1580,7350,1.0,0,0,4,7,960,620,1963,0,98052,47.6734,-122.154,1560,7350,5770,5790,61.49659863945578,0.04944262295081967,Very Cheap
20150205T000000,370000.0,3,2.0,1680,5036,1.0,0,1,4,7,1680,0,1987,0,98055,47.4734,-122.186,1680,4921,3356,3241,73.47100873709293,0.038688524590163934,Very Cheap
20150127T000000,232000.0,3,1.75,1300,11230,1.0,0,0,5,7,1300,0,1968,0,98042,47.3811,-122.087,1300,10794,9930,9494,20.658949243098842,0.02059016393442623,Very Cheap
20141030T000000,669950.0,5,2.5,2820,14062,2.0,0,0,4,7,2380,440,1960,0,98034,47.7081,-122.215,1910,10392,11242,8482,47.64258284739013,0.07802622950819672,Very Cheap
20140614T000000,397500.0,3,2.0,1510,6710,1.0,0,0,3,7,1070,440,1972,0,98034,47.7193,-122.216,1660,6600,5200,4940,59.23994038748137,0.04229508196721311,Very Cheap
20140512T000000,490000.0,2,2.5,1230,1391,2.0,0,0,3,8,870,360,2004,0,98112,47.6192,-122.301,1240,1350,161,110,352.2645578720345,0.05442622950819672,Very Cheap
20150128T000000,725000.0,4,2.0,2110,4140,2.0,0,0,3,9,1710,400,1925,2003,98116,47.5836,-122.387,1440,4420,2030,2980,175.12077294685992,0.08524590163934426,Very Cheap
20140917T000000,299000.0,3,2.75,3080,19635,1.0,0,2,4,7,1610,1470,1958,0,98032,47.3841,-122.284,2424,12410,16555,9986,15.227909345556405,0.02937704918032787,Very Cheap
20140818T000000,625000.0,2,1.5,1490,5750,1.5,0,0,4,7,1190,300,1900,0,98116,47.5872,-122.39,1590,4025,4260,2435,108.69565217391305,0.07213114754098361,Very Cheap
20141106T000000,437500.0,3,2.5,2120,4500,2.0,0,0,3,7,2120,0,2000,0,98065,47.5322,-121.88,2530,4816,2380,2286,97.22222222222223,0.047540983606557376,Very Cheap
20150510T000000,650000.0,4,2.5,3180,5438,2.0,0,0,3,9,3180,0,2003,0,98065,47.5416,-121.864,3030,5335,2258,2305,119.52923869069511,0.07540983606557378,Very Cheap
20140519T000000,475000.0,2,1.0,1490,3825,1.0,0,0,3,7,860,630,1929,0,98117,47.6799,-122.381,1460,3825,2335,2365,124.18300653594771,0.05245901639344262,Very Cheap
20140502T000000,342000.0,3,2.0,1930,11947,1.0,0,0,4,8,1930,0,1966,0,98042,47.3672,-122.151,2200,12825,10017,10625,28.626433414246254,0.03501639344262295,Very Cheap
20141015T000000,1197350.0,4,2.5,2770,7800,2.0,0,0,3,10,2770,0,1999,0,98033,47.684,-122.205,2720,10000,5030,7280,153.50641025641025,0.1471934426229508,Cheap
20150210T000000,280000.0,3,1.5,1670,11610,1.0,0,0,4,7,1670,0,1963,0,98055,47.4404,-122.191,1930,10200,9940,8270,24.117140396210164,0.026885245901639345,Very Cheap
20140521T000000,240000.0,2,1.75,1330,7200,1.0,0,0,3,7,1330,0,1993,0,98188,47.4467,-122.281,1450,11682,5870,10232,33.333333333333336,0.021639344262295083,Very Cheap
20140527T000000,529000.0,3,1.0,1210,3328,1.5,0,0,4,7,1210,0,1924,0,98107,47.6729,-122.363,1640,3333,2118,1693,158.95432692307693,0.05954098360655738,Very Cheap
20150202T000000,442000.0,3,1.0,1190,5100,1.0,0,0,4,7,1030,160,1941,0,98136,47.5346,-122.385,1690,5100,3910,3410,86.66666666666667,0.048131147540983604,Very Cheap
20140508T000000,615000.0,2,1.0,1540,6872,1.0,0,0,4,7,820,720,1946,0,98119,47.6454,-122.373,1420,5538,5332,4118,89.49359720605355,0.07081967213114754,Very Cheap
20140612T000000,1485000.0,4,3.75,4030,10800,2.0,0,0,3,10,4030,0,2006,0,98033,47.6821,-122.196,2160,7200,6770,5040,137.5,0.18491803278688523,Cheap
20150505T000000,585000.0,4,1.75,2430,7559,1.0,0,0,4,8,1580,850,1981,0,98052,47.7206,-122.11,1980,8750,5129,6770,77.3911893107554,0.06688524590163934,Very Cheap
20150305T000000,480000.0,4,2.5,2600,7787,2.0,0,0,3,8,2600,0,2005,0,98059,47.4877,-122.139,2830,7787,5187,4957,61.64119686657249,0.05311475409836065,Very Cheap
20140721T000000,1095000.0,5,3.5,4410,57063,2.0,0,0,4,9,4410,0,1990,0,98053,47.6554,-122.018,2900,50529,52653,47629,19.189317070606172,0.13377049180327868,Cheap
20141105T000000,290000.0,4,1.0,1330,8184,1.5,0,0,3,7,1330,0,1949,0,98133,47.7343,-122.347,1220,660,6854,-560,35.43499511241447,0.02819672131147541,Very Cheap
20140820T000000,615000.0,3,1.75,1900,5000,1.0,0,0,5,7,950,950,1951,0,98116,47.5789,-122.393,1770,5000,3100,3230,123.0,0.07081967213114754,Very Cheap
20150311T000000,300000.0,2,1.0,1100,7680,1.0,0,0,4,7,1100,0,1950,0,98133,47.7439,-122.339,1460,7680,6580,6220,39.0625,0.029508196721311476,Very Cheap
20141029T000000,308000.0,3,1.0,1980,39150,1.5,0,0,3,6,1580,400,1932,0,98030,47.3818,-122.225,1860,11811,37170,9951,7.8671775223499365,0.030557377049180327,Very Cheap
20150507T000000,750000.0,3,2.5,2400,7745,2.0,0,0,3,9,2400,0,2001,0,98033,47.6734,-122.173,2080,8615,5345,6535,96.83666881859264,0.08852459016393442,Very Cheap
20141114T000000,2250000.0,4,2.25,4760,8036,2.5,0,0,5,9,3390,1370,1916,0,98112,47.6415,-122.285,2950,9323,3276,6373,279.99004479840715,0.28524590163934427,Cheap
20140805T000000,890000.0,4,3.25,3180,194278,2.0,0,0,3,10,3180,0,2005,0,98059,47.4711,-122.084,2200,178160,191098,175960,4.581064248139264,0.10688524590163935,Cheap
20150325T000000,288000.0,3,1.0,1190,7560,1.0,0,0,5,6,1190,0,1958,0,98058,47.452,-122.177,1190,7560,6370,6370,38.095238095238095,0.027934426229508195,Very Cheap
20140906T000000,190000.0,2,1.0,630,6000,1.0,0,0,3,6,630,0,1943,2005,98178,47.4973,-122.221,1470,6840,5370,5370,31.666666666666668,0.015081967213114755,Very Cheap
20150326T000000,515000.0,5,3.0,2530,5105,1.0,0,0,3,8,1520,1010,2005,0,98133,47.7546,-122.341,2290,4011,2575,1721,100.88148873653282,0.057704918032786885,Very Cheap
20141105T000000,235000.0,4,1.5,1690,11054,1.0,0,0,4,5,1690,0,1930,0,98055,47.4667,-122.215,1690,9040,9364,7350,21.259272661480008,0.02098360655737705,Very Cheap
20140818T000000,275000.0,2,1.0,940,5000,1.0,0,0,3,6,940,0,1951,0,98126,47.5186,-122.374,940,5000,4060,4060,55.0,0.02622950819672131,Very Cheap
20141121T000000,727500.0,2,2.0,1240,9119,1.0,0,0,4,7,1240,0,1952,0,98004,47.6221,-122.193,1380,9121,7879,7741,79.77848448294769,0.08557377049180327,Very Cheap
20140620T000000,650000.0,4,2.5,3040,6587,2.0,0,0,3,7,3040,0,2003,0,98053,47.683,-122.039,2740,6587,3547,3847,98.67921663883406,0.07540983606557378,Very Cheap
20140618T000000,1600000.0,6,5.0,6050,230652,2.0,0,3,3,11,6050,0,2001,0,98024,47.6033,-121.943,4210,233971,224602,229761,6.936857256819798,0.2,Cheap
20141105T000000,365000.0,4,1.0,1590,7085,1.5,0,0,3,6,1590,0,1944,0,98125,47.7315,-122.305,1320,7085,5495,5765,51.51729004940014,0.0380327868852459,Very Cheap
20141008T000000,662000.0,3,1.75,2500,36947,1.0,0,0,3,9,2500,0,1984,0,98052,47.6917,-122.084,2590,28837,34447,26247,17.917557582483017,0.07698360655737704,Very Cheap
20150429T000000,270500.0,3,2.5,1780,7848,1.0,0,0,3,7,1320,460,1978,0,98038,47.3608,-122.056,1680,7848,6068,6168,34.46738022426096,0.025639344262295083,Very Cheap
20150505T000000,200000.0,2,1.5,1360,1898,2.0,0,0,3,7,1360,0,1978,0,98092,47.2852,-122.19,1360,1898,538,538,105.3740779768177,0.01639344262295082,Very Cheap
20150224T000000,970000.0,4,3.25,4740,76230,2.0,0,0,3,10,4740,0,1987,0,98075,47.5931,-122.071,3340,49206,71490,45866,12.724649088285451,0.11737704918032787,Cheap
20140624T000000,160000.0,3,1.5,1010,9600,1.0,0,0,4,7,1010,0,1962,0,98198,47.4097,-122.316,1400,9660,8590,8260,16.666666666666668,0.011147540983606558,Very Cheap
20150218T000000,204000.0,3,1.0,1040,7405,1.0,0,0,4,6,1040,0,1971,0,98010,47.3105,-122.021,1580,7405,6365,5825,27.548953409858203,0.016918032786885247,Very Cheap
20150218T000000,358000.0,3,2.25,1610,6655,2.0,0,0,4,7,1610,0,1985,0,98058,47.4296,-122.161,1780,7529,5045,5749,53.794139744552965,0.03711475409836065,Very Cheap
20150501T000000,452000.0,4,1.75,1570,8268,1.0,0,0,3,7,1570,0,1979,0,98011,47.7373,-122.197,1870,8190,6698,6320,54.66860183841316,0.04944262295081967,Very Cheap
20141204T000000,595000.0,2,2.0,1510,4000,1.0,0,0,4,7,1010,500,1900,0,98103,47.6582,-122.345,1920,4000,2490,2080,148.75,0.06819672131147542,Very Cheap
20150410T000000,249000.0,3,2.0,1360,6082,1.0,0,0,3,7,1360,0,1994,0,98042,47.3577,-122.16,1360,6987,4722,5627,40.940480105228545,0.02281967213114754,Very Cheap
20150310T000000,346900.0,4,2.5,1970,5106,2.0,0,0,3,8,1970,0,1999,0,98055,47.449,-122.205,2230,5109,3136,2879,67.93967880924403,0.03565901639344262,Very Cheap
20150218T000000,2125000.0,3,2.5,5403,24069,2.0,1,4,4,12,5403,0,1976,0,98166,47.4169,-122.348,3980,104374,18666,100394,88.28783912917031,0.26885245901639343,Cheap
20141030T000000,280000.0,4,2.5,1560,4350,2.0,0,0,3,7,1560,0,2003,0,98056,47.5025,-122.186,1560,4350,2790,2790,64.36781609195403,0.026885245901639345,Very Cheap
20141013T000000,318888.0,4,1.75,2320,12000,1.0,0,0,4,8,2270,50,1973,0,98032,47.3644,-122.28,2120,9880,9680,7760,26.574,0.03198531147540984,Very Cheap
20140911T000000,530000.0,3,2.25,2120,40518,1.0,0,0,3,8,2120,0,1967,0,98075,47.5896,-122.009,2480,13492,38398,11012,13.08060615035293,0.05967213114754098,Very Cheap
20141121T000000,375000.0,3,2.25,2120,18500,2.0,0,0,4,8,2120,0,1983,0,98031,47.3914,-122.169,2120,14479,16380,12359,20.27027027027027,0.03934426229508197,Very Cheap
20150422T000000,910000.0,4,2.5,3350,29242,2.0,0,0,3,11,3350,0,1988,0,98052,47.7197,-122.131,3920,24728,25892,20808,31.119622460843992,0.10950819672131147,Cheap
20140523T000000,782000.0,4,2.5,2380,9614,2.0,0,0,4,10,2380,0,1991,0,98006,47.5623,-122.116,2560,9770,7234,7210,81.33971291866028,0.09272131147540984,Very Cheap
20150319T000000,259950.0,2,2.0,1070,649,2.0,0,0,3,9,720,350,2008,0,98106,47.5213,-122.357,1070,928,-421,-142,400.5392912172573,0.024255737704918033,Very Cheap
20140923T000000,315000.0,4,2.75,2300,18360,1.0,0,0,4,7,1560,740,1979,0,98058,47.4518,-122.16,1870,9588,16060,7718,17.15686274509804,0.031475409836065574,Very Cheap
20140528T000000,215000.0,2,1.0,1320,8865,1.0,0,0,4,6,1320,0,1943,0,98168,47.4949,-122.3,1190,6490,7545,5300,24.2526790750141,0.018360655737704918,Very Cheap
20140723T000000,705000.0,3,1.75,2180,10221,1.0,0,2,4,7,1140,1040,1946,0,98040,47.5885,-122.248,2180,8535,8041,6355,68.97563839154681,0.08262295081967214,Very Cheap
20141013T000000,1450000.0,3,3.0,4380,6320,2.0,0,3,5,10,3580,800,1952,0,98199,47.6452,-122.411,3080,7680,1940,4600,229.43037974683546,0.18032786885245902,Cheap
20150508T000000,451000.0,3,1.75,1790,9813,2.0,0,0,3,7,1790,0,1949,0,98155,47.749,-122.305,1520,10125,8023,8605,45.95944155711811,0.04931147540983607,Very Cheap
20140902T000000,261000.0,2,1.0,750,8125,1.0,0,0,4,6,750,0,1943,0,98055,47.4727,-122.198,1340,8750,7375,7410,32.12307692307692,0.02439344262295082,Very Cheap
20141117T000000,396000.0,3,1.5,1300,8280,1.0,0,0,5,7,1300,0,1956,0,98028,47.7403,-122.256,1570,8692,6980,7122,47.82608695652174,0.0420983606557377,Very Cheap
20140722T000000,725000.0,4,2.5,2990,29170,2.0,0,3,3,9,2990,0,1999,0,98059,47.5146,-122.117,3715,29170,26180,25455,24.85430236544395,0.08524590163934426,Very Cheap
20140620T000000,1950000.0,7,3.5,4640,15235,2.0,0,1,3,11,2860,1780,1965,2003,98040,47.5666,-122.231,3230,20697,10595,17467,127.9947489333771,0.2459016393442623,Cheap
20140715T000000,238000.0,4,1.0,1400,7242,1.5,0,0,3,7,1400,0,1959,0,98188,47.4339,-122.291,1310,7314,5842,6004,32.863849765258216,0.02137704918032787,Very Cheap
20150427T000000,750000.0,6,1.75,2750,9563,2.0,0,0,4,8,2750,0,1973,0,98052,47.6368,-122.097,2040,9563,6813,7523,78.42727177663913,0.08852459016393442,Very Cheap
20141027T000000,331500.0,4,2.5,2050,10271,2.0,0,0,3,7,2050,0,1998,0,98042,47.3628,-122.075,2050,8103,8221,6053,32.275338331223836,0.03363934426229508,Very Cheap
20141028T000000,460000.0,4,3.0,2230,108900,1.0,0,0,3,7,1410,820,1978,0,98065,47.52,-121.845,1960,65340,106670,63380,4.224058769513315,0.050491803278688525,Very Cheap
20140707T000000,404950.0,4,2.25,2340,217014,1.0,0,0,4,8,2340,0,1982,0,98092,47.2953,-122.083,2340,107898,214674,105558,1.866008644603574,0.043272131147540985,Very Cheap
20141217T000000,880000.0,3,2.5,2870,5163,2.0,0,0,3,9,2870,0,2014,0,98103,47.6935,-122.352,1630,7995,2293,6365,170.4435405771838,0.10557377049180328,Cheap
20140613T000000,863000.0,4,2.5,4120,22370,2.0,0,0,3,10,4120,0,1997,0,98074,47.6239,-122.023,3180,7257,18250,4077,38.578453285650426,0.10334426229508197,Cheap
20141216T000000,638700.0,3,1.75,2080,9162,1.0,0,0,3,7,1370,710,1960,0,98005,47.5846,-122.168,1870,8944,7082,7074,69.71185330713818,0.07392786885245901,Very Cheap
20140728T000000,435000.0,3,2.5,1840,5680,2.0,0,0,3,7,1840,0,2008,0,98053,47.6969,-122.026,1600,4697,3840,3097,76.58450704225352,0.04721311475409836,Very Cheap
20141231T000000,260000.0,3,1.0,1180,5350,1.5,0,0,4,6,1180,0,1959,0,98178,47.505,-122.259,1490,5350,4170,3860,48.598130841121495,0.024262295081967214,Very Cheap
20140814T000000,671500.0,5,2.75,2160,4000,1.5,0,0,5,7,1530,630,1927,0,98105,47.667,-122.289,2040,4000,1840,1960,167.875,0.07822950819672131,Very Cheap
20141022T000000,610000.0,3,1.0,1180,3400,1.5,0,0,3,8,1180,0,1907,0,98109,47.6376,-122.353,1440,3400,2220,1960,179.41176470588235,0.07016393442622951,Very Cheap
20141218T000000,405000.0,2,0.75,1160,15029,1.0,0,0,4,6,870,290,1937,0,98014,47.6929,-121.87,1870,25346,13869,23476,26.94790072526449,0.043278688524590166,Very Cheap
20140718T000000,338900.0,4,2.5,1830,5612,2.0,0,0,3,7,1830,0,2003,0,98038,47.3572,-122.015,1830,5998,3782,4168,60.38845331432644,0.034609836065573774,Very Cheap
20150123T000000,720000.0,4,4.0,3200,7708,2.0,0,0,3,10,3200,0,2004,0,98075,47.5816,-121.97,3480,7944,4508,4464,93.4094447327452,0.08459016393442623,Very Cheap
20150424T000000,442000.0,5,3.0,2560,5445,1.5,0,0,4,7,1760,800,1927,0,98108,47.5502,-122.311,1080,5445,2885,4365,81.17539026629936,0.048131147540983604,Very Cheap
20140603T000000,650000.0,5,2.75,2550,5040,1.5,0,0,5,8,2550,0,1902,0,98122,47.6136,-122.299,1590,3840,2490,2250,128.96825396825398,0.07540983606557378,Very Cheap
20150102T000000,263500.0,3,1.75,1330,9917,1.0,0,0,3,7,1040,290,1981,0,98058,47.4478,-122.161,1330,9081,8587,7751,26.57053544418675,0.024721311475409836,Very Cheap
20141217T000000,300000.0,2,1.0,1220,75794,1.0,0,0,4,7,1220,0,1963,0,98038,47.4219,-122.007,2010,98010,74574,96000,3.9580969469878884,0.029508196721311476,Very Cheap
20141209T000000,266000.0,3,2.5,1805,3402,2.0,0,0,3,7,1805,0,2009,0,98002,47.3521,-122.212,2095,3402,1597,1307,78.18930041152264,0.02504918032786885,Very Cheap
20141211T000000,930000.0,4,4.0,6050,84942,2.5,0,2,3,9,4150,1900,2009,0,98077,47.7466,-122.029,2700,199504,78892,196804,10.948647312283676,0.1121311475409836,Cheap
20150127T000000,530000.0,4,2.5,2320,5493,2.0,0,0,3,8,2320,0,2004,0,98028,47.7727,-122.229,2450,5471,3173,3021,96.48643728381576,0.05967213114754098,Very Cheap
20141211T000000,180000.0,3,1.0,1384,8960,1.0,0,0,4,6,1384,0,1965,0,98023,47.3062,-122.371,1000,8470,7576,7470,20.089285714285715,0.01377049180327869,Very Cheap
20140516T000000,619000.0,3,2.5,2720,6439,2.0,0,0,3,9,2720,0,2005,0,98065,47.5422,-121.86,3180,7320,3719,4140,96.13293989749961,0.07134426229508196,Very Cheap
20140821T000000,264000.0,3,1.5,1820,10608,1.0,0,0,4,7,1820,0,1962,0,98003,47.3366,-122.306,1380,8976,8788,7596,24.8868778280543,0.02478688524590164,Very Cheap
20140701T000000,730000.0,2,2.25,2130,4920,1.5,0,4,4,7,1530,600,1941,0,98116,47.573,-122.409,2130,4920,2790,2790,148.3739837398374,0.0859016393442623,Very Cheap
20141022T000000,439000.0,4,2.25,2060,10070,2.0,0,0,3,7,2060,0,1975,0,98034,47.7258,-122.177,2060,8155,8010,6095,43.594836146971204,0.04773770491803279,Very Cheap
20141117T000000,268500.0,4,1.75,1420,7500,1.0,0,0,4,7,1080,340,1981,0,98031,47.4025,-122.176,1500,7260,6080,5760,35.8,0.02537704918032787,Very Cheap
20140715T000000,330000.0,3,1.75,1510,15744,1.0,0,0,3,7,1510,0,1985,0,98045,47.476,-121.755,1470,15744,14234,14274,20.960365853658537,0.03344262295081967,Very Cheap
20140819T000000,640000.0,3,2.5,2160,4000,1.5,0,0,3,8,1960,200,1903,2013,98122,47.6045,-122.307,2160,5120,1840,2960,160.0,0.0740983606557377,Very Cheap
20140708T000000,900000.0,3,2.5,3180,12600,2.0,0,0,4,11,3180,0,1978,0,98074,47.6366,-122.058,3030,12835,9420,9805,71.42857142857143,0.10819672131147541,Cheap
20140930T000000,370000.0,3,2.25,2110,13300,2.0,0,0,4,8,2110,0,1985,0,98038,47.3725,-122.06,2470,14000,11190,11530,27.81954887218045,0.038688524590163934,Very Cheap
20150314T000000,685000.0,3,2.0,2060,2900,1.5,0,0,5,8,1330,730,1931,0,98144,47.5897,-122.292,1910,3900,840,1990,236.20689655172413,0.08,Very Cheap
20140904T000000,505000.0,3,1.5,1830,217800,1.0,0,0,3,7,1010,820,1981,0,98053,47.6277,-121.972,2450,165963,215970,163513,2.318640955004591,0.05639344262295082,Very Cheap
20141021T000000,265000.0,3,1.75,1820,32666,1.0,0,0,4,7,1820,0,1966,0,98022,47.1803,-121.974,2050,43560,30846,41510,8.112410457356273,0.024918032786885248,Very Cheap
20150324T000000,290000.0,3,2.5,1610,2937,2.0,0,0,3,8,1610,0,2006,0,98055,47.4489,-122.188,1610,3049,1327,1439,98.74021109976167,0.02819672131147541,Very Cheap
20140902T000000,296000.0,4,2.5,1780,3600,2.0,0,0,3,7,1780,0,2006,0,98038,47.3665,-122.017,2020,3802,1820,1782,82.22222222222223,0.02898360655737705,Very Cheap
20150213T000000,360000.0,4,2.5,1840,9611,2.0,0,0,3,7,1840,0,1996,0,98178,47.4964,-122.251,1830,8505,7771,6675,37.457080428675475,0.037377049180327866,Very Cheap
20140604T000000,240500.0,3,1.75,1460,10584,1.0,0,0,3,7,990,470,1997,0,98168,47.492,-122.317,1220,12012,9124,10792,22.72297808012094,0.021704918032786884,Very Cheap
20140722T000000,372500.0,2,2.5,1400,2958,2.0,0,0,3,8,1400,0,2007,0,98126,47.5496,-122.373,1540,2385,1558,845,125.92968221771467,0.03901639344262295,Very Cheap
20141002T000000,595000.0,3,2.5,3370,14402,2.0,0,2,3,9,3370,0,2004,0,98045,47.5008,-121.776,3330,9691,11032,6361,41.313706429662545,0.06819672131147542,Very Cheap
20141017T000000,515000.0,4,3.0,3590,8249,2.0,0,0,3,9,3590,0,1997,0,98023,47.2846,-122.341,2860,7995,4659,5135,62.431809916353494,0.057704918032786885,Very Cheap
20140805T000000,1220000.0,4,2.25,3200,15367,2.0,0,0,4,9,3200,0,1962,0,98040,47.5494,-122.216,3070,15263,12167,12193,79.39090258345806,0.1501639344262295,Cheap
20141009T000000,507000.0,2,1.75,1670,6460,1.0,0,0,3,8,1670,0,2004,0,98053,47.7123,-122.027,2170,6254,4790,4084,78.48297213622291,0.05665573770491803,Very Cheap
20150204T000000,399950.0,4,2.0,2420,31465,1.0,0,0,3,9,2420,0,1984,0,98092,47.3131,-122.115,2560,32186,29045,29626,12.710948673128874,0.04261639344262295,Very Cheap
20140820T000000,185000.0,3,1.75,1430,10816,2.0,0,0,3,7,1430,0,1994,0,98010,47.3122,-121.996,1560,10816,9386,9256,17.1042899408284,0.014426229508196721,Very Cheap
20140825T000000,460000.0,3,1.75,1440,7070,1.0,0,0,3,7,1440,0,1980,0,98052,47.6947,-122.125,1440,7210,5630,5770,65.06364922206507,0.050491803278688525,Very Cheap
20150224T000000,435500.0,3,2.25,1450,4789,2.0,0,0,3,7,1450,0,1985,0,98029,47.5665,-122.018,1560,4490,3339,2930,90.93756525370641,0.04727868852459016,Very Cheap
20150408T000000,469000.0,4,2.75,3550,13938,1.0,0,0,5,8,2100,1450,1966,0,98188,47.425,-122.283,2050,9000,10388,6950,33.649017075620606,0.05167213114754098,Very Cheap
20140505T000000,531000.0,2,3.0,1270,1175,2.0,0,0,3,8,1110,160,2000,0,98103,47.6634,-122.34,1290,1800,-95,510,451.9148936170213,0.05980327868852459,Very Cheap
20150206T000000,443500.0,2,1.0,940,6804,1.0,0,0,3,7,940,0,1949,0,98177,47.7047,-122.373,1150,6930,5864,5780,65.1822457378013,0.048327868852459016,Very Cheap
20141126T000000,223000.0,3,2.0,1670,6824,1.0,0,0,3,7,1300,370,1990,0,98042,47.3666,-122.084,1660,7586,5154,5926,32.67878077373974,0.019409836065573772,Very Cheap
20150417T000000,590000.0,4,3.5,3100,15842,2.0,0,0,3,8,2400,700,1996,0,98028,47.7466,-122.242,2200,19400,12742,17200,37.2427723772251,0.06754098360655737,Very Cheap
20141209T000000,340000.0,2,2.5,1100,1760,3.0,0,0,3,7,1100,0,1997,0,98103,47.6972,-122.35,1200,1415,660,215,193.1818181818182,0.03475409836065574,Very Cheap
20141105T000000,650000.0,3,2.0,1870,3388,1.0,0,0,4,8,1230,640,1925,0,98199,47.6372,-122.395,1780,4050,1518,2270,191.85360094451005,0.07540983606557378,Very Cheap
20140925T000000,533600.0,3,2.5,1930,5080,2.0,0,0,4,8,1930,0,1990,0,98029,47.5694,-122.001,2190,5085,3150,2895,105.03937007874016,0.06014426229508197,Very Cheap
20140610T000000,695000.0,3,2.75,2540,4694,2.0,0,0,3,9,2540,0,2005,0,98074,47.6214,-122.024,2600,6344,2154,3744,148.06135492117596,0.08131147540983606,Very Cheap
20140617T000000,242000.0,3,1.75,1280,7524,1.5,0,0,4,7,1280,0,1988,0,98031,47.3961,-122.188,1500,7777,6244,6277,32.16374269005848,0.021901639344262296,Very Cheap
20150114T000000,425000.0,3,2.25,1820,8814,1.0,0,0,3,7,1280,540,1967,0,98125,47.7162,-122.309,1810,7515,6994,5705,48.2187429090084,0.04590163934426229,Very Cheap
20150506T000000,525000.0,3,2.25,1490,9414,2.0,0,0,3,7,1490,0,1981,0,98052,47.6844,-122.113,1290,10125,7924,8835,55.76800509878904,0.05901639344262295,Very Cheap
20140922T000000,485000.0,3,2.5,1880,5502,2.0,0,0,3,8,1880,0,1988,0,98029,47.5737,-122.018,2040,5411,3622,3371,88.14976372228281,0.05377049180327869,Very Cheap
20150113T000000,175000.0,3,1.0,1250,9775,1.0,0,0,3,7,1250,0,1971,0,98045,47.4474,-121.771,1390,9650,8525,8260,17.902813299232736,0.013114754098360656,Very Cheap
20140619T000000,210000.0,3,2.0,1440,7210,1.0,0,0,3,8,1440,0,1983,0,98092,47.3128,-122.184,1700,7245,5770,5545,29.12621359223301,0.017704918032786884,Very Cheap
20150415T000000,260000.0,3,2.5,1920,7415,2.0,0,0,3,7,1920,0,1989,0,98031,47.4022,-122.171,1930,7536,5495,5606,35.06405933917734,0.024262295081967214,Very Cheap
20140623T000000,577000.0,3,2.5,2060,5750,1.0,0,0,3,7,1330,730,1976,0,98116,47.5671,-122.391,1920,5750,3690,3830,100.34782608695652,0.06583606557377049,Very Cheap
20141021T000000,200000.0,3,1.5,1210,10588,1.0,0,0,4,7,1210,0,1958,0,98002,47.2876,-122.212,1408,10588,9378,9180,18.889308651303363,0.01639344262295082,Very Cheap
20150225T000000,605000.0,2,1.75,1760,5000,1.0,0,0,4,7,940,820,1927,0,98117,47.682,-122.372,1530,5000,3240,3470,121.0,0.06950819672131148,Very Cheap
20140521T000000,325000.0,3,1.0,990,6750,1.0,0,0,4,6,990,0,1947,0,98133,47.7125,-122.331,1440,6860,5760,5420,48.148148148148145,0.03278688524590164,Very Cheap
20140814T000000,289500.0,3,1.0,960,6400,1.0,0,0,4,6,820,140,1944,0,98178,47.496,-122.239,1200,6600,5440,5400,45.234375,0.028131147540983607,Very Cheap
20140808T000000,559950.0,3,2.5,1660,1458,3.0,0,0,3,9,1660,0,2014,0,98144,47.5876,-122.309,1660,1784,-202,124,384.05349794238685,0.0636,Very Cheap
20150406T000000,1042500.0,3,1.75,1900,9375,1.0,0,1,4,8,1330,570,1941,0,98115,47.6821,-122.273,2760,9375,7475,6615,111.2,0.12688524590163935,Cheap
20141009T000000,543500.0,3,2.25,1270,2790,1.0,0,0,3,7,990,280,1970,0,98199,47.6581,-122.396,1920,4000,1520,2080,194.80286738351253,0.061442622950819675,Very Cheap
20140522T000000,480000.0,4,2.25,3250,34293,2.0,0,0,4,9,3250,0,1983,0,98042,47.3496,-122.094,3110,35982,31043,32872,13.99702563205319,0.05311475409836065,Very Cheap
20140523T000000,218000.0,3,1.0,960,9633,1.0,0,0,5,6,960,0,1982,0,98022,47.1951,-122.001,1080,8610,8673,7530,22.63054084916433,0.018754098360655738,Very Cheap
20140622T000000,565000.0,2,1.75,1330,6000,1.0,0,0,4,7,960,370,1914,1945,98199,47.6539,-122.396,1620,6000,4670,4380,94.16666666666667,0.06426229508196721,Very Cheap
20141212T000000,426700.0,3,1.75,2080,7700,1.0,0,0,5,7,1600,480,1968,0,98056,47.5375,-122.178,1680,7700,5620,6020,55.41558441558441,0.04612459016393443,Very Cheap
20140912T000000,650000.0,3,2.5,2690,11575,1.0,0,3,3,8,2130,560,1957,0,98028,47.7605,-122.267,2390,11782,8885,9392,56.15550755939525,0.07540983606557378,Very Cheap
20140924T000000,542000.0,2,1.0,890,3060,1.0,0,0,3,7,770,120,1910,0,98105,47.6663,-122.326,1760,4080,2170,2320,177.12418300653596,0.06124590163934426,Very Cheap
20140624T000000,415000.0,3,1.75,1070,8000,1.0,0,0,3,7,1070,0,1977,0,98052,47.6978,-122.13,1200,7990,6930,6790,51.875,0.04459016393442623,Very Cheap
20140815T000000,214000.0,3,1.0,1200,8316,1.0,0,0,4,6,1200,0,1953,0,98002,47.3221,-122.215,1200,8316,7116,7116,25.733525733525735,0.01822950819672131,Very Cheap
20150121T000000,245000.0,3,1.5,1360,8910,2.0,0,0,5,7,1360,0,1949,0,98188,47.4488,-122.275,1220,8912,7550,7692,27.49719416386083,0.022295081967213116,Very Cheap
20140701T000000,314500.0,3,2.0,2050,13303,1.0,0,0,3,8,2050,0,1993,0,98003,47.2681,-122.31,2180,11590,11253,9410,23.641283920920092,0.03140983606557377,Very Cheap
20150409T000000,1120000.0,3,1.5,3000,5750,2.0,0,0,5,9,2000,1000,1924,0,98116,47.5821,-122.39,1820,5750,2750,3930,194.7826086956522,0.13704918032786886,Cheap
20150303T000000,378000.0,2,2.0,1300,3850,1.0,0,0,3,7,800,500,1963,0,98136,47.5395,-122.39,950,5500,2550,4550,98.18181818181819,0.03973770491803279,Very Cheap
20140728T000000,305000.0,4,2.5,2250,9091,1.0,0,0,3,7,1340,910,1982,0,98001,47.336,-122.269,1540,7802,6841,6262,33.54966450335497,0.03016393442622951,Very Cheap
20150320T000000,595000.0,5,2.75,3740,6750,1.0,0,0,4,8,1980,1760,1978,0,98028,47.7679,-122.261,2620,7920,3010,5300,88.14814814814815,0.06819672131147542,Very Cheap
20150512T000000,729500.0,3,2.5,1660,1091,3.0,0,1,3,9,1530,130,2015,0,98116,47.5818,-122.402,1510,1352,-569,-158,668.6526122823099,0.08583606557377049,Very Cheap
20140930T000000,430000.0,3,2.5,2360,6699,2.0,0,0,3,7,2360,0,2003,0,98065,47.5317,-121.853,2360,4744,4339,2384,64.18868487834006,0.04655737704918033,Very Cheap
20150409T000000,240000.0,3,1.75,1760,6500,1.0,0,0,3,7,1150,610,1987,0,98038,47.3647,-122.05,1760,8125,4740,6365,36.92307692307692,0.021639344262295083,Very Cheap
20150320T000000,545000.0,3,1.75,1680,6200,1.5,0,0,3,7,1680,0,1916,0,98136,47.5338,-122.384,1680,5100,4520,3420,87.90322580645162,0.06163934426229508,Very Cheap
20140707T000000,530000.0,3,1.75,1320,2500,1.0,0,0,3,7,870,450,1918,0,98105,47.6681,-122.305,1580,2750,1180,1170,212.0,0.05967213114754098,Very Cheap
20141118T000000,157000.0,1,1.0,870,26326,1.0,0,0,3,6,870,0,1939,0,98198,47.4152,-122.3,1250,10608,25456,9358,5.963686089797159,0.010754098360655738,Very Cheap
20150407T000000,425000.0,4,1.0,1260,7645,1.5,0,0,3,6,1260,0,1925,0,98146,47.5044,-122.35,1170,7649,6385,6479,55.591890124264225,0.04590163934426229,Very Cheap
20141117T000000,220000.0,3,1.0,1000,6020,1.0,0,0,3,6,1000,0,1944,0,98166,47.4793,-122.346,1300,8640,5020,7340,36.54485049833887,0.01901639344262295,Very Cheap
20141124T000000,521000.0,4,1.75,2020,36400,1.0,0,0,4,8,1550,470,1976,0,98077,47.7627,-122.076,2520,38255,34380,35735,14.313186813186814,0.058491803278688526,Very Cheap
20140523T000000,325000.0,3,1.0,1920,6862,1.0,0,2,3,7,1120,800,1952,0,98118,47.5193,-122.274,2000,6900,4942,4900,47.36228504809093,0.03278688524590164,Very Cheap
20150403T000000,597500.0,3,2.0,2150,5400,1.5,0,0,4,7,1380,770,1911,0,98126,47.555,-122.379,1940,6500,3250,4560,110.64814814814815,0.06852459016393443,Very Cheap
20140723T000000,337000.0,3,2.5,1470,3976,2.0,0,0,3,7,1470,0,1999,0,98065,47.526,-121.826,1490,4400,2506,2910,84.75855130784709,0.034360655737704915,Very Cheap
20150422T000000,1000000.0,3,2.5,3180,10492,2.0,0,2,3,10,3180,0,1991,0,98052,47.655,-122.124,3000,9812,7312,6812,95.31071292413267,0.12131147540983607,Cheap
20141120T000000,3070000.0,3,2.5,3930,55867,1.0,1,4,4,8,2330,1600,1957,0,98034,47.7022,-122.224,2730,26324,51937,23594,54.951939427569044,0.39278688524590166,Medium
20140507T000000,495000.0,3,1.0,990,6000,1.0,0,0,3,6,990,0,1943,0,98105,47.6718,-122.267,1250,6000,5010,4750,82.5,0.05508196721311476,Very Cheap
20150102T000000,748000.0,4,3.5,2770,3330,2.0,0,0,3,8,1970,800,2001,0,98052,47.6327,-122.109,2180,3380,560,1200,224.62462462462463,0.08826229508196722,Very Cheap
20140902T000000,888000.0,3,1.5,1250,8710,1.0,0,0,4,7,1250,0,1953,0,98004,47.6245,-122.198,1750,9185,7460,7435,101.95177956371987,0.10662295081967213,Cheap
20150324T000000,269900.0,3,1.75,1140,22267,1.0,0,0,3,7,1140,0,1986,0,98045,47.4761,-121.758,1150,15625,21127,14475,12.121076031795932,0.02556065573770492,Very Cheap
20141113T000000,496500.0,4,2.5,2250,14440,1.0,0,0,3,7,1550,700,1967,0,98027,47.5221,-122.045,2090,11400,12190,9310,34.38365650969529,0.05527868852459016,Very Cheap
20150121T000000,475000.0,3,2.5,1640,5097,2.0,0,0,3,7,1640,0,1969,0,98155,47.7522,-122.278,1880,6000,3457,4120,93.19207376888366,0.05245901639344262,Very Cheap
20140527T000000,312000.0,3,1.5,1255,1374,3.0,0,0,3,7,1255,0,2004,0,98125,47.7145,-122.311,1307,1232,119,-75,227.07423580786025,0.031081967213114754,Very Cheap
20141124T000000,323000.0,3,1.0,1290,12231,1.0,0,0,3,7,1290,0,1976,0,98072,47.7404,-122.11,1390,11632,10941,10242,26.408306761507646,0.03252459016393443,Very Cheap
20141124T000000,331000.0,3,1.75,1300,9079,1.0,0,0,3,7,1300,0,1986,0,98059,47.4834,-122.159,1890,7369,7779,5479,36.45775966516136,0.03357377049180328,Very Cheap
20140514T000000,306000.0,3,1.5,1220,1086,3.0,0,0,3,8,1220,0,2007,0,98133,47.7049,-122.353,1220,1422,-134,202,281.76795580110496,0.030295081967213113,Very Cheap
20140930T000000,655000.0,4,2.5,2630,4000,3.0,0,0,3,8,2630,0,2002,0,98117,47.6915,-122.381,1640,4000,1370,2360,163.75,0.0760655737704918,Very Cheap
20140709T000000,290000.0,3,1.5,1950,15954,1.0,0,0,4,8,1950,0,1959,0,98003,47.336,-122.319,1940,12667,14004,10727,18.177259621411558,0.02819672131147541,Very Cheap
20140802T000000,1250000.0,4,3.25,3160,5000,2.0,0,0,5,9,2360,800,1965,0,98105,47.6597,-122.274,2220,4000,1840,1780,250.0,0.1540983606557377,Cheap
20140616T000000,460000.0,3,1.75,1550,4708,1.0,0,0,4,7,860,690,1949,0,98115,47.6759,-122.286,1880,5600,3158,3720,97.70603228547154,0.050491803278688525,Very Cheap
20140912T000000,435000.0,4,2.5,1700,6380,1.0,0,0,4,7,850,850,1940,0,98115,47.6988,-122.319,1380,6380,4680,5000,68.18181818181819,0.04721311475409836,Very Cheap
20150316T000000,664000.0,4,2.75,2510,11880,1.0,0,0,5,8,1630,880,1978,0,98006,47.5427,-122.181,2390,11211,9370,8821,55.89225589225589,0.07724590163934426,Very Cheap
20140729T000000,865000.0,4,1.75,1800,4180,2.0,0,3,4,8,1800,0,1921,0,98102,47.6462,-122.318,2180,4620,2380,2440,206.9377990430622,0.10360655737704919,Cheap
20140813T000000,385000.0,3,1.75,1800,18000,1.0,0,0,3,8,1200,600,1968,0,98058,47.4406,-122.146,1800,18000,16200,16200,21.38888888888889,0.04065573770491803,Very Cheap
20140718T000000,497000.0,3,2.25,1870,9315,1.0,0,0,3,7,1350,520,1975,0,98034,47.705,-122.202,2230,9579,7445,7349,53.35480407944176,0.055344262295081964,Very Cheap
20140623T000000,280000.0,2,1.0,1010,3000,1.0,0,0,4,7,1010,0,1925,0,98045,47.4965,-121.785,1150,7000,1990,5850,93.33333333333333,0.026885245901639345,Very Cheap
20150127T000000,188000.0,2,1.5,1120,17487,1.0,0,0,3,6,1120,0,1924,0,98178,47.5024,-122.271,1690,8056,16367,6366,10.75084348373077,0.014819672131147541,Very Cheap
20140930T000000,478500.0,3,1.0,2090,4755,1.0,0,2,3,8,1200,890,1969,0,98136,47.5304,-122.387,1850,5300,2665,3450,100.63091482649843,0.05291803278688525,Very Cheap
20140731T000000,1145000.0,4,3.5,4370,18361,2.0,0,0,3,11,4370,0,2001,0,98065,47.544,-121.872,4190,13641,13991,9451,62.36043788464681,0.14032786885245901,Cheap
20140815T000000,222000.0,3,2.0,1440,7187,1.0,0,0,4,7,970,470,1981,0,98023,47.291,-122.368,1440,7187,5747,5747,30.88910532906637,0.019278688524590165,Very Cheap
20140528T000000,799000.0,4,3.0,2580,209523,2.0,0,0,3,8,2580,0,1984,0,98053,47.6932,-122.006,3440,213444,206943,210004,3.8134238245920495,0.09495081967213115,Very Cheap
20140609T000000,609900.0,4,2.5,3190,7399,2.0,0,0,3,10,3190,0,2006,0,98038,47.3558,-122.004,3250,7323,4209,4073,82.43005811596161,0.07015081967213115,Very Cheap
20141016T000000,413000.0,4,3.5,2380,5809,2.0,0,0,4,7,1750,630,1995,0,98106,47.5536,-122.359,1620,5775,3429,4155,71.09657428128766,0.04432786885245902,Very Cheap
20141013T000000,400000.0,4,1.0,1420,4875,1.5,0,0,3,7,1420,0,1930,0,98115,47.6942,-122.321,1110,5413,3455,4303,82.05128205128206,0.04262295081967213,Very Cheap
20150105T000000,802541.0,5,2.75,2990,6768,2.0,0,0,3,9,2990,0,2014,0,98006,47.5462,-122.182,2870,6768,3778,3898,118.57875295508275,0.0954152131147541,Very Cheap
20140519T000000,320000.0,3,2.5,2680,7757,2.0,0,0,3,8,2680,0,1990,0,98023,47.2918,-122.346,2430,8231,5077,5801,41.25306175067681,0.032131147540983604,Very Cheap
20150311T000000,507000.0,4,2.5,2730,7649,2.0,0,0,3,7,2730,0,2006,0,98065,47.5441,-121.882,2730,6216,4919,3486,66.28317427114655,0.05665573770491803,Very Cheap
20140924T000000,387500.0,3,1.0,1220,8329,1.0,0,0,3,6,1220,0,1946,0,98115,47.6982,-122.298,1490,8322,7109,6832,46.52419258014167,0.040983606557377046,Very Cheap
20150224T000000,396000.0,3,1.0,1500,12616,1.0,0,0,3,7,1500,0,1967,0,98072,47.7415,-122.101,1820,13950,11116,12130,31.388712745719722,0.0420983606557377,Very Cheap
20140821T000000,373000.0,3,1.75,1830,11788,1.0,0,1,3,8,1430,400,1958,0,98055,47.4862,-122.224,2140,11964,9958,9824,31.64234815066169,0.03908196721311476,Very Cheap
20140923T000000,1484900.0,5,2.5,4570,19252,2.0,0,0,5,10,4570,0,1965,0,98040,47.5553,-122.22,3180,13314,14682,10134,77.12964886765012,0.18490491803278689,Cheap
20140721T000000,359900.0,4,2.25,2470,7698,2.0,0,0,3,8,2470,0,1983,0,98058,47.4406,-122.141,2330,7986,5228,5656,46.75240322161601,0.03736393442622951,Very Cheap
20150304T000000,410000.0,2,1.0,800,4342,1.0,0,0,3,6,670,130,1927,0,98115,47.6997,-122.316,1210,4343,3542,3133,94.42653155228005,0.043934426229508196,Very Cheap
20140712T000000,690000.0,4,2.5,2900,23488,2.0,0,0,3,9,2900,0,1992,0,98053,47.6726,-122.03,2900,34589,20588,31689,29.376702997275203,0.08065573770491803,Very Cheap
20140625T000000,245000.0,3,2.0,1410,5760,1.0,0,0,3,7,1410,0,1985,0,98030,47.3702,-122.185,1670,6222,4350,4552,42.53472222222222,0.022295081967213116,Very Cheap
20141229T000000,700000.0,5,2.5,2830,25958,1.0,0,1,5,8,1610,1220,1979,0,98075,47.5896,-122.083,2670,21567,23128,18897,26.96663841590261,0.08196721311475409,Very Cheap
20140922T000000,268000.0,4,1.75,1680,9966,1.0,0,0,3,7,1100,580,1977,0,98198,47.3923,-122.311,2400,10369,8286,7969,26.891430864940798,0.025311475409836064,Very Cheap
20140610T000000,225000.0,3,1.75,1760,26055,1.0,0,0,3,7,920,840,1979,0,98042,47.3664,-122.1,1350,13475,24295,12125,8.635578583765112,0.019672131147540985,Very Cheap
20141009T000000,980000.0,4,2.25,2240,11034,2.0,0,0,3,8,2240,0,1976,0,98004,47.5894,-122.195,2300,11550,8794,9250,88.81638571687512,0.11868852459016394,Cheap
20150407T000000,795000.0,2,1.0,1380,5000,1.5,0,2,3,5,1380,0,1905,0,98106,47.5708,-122.359,1500,5000,3620,3500,159.0,0.09442622950819672,Very Cheap
20150504T000000,195000.0,2,1.0,820,5100,1.0,0,0,3,6,820,0,1953,0,98118,47.5156,-122.262,1170,5304,4280,4134,38.23529411764706,0.015737704918032787,Very Cheap
20141103T000000,480000.0,4,2.0,2180,10575,1.0,0,0,2,6,1730,450,1950,0,98005,47.589,-122.177,2180,12010,8395,9830,45.39007092198582,0.05311475409836065,Very Cheap
20141219T000000,485000.0,4,2.0,1400,3600,1.0,0,0,3,7,1100,300,1900,0,98119,47.6385,-122.37,1630,2048,2200,418,134.72222222222223,0.05377049180327869,Very Cheap
20140815T000000,130000.0,2,1.0,880,9000,1.0,0,0,3,5,880,0,1928,0,98188,47.4672,-122.291,1410,10000,8120,8590,14.444444444444445,0.007213114754098361,Very Cheap
20140804T000000,325000.0,2,1.0,1060,5703,1.0,0,2,4,6,1060,0,1946,0,98198,47.3444,-122.327,2240,4416,4643,2176,56.987550412063825,0.03278688524590164,Very Cheap
20150413T000000,440000.0,3,1.75,1530,7245,1.0,0,0,4,7,1530,0,1984,0,98034,47.731,-122.191,1530,7490,5715,5960,60.73153899240856,0.04786885245901639,Very Cheap
20141014T000000,550000.0,4,1.75,2480,14782,1.0,0,3,3,8,1460,1020,1958,0,98155,47.7646,-122.271,2910,10800,12302,7890,37.207414422946826,0.06229508196721312,Very Cheap
20140805T000000,310000.0,3,1.75,1490,7150,1.0,0,0,5,6,1490,0,1967,0,98059,47.5015,-122.124,1350,9100,5660,7750,43.35664335664335,0.03081967213114754,Very Cheap
20140701T000000,530000.0,3,2.5,3660,39478,2.0,0,2,4,9,3260,400,1989,0,98022,47.2413,-121.972,2700,38312,35818,35612,13.425198844926289,0.05967213114754098,Very Cheap
20140625T000000,390000.0,4,2.5,2340,8548,2.0,0,0,3,8,2340,0,1993,0,98031,47.4206,-122.183,1970,6818,6208,4848,45.62470753392606,0.04131147540983607,Very Cheap
20140908T000000,243000.0,3,1.75,1450,12125,1.0,0,0,4,7,1450,0,1981,0,98001,47.3575,-122.28,1210,12125,10675,10915,20.04123711340206,0.022032786885245903,Very Cheap
20140722T000000,639000.0,4,2.5,2210,9875,2.0,0,0,3,9,2210,0,1990,0,98074,47.6285,-122.025,2440,8799,7665,6359,64.70886075949367,0.0739672131147541,Very Cheap
20140918T000000,215000.0,4,1.0,1130,7400,1.0,0,0,4,7,1130,0,1969,0,98003,47.3437,-122.316,1540,7379,6270,5839,29.054054054054053,0.018360655737704918,Very Cheap
20150304T000000,405000.0,5,1.75,1550,10500,1.0,0,0,3,7,1100,450,1961,0,98011,47.7573,-122.22,1420,9823,8950,8403,38.57142857142857,0.043278688524590166,Very Cheap
20141222T000000,250000.0,4,1.75,1710,7140,1.0,0,0,5,7,1010,700,1968,0,98032,47.3745,-122.275,1770,8960,5430,7190,35.0140056022409,0.022950819672131147,Very Cheap
20140715T000000,405500.0,3,1.5,1010,8108,1.0,0,0,5,7,1010,0,1954,0,98155,47.7359,-122.309,1300,8108,7098,6808,50.01233349777997,0.04334426229508197,Very Cheap
20140728T000000,452000.0,6,2.25,2660,13579,2.0,0,0,3,7,2660,0,1937,1990,98125,47.7142,-122.286,1120,8242,10919,7122,33.28669268723765,0.04944262295081967,Very Cheap
20150102T000000,730000.0,6,2.25,2660,13579,2.0,0,0,3,7,2660,0,1937,1990,98125,47.7142,-122.286,1120,8242,10919,7122,53.759481552397084,0.0859016393442623,Very Cheap
20150414T000000,267000.0,3,2.0,1300,9644,1.0,0,0,3,7,1300,0,1994,0,98010,47.3131,-121.998,1430,9656,8344,8226,27.685607631688097,0.025180327868852458,Very Cheap
20140808T000000,289950.0,3,2.5,1670,6186,2.0,0,0,3,7,1670,0,2002,0,98038,47.3668,-122.031,2390,6924,4516,4534,46.871968962172645,0.028190163934426228,Very Cheap
20140728T000000,565000.0,2,1.0,960,4080,1.0,0,0,5,7,960,0,1911,0,98103,47.6893,-122.349,1300,4080,3120,2780,138.48039215686273,0.06426229508196721,Very Cheap
20140808T000000,1578000.0,4,3.25,4670,51836,2.0,0,0,4,12,4670,0,1988,0,98005,47.635,-122.164,4230,41075,47166,36845,30.442163747202716,0.19711475409836066,Cheap
20150420T000000,636000.0,3,2.5,2140,2770,2.0,0,0,3,8,1770,370,2007,0,98052,47.6664,-122.131,2510,2708,630,198,229.6028880866426,0.07357377049180328,Very Cheap
20140918T000000,350000.0,5,3.0,2520,5500,1.0,0,0,3,8,1550,970,2004,0,98178,47.4938,-122.255,1700,8000,2980,6300,63.63636363636363,0.036065573770491806,Very Cheap
20140604T000000,320000.0,3,1.5,1650,9380,1.0,0,0,5,7,1130,520,1978,0,98058,47.4525,-122.162,1720,8856,7730,7136,34.11513859275053,0.032131147540983604,Very Cheap
20140613T000000,210000.0,2,1.75,1440,5680,1.0,0,0,4,8,1440,0,1978,0,98198,47.3825,-122.319,1320,3547,4240,2227,36.971830985915496,0.017704918032786884,Very Cheap
20140910T000000,245000.0,2,1.0,1050,5900,1.0,0,0,3,7,1050,0,1950,0,98126,47.5326,-122.376,1280,5900,4850,4620,41.52542372881356,0.022295081967213116,Very Cheap
20141106T000000,328000.0,3,1.75,1470,7650,1.0,0,0,3,7,1130,340,1983,0,98059,47.4818,-122.161,1590,7500,6180,5910,42.87581699346405,0.03318032786885246,Very Cheap
20140509T000000,985000.0,4,2.25,4230,37769,2.0,0,0,3,11,4230,0,1989,0,98077,47.7287,-122.077,3890,37034,33539,33144,26.07958908099235,0.11934426229508197,Cheap
20140612T000000,501000.0,3,1.75,1970,7972,1.0,0,3,5,8,1370,600,1976,0,98055,47.4908,-122.225,2460,9796,6002,7336,62.84495735072755,0.05586885245901639,Very Cheap
20140917T000000,315000.0,3,2.25,1540,17424,2.0,0,0,3,7,1540,0,1992,0,98045,47.4429,-121.759,1560,11439,15884,9879,18.078512396694215,0.031475409836065574,Very Cheap
20140508T000000,403000.0,3,2.75,2090,8354,2.0,0,0,3,8,2090,0,2012,0,98019,47.7336,-121.965,2280,6348,6264,4068,48.24036389753412,0.04301639344262295,Very Cheap
20140715T000000,550000.0,3,2.0,2380,17950,2.0,0,0,4,8,2110,270,1934,0,98155,47.7591,-122.28,2030,23900,15570,21870,30.64066852367688,0.06229508196721312,Very Cheap
20150113T000000,347500.0,4,2.5,2156,3562,2.0,0,0,3,9,2156,0,2012,0,98030,47.3591,-122.201,1708,3539,1406,1831,97.55755193711398,0.035737704918032784,Very Cheap
20141006T000000,365000.0,4,2.25,2070,8893,2.0,0,0,4,8,2070,0,1986,0,98058,47.4388,-122.162,2390,7700,6823,5310,41.04351737321489,0.0380327868852459,Very Cheap
20150224T000000,588000.0,3,1.0,1910,8167,1.0,0,0,4,8,1270,640,1951,0,98117,47.7004,-122.368,1500,6816,6257,5316,71.99706134443493,0.06727868852459017,Very Cheap
20140820T000000,605000.0,3,1.75,1920,7400,1.0,0,0,4,8,1260,660,1977,0,98006,47.5633,-122.131,2360,8048,5480,5688,81.75675675675676,0.06950819672131148,Very Cheap
20141113T000000,1300000.0,3,3.25,3400,5979,2.0,0,0,4,9,2290,1110,1937,0,98105,47.6585,-122.273,3090,6435,2579,3345,217.42766348887773,0.16065573770491803,Cheap
20141119T000000,233000.0,3,2.0,1400,9177,1.0,0,0,3,7,1400,0,1974,0,98001,47.3415,-122.272,2020,8547,7777,6527,25.38956085866841,0.020721311475409836,Very Cheap
20140728T000000,360000.0,4,2.5,2210,17715,2.0,0,0,3,8,2210,0,1997,0,98030,47.3818,-122.2,2210,16907,15505,14697,20.321761219305674,0.037377049180327866,Very Cheap
20141215T000000,459000.0,2,1.75,1170,4887,1.0,0,0,3,6,1020,150,1929,0,98117,47.695,-122.366,1170,5441,3717,4271,93.92265193370166,0.050360655737704915,Very Cheap
20141107T000000,740000.0,3,2.0,2100,72745,1.0,0,0,4,9,2100,0,1995,0,98077,47.7479,-122.062,2290,54885,70645,52595,10.172520448140766,0.08721311475409836,Very Cheap
20140917T000000,305000.0,3,1.0,1160,9750,1.0,0,0,3,7,1160,0,1967,0,98077,47.7422,-122.073,1160,9650,8590,8490,31.28205128205128,0.03016393442622951,Very Cheap
20140620T000000,395000.0,3,1.0,1500,4000,1.0,0,0,3,6,900,600,1925,0,98117,47.6921,-122.38,950,4000,2500,3050,98.75,0.0419672131147541,Very Cheap
20150123T000000,560000.0,4,2.5,2940,6000,2.0,0,0,3,8,2940,0,2000,0,98011,47.7533,-122.198,2510,6600,3060,4090,93.33333333333333,0.06360655737704918,Very Cheap
20140714T000000,650000.0,4,1.75,2010,5070,1.0,0,1,4,7,1300,710,1963,0,98116,47.5793,-122.402,2180,5400,3060,3220,128.2051282051282,0.07540983606557378,Very Cheap
20140605T000000,449950.0,3,2.5,2170,4912,2.0,0,0,3,7,2170,0,2003,0,98028,47.7767,-122.239,2010,4395,2742,2385,91.6021986970684,0.04917377049180328,Very Cheap
20150224T000000,517500.0,3,1.5,1430,5200,1.0,0,3,4,7,1250,180,1940,0,98117,47.6988,-122.387,2210,6240,3770,4030,99.51923076923077,0.0580327868852459,Very Cheap
20140903T000000,435000.0,4,1.5,1510,6460,1.0,0,0,3,7,1070,440,1970,0,98034,47.7121,-122.214,1450,6630,4950,5180,67.3374613003096,0.04721311475409836,Very Cheap
20150409T000000,329999.0,3,1.0,1150,6908,1.0,0,0,3,6,800,350,1952,0,98155,47.7447,-122.313,1150,6908,5758,5758,47.77055587724377,0.03344249180327869,Very Cheap
20141210T000000,950000.0,3,1.75,2150,4200,1.0,0,4,5,8,1140,1010,1960,0,98116,47.5671,-122.405,2510,7500,2050,4990,226.1904761904762,0.11475409836065574,Cheap
20140730T000000,447000.0,3,1.0,1370,6001,1.0,0,0,5,7,1230,140,1944,0,98108,47.5646,-122.317,1370,5520,4631,4150,74.48758540243293,0.04878688524590164,Very Cheap
20140828T000000,699800.0,2,2.5,2380,6600,1.0,0,0,3,8,2380,0,2010,0,98053,47.717,-122.02,1870,6600,4220,4730,106.03030303030303,0.08194098360655738,Very Cheap
20140603T000000,850000.0,3,1.75,1370,3850,1.0,0,0,5,7,770,600,1911,1988,98112,47.6374,-122.279,1390,3600,2480,2210,220.7792207792208,0.10163934426229508,Cheap
20140902T000000,316500.0,3,1.75,1600,14250,1.0,0,0,3,7,1070,530,1979,0,98023,47.3272,-122.355,2140,14960,12650,12820,22.210526315789473,0.031672131147540986,Very Cheap
20140715T000000,942500.0,5,3.5,3750,9612,1.0,0,2,4,9,2030,1720,1981,0,98006,47.5511,-122.157,3270,9688,5862,6418,98.05451518934665,0.1137704918032787,Cheap
20150121T000000,1310000.0,2,2.25,3950,3938,2.0,0,4,3,10,2910,1040,1991,0,98116,47.5912,-122.384,3220,4500,-12,1280,332.6561706449975,0.1619672131147541,Cheap
20150202T000000,856600.0,4,2.25,2400,13430,1.0,0,0,4,9,2400,0,1964,0,98005,47.5987,-122.178,2580,10077,11030,7497,63.78257632166791,0.10250491803278688,Cheap
20141024T000000,405600.0,5,1.5,2830,4000,2.5,0,0,4,8,2830,0,1918,0,98118,47.5132,-122.262,1480,4000,1170,2520,101.4,0.04335737704918033,Very Cheap
20140529T000000,565000.0,4,2.5,2440,22594,2.0,0,0,3,8,2440,0,1996,0,98053,47.6333,-121.97,2560,33341,20154,30781,25.006638930689565,0.06426229508196721,Very Cheap
20140911T000000,400000.0,3,2.25,1190,1149,2.0,0,0,3,8,1050,140,2008,0,98116,47.5818,-122.387,1210,1316,-41,106,348.12880765883375,0.04262295081967213,Very Cheap
20150324T000000,330000.0,3,2.0,1400,218252,1.0,0,0,3,7,1400,0,1997,0,98019,47.7576,-121.934,2230,218222,216852,215992,1.5120136356138776,0.03344262295081967,Very Cheap
20150227T000000,374950.0,4,2.75,2730,4683,2.0,0,0,3,7,2730,0,2005,0,98038,47.3608,-122.043,2230,4924,1953,2694,80.06619688234038,0.03933770491803279,Very Cheap
20141217T000000,405300.0,3,2.75,2390,7939,1.0,0,0,5,7,1610,780,1983,0,98056,47.4987,-122.166,1920,7939,5549,6019,51.05176974430029,0.043318032786885244,Very Cheap
20141104T000000,560000.0,3,2.25,2060,31400,2.0,0,0,3,8,2060,0,1984,0,98074,47.6216,-122.056,2160,34500,29340,32340,17.8343949044586,0.06360655737704918,Very Cheap
20150324T000000,824000.0,4,2.25,2490,9864,1.0,0,0,4,8,1290,1200,1961,0,98004,47.6051,-122.195,2360,9864,7374,7504,83.53609083536091,0.09822950819672131,Very Cheap
20140716T000000,260000.0,3,1.75,1100,10968,1.0,0,0,5,7,1100,0,1984,0,98042,47.363,-122.08,1400,7799,9868,6399,23.705324580598102,0.024262295081967214,Very Cheap
20150107T000000,760000.0,4,2.5,2430,6099,1.0,0,0,5,8,1470,960,1965,0,98115,47.6777,-122.287,2180,6099,3669,3919,124.61059190031153,0.0898360655737705,Very Cheap
20140624T000000,405000.0,3,2.5,3170,12750,2.0,0,0,3,10,2360,810,1995,0,98023,47.3384,-122.336,2970,13125,9580,10155,31.764705882352942,0.043278688524590166,Very Cheap
20140619T000000,429900.0,4,2.5,2640,8625,2.0,0,0,3,8,2640,0,1987,0,98058,47.4598,-122.15,2240,8700,5985,6460,49.84347826086957,0.04654426229508197,Very Cheap
20141113T000000,341500.0,3,1.5,1130,7223,1.0,0,0,4,7,1130,0,1961,0,98056,47.5089,-122.189,1320,7356,6093,6036,47.27952374359684,0.03495081967213115,Very Cheap
20140612T000000,465250.0,5,2.0,1940,7642,1.5,0,0,3,7,1940,0,1957,0,98177,47.7751,-122.38,1940,8724,5702,6784,60.880659513216436,0.05118032786885246,Very Cheap
20140506T000000,450000.0,2,2.0,1100,3000,1.5,0,0,3,7,1100,0,1912,2005,98117,47.6797,-122.362,1390,4000,1900,2610,150.0,0.04918032786885246,Very Cheap
20150209T000000,390000.0,3,1.0,1200,10800,1.0,0,0,4,7,1200,0,1955,0,98006,47.5771,-122.144,1370,9950,9600,8580,36.111111111111114,0.04131147540983607,Very Cheap
20140502T000000,420000.0,3,2.25,2000,8030,1.0,0,0,4,8,1000,1000,1963,0,98008,47.6188,-122.114,2070,8250,6030,6180,52.30386052303861,0.04524590163934426,Very Cheap
20140615T000000,269950.0,3,2.5,1890,4838,2.0,0,0,3,8,1730,160,2002,0,98168,47.4802,-122.279,1910,7409,2948,5499,55.79785035138487,0.025567213114754097,Very Cheap
20141016T000000,493000.0,4,2.0,1910,2874,1.0,0,0,3,7,1060,850,1910,0,98122,47.6101,-122.295,1520,2874,964,1354,171.53792623521224,0.054819672131147544,Very Cheap
20140515T000000,370000.0,4,2.5,2710,5880,2.0,0,0,3,9,2710,0,1998,0,98092,47.3314,-122.172,2520,6000,3170,3480,62.925170068027214,0.038688524590163934,Very Cheap
20140612T000000,2250000.0,5,4.25,4860,9453,1.5,0,1,5,10,3100,1760,1905,0,98112,47.6196,-122.286,3150,8557,4593,5407,238.01967629324025,0.28524590163934427,Cheap
20150225T000000,305000.0,3,1.0,1250,23680,1.0,0,0,5,7,1250,0,1967,0,98059,47.475,-122.11,1450,23680,22430,22230,12.880067567567568,0.03016393442622951,Very Cheap
20140612T000000,400000.0,3,1.75,1590,8219,1.5,0,0,5,6,970,620,1938,0,98034,47.7146,-122.217,2030,7504,6629,5474,48.667721133957905,0.04262295081967213,Very Cheap
20141118T000000,320000.0,3,1.5,1240,1221,2.0,0,0,3,8,1050,190,2009,0,98133,47.7073,-122.356,1180,887,-19,-293,262.08026208026206,0.032131147540983604,Very Cheap
20150121T000000,715000.0,4,1.0,2000,4800,2.0,0,0,4,7,2000,0,1911,0,98103,47.6583,-122.351,1260,1452,2800,192,148.95833333333334,0.0839344262295082,Very Cheap
20141202T000000,650000.0,6,2.75,3610,10003,1.5,0,0,4,8,3610,0,1966,0,98008,47.6261,-122.125,2560,10004,6393,7444,64.98050584824553,0.07540983606557378,Very Cheap
20150304T000000,218000.0,5,1.75,1930,8040,1.0,0,0,4,8,1930,0,1966,0,98023,47.3109,-122.376,2370,8000,6110,5630,27.114427860696516,0.018754098360655738,Very Cheap
20150415T000000,500000.0,2,1.0,1280,5400,1.0,0,0,3,7,1280,0,1964,0,98117,47.6949,-122.371,1540,5670,4120,4130,92.5925925925926,0.05573770491803279,Very Cheap
20141120T000000,460000.0,4,2.0,2090,40419,1.0,0,0,4,7,2090,0,1984,0,98027,47.4691,-121.993,2380,63162,38329,60782,11.380786263885796,0.050491803278688525,Very Cheap
20140709T000000,232500.0,3,1.5,1940,9887,1.0,0,0,4,7,1140,800,1969,0,98003,47.3289,-122.327,1410,9936,7947,8526,23.515727723272985,0.020655737704918034,Very Cheap
20140516T000000,408200.0,3,2.5,1800,5761,2.0,0,0,4,7,1800,0,1990,0,98106,47.5293,-122.363,1800,5952,3961,4152,70.85575420933866,0.043698360655737706,Very Cheap
20140611T000000,522000.0,3,1.75,1730,8400,1.0,0,0,4,7,1400,330,1980,0,98052,47.6792,-122.115,1830,8636,6670,6806,62.142857142857146,0.05862295081967213,Very Cheap
20140623T000000,675000.0,4,2.5,2810,11120,2.0,0,0,3,9,2810,0,1982,0,98074,47.6337,-122.044,3100,12672,8310,9572,60.701438848920866,0.07868852459016394,Very Cheap
20140709T000000,1355000.0,4,3.5,3550,11000,1.0,0,2,3,11,2260,1290,1999,0,98006,47.5506,-122.134,4100,10012,7450,5912,123.18181818181819,0.1678688524590164,Cheap
20141009T000000,249950.0,4,1.0,1330,7980,1.5,0,0,3,6,1330,0,1952,0,98168,47.492,-122.333,1570,8588,6650,7018,31.32205513784461,0.022944262295081966,Very Cheap
20150304T000000,210000.0,2,1.0,750,34133,1.0,0,0,3,6,750,0,1950,0,98168,47.4781,-122.294,1460,25792,33383,24332,6.152403832068672,0.017704918032786884,Very Cheap
20140711T000000,429950.0,4,1.0,1760,7216,1.0,0,0,3,7,1090,670,1947,0,98133,47.7041,-122.355,1180,3844,5456,2664,59.58287139689579,0.04655081967213115,Very Cheap
20141006T000000,737500.0,4,2.5,3200,36276,2.0,0,0,3,9,3200,0,1993,0,98053,47.6304,-121.994,2930,33171,33076,30241,20.33024589260117,0.08688524590163935,Very Cheap
20140926T000000,710000.0,4,2.0,1740,9000,1.0,0,0,5,8,1740,0,1958,0,98033,47.6815,-122.198,1850,7700,7260,5850,78.88888888888889,0.08327868852459017,Very Cheap
20141020T000000,470000.0,3,2.5,2100,4700,2.0,0,0,3,8,2100,0,1999,0,98065,47.5341,-121.867,2100,4700,2600,2600,100.0,0.05180327868852459,Very Cheap
20150224T000000,1100000.0,4,3.5,4270,40097,1.0,0,0,4,12,4270,0,1993,0,98077,47.7354,-122.078,3510,36149,35827,32639,27.43347382597202,0.13442622950819672,Cheap
20140815T000000,650000.0,3,2.0,1340,2720,1.5,0,0,3,7,1340,0,1913,0,98103,47.6518,-122.335,2030,4590,1380,2560,238.97058823529412,0.07540983606557378,Very Cheap
20140519T000000,1216000.0,4,2.5,3190,8684,1.0,0,3,5,9,1680,1510,1967,0,98006,47.5619,-122.162,3160,8684,5494,5524,140.02763703362507,0.14963934426229508,Cheap
20150115T000000,422120.0,3,2.5,1630,4534,2.0,0,0,3,8,1630,0,1987,0,98034,47.7148,-122.205,1380,4779,2904,3399,93.10101455668284,0.045523934426229505,Very Cheap
20150107T000000,625000.0,5,2.5,2990,15085,2.0,0,0,3,9,2990,0,2007,0,98011,47.746,-122.218,3150,13076,12095,9926,41.43188597944978,0.07213114754098361,Very Cheap
20140606T000000,385200.0,4,1.0,1550,7740,1.5,0,0,3,6,1550,0,1954,0,98126,47.5222,-122.375,1220,7740,6190,6520,49.76744186046512,0.040681967213114754,Very Cheap
20150414T000000,500000.0,3,2.25,1690,4964,2.0,0,0,3,8,1690,0,1989,0,98029,47.5756,-122.01,1800,5036,3274,3236,100.72522159548751,0.05573770491803279,Very Cheap
20141118T000000,308000.0,4,2.25,1960,12243,2.0,0,0,3,8,1960,0,1989,0,98042,47.3405,-122.058,1910,12230,10283,10320,25.157232704402517,0.030557377049180327,Very Cheap
20140605T000000,565000.0,3,2.75,2390,9966,1.0,0,0,5,8,1360,1030,1977,0,98006,47.5433,-122.185,2140,10713,7576,8573,56.69275536825206,0.06426229508196721,Very Cheap
20140908T000000,581000.0,3,2.5,2600,4438,2.0,0,0,3,7,2600,0,2004,0,98053,47.6799,-122.034,2600,4904,1838,2304,130.9148264984227,0.06636065573770492,Very Cheap
20140806T000000,361000.0,3,2.0,1950,8698,1.0,0,0,3,8,1950,0,1999,0,98042,47.39,-122.153,2330,7212,6748,4882,41.50379397562658,0.037508196721311476,Very Cheap
20150122T000000,345000.0,3,1.0,1250,7210,1.0,0,0,4,7,1250,0,1964,0,98008,47.6329,-122.121,1530,8800,5960,7270,47.8502080443828,0.03540983606557377,Very Cheap
20141016T000000,419000.0,2,2.25,1180,1253,2.0,0,0,3,8,840,340,2008,0,98122,47.6124,-122.309,1310,1963,73,653,334.39744612928973,0.04511475409836065,Very Cheap
20150512T000000,347000.0,3,2.5,1680,4308,2.0,0,0,3,7,1680,0,2004,0,98056,47.4802,-122.179,2160,4182,2628,2022,80.54781801299907,0.03567213114754098,Very Cheap
20141022T000000,625000.0,4,2.25,2220,36085,2.0,0,0,3,9,2220,0,1989,0,98075,47.5839,-121.991,3000,36906,33865,33906,17.32021615629763,0.07213114754098361,Very Cheap
20150325T000000,2400000.0,4,4.25,4890,15188,2.0,0,2,3,11,3090,1800,1999,0,98040,47.5602,-122.227,3470,16201,10298,12731,158.01948907031868,0.30491803278688523,Medium
20141223T000000,379000.0,3,3.25,2660,17852,2.5,0,0,3,8,2660,0,2014,0,98010,47.3077,-122.011,1320,11876,15192,10556,21.230114272910598,0.03986885245901639,Very Cheap
20141222T000000,310000.0,3,1.5,1150,3323,2.0,0,0,3,7,1150,0,1988,0,98029,47.5707,-122.017,1150,2980,2173,1830,93.28919650917845,0.03081967213114754,Very Cheap
20150513T000000,250000.0,2,2.0,1130,5500,1.0,0,0,4,6,1130,0,1941,0,98030,47.3839,-122.225,1320,6600,4370,5280,45.45454545454545,0.022950819672131147,Very Cheap
20140814T000000,682000.0,5,2.75,2760,5000,2.0,0,0,3,9,2760,0,2005,0,98059,47.539,-122.188,2870,5030,2240,2160,136.4,0.07960655737704918,Very Cheap
20140721T000000,246500.0,3,2.0,1430,8919,1.0,0,0,3,7,1430,0,1992,0,98022,47.2118,-121.983,1580,8919,7489,7339,27.637627536719364,0.022491803278688525,Very Cheap
20141029T000000,325000.0,3,1.0,1490,57381,1.5,0,0,4,5,1490,0,1932,0,98092,47.2597,-122.228,1580,101529,55891,99949,5.663895714609366,0.03278688524590164,Very Cheap
20140806T000000,310950.0,4,2.5,2030,4997,2.0,0,0,3,8,2030,0,2004,0,98031,47.393,-122.184,2095,5500,2967,3405,62.22733640184111,0.030944262295081966,Very Cheap
20140901T000000,1100000.0,3,2.0,3010,5000,2.0,0,2,5,9,1890,1120,1931,0,98199,47.6347,-122.396,2688,5000,1990,2312,220.0,0.13442622950819672,Cheap
20141002T000000,287500.0,3,1.0,1810,7200,1.0,0,0,4,7,1130,680,1954,0,98133,47.7493,-122.351,1810,8100,5390,6290,39.93055555555556,0.027868852459016394,Very Cheap
20150218T000000,431000.0,3,1.0,1810,7200,1.0,0,0,4,7,1130,680,1954,0,98133,47.7493,-122.351,1810,8100,5390,6290,59.861111111111114,0.046688524590163934,Very Cheap
20140822T000000,226000.0,3,1.0,970,5000,1.0,0,0,3,6,970,0,1968,0,98118,47.5282,-122.279,1290,5875,4030,4585,45.2,0.01980327868852459,Very Cheap
20150512T000000,825000.0,3,1.75,2010,3090,1.5,0,0,5,7,1510,500,1926,0,98103,47.682,-122.348,1600,3150,1080,1550,266.99029126213594,0.09836065573770492,Very Cheap
20140911T000000,175000.0,4,1.0,1300,6030,1.5,0,0,3,6,1300,0,1947,0,98168,47.4778,-122.286,1240,6900,4730,5660,29.021558872305143,0.013114754098360656,Very Cheap
20140515T000000,465750.0,3,1.5,1260,10350,1.0,0,0,3,7,1260,0,1959,0,98008,47.6357,-122.123,1800,10350,9090,8550,45.0,0.05124590163934426,Very Cheap
20150319T000000,659000.0,4,2.25,2610,24931,2.0,0,0,3,8,2610,0,1983,0,98075,47.5771,-122.05,2550,18306,22321,15756,26.43295495567767,0.07659016393442623,Very Cheap
20150210T000000,595000.0,3,1.75,1910,5753,1.0,0,3,3,8,1110,800,1941,0,98115,47.6898,-122.327,1630,5580,3843,3950,103.42430036502694,0.06819672131147542,Very Cheap
20140626T000000,350000.0,3,2.25,1780,16290,2.0,0,0,4,8,1780,0,1987,0,98058,47.4622,-122.127,1780,8810,14510,7030,21.485573971761816,0.036065573770491806,Very Cheap
20140606T000000,270000.0,4,2.25,1900,8600,1.0,0,0,4,8,1900,0,1975,0,98023,47.3102,-122.381,2120,8000,6700,5880,31.3953488372093,0.025573770491803278,Very Cheap
20140911T000000,662500.0,6,2.25,2450,25600,1.0,0,2,3,7,1340,1110,1957,0,98008,47.6061,-122.117,1850,10230,23150,8380,25.87890625,0.07704918032786885,Very Cheap
20141120T000000,249900.0,3,1.75,1380,14000,1.0,0,0,4,5,1380,0,1939,1957,98001,47.294,-122.281,1490,18503,12620,17013,17.85,0.02293770491803279,Very Cheap
20150317T000000,324500.0,3,1.75,1920,11340,1.0,0,0,4,7,1230,690,1977,0,98023,47.3272,-122.362,1980,9638,9420,7658,28.61552028218695,0.03272131147540984,Very Cheap
20140718T000000,430000.0,2,1.75,1350,4003,1.0,0,0,3,8,1350,0,2004,0,98053,47.7176,-122.033,1350,4479,2653,3129,107.41943542343243,0.04655737704918033,Very Cheap
20150513T000000,419950.0,2,1.75,1350,4003,1.0,0,0,3,8,1350,0,2004,0,98053,47.7176,-122.033,1350,4479,2653,3129,104.90881838621034,0.04523934426229508,Very Cheap
20140728T000000,285000.0,4,1.75,2510,7440,1.0,0,2,4,8,1290,1220,1962,0,98032,47.3748,-122.276,1790,8000,4930,6210,38.306451612903224,0.02754098360655738,Very Cheap
20150107T000000,332000.0,4,2.5,2470,7780,2.0,0,0,3,8,2470,0,2002,0,98092,47.3337,-122.191,2100,5972,5310,3872,42.673521850899746,0.033704918032786885,Very Cheap
20141215T000000,282000.0,4,1.75,1660,10725,1.0,0,0,3,7,960,700,1956,0,98168,47.5033,-122.3,1340,9023,9065,7683,26.293706293706293,0.02714754098360656,Very Cheap
20141118T000000,320000.0,3,1.0,1340,5175,1.0,0,0,3,7,940,400,1987,0,98133,47.7321,-122.34,1020,5500,3835,4480,61.83574879227053,0.032131147540983604,Very Cheap
20140509T000000,428750.0,3,1.0,1620,30736,1.5,0,0,4,7,1620,0,1911,1977,98006,47.5719,-122.119,2440,28826,29116,26386,13.949440395627278,0.04639344262295082,Very Cheap
20150114T000000,330000.0,3,2.25,2300,35287,2.0,0,0,3,8,2300,0,1977,0,98022,47.2477,-121.937,1760,47916,32987,46156,9.35188596366934,0.03344262295081967,Very Cheap
20141209T000000,456500.0,4,3.5,2000,2309,3.0,0,0,3,8,2000,0,2008,0,98177,47.7027,-122.361,1440,1548,309,108,197.70463404071026,0.0500327868852459,Very Cheap
20140509T000000,352000.0,3,2.25,1640,11050,1.0,0,0,4,8,1640,0,1972,0,98059,47.4723,-122.121,1870,11050,9410,9180,31.855203619909503,0.03632786885245902,Very Cheap
20141125T000000,664000.0,4,2.0,1530,4080,1.5,0,0,4,7,1530,0,1912,0,98105,47.6645,-122.325,1860,4080,2550,2220,162.7450980392157,0.07724590163934426,Very Cheap
20140722T000000,628000.0,3,1.75,4000,11894,1.0,0,0,3,9,2190,1810,1987,0,98011,47.7738,-122.203,2530,8650,7894,6120,52.799730956784934,0.07252459016393442,Very Cheap
20150304T000000,512000.0,3,1.75,1610,12555,1.0,0,0,3,7,1080,530,1977,0,98052,47.6618,-122.136,1780,10374,10945,8594,40.78056551174831,0.05731147540983607,Very Cheap
20141211T000000,254000.0,3,2.0,2070,9000,1.0,0,0,4,7,1450,620,1969,0,98023,47.3085,-122.376,1630,7885,6930,6255,28.22222222222222,0.023475409836065574,Very Cheap
20140521T000000,535800.0,4,2.5,1900,5790,2.0,0,0,3,8,1900,0,1994,0,98029,47.5691,-121.996,2030,5790,3890,3760,92.53886010362694,0.0604327868852459,Very Cheap
20141010T000000,287653.0,3,1.0,1050,16050,1.0,0,0,4,7,1050,0,1960,1981,98038,47.3841,-122.006,1610,27600,15000,25990,17.922305295950157,0.027888918032786886,Very Cheap
20140731T000000,438000.0,3,2.5,1520,1304,2.0,0,0,3,8,1180,340,2006,0,98136,47.5446,-122.385,1270,1718,-216,448,335.88957055214723,0.04760655737704918,Very Cheap
20140716T000000,450000.0,4,1.75,2390,23899,1.0,0,0,3,7,1750,640,1949,0,98028,47.7557,-122.237,1840,33900,21509,32060,18.829239717142976,0.04918032786885246,Very Cheap
20140627T000000,327000.0,5,2.75,2400,8050,2.0,0,0,3,8,2400,0,1998,0,98092,47.2635,-122.209,2400,8050,5650,5650,40.62111801242236,0.033049180327868855,Very Cheap
20140812T000000,370500.0,4,2.5,1790,6120,2.0,0,0,3,7,1790,0,2005,0,98059,47.4829,-122.128,1950,5660,4330,3710,60.53921568627451,0.038754098360655735,Very Cheap
20141022T000000,265000.0,3,2.5,1720,6271,2.0,0,0,3,7,1720,0,1993,0,98038,47.3898,-122.049,1570,6587,4551,5017,42.25801307606442,0.024918032786885248,Very Cheap
20150310T000000,450000.0,4,2.75,2980,13260,1.0,0,0,4,8,1800,1180,1979,0,98056,47.5152,-122.197,1920,10731,10280,8811,33.93665158371041,0.04918032786885246,Very Cheap
20140627T000000,425000.0,3,1.0,1520,213444,1.5,0,3,5,8,1520,0,1988,0,98027,47.5081,-122.093,2640,213444,211924,210804,1.991154588557186,0.04590163934426229,Very Cheap
20141113T000000,166600.0,3,1.75,1150,8690,1.0,0,0,4,7,1150,0,1977,0,98042,47.3729,-122.115,1330,7040,7540,5710,19.171461449942463,0.01201311475409836,Very Cheap
20140620T000000,245000.0,1,0.75,380,15000,1.0,0,0,3,5,380,0,1963,0,98168,47.481,-122.323,1170,15000,14620,13830,16.333333333333332,0.022295081967213116,Very Cheap
20150508T000000,565000.0,3,1.0,910,5212,1.0,0,0,3,7,910,0,1951,0,98115,47.6742,-122.284,1520,6300,4302,4780,108.40368380660016,0.06426229508196721,Very Cheap
20140811T000000,539900.0,3,1.75,1650,10150,1.0,0,0,3,8,1230,420,1976,0,98033,47.6963,-122.169,1930,8958,8500,7028,53.19211822660098,0.06097049180327869,Very Cheap
20150303T000000,910000.0,3,3.5,2480,3200,2.0,0,0,3,10,2480,0,2010,0,98144,47.5951,-122.307,1980,3200,720,1220,284.375,0.10950819672131147,Cheap
20141104T000000,280000.0,4,2.5,2050,7416,2.0,0,0,3,8,2050,0,1990,0,98092,47.2658,-122.219,2050,7920,5366,5870,37.75620280474649,0.026885245901639345,Very Cheap
20150313T000000,275000.0,3,2.25,1420,8549,2.0,0,0,4,7,1420,0,1989,0,98038,47.3576,-122.039,1560,7471,7129,5911,32.16750497134168,0.02622950819672131,Very Cheap
20150427T000000,467000.0,3,2.5,3460,6590,2.0,0,0,3,7,3460,0,2001,0,98056,47.4802,-122.188,2490,6312,3130,3822,70.8649468892261,0.05140983606557377,Very Cheap
20140731T000000,457500.0,3,2.5,1500,4445,2.0,0,0,3,8,1500,0,1996,0,98029,47.5682,-122.005,1730,4408,2945,2678,102.92463442069742,0.05016393442622951,Very Cheap
20141226T000000,381156.0,2,1.0,1320,3090,1.0,0,0,4,7,1320,0,1908,0,98118,47.5517,-122.276,1270,4120,1770,2850,123.35145631067961,0.04015160655737705,Very Cheap
20150423T000000,289999.0,5,2.5,2180,8240,1.0,0,0,4,8,1220,960,1977,0,98092,47.3122,-122.191,2050,7590,6060,5540,35.19405339805825,0.028196590163934426,Very Cheap
20150422T000000,642450.0,3,1.75,1830,4160,1.0,0,0,3,7,1230,600,1919,0,98144,47.5962,-122.288,1950,4160,2330,2210,154.43509615384616,0.07441967213114754,Very Cheap
20140919T000000,469950.0,3,2.25,1620,8701,1.0,0,0,3,7,1220,400,1962,0,98007,47.6071,-122.137,1600,7910,7081,6310,54.01103321457304,0.05179672131147541,Very Cheap
20150305T000000,795000.0,3,2.0,2920,13650,1.0,0,2,5,8,1460,1460,1975,0,98033,47.6652,-122.188,2920,10988,10730,8068,58.24175824175824,0.09442622950819672,Very Cheap
20150211T000000,785000.0,4,2.5,3300,10514,2.0,0,0,3,10,3300,0,1984,0,98074,47.6323,-122.036,2820,11462,7214,8642,74.6623549552977,0.09311475409836066,Very Cheap
20140530T000000,860000.0,3,2.25,3060,12095,2.0,0,0,3,10,3060,0,1983,0,98006,47.5611,-122.106,3060,11455,9035,8395,71.10376188507648,0.10295081967213114,Cheap
20140612T000000,1095000.0,0,0.0,3064,4764,3.5,0,2,3,7,3064,0,1990,0,98102,47.6362,-122.322,2360,4000,1700,1640,229.84886649874056,0.13377049180327868,Cheap
20150213T000000,147500.0,3,1.0,1530,8498,1.0,0,0,3,7,1530,0,1959,0,98031,47.404,-122.203,1380,8498,6968,7118,17.35702518239586,0.009508196721311476,Very Cheap
20141125T000000,390000.0,3,2.0,1910,11576,1.0,0,0,3,7,1410,500,1978,0,98011,47.7356,-122.198,2040,8750,9666,6710,33.69039391845197,0.04131147540983607,Very Cheap
20141219T000000,229000.0,3,1.0,1020,8100,1.0,0,0,3,7,1020,0,1954,0,98198,47.3586,-122.314,1020,8100,7080,7080,28.271604938271604,0.02019672131147541,Very Cheap
20140515T000000,185000.0,3,1.0,1150,8100,1.0,0,0,3,6,1150,0,1932,0,98168,47.494,-122.307,1120,8100,6950,6980,22.839506172839506,0.014426229508196721,Very Cheap
20140826T000000,414900.0,3,1.5,1260,9570,1.0,0,0,3,7,870,390,1941,0,98115,47.7004,-122.305,1620,7000,8310,5380,43.35423197492163,0.04457704918032787,Very Cheap
20150212T000000,200000.0,4,2.0,1920,4822,1.0,0,0,2,6,920,1000,1914,0,98136,47.5507,-122.381,1120,4822,2902,3702,41.4765657403567,0.01639344262295082,Very Cheap
20141021T000000,225000.0,4,2.25,1800,9350,1.0,0,0,3,8,1800,0,1969,0,98092,47.2959,-122.191,2060,8800,7550,6740,24.06417112299465,0.019672131147540985,Very Cheap
20140912T000000,720000.0,3,1.75,2040,4000,2.0,0,0,5,7,1360,680,1924,0,98105,47.6675,-122.289,1610,4000,1960,2390,180.0,0.08459016393442623,Very Cheap
20140603T000000,930000.0,4,2.5,2200,4000,2.0,0,0,5,8,1430,770,1908,0,98119,47.6402,-122.37,2100,4000,1800,1900,232.5,0.1121311475409836,Cheap
20140604T000000,1270000.0,5,2.5,3200,17204,1.0,0,0,3,7,2160,1040,1952,0,98004,47.6209,-122.222,4090,15732,14004,11642,73.8200418507324,0.15672131147540982,Cheap
20141111T000000,700000.0,5,3.25,2400,3118,2.0,0,0,4,7,1780,620,1928,0,98122,47.6094,-122.291,2100,3941,718,1841,224.50288646568313,0.08196721311475409,Very Cheap
20140715T000000,466000.0,2,1.5,1140,1058,3.0,0,0,3,7,1140,0,2005,0,98103,47.6608,-122.333,1170,1116,-82,-54,440.45368620037806,0.051278688524590166,Very Cheap
20140825T000000,374000.0,3,1.5,1330,10640,1.0,0,0,3,7,1330,0,1976,0,98011,47.7364,-122.193,1460,8520,9310,7060,35.150375939849624,0.03921311475409836,Very Cheap
20140716T000000,480000.0,3,2.5,1940,10035,2.0,0,0,4,8,1940,0,1994,0,98072,47.7438,-122.172,2810,8333,8095,5523,47.832585949177876,0.05311475409836065,Very Cheap
20140610T000000,740000.0,3,2.5,3000,25341,2.0,0,0,3,9,3000,0,1995,0,98053,47.6724,-122.013,3000,32417,22341,29417,29.201688962550808,0.08721311475409836,Very Cheap
20141110T000000,1010000.0,4,1.0,1820,5400,1.5,0,0,3,8,1820,0,1923,2014,98102,47.6476,-122.318,1820,5400,3580,3580,187.03703703703704,0.12262295081967213,Cheap
20140530T000000,395000.0,4,2.5,2910,5000,2.0,0,0,3,8,2910,0,2002,0,98042,47.3782,-122.127,2740,5045,2090,2305,79.0,0.0419672131147541,Very Cheap
20140725T000000,340000.0,2,1.0,1090,6771,1.0,0,0,3,6,1090,0,1954,0,98106,47.5185,-122.352,1200,4992,5681,3792,50.21414857480431,0.03475409836065574,Very Cheap
20140811T000000,209000.0,3,2.0,1230,1340,2.0,0,0,3,7,1020,210,2003,0,98106,47.526,-122.361,1260,1312,110,52,155.97014925373134,0.017573770491803278,Very Cheap
20141114T000000,431650.0,5,2.5,1710,7700,1.5,0,0,3,7,1710,0,1962,0,98007,47.5922,-122.146,1530,7700,5990,6170,56.05844155844156,0.04677377049180328,Very Cheap
20140508T000000,980000.0,5,2.5,3160,11470,1.0,0,0,4,9,1780,1380,1971,0,98040,47.5368,-122.216,3260,11470,8310,8210,85.44027898866608,0.11868852459016394,Cheap
20140805T000000,660000.0,3,2.5,2680,28243,2.0,0,0,3,9,2680,0,1993,0,98077,47.7637,-122.05,2670,32130,25563,29460,23.36862231349361,0.07672131147540984,Very Cheap
20150311T000000,730000.0,4,2.25,2190,9009,2.0,0,0,4,8,1840,350,1977,0,98033,47.6916,-122.188,2190,10251,6819,8061,81.03008103008104,0.0859016393442623,Very Cheap
20150414T000000,291500.0,3,1.75,1260,9600,1.0,0,0,4,7,1260,0,1988,0,98042,47.3592,-122.076,1640,9946,8340,8306,30.364583333333332,0.02839344262295082,Very Cheap
20140620T000000,905000.0,4,3.5,2970,14486,2.0,0,0,3,9,2340,630,1997,0,98040,47.5627,-122.215,3680,14486,11516,10806,62.474112936628465,0.10885245901639344,Cheap
20140811T000000,800000.0,4,2.5,2570,50308,1.5,0,0,3,10,2570,0,1993,0,98077,47.7418,-122.039,3420,37891,47738,34471,15.902043412578516,0.09508196721311475,Very Cheap
20140509T000000,839900.0,4,3.5,3810,13592,1.0,0,1,3,9,2560,1250,2013,0,98056,47.5134,-122.2,3230,9311,9782,6081,61.79370217775162,0.10031475409836066,Cheap
20140714T000000,200000.0,1,1.5,1010,1157,2.0,0,0,3,8,950,60,2007,0,98126,47.5492,-122.372,1360,1688,147,328,172.8608470181504,0.01639344262295082,Very Cheap
20150218T000000,300000.0,3,2.0,1480,6698,1.0,0,0,4,7,1080,400,1979,0,98058,47.4614,-122.168,1850,7348,5218,5498,44.789489399820845,0.029508196721311476,Very Cheap
20140603T000000,530000.0,3,1.75,1250,6041,1.5,0,0,5,7,1250,0,1942,0,98115,47.69,-122.304,1180,6042,4791,4862,87.73381890415494,0.05967213114754098,Very Cheap
20150326T000000,314950.0,3,2.25,1654,8479,2.0,0,0,3,7,1654,0,1995,0,98038,47.3627,-122.037,1654,8479,6825,6825,37.14471046113928,0.03146885245901639,Very Cheap
20141007T000000,255000.0,3,1.75,1410,9315,1.0,0,0,5,7,1410,0,1960,0,98031,47.3969,-122.198,1630,8250,7905,6620,27.375201288244767,0.02360655737704918,Very Cheap
20141016T000000,550000.0,5,2.75,2160,5720,1.0,0,0,5,7,1500,660,1950,0,98144,47.5728,-122.304,2160,4996,3560,2836,96.15384615384616,0.06229508196721312,Very Cheap
20140806T000000,435000.0,3,1.0,1400,4800,1.0,0,0,4,6,700,700,1917,0,98136,47.5499,-122.391,1470,6000,3400,4530,90.625,0.04721311475409836,Very Cheap
20141124T000000,234000.0,3,1.75,1420,8738,1.0,0,0,4,7,1420,0,1966,0,98002,47.3113,-122.207,1660,8738,7318,7078,26.77958342870222,0.020852459016393442,Very Cheap
20141010T000000,615000.0,4,2.25,2500,10062,1.0,0,0,3,8,1600,900,1975,0,98052,47.639,-122.1,2500,9750,7562,7250,61.121049493142515,0.07081967213114754,Very Cheap
20140910T000000,205000.0,3,2.0,1410,8384,1.0,0,0,3,7,1410,0,1985,0,98001,47.3315,-122.263,1410,9205,6974,7795,24.451335877862597,0.017049180327868854,Very Cheap
20140919T000000,384000.0,4,1.75,2100,7135,1.0,0,0,4,7,1050,1050,1955,0,98106,47.5353,-122.349,1730,4000,5035,2270,53.819201121233355,0.04052459016393443,Very Cheap
20140522T000000,324000.0,3,2.5,1750,7208,2.0,0,0,3,8,1750,0,1994,0,98055,47.4315,-122.192,2050,7524,5458,5474,44.95005549389567,0.03265573770491803,Very Cheap
20140722T000000,645000.0,3,1.75,2070,5500,1.0,0,0,4,7,1130,940,1946,0,98115,47.6733,-122.301,1800,4400,3430,2600,117.27272727272727,0.07475409836065573,Very Cheap
20141023T000000,570000.0,3,3.25,1570,1777,2.0,0,0,3,8,1260,310,2007,0,98107,47.6655,-122.369,1000,1777,207,777,320.76533483398987,0.06491803278688525,Very Cheap
20141210T000000,324000.0,3,2.5,1920,5322,2.0,0,0,3,8,1920,0,1999,0,98031,47.4095,-122.195,1920,5000,3402,3080,60.879368658399095,0.03265573770491803,Very Cheap
20140828T000000,270000.0,2,1.0,1000,10320,1.0,0,0,3,6,1000,0,1943,0,98106,47.527,-122.356,1100,5160,9320,4060,26.162790697674417,0.025573770491803278,Very Cheap
20140519T000000,290000.0,5,1.5,2120,7700,1.5,0,0,5,7,2120,0,1962,0,98058,47.4599,-122.172,1730,7700,5580,5970,37.66233766233766,0.02819672131147541,Very Cheap
20140630T000000,250000.0,3,2.0,1440,9220,1.0,0,0,3,7,1440,0,1965,0,98198,47.3702,-122.317,1390,7830,7780,6440,27.114967462039047,0.022950819672131147,Very Cheap
20150120T000000,342000.0,3,1.75,1660,16275,2.0,0,0,3,7,1660,0,1990,0,98014,47.6903,-121.915,1520,16275,14615,14755,21.013824884792626,0.03501639344262295,Very Cheap
20150318T000000,255000.0,3,1.5,1340,8450,1.0,0,0,4,7,1340,0,1958,0,98188,47.4405,-122.28,1340,8920,7110,7580,30.17751479289941,0.02360655737704918,Very Cheap
20140623T000000,800000.0,3,2.25,2380,11824,1.0,0,0,4,9,1450,930,1972,0,98040,47.5371,-122.218,2750,11491,9444,8741,67.65899864682002,0.09508196721311475,Very Cheap
20140516T000000,451000.0,3,1.75,1560,4049,1.5,0,2,3,7,1000,560,1926,0,98126,47.5666,-122.375,1430,3738,2489,2308,111.38552729068905,0.04931147540983607,Very Cheap
20141203T000000,990000.0,4,2.5,2780,10480,1.0,0,3,3,7,1390,1390,1967,0,98033,47.6597,-122.204,2860,10506,7700,7646,94.46564885496183,0.12,Cheap
20140520T000000,288400.0,4,2.5,1860,6687,1.0,0,0,4,7,1220,640,1983,0,98031,47.4046,-122.186,1860,6117,4827,4257,43.12845820248243,0.02798688524590164,Very Cheap
20150310T000000,420000.0,3,1.5,2390,4600,2.0,0,0,3,8,1750,640,1920,1995,98118,47.5383,-122.268,1690,5220,2210,3530,91.30434782608695,0.04524590163934426,Very Cheap
20150514T000000,359000.0,2,2.75,1370,1140,2.0,0,0,3,8,1080,290,2009,0,98133,47.7052,-122.343,1370,1090,-230,-280,314.9122807017544,0.03724590163934426,Very Cheap
20140808T000000,390000.0,4,3.0,2570,262018,1.0,0,0,3,7,1420,1150,1988,0,98058,47.4417,-122.09,2260,19811,259448,17551,1.4884473585784184,0.04131147540983607,Very Cheap
20140902T000000,300000.0,3,2.5,1320,2614,2.0,0,0,3,7,1320,0,2005,0,98118,47.5355,-122.283,1320,2533,1294,1213,114.76664116296863,0.029508196721311476,Very Cheap
20150305T000000,545000.0,5,2.5,2520,7863,1.0,0,0,3,7,1500,1020,1981,0,98034,47.7096,-122.199,2030,8580,5343,6550,69.31196744245199,0.06163934426229508,Very Cheap
20150408T000000,288349.0,3,1.0,1250,18616,1.0,0,0,4,6,1250,0,1972,0,98010,47.3414,-122.047,1920,15654,17366,13734,15.489310270734851,0.027980196721311475,Very Cheap
20150205T000000,299900.0,3,2.25,1560,35026,1.0,0,0,3,7,1290,270,1985,0,98092,47.3023,-122.069,1660,35160,33466,33500,8.562210929024154,0.029495081967213115,Very Cheap
20140717T000000,891000.0,4,2.0,2330,5000,1.5,0,0,5,7,1720,610,1925,0,98117,47.6804,-122.358,2090,5000,2670,2910,178.2,0.10701639344262295,Cheap
20150331T000000,1200000.0,3,2.0,3660,22410,1.0,0,3,4,9,1830,1830,1947,0,98117,47.6972,-122.4,2680,8250,18750,5570,53.5475234270415,0.14754098360655737,Cheap
20150205T000000,378000.0,4,2.5,2790,4650,2.0,0,0,3,8,2790,0,2004,0,98038,47.3556,-122.026,2820,4650,1860,1830,81.29032258064517,0.03973770491803279,Very Cheap
20140623T000000,299995.0,2,1.0,1060,7200,1.0,0,0,4,6,1060,0,1951,0,98155,47.7463,-122.315,1850,8291,6140,6441,41.66597222222222,0.029507540983606556,Very Cheap
20141007T000000,253000.0,3,2.5,2020,6564,1.0,0,0,3,7,1310,710,1994,0,98042,47.3545,-122.158,1710,5151,4544,3441,38.54357099329677,0.023344262295081967,Very Cheap
20150120T000000,350000.0,3,2.25,1580,47916,1.0,0,0,3,7,1580,0,1979,0,98024,47.5583,-121.852,1980,75358,46336,73378,7.3044494532097834,0.036065573770491806,Very Cheap
20150311T000000,565000.0,4,3.0,2020,4300,1.5,0,0,3,6,2020,0,1900,0,98107,47.6653,-122.372,1290,3440,2280,2150,131.3953488372093,0.06426229508196721,Very Cheap
20140612T000000,315000.0,2,1.0,970,5665,1.0,0,0,4,6,970,0,1908,0,98118,47.5513,-122.273,1490,4429,4695,2939,55.60458958517211,0.031475409836065574,Very Cheap
20141022T000000,570000.0,4,3.0,1490,6766,1.5,0,1,5,7,1490,0,1915,0,98136,47.5446,-122.382,1990,6526,5276,4536,84.24475317765297,0.06491803278688525,Very Cheap
20140811T000000,971000.0,5,3.5,4390,10140,2.0,0,0,3,9,3350,1040,2005,0,98125,47.7174,-122.282,2010,8400,5750,6390,95.75936883629191,0.11750819672131148,Cheap
20140828T000000,915000.0,5,2.5,2750,5589,1.5,0,0,5,9,1840,910,1910,0,98112,47.6364,-122.3,1460,4250,2839,2790,163.7144390767579,0.11016393442622952,Cheap
20150112T000000,419000.0,4,1.5,2150,23568,1.0,0,0,4,7,2150,0,1950,0,98166,47.4522,-122.355,2150,10125,21418,7975,17.778343516632724,0.04511475409836065,Very Cheap
20150209T000000,260000.0,4,1.75,1810,7480,1.0,0,0,3,7,1230,580,1977,0,98023,47.3275,-122.361,1870,9594,5670,7724,34.75935828877005,0.024262295081967214,Very Cheap
20150408T000000,1321500.0,3,3.0,2230,12968,2.0,0,0,3,9,2230,0,1990,0,98004,47.6271,-122.197,2260,10160,10738,7900,101.90468846391117,0.16347540983606557,Cheap
20150306T000000,369950.0,3,1.0,2430,10720,1.0,0,0,3,7,2430,0,1977,0,98045,47.4895,-121.787,1660,11560,8290,9900,34.51026119402985,0.03868196721311475,Very Cheap
20141015T000000,1029900.0,3,2.5,3680,13384,2.0,0,0,3,10,3680,0,1994,0,98006,47.5484,-122.119,3600,11306,9704,7706,76.95008965929468,0.1252327868852459,Cheap
20150506T000000,435000.0,5,1.0,1410,6750,1.5,0,0,3,6,1410,0,1929,0,98118,47.5453,-122.278,1360,6750,5340,5390,64.44444444444444,0.04721311475409836,Very Cheap
20150325T000000,601000.0,3,1.75,1330,6743,1.0,0,0,3,8,1330,0,1958,2002,98125,47.7012,-122.286,2600,7350,5413,4750,89.1294675960255,0.06898360655737705,Very Cheap
20140716T000000,460500.0,3,1.0,1490,10650,1.0,0,0,3,7,1150,340,1963,0,98033,47.663,-122.178,1730,9800,9160,8070,43.23943661971831,0.05055737704918033,Very Cheap
20140521T000000,720000.0,3,2.5,2020,1159,3.0,0,3,3,8,2020,0,2000,0,98103,47.6617,-122.356,1920,3600,-861,1680,621.2251941328732,0.08459016393442623,Very Cheap
20150421T000000,851000.0,4,2.5,3130,13202,2.0,0,0,3,10,3130,0,1996,0,98075,47.5878,-121.976,2840,10470,10072,7630,64.45993031358886,0.10177049180327868,Cheap
20140904T000000,550000.0,4,3.0,2670,5000,2.0,0,2,3,7,2670,0,1916,1978,98126,47.5784,-122.377,2300,5000,2330,2700,110.0,0.06229508196721312,Very Cheap
20150323T000000,700000.0,4,1.0,1980,4560,1.5,0,0,3,7,1980,0,1920,0,98103,47.6606,-122.331,1810,3245,2580,1435,153.50877192982455,0.08196721311475409,Very Cheap
20140908T000000,323000.0,3,1.75,2100,14850,1.0,0,0,4,7,2100,0,1963,0,98042,47.3622,-122.059,1930,17238,12750,15308,21.75084175084175,0.03252459016393443,Very Cheap
20140922T000000,345500.0,3,1.0,1350,8581,1.0,0,0,5,6,1350,0,1944,0,98177,47.7612,-122.362,2080,8451,7231,6371,40.26337256729985,0.03547540983606557,Very Cheap
20141203T000000,378000.0,4,1.5,2140,7920,1.0,0,0,3,7,1190,950,1959,0,98118,47.5491,-122.272,2140,7238,5780,5098,47.72727272727273,0.03973770491803279,Very Cheap
20141112T000000,650000.0,4,2.0,2208,5000,3.0,0,0,5,8,2208,0,1917,0,98116,47.5711,-122.383,1760,5000,2792,3240,130.0,0.07540983606557378,Very Cheap
20150413T000000,385000.0,3,2.0,1010,7380,1.0,0,0,3,7,1010,0,1982,0,98074,47.6273,-122.062,1650,9030,6370,7380,52.1680216802168,0.04065573770491803,Very Cheap
20140916T000000,425000.0,2,1.0,970,2970,1.0,0,0,3,7,970,0,1910,0,98102,47.6233,-122.319,1670,3000,2000,1330,143.0976430976431,0.04590163934426229,Very Cheap
20141202T000000,210000.0,4,2.0,1520,6174,1.5,0,0,5,6,1520,0,1920,0,98022,47.2105,-121.989,1390,5407,4654,4017,34.01360544217687,0.017704918032786884,Very Cheap
20140528T000000,630000.0,4,2.5,2740,43101,2.0,0,0,3,9,2740,0,1993,0,98077,47.7649,-122.049,2740,33447,40361,30707,14.616830235957403,0.07278688524590164,Very Cheap
20140730T000000,335000.0,3,1.75,1570,7500,1.0,0,1,3,7,1300,270,1953,0,98146,47.4999,-122.368,1590,7660,5930,6070,44.666666666666664,0.03409836065573771,Very Cheap
20140625T000000,196500.0,3,1.0,1320,9000,1.0,0,0,3,7,1320,0,1966,0,98001,47.3461,-122.272,1320,9800,7680,8480,21.833333333333332,0.015934426229508195,Very Cheap
20140515T000000,582800.0,4,2.75,2550,7636,1.0,0,0,3,8,1440,1110,1986,0,98074,47.6471,-122.06,2290,8223,5086,5933,76.32268203247774,0.06659672131147541,Very Cheap
20140623T000000,440000.0,3,1.75,1560,7207,1.0,0,0,3,7,1250,310,1983,0,98034,47.7283,-122.222,1540,7485,5647,5945,61.05175523796309,0.04786885245901639,Very Cheap
20140825T000000,752500.0,4,2.25,2360,8616,2.0,0,0,4,8,2360,0,1974,0,98033,47.6495,-122.198,2360,9337,6256,6977,87.33751160631384,0.08885245901639344,Very Cheap
20141028T000000,532500.0,3,1.75,1330,5000,2.0,0,0,4,7,1210,120,1909,0,98116,47.5724,-122.384,1500,4000,3670,2500,106.5,0.06,Very Cheap
20150506T000000,265000.0,3,1.0,1070,9000,1.0,0,0,4,7,1070,0,1950,0,98198,47.4061,-122.33,1840,12000,7930,10160,29.444444444444443,0.024918032786885248,Very Cheap
20150202T000000,397500.0,3,1.25,1510,13737,1.0,0,3,4,6,810,700,1961,0,98125,47.7289,-122.283,2560,10202,12227,7642,28.93644900633326,0.04229508196721311,Very Cheap
20140724T000000,524250.0,3,2.5,1710,3469,2.0,0,0,3,8,1710,0,1999,0,98029,47.546,-122.011,2120,3560,1759,1440,151.12424329778034,0.05891803278688525,Very Cheap
20140509T000000,765000.0,4,2.75,2790,10819,2.0,0,0,3,10,2790,0,1996,0,98027,47.5515,-122.08,3080,12603,8029,9523,70.70893797948054,0.09049180327868853,Very Cheap
20140806T000000,648000.0,4,2.5,2620,5450,2.0,0,0,3,9,2620,0,2001,0,98074,47.6301,-122.019,2590,5371,2830,2781,118.89908256880734,0.07514754098360656,Very Cheap
20140812T000000,469500.0,5,2.5,2970,24759,1.0,0,0,4,8,1670,1300,1969,0,98031,47.3908,-122.173,2100,21803,21789,19703,18.9628014055495,0.051737704918032784,Very Cheap
20150324T000000,237500.0,3,1.75,1050,7854,1.0,0,0,4,7,1050,0,1975,0,98023,47.3011,-122.369,1360,7668,6804,6308,30.23936847466259,0.021311475409836064,Very Cheap
20150121T000000,216000.0,3,1.0,1280,8712,1.0,0,0,4,7,1280,0,1956,0,98003,47.3298,-122.297,1420,8800,7432,7380,24.793388429752067,0.018491803278688525,Very Cheap
20150330T000000,427200.0,3,1.0,1030,8400,1.0,0,0,4,7,1030,0,1963,0,98056,47.5364,-122.173,1270,8400,7370,7130,50.857142857142854,0.04619016393442623,Very Cheap
20150311T000000,280000.0,3,2.25,1900,7800,1.0,0,0,4,8,1390,510,1977,0,98055,47.4545,-122.208,1730,7800,5900,6070,35.8974358974359,0.026885245901639345,Very Cheap
20150425T000000,718000.0,5,3.0,3070,9804,1.0,0,0,4,9,1740,1330,1968,0,98006,47.5702,-122.128,2550,9689,6734,7139,73.23541411668707,0.08432786885245902,Very Cheap
20150310T000000,420000.0,2,2.75,1760,4139,2.0,0,0,3,8,1760,0,2010,0,98065,47.5175,-121.878,1870,3076,2379,1206,101.47378593863252,0.04524590163934426,Very Cheap
20140916T000000,379000.0,2,1.0,930,5400,1.0,0,0,3,7,930,0,1952,0,98117,47.6971,-122.372,1050,5400,4470,4350,70.18518518518519,0.03986885245901639,Very Cheap
20140527T000000,326100.0,2,1.0,880,7683,1.0,0,0,3,6,880,0,1942,0,98177,47.7145,-122.361,1370,7695,6803,6325,42.44435767278407,0.032931147540983606,Very Cheap
20140529T000000,535000.0,3,2.5,1360,1016,3.0,0,0,3,7,1310,50,2003,0,98115,47.6774,-122.324,1365,1156,-344,-209,526.5748031496063,0.06032786885245902,Very Cheap
20141001T000000,283000.0,4,2.75,2130,8560,1.0,0,0,3,7,1560,570,1992,0,98022,47.1949,-122.01,2130,8560,6430,6430,33.0607476635514,0.027278688524590165,Very Cheap
20140821T000000,260000.0,3,1.0,1480,7469,1.5,0,0,3,6,1120,360,1940,0,98168,47.5048,-122.301,1460,7379,5989,5919,34.8105502744678,0.024262295081967214,Very Cheap
20150413T000000,399000.0,4,1.0,1500,6388,1.5,0,0,4,7,1500,0,1951,0,98126,47.5303,-122.378,980,5366,4888,4386,62.46086412022542,0.042491803278688525,Very Cheap
20150225T000000,484950.0,3,2.25,1670,5004,2.0,0,0,3,8,1670,0,1987,0,98029,47.5688,-122.017,1850,5276,3334,3426,96.91247002398082,0.05376393442622951,Very Cheap
20141013T000000,640000.0,4,1.75,2060,9828,1.0,0,0,4,8,2060,0,1960,0,98005,47.5867,-122.174,2260,9996,7768,7736,65.12006512006512,0.0740983606557377,Very Cheap
20150304T000000,585000.0,4,2.5,2160,8158,1.0,0,0,4,8,1660,500,1952,0,98115,47.6948,-122.328,1520,7208,5998,5688,71.70875214513362,0.06688524590163934,Very Cheap
20150108T000000,645000.0,4,2.0,2780,11583,1.0,0,3,3,8,1190,1590,1955,0,98125,47.7293,-122.284,2580,10241,8803,7661,55.68505568505569,0.07475409836065573,Very Cheap
20150505T000000,253000.0,3,2.0,1490,7651,1.0,0,0,3,7,1490,0,1988,0,98003,47.3211,-122.325,1590,7795,6161,6205,33.06757286629199,0.023344262295081967,Very Cheap
20140721T000000,178500.0,2,1.0,740,6460,1.0,0,0,3,6,740,0,1953,0,98146,47.5077,-122.344,1170,6975,5720,5805,27.63157894736842,0.01357377049180328,Very Cheap
20140821T000000,291000.0,4,2.5,1860,6325,2.0,0,0,4,7,1860,0,1991,0,98038,47.3492,-122.03,1860,6449,4465,4589,46.00790513833992,0.028327868852459016,Very Cheap
20140917T000000,199950.0,2,2.75,1590,20917,1.5,0,0,3,5,1590,0,1920,0,98001,47.2786,-122.25,1310,6000,19327,4690,9.559210211789454,0.01638688524590164,Very Cheap
20140804T000000,553500.0,2,1.0,850,2340,1.0,0,0,3,7,850,0,1922,0,98105,47.6707,-122.328,1300,3000,1490,1700,236.53846153846155,0.06275409836065574,Very Cheap
20150415T000000,189950.0,2,1.0,1030,4188,1.0,0,0,3,8,1030,0,1981,0,98038,47.3738,-122.057,1450,3376,3158,1926,45.35577841451767,0.015075409836065574,Very Cheap
20140924T000000,289000.0,3,2.0,1850,9550,1.0,0,0,3,8,1850,0,1988,0,98001,47.3225,-122.273,2250,9550,7700,7300,30.26178010471204,0.028065573770491802,Very Cheap
20150427T000000,700000.0,4,2.0,1830,4590,2.0,0,0,3,8,1830,0,1908,0,98105,47.6593,-122.327,1650,4590,2760,2940,152.5054466230937,0.08196721311475409,Very Cheap
20141022T000000,270000.0,3,2.0,1560,8853,1.0,0,0,3,7,1560,0,1967,0,98058,47.4312,-122.171,1610,8750,7293,7140,30.498136225008473,0.025573770491803278,Very Cheap
20140508T000000,258000.0,4,1.75,1730,8320,1.0,0,0,3,7,1230,500,1977,0,98023,47.327,-122.361,1840,9800,6590,7960,31.009615384615383,0.024,Very Cheap
20140614T000000,530000.0,3,2.5,1930,7214,2.0,0,0,3,8,1930,0,2005,0,98125,47.7191,-122.309,1930,7266,5284,5336,73.46825616856113,0.05967213114754098,Very Cheap
20141218T000000,245000.0,3,2.25,1422,3677,2.0,0,0,3,7,1422,0,2012,0,98092,47.3204,-122.178,1677,3677,2255,2000,66.63040522164809,0.022295081967213116,Very Cheap
20150422T000000,563000.0,3,2.0,1380,5000,1.5,0,0,4,7,1380,0,1917,0,98117,47.6807,-122.369,1350,5000,3620,3650,112.6,0.064,Very Cheap
20141119T000000,515000.0,3,2.5,2430,4203,2.0,0,0,3,8,2430,0,2001,0,98065,47.5346,-121.875,2500,4798,1773,2298,122.53152510111825,0.057704918032786885,Very Cheap
20140617T000000,325000.0,4,2.5,2610,7091,2.0,0,0,3,9,2610,0,1987,0,98023,47.3017,-122.349,2610,7773,4481,5163,45.832745734029054,0.03278688524590164,Very Cheap
20150402T000000,540000.0,3,2.25,2000,217800,2.0,0,0,3,8,2000,0,1996,0,98024,47.5599,-121.911,2220,217800,215800,215580,2.479338842975207,0.06098360655737705,Very Cheap
20141210T000000,280300.0,2,1.0,920,5000,1.0,0,0,4,6,490,430,1949,0,98103,47.7008,-122.338,1500,5000,4080,3500,56.06,0.026924590163934427,Very Cheap
20140509T000000,460000.0,4,1.75,1750,5500,1.5,0,0,5,7,1050,700,1926,0,98117,47.6802,-122.388,1640,5500,3750,3860,83.63636363636364,0.050491803278688525,Very Cheap
20141212T000000,475000.0,3,1.75,2020,8970,1.0,0,0,4,7,1180,840,1981,0,98072,47.7571,-122.145,2140,8008,6950,5868,52.954292084726866,0.05245901639344262,Very Cheap
20140612T000000,900000.0,4,2.25,2460,44431,1.0,0,0,4,9,2460,0,1957,0,98007,47.6042,-122.147,2830,44431,41971,41601,20.256127478562266,0.10819672131147541,Cheap
20141230T000000,538200.0,4,3.0,1780,7260,1.0,0,0,4,8,1780,0,1964,0,98008,47.627,-122.114,1810,7920,5480,6110,74.13223140495867,0.06074754098360656,Very Cheap
20140909T000000,429000.0,2,1.0,1080,3600,1.0,0,0,3,7,1080,0,1922,0,98122,47.6078,-122.291,2230,4500,2520,2270,119.16666666666667,0.04642622950819672,Very Cheap
20140725T000000,164808.0,3,1.0,1250,5411,1.0,0,0,3,7,1250,0,1980,0,98178,47.5064,-122.265,1490,6320,4161,4830,30.457956015523934,0.011778098360655737,Very Cheap
20150126T000000,520000.0,4,2.25,1870,7700,2.0,0,0,3,7,1870,0,1977,0,98052,47.6937,-122.127,1970,7700,5830,5730,67.53246753246754,0.058360655737704915,Very Cheap
20140618T000000,475000.0,3,1.75,1700,8432,1.0,0,0,3,8,1230,470,1977,0,98125,47.7221,-122.317,1800,7842,6732,6042,56.333017077798864,0.05245901639344262,Very Cheap
20140926T000000,283000.0,4,1.5,1480,47045,1.0,0,0,5,6,1480,0,1942,0,98168,47.4809,-122.3,1530,11000,45565,9470,6.015517058135828,0.027278688524590165,Very Cheap
20150331T000000,321500.0,4,2.5,1930,6228,2.0,0,0,3,8,1930,0,2000,0,98030,47.3572,-122.191,1930,6168,4298,4238,51.62170841361593,0.032327868852459016,Very Cheap
20140729T000000,840000.0,4,2.75,3130,21810,2.0,0,0,4,10,3130,0,1993,0,98077,47.7083,-122.073,3330,21810,18680,18480,38.514442916093536,0.10032786885245902,Cheap
20150414T000000,287000.0,3,2.25,1370,6000,2.0,0,0,4,7,1370,0,1992,0,98038,47.3484,-122.033,1370,6200,4630,4830,47.833333333333336,0.02780327868852459,Very Cheap
20140605T000000,375000.0,3,1.75,960,8106,1.0,0,0,3,7,960,0,1962,0,98052,47.6737,-122.156,1650,8035,7146,6385,46.2620281273131,0.03934426229508197,Very Cheap
20140825T000000,349500.0,3,1.75,1260,7128,1.0,0,0,4,7,1260,0,1969,0,98034,47.7263,-122.205,1330,7326,5868,5996,49.03198653198653,0.036,Very Cheap
20140814T000000,446450.0,3,1.5,1480,7749,1.0,0,0,5,7,1480,0,1960,0,98126,47.5144,-122.379,1140,5320,6269,4180,57.61388566266615,0.04871475409836066,Very Cheap
20140610T000000,315000.0,4,2.5,1930,9643,2.0,0,0,4,7,1930,0,1992,0,98031,47.4065,-122.18,1930,7525,7713,5595,32.66618272321892,0.031475409836065574,Very Cheap
20140520T000000,271310.0,2,1.0,870,5340,1.5,0,0,2,6,870,0,1906,0,98144,47.5849,-122.302,1190,4440,4470,3250,50.80711610486891,0.025745573770491803,Very Cheap
20150122T000000,315000.0,4,1.0,1300,8400,1.5,0,0,4,7,1300,0,1953,0,98133,47.7612,-122.332,1330,8400,7100,7070,37.5,0.031475409836065574,Very Cheap
20140515T000000,245000.0,3,1.75,1490,6930,1.0,0,0,4,7,1490,0,1990,0,98030,47.3682,-122.179,1880,6861,5440,4981,35.35353535353536,0.022295081967213116,Very Cheap
20150305T000000,543115.0,2,1.0,1380,5484,1.0,0,0,3,8,1030,350,1947,0,98199,47.6382,-122.399,1380,5347,4104,3967,99.03628738147337,0.06139213114754098,Very Cheap
20141020T000000,900000.0,4,2.0,1190,8190,1.5,0,0,3,7,1190,0,1945,0,98117,47.6908,-122.397,1190,1567,7000,377,109.89010989010988,0.10819672131147541,Cheap
20150417T000000,2450000.0,4,4.25,4250,6552,2.0,0,3,4,10,2870,1380,2008,0,98144,47.5747,-122.283,3640,8841,2302,5201,373.9316239316239,0.3114754098360656,Medium
20150429T000000,554000.0,2,2.0,1920,6045,1.0,0,0,3,8,1920,0,2003,0,98053,47.7107,-122.031,1670,5200,4125,3530,91.64598842018196,0.06281967213114754,Very Cheap
20140717T000000,249900.0,3,1.75,2080,12522,1.0,0,0,5,6,2080,0,1950,0,98001,47.267,-122.25,1690,11200,10442,9510,19.956875898418783,0.02293770491803279,Very Cheap
20140820T000000,768000.0,3,2.5,3220,54160,2.0,0,2,4,9,2690,530,1981,0,98006,47.5468,-122.109,3460,44374,50940,40914,14.180206794682423,0.09088524590163935,Very Cheap
20140523T000000,980000.0,4,3.0,3680,5854,1.0,0,3,3,10,2060,1620,1967,0,98199,47.6327,-122.395,3140,5000,2174,1860,167.40690126409294,0.11868852459016394,Cheap
20150420T000000,395000.0,5,2.5,2070,9600,1.0,0,0,3,7,1270,800,1962,0,98146,47.4997,-122.364,1950,7800,7530,5850,41.145833333333336,0.0419672131147541,Very Cheap
20150413T000000,415000.0,3,1.75,1480,2200,2.0,0,0,3,7,1480,0,1995,0,98103,47.6969,-122.35,1360,2190,720,830,188.63636363636363,0.04459016393442623,Very Cheap
20150220T000000,380000.0,4,2.5,2000,6921,2.0,0,0,3,8,2000,0,2003,0,98038,47.3559,-122.014,2430,6339,4921,3909,54.905360497038004,0.04,Very Cheap
20150226T000000,566000.0,3,2.5,1560,5259,2.0,0,0,3,8,1560,0,1999,0,98075,47.5985,-122.016,2170,5461,3699,3291,107.62502376877734,0.06439344262295082,Very Cheap
20150316T000000,218500.0,2,1.0,1600,8961,1.0,0,0,4,7,1390,210,1949,0,98002,47.3098,-122.21,1502,6798,7361,5296,24.383439348287023,0.01881967213114754,Very Cheap
20140502T000000,550000.0,4,2.5,1940,10500,1.0,0,0,4,7,1140,800,1976,0,98052,47.683,-122.114,2200,10500,8560,8300,52.38095238095238,0.06229508196721312,Very Cheap
20140702T000000,512031.0,3,1.75,1540,3000,1.0,0,2,3,7,770,770,1920,0,98117,47.6769,-122.36,1420,4200,1460,2780,170.677,0.057315540983606555,Very Cheap
20150317T000000,197500.0,2,1.0,820,8860,1.0,0,0,3,6,820,0,1950,0,98055,47.452,-122.19,1660,15375,8040,13715,22.291196388261852,0.016065573770491802,Very Cheap
20140715T000000,470000.0,3,2.25,1780,8784,1.0,0,0,3,7,1230,550,1977,0,98033,47.701,-122.172,1780,7704,7004,5924,53.5063752276867,0.05180327868852459,Very Cheap
20150313T000000,590000.0,3,1.75,1560,242629,1.0,0,0,3,7,1560,0,1981,0,98053,47.6493,-121.956,2320,220654,241069,218334,2.431696128657333,0.06754098360655737,Very Cheap
20150318T000000,465000.0,4,2.25,2210,8862,1.0,0,0,4,8,1270,940,1977,0,98011,47.7725,-122.198,2030,8862,6652,6832,52.47122545700745,0.051147540983606556,Very Cheap
20140915T000000,499000.0,2,1.75,2040,114562,1.0,0,0,4,7,2040,0,1968,0,98027,47.4985,-122.092,1850,94960,112522,93110,4.355720046786892,0.05560655737704918,Very Cheap
20140825T000000,515000.0,3,2.25,1920,11500,1.0,0,0,3,8,1920,0,1972,2000,98006,47.5498,-122.188,2260,8866,9580,6606,44.78260869565217,0.057704918032786885,Very Cheap
20141106T000000,716500.0,3,1.75,1930,5000,1.0,0,0,3,9,1230,700,1936,0,98105,47.6582,-122.278,2300,6000,3070,3700,143.3,0.08413114754098361,Very Cheap
20140517T000000,410000.0,3,2.0,1700,4250,1.0,0,0,3,6,890,810,1944,0,98199,47.6542,-122.385,1440,4250,2550,2810,96.47058823529412,0.043934426229508196,Very Cheap
20141022T000000,850000.0,4,3.25,3450,6500,2.0,0,0,3,8,2450,1000,1994,0,98136,47.5437,-122.388,1750,6500,3050,4750,130.76923076923077,0.10163934426229508,Cheap
20140522T000000,1050000.0,4,3.25,3440,35021,2.0,0,0,3,10,3440,0,1983,0,98033,47.6476,-122.184,3440,35021,31581,31581,29.982010793523887,0.12786885245901639,Cheap
20140609T000000,648000.0,4,2.5,2380,13435,2.0,0,0,3,10,2380,0,1992,0,98075,47.5833,-122.028,2730,9677,11055,6947,48.232229251953854,0.07514754098360656,Very Cheap
20140605T000000,620000.0,4,2.25,2400,5350,1.5,0,0,4,7,1460,940,1929,0,98117,47.6763,-122.37,1250,4880,2950,3630,115.88785046728972,0.07147540983606557,Very Cheap
20150202T000000,935000.0,4,4.5,5670,84267,2.0,0,2,3,11,5670,0,2008,0,98010,47.323,-122.044,4100,83729,78597,79629,11.095683956946372,0.11278688524590164,Cheap
20150319T000000,379000.0,3,1.0,1140,10320,1.0,0,0,4,7,1140,0,1963,0,98034,47.7168,-122.196,1140,10412,9180,9272,36.724806201550386,0.03986885245901639,Very Cheap
20140716T000000,699000.0,3,1.75,1670,5375,1.0,0,0,3,7,1270,400,1952,0,98199,47.6416,-122.397,1460,6125,3705,4665,130.04651162790697,0.08183606557377049,Very Cheap
20141230T000000,528000.0,4,2.25,1910,8005,1.0,0,0,3,8,1280,630,1960,0,98125,47.7259,-122.298,1860,8010,6095,6150,65.95877576514678,0.05940983606557377,Very Cheap
20150426T000000,425000.0,3,1.75,1560,9452,1.0,0,0,4,8,1560,0,1974,0,98056,47.5197,-122.18,2200,9985,7892,7785,44.96402877697842,0.04590163934426229,Very Cheap
20140623T000000,249500.0,2,1.75,1500,8645,1.0,0,0,4,7,1500,0,1963,0,98042,47.3643,-122.115,1220,8645,7145,7425,28.860613071139387,0.022885245901639345,Very Cheap
20140716T000000,1035480.0,5,3.25,4475,6642,2.0,0,0,3,9,4475,0,2014,0,98053,47.6849,-122.018,3720,6633,2167,2913,155.89882565492323,0.12596459016393444,Cheap
20140813T000000,790000.0,4,2.75,2840,11900,1.0,0,3,4,9,1640,1200,1961,0,98136,47.5271,-122.386,2790,10070,9060,7280,66.38655462184875,0.09377049180327869,Very Cheap
20140818T000000,399950.0,3,1.0,1020,18050,1.0,0,0,3,7,1020,0,1969,0,98027,47.5254,-122.043,1750,11640,17030,9890,22.157894736842106,0.04261639344262295,Very Cheap
20141021T000000,275000.0,3,1.5,1410,9000,1.0,0,0,3,7,1410,0,1953,0,98133,47.7635,-122.35,1910,7214,7590,5304,30.555555555555557,0.02622950819672131,Very Cheap
20150123T000000,550000.0,3,1.0,1520,2500,1.5,0,0,3,8,1520,0,1912,0,98109,47.6347,-122.352,1880,3600,980,1720,220.0,0.06229508196721312,Very Cheap
20141105T000000,140000.0,1,1.0,730,6890,1.0,0,0,4,4,730,0,1926,0,98055,47.467,-122.215,1790,7969,6160,6179,20.319303338171263,0.008524590163934427,Very Cheap
20140725T000000,250000.0,3,1.0,1190,6250,1.0,0,0,3,7,990,200,1954,0,98108,47.5658,-122.292,1760,6434,5060,4674,40.0,0.022950819672131147,Very Cheap
20140903T000000,318000.0,3,2.25,1410,8909,2.0,0,2,3,7,1410,0,1988,0,98198,47.3983,-122.31,2050,8909,7499,6859,35.694241777977325,0.03186885245901639,Very Cheap
20140710T000000,505000.0,2,1.0,1240,57000,1.0,0,0,3,7,1240,0,1962,0,98075,47.597,-122.059,3050,25545,55760,22495,8.859649122807017,0.05639344262295082,Very Cheap
20150417T000000,470500.0,5,2.5,2500,9248,1.0,0,0,3,8,1300,1200,1966,0,98006,47.5415,-122.18,2090,8568,6748,6478,50.87586505190311,0.051868852459016394,Very Cheap
20140527T000000,360000.0,3,1.0,1050,9206,1.5,0,0,3,7,1050,0,1954,0,98125,47.7071,-122.301,1380,6384,8156,5004,39.10493156636976,0.037377049180327866,Very Cheap
20150319T000000,1242500.0,4,2.75,2680,8500,1.0,0,4,4,9,1480,1200,1962,0,98006,47.5634,-122.156,2940,8650,5820,5710,146.1764705882353,0.15311475409836064,Cheap
20150410T000000,986000.0,3,2.5,2380,16080,1.0,0,2,4,9,1340,1040,1964,0,98136,47.5262,-122.386,2560,10070,13700,7510,61.318407960199,0.11947540983606557,Cheap
20150205T000000,515000.0,2,1.0,1060,4228,1.0,0,0,3,7,860,200,1906,0,98112,47.6231,-122.293,1060,4187,3168,3127,121.8070009460738,0.057704918032786885,Very Cheap
20150114T000000,320000.0,3,1.75,2300,41900,1.0,0,0,4,8,1310,990,1939,0,98168,47.477,-122.292,1160,8547,39600,7387,7.637231503579952,0.032131147540983604,Very Cheap
20150202T000000,310000.0,4,3.0,2010,7426,1.0,0,0,5,7,1090,920,1951,0,98178,47.5042,-122.265,1470,7426,5416,5956,41.74521949905736,0.03081967213114754,Very Cheap
20140530T000000,356700.0,2,1.0,1090,5000,1.0,0,0,4,7,730,360,1942,0,98126,47.5258,-122.378,990,5250,3910,4260,71.34,0.036944262295081964,Very Cheap
20150422T000000,775000.0,4,1.75,2320,5595,1.0,0,0,3,7,1510,810,1956,0,98199,47.6397,-122.388,1840,5596,3275,3756,138.5165326184093,0.09180327868852459,Very Cheap
20150421T000000,325000.0,3,1.0,1040,7541,1.0,0,0,3,6,1040,0,1951,0,98133,47.7565,-122.339,1140,6100,6501,4960,43.09773239623392,0.03278688524590164,Very Cheap
20141002T000000,208000.0,4,2.75,1810,8677,1.5,0,0,3,7,1810,0,1962,0,98198,47.3668,-122.31,1740,8677,6867,6937,23.97141869309669,0.01744262295081967,Very Cheap
20140827T000000,825000.0,2,1.0,1150,12775,1.0,1,4,4,6,1150,0,1908,0,98178,47.502,-122.222,2440,11852,11625,9412,64.57925636007828,0.09836065573770492,Very Cheap
20140716T000000,515000.0,3,2.5,2360,11254,1.0,0,2,3,9,2360,0,1990,0,98003,47.3356,-122.333,2390,11254,8894,8864,45.76150701972632,0.057704918032786885,Very Cheap
20150127T000000,490000.0,3,1.5,1970,3400,1.5,0,0,4,8,1420,550,1929,0,98122,47.6163,-122.292,1940,4000,1430,2060,144.11764705882354,0.05442622950819672,Very Cheap
20140520T000000,675000.0,4,3.0,2690,28300,1.0,0,0,3,8,2690,0,1954,1999,98166,47.4458,-122.343,2820,27100,25610,24280,23.851590106007066,0.07868852459016394,Very Cheap
20140717T000000,360000.0,4,2.5,2080,4080,1.0,0,0,5,7,1040,1040,1962,0,98144,47.572,-122.29,1340,4080,2000,2740,88.23529411764706,0.037377049180327866,Very Cheap
20150420T000000,550000.0,4,2.5,2080,4080,1.0,0,0,5,7,1040,1040,1962,0,98144,47.572,-122.29,1340,4080,2000,2740,134.80392156862746,0.06229508196721312,Very Cheap
20140725T000000,225000.0,3,1.5,1370,9000,1.0,0,0,3,7,1370,0,1962,0,98168,47.4973,-122.328,1400,9075,7630,7675,25.0,0.019672131147540985,Very Cheap
20150317T000000,500000.0,3,2.75,3410,9360,1.5,0,0,4,8,3410,0,1967,0,98058,47.4497,-122.147,2260,10128,5950,7868,53.41880341880342,0.05573770491803279,Very Cheap
20150427T000000,385000.0,4,2.0,1850,11700,1.0,0,0,4,8,1850,0,1969,0,98059,47.4702,-122.12,2110,11700,9850,9590,32.9059829059829,0.04065573770491803,Very Cheap
20140617T000000,837700.0,5,2.75,3010,12611,2.0,0,0,3,10,3010,0,1994,0,98052,47.696,-122.102,2890,9456,9601,6566,66.42613591309174,0.10002622950819672,Cheap
20150210T000000,448000.0,3,2.25,1530,3056,2.0,0,0,3,7,1530,0,2003,0,98053,47.6817,-122.035,1560,3064,1526,1504,146.59685863874344,0.048918032786885245,Very Cheap
20150507T000000,730000.0,5,1.75,2690,21357,1.0,0,0,4,7,1420,1270,1952,0,98004,47.5831,-122.191,2600,17539,18667,14939,34.18083064100763,0.0859016393442623,Very Cheap
20140714T000000,575000.0,4,1.5,2810,7140,1.0,0,2,3,8,1490,1320,1954,0,98136,47.5252,-122.382,2240,6825,4330,4585,80.53221288515407,0.06557377049180328,Very Cheap
20141118T000000,430000.0,3,1.75,1810,7300,1.0,0,0,4,7,1240,570,1976,0,98034,47.7299,-122.192,1460,7560,5490,6100,58.9041095890411,0.04655737704918033,Very Cheap
20150114T000000,435000.0,3,2.5,1560,3987,2.0,0,0,3,7,1560,0,2002,0,98053,47.687,-122.043,1600,3152,2427,1552,109.104589917231,0.04721311475409836,Very Cheap
20141219T000000,241000.0,3,1.0,1010,9611,1.0,0,0,4,6,1010,0,1973,0,98092,47.3006,-122.066,1200,9611,8601,8411,25.075434398085527,0.02177049180327869,Very Cheap
20150513T000000,453500.0,2,1.75,1000,1760,1.0,0,0,4,6,600,400,1924,0,98109,47.6261,-122.355,2120,2802,760,682,257.67045454545456,0.04963934426229508,Very Cheap
20150406T000000,285000.0,2,1.5,990,1380,3.0,0,0,3,7,990,0,2001,0,98133,47.7218,-122.356,1050,1380,390,330,206.52173913043478,0.02754098360655738,Very Cheap
20140528T000000,151000.0,2,1.0,720,4222,1.0,0,0,4,5,720,0,1942,0,98056,47.4965,-122.186,860,4785,3502,3925,35.76504026527712,0.009967213114754098,Very Cheap
20141110T000000,1570000.0,5,4.5,6070,14731,2.0,0,0,3,11,6070,0,2004,0,98059,47.5306,-122.134,4750,13404,8661,8654,106.57796483606,0.1960655737704918,Cheap
20141105T000000,631000.0,5,2.0,2270,2400,2.0,0,0,3,7,2270,0,1905,0,98122,47.6051,-122.319,1320,2400,130,1080,262.9166666666667,0.07291803278688525,Very Cheap
20140602T000000,285000.0,2,2.5,1380,1073,2.0,0,0,3,7,1140,240,2011,0,98126,47.5462,-122.369,1580,2036,-307,456,265.61043802423114,0.02754098360655738,Very Cheap
20150220T000000,195000.0,3,1.0,1260,8378,1.0,0,0,4,6,840,420,1959,1977,98023,47.3274,-122.348,1140,8496,7118,7356,23.2752446884698,0.015737704918032787,Very Cheap
20150425T000000,817500.0,4,2.5,2910,35679,2.0,0,0,4,9,2910,0,1987,0,98075,47.5859,-121.991,2720,36728,32769,34008,22.9126376860338,0.09737704918032787,Very Cheap
20150109T000000,550000.0,3,2.0,1810,12825,1.0,0,0,4,7,1810,0,1960,0,98007,47.5953,-122.14,1490,10800,11015,9310,42.8849902534113,0.06229508196721312,Very Cheap
20140703T000000,1127000.0,4,2.5,3160,8281,2.0,0,0,4,9,3160,0,1995,0,98033,47.6699,-122.195,3000,8281,5121,5281,136.09467455621302,0.1379672131147541,Cheap
20141230T000000,609850.0,2,2.75,1910,1369,3.0,0,0,3,9,1910,0,2002,0,98119,47.6544,-122.373,1910,1879,-541,-31,445.47114682249816,0.07014426229508197,Very Cheap
20150106T000000,200000.0,3,1.0,1230,4380,1.0,0,0,3,6,1230,0,1947,0,98106,47.5352,-122.361,1525,6026,3150,4501,45.662100456621005,0.01639344262295082,Very Cheap
20150306T000000,367000.0,4,2.5,2960,6219,2.0,0,0,3,9,2960,0,2006,0,98038,47.3603,-122.037,2960,5361,3259,2401,59.01270300691429,0.03829508196721312,Very Cheap
20140825T000000,285167.0,3,2.25,2200,8375,2.0,0,0,3,8,2200,0,1988,0,98092,47.2626,-122.218,2200,10002,6175,7802,34.04979104477612,0.027562885245901638,Very Cheap
20150402T000000,275000.0,2,1.5,1270,32175,1.0,0,0,4,7,1270,0,1947,0,98003,47.3347,-122.304,1270,10200,30905,8930,8.547008547008547,0.02622950819672131,Very Cheap
20150324T000000,350900.0,4,2.5,2540,12843,2.0,0,0,3,9,2540,0,1992,0,98030,47.3866,-122.169,2410,9383,10303,6973,27.322276726621507,0.03618360655737705,Very Cheap
20140620T000000,660000.0,4,3.25,3030,9273,2.0,0,0,5,8,3030,0,1988,0,98029,47.5747,-122.014,2360,7632,6243,5272,71.17437722419929,0.07672131147540984,Very Cheap
20140819T000000,525000.0,3,1.75,1520,8835,1.0,0,0,4,7,1520,0,1957,0,98008,47.6054,-122.118,1760,8580,7315,6820,59.42275042444822,0.05901639344262295,Very Cheap
20150206T000000,262000.0,4,2.5,1560,7800,2.0,0,0,3,7,1560,0,1997,0,98168,47.514,-122.316,1160,7800,6240,6640,33.58974358974359,0.024524590163934427,Very Cheap
20140623T000000,690000.0,2,1.0,970,4560,1.0,0,0,4,7,970,0,1907,0,98103,47.6561,-122.332,1500,4560,3590,3060,151.31578947368422,0.08065573770491803,Very Cheap
20150324T000000,624000.0,5,3.75,3570,14648,2.0,0,0,3,9,3570,0,2005,0,98019,47.7377,-121.974,3160,7882,11078,4722,42.599672310212995,0.072,Very Cheap
20140506T000000,353000.0,3,1.0,1350,7740,1.0,0,0,4,6,860,490,1947,0,98125,47.7098,-122.291,1130,7740,6390,6610,45.60723514211886,0.03645901639344262,Very Cheap
20150311T000000,552500.0,4,3.5,3710,10400,2.0,0,0,3,8,2290,1420,2002,0,98056,47.5041,-122.186,1720,4276,6690,2556,53.125,0.06262295081967213,Very Cheap
20140509T000000,224500.0,4,1.0,1430,8355,1.5,0,0,4,7,1430,0,1983,0,98092,47.3178,-122.174,1550,7938,6925,6388,26.870137642130462,0.01960655737704918,Very Cheap
20150427T000000,239000.0,3,1.0,940,8571,1.0,0,0,3,6,940,0,1950,0,98146,47.5006,-122.336,1100,8573,7631,7473,27.88472756971182,0.021508196721311476,Very Cheap
20140711T000000,975000.0,5,4.5,4300,12250,2.0,0,0,3,10,4300,0,2004,0,98029,47.5557,-122.027,3950,12250,7950,8300,79.59183673469387,0.1180327868852459,Cheap
20140625T000000,1200000.0,4,1.75,3990,13470,2.0,0,0,3,11,3990,0,2006,0,98059,47.5305,-122.131,5790,13709,9480,7919,89.08685968819599,0.14754098360655737,Cheap
20150325T000000,505000.0,3,1.0,1380,4000,1.5,0,0,3,7,1380,0,1910,0,98112,47.6261,-122.296,1690,4000,2620,2310,126.25,0.05639344262295082,Very Cheap
20140515T000000,302000.0,4,1.75,2020,7865,1.0,0,0,4,7,1010,1010,1963,0,98059,47.5008,-122.162,1650,7865,5845,6215,38.39796567069294,0.02977049180327869,Very Cheap
20140922T000000,170000.0,3,1.0,1480,5670,1.0,0,0,3,6,780,700,1944,0,98106,47.5175,-122.36,760,5040,4190,4280,29.98236331569665,0.012459016393442624,Very Cheap
20140707T000000,195000.0,2,1.0,1190,27007,1.0,0,0,4,5,1190,0,1910,0,98027,47.524,-122.04,1730,12632,25817,10902,7.2203502795571515,0.015737704918032787,Very Cheap
20140909T000000,272000.0,5,1.5,2550,6300,1.0,0,0,4,7,1560,990,1959,0,98056,47.5014,-122.172,1380,6300,3750,4920,43.17460317460318,0.02583606557377049,Very Cheap
20150213T000000,369000.0,5,1.5,2550,6300,1.0,0,0,4,7,1560,990,1959,0,98056,47.5014,-122.172,1380,6300,3750,4920,58.57142857142857,0.03855737704918033,Very Cheap
20150114T000000,332500.0,3,1.5,1500,6332,1.0,0,0,3,7,1500,0,1953,0,98125,47.7274,-122.312,1500,6337,4832,4837,52.51105495893872,0.033770491803278686,Very Cheap
20150506T000000,515000.0,3,2.5,3000,8250,1.0,0,0,4,8,1760,1240,1963,0,98008,47.6191,-122.112,2040,8250,5250,6210,62.42424242424242,0.057704918032786885,Very Cheap
20140605T000000,269000.0,3,1.0,1690,4250,1.0,0,0,3,7,1020,670,1967,0,98178,47.4945,-122.258,1820,8865,2560,7045,63.294117647058826,0.02544262295081967,Very Cheap
20140730T000000,1278000.0,4,4.0,4390,17832,1.0,0,0,4,11,2430,1960,1994,0,98059,47.5283,-122.143,3090,12369,13442,9279,71.66890982503365,0.15777049180327868,Cheap
20150206T000000,303000.0,3,2.5,1560,4100,2.0,0,0,3,7,1560,0,1985,0,98055,47.4733,-122.189,1660,4400,2540,2740,73.90243902439025,0.029901639344262296,Very Cheap
20150105T000000,420000.0,7,3.0,2940,8624,1.0,0,0,3,8,1690,1250,1977,0,98155,47.7555,-122.307,1850,8031,5684,6181,48.701298701298704,0.04524590163934426,Very Cheap
20141110T000000,400000.0,3,1.0,1130,4100,1.0,0,0,3,7,990,140,1941,0,98117,47.6856,-122.385,1800,4100,2970,2300,97.5609756097561,0.04262295081967213,Very Cheap
20150204T000000,225000.0,3,1.0,1020,8437,1.0,0,0,5,6,1020,0,1987,0,98022,47.2093,-122.0,1420,8500,7417,7080,26.668247007230057,0.019672131147540985,Very Cheap
20140916T000000,219000.0,2,2.0,1310,2550,2.0,0,0,3,6,1310,0,2004,0,98038,47.3496,-122.022,1310,2550,1240,1240,85.88235294117646,0.018885245901639345,Very Cheap
20141231T000000,605000.0,3,2.5,2570,9487,2.0,0,3,3,9,2570,0,1989,0,98011,47.7408,-122.216,2490,9898,6917,7408,63.77147675766839,0.06950819672131148,Very Cheap
20141014T000000,625000.0,4,2.0,2020,6867,1.0,0,0,5,8,1010,1010,1942,0,98115,47.7,-122.292,1250,6842,4847,5592,91.01499927188,0.07213114754098361,Very Cheap
20150224T000000,380000.0,5,2.0,1680,3240,1.0,0,0,3,5,840,840,1906,0,98144,47.5965,-122.311,1380,1260,1560,-120,117.28395061728395,0.04,Very Cheap
20150424T000000,620000.0,4,2.0,1770,7700,1.5,0,0,4,7,1770,0,1962,0,98007,47.5916,-122.146,1710,7700,5930,5990,80.51948051948052,0.07147540983606557,Very Cheap
20140627T000000,687500.0,4,2.75,3190,10970,2.0,0,0,3,10,3190,0,1994,0,98075,47.5862,-122.029,2850,8416,7780,5566,62.67092069279854,0.08032786885245902,Very Cheap
20140723T000000,225500.0,4,2.0,1440,7950,1.0,0,0,5,6,1440,0,1962,0,98058,47.4517,-122.082,1530,20037,6510,18507,28.364779874213838,0.019737704918032787,Very Cheap
20141215T000000,252500.0,3,2.0,1150,6000,1.0,0,0,5,7,1150,0,1956,0,98178,47.498,-122.263,1980,6360,4850,4380,42.083333333333336,0.023278688524590165,Very Cheap
20141029T000000,510000.0,3,2.5,1860,3658,2.0,0,0,3,8,1860,0,1994,0,98029,47.5703,-122.004,1840,3739,1798,1899,139.4204483324221,0.057049180327868855,Very Cheap
20140507T000000,510000.0,4,2.5,2430,5203,2.0,0,0,3,8,2430,0,2003,0,98155,47.7402,-122.317,2260,7474,2773,5214,98.0203728618105,0.057049180327868855,Very Cheap
20140808T000000,725000.0,3,2.5,1940,4000,1.5,0,0,5,7,1940,0,1906,0,98109,47.6372,-122.352,1440,4000,2060,2560,181.25,0.08524590163934426,Very Cheap
20150217T000000,75000.0,1,0.0,670,43377,1.0,0,0,3,3,670,0,1966,0,98022,47.2638,-121.906,1160,42882,42707,41722,1.729026903658621,0.0,Very Cheap
20150312T000000,492000.0,2,1.0,880,2970,1.0,0,0,3,7,880,0,1927,0,98103,47.6868,-122.349,1370,3060,2090,1690,165.65656565656565,0.054688524590163934,Very Cheap
20150311T000000,425000.0,4,2.5,1930,14196,1.0,0,0,4,7,1330,600,1977,0,98072,47.7407,-122.097,1470,12852,12266,11382,29.938010707241478,0.04590163934426229,Very Cheap
20150421T000000,1955000.0,4,2.75,3120,7898,1.0,1,4,4,8,1560,1560,1963,0,98034,47.7165,-122.259,2630,13868,4778,11238,247.53102051152192,0.24655737704918032,Cheap
20150309T000000,298900.0,3,2.5,1830,6162,2.0,0,0,3,8,1830,0,1994,0,98092,47.3291,-122.17,1860,7017,4332,5157,48.5069782538137,0.029363934426229508,Very Cheap
20150406T000000,699000.0,4,2.5,3230,40319,2.0,0,0,4,10,3230,0,1987,0,98027,47.4856,-122.069,2990,40234,37089,37244,17.336739502467818,0.08183606557377049,Very Cheap
20140702T000000,310000.0,2,1.0,700,3000,1.0,0,0,4,6,700,0,1918,0,98103,47.6846,-122.346,1560,4500,2300,2940,103.33333333333333,0.03081967213114754,Very Cheap
20141222T000000,350000.0,3,1.75,1010,8580,1.0,0,0,3,7,1010,0,1961,0,98033,47.6703,-122.174,1500,8580,7570,7080,40.79254079254079,0.036065573770491806,Very Cheap
20141229T000000,790000.0,4,1.75,2460,10061,1.0,1,4,3,7,1410,1050,1961,0,98178,47.5105,-122.238,2300,10061,7601,7761,78.52102176721996,0.09377049180327869,Very Cheap
20140729T000000,305000.0,4,2.5,2230,5000,2.0,0,0,3,8,2230,0,2003,0,98031,47.3919,-122.184,2230,6137,2770,3907,61.0,0.03016393442622951,Very Cheap
20141002T000000,315000.0,3,2.5,1570,2865,2.0,0,0,3,7,1570,0,2003,0,98118,47.5412,-122.288,1610,2582,1295,972,109.94764397905759,0.031475409836065574,Very Cheap
20140812T000000,267500.0,5,3.5,2390,6600,2.0,0,0,5,7,2390,0,1977,0,98042,47.3737,-122.115,1140,6600,4210,5460,40.53030303030303,0.025245901639344263,Very Cheap
20140819T000000,1750000.0,4,3.25,3460,7749,2.0,0,1,3,10,3020,440,1950,1998,98115,47.6849,-122.273,3030,8680,4289,5650,225.83559168925024,0.21967213114754097,Cheap
20140813T000000,435000.0,6,3.5,2400,8620,2.0,0,0,3,8,1640,760,1987,0,98034,47.7152,-122.162,1940,7350,6220,5410,50.464037122969835,0.04721311475409836,Very Cheap
20140905T000000,482500.0,6,4.5,2940,7500,1.5,0,0,4,8,2940,0,1966,0,98034,47.7208,-122.182,2010,7500,4560,5490,64.33333333333333,0.053442622950819675,Very Cheap
20141020T000000,5110800.0,5,5.25,8010,45517,2.0,1,4,3,12,5990,2020,1999,0,98033,47.6767,-122.211,3430,26788,37507,23358,112.28332271459016,0.6604327868852459,Very High
20140828T000000,439995.0,3,1.75,1570,8400,1.0,0,0,4,7,1570,0,1959,0,98133,47.76,-122.34,1860,8639,6830,6779,52.38035714285714,0.04786819672131148,Very Cheap
20150508T000000,460000.0,3,3.0,1520,7500,1.0,0,0,3,7,1180,340,1967,0,98034,47.7276,-122.181,2080,8000,5980,5920,61.333333333333336,0.050491803278688525,Very Cheap
20140729T000000,194000.0,3,1.0,1070,6440,1.0,0,0,4,7,1070,0,1971,0,98023,47.3186,-122.373,1190,6532,5370,5342,30.124223602484474,0.01560655737704918,Very Cheap
20141009T000000,290000.0,2,0.75,440,8313,1.0,1,3,4,5,440,0,1943,0,98070,47.4339,-122.512,880,26289,7873,25409,34.8851196920486,0.02819672131147541,Very Cheap
20140715T000000,274700.0,4,2.0,2440,9600,1.0,0,0,5,7,1220,1220,1963,0,98031,47.4142,-122.179,1370,9600,7160,8230,28.614583333333332,0.02619016393442623,Very Cheap
20150317T000000,900000.0,4,2.5,2660,3672,2.0,0,0,5,8,1800,860,1910,0,98105,47.6609,-122.324,1510,3825,1012,2315,245.09803921568627,0.10819672131147541,Cheap
20140507T000000,1150000.0,4,4.0,4460,103382,2.0,0,0,3,11,4460,0,2001,0,98053,47.634,-121.997,3470,88519,98922,85049,11.123793310247432,0.14098360655737704,Cheap
20140903T000000,605000.0,3,2.5,2010,3667,2.0,0,0,3,9,2010,0,2008,0,98027,47.545,-122.015,2350,3600,1657,1250,164.9850013635124,0.06950819672131148,Very Cheap
20150309T000000,359000.0,3,2.5,1450,3850,2.0,0,0,3,7,1450,0,2004,0,98065,47.5318,-121.85,1970,3748,2400,1778,93.24675324675324,0.03724590163934426,Very Cheap
20141008T000000,850000.0,3,1.75,1400,9900,1.0,0,0,3,7,1400,0,1951,0,98004,47.6272,-122.209,1810,10796,8500,8986,85.85858585858585,0.10163934426229508,Cheap
20140821T000000,505000.0,3,2.0,1500,2500,2.0,0,0,3,8,1500,0,2002,0,98107,47.6748,-122.385,1550,5000,1000,3450,202.0,0.05639344262295082,Very Cheap
20140709T000000,565000.0,3,2.5,2500,7394,2.0,0,0,3,9,2500,0,1990,0,98072,47.7441,-122.173,2790,7642,4894,4852,76.41330808763863,0.06426229508196721,Very Cheap
20150429T000000,585000.0,2,1.75,1280,7110,1.0,0,0,4,7,1000,280,1955,0,98118,47.5569,-122.273,1550,6835,5830,5285,82.27848101265823,0.06688524590163934,Very Cheap
20150430T000000,328000.0,4,3.25,3380,7500,2.0,0,3,3,7,2420,960,1990,0,98198,47.4092,-122.33,1920,7500,4120,5580,43.733333333333334,0.03318032786885246,Very Cheap
20140709T000000,749950.0,4,2.75,2910,18700,1.0,0,0,3,9,2210,700,1957,1995,98177,47.7557,-122.368,2420,26140,15790,23720,40.10427807486631,0.08851803278688525,Very Cheap
20140626T000000,826000.0,4,2.5,3060,7140,2.0,0,0,3,9,3060,0,2006,0,98027,47.5393,-121.998,3240,6218,4080,2978,115.68627450980392,0.09849180327868852,Very Cheap
20140904T000000,535000.0,3,1.0,1330,40259,1.0,0,0,4,7,1330,0,1977,0,98024,47.552,-121.89,1710,34787,38929,33077,13.288954022702999,0.06032786885245902,Very Cheap
20140806T000000,925000.0,4,2.5,3300,101930,2.0,0,0,4,10,3300,0,1991,0,98029,47.576,-121.976,2880,213879,98630,210999,9.074855292848033,0.11147540983606558,Cheap
20140605T000000,875000.0,3,3.5,3250,6000,2.0,0,0,3,10,2500,750,2001,0,98136,47.5533,-122.391,1650,6000,2750,4350,145.83333333333334,0.10491803278688525,Cheap
20140523T000000,902000.0,4,2.25,2530,9200,1.0,0,0,5,9,1570,960,1976,0,98006,47.5612,-122.152,3030,9400,6670,6370,98.04347826086956,0.10845901639344262,Cheap
20141001T000000,423000.0,3,1.0,1830,13900,1.0,0,0,3,7,1830,0,1951,0,98133,47.7654,-122.352,1840,10667,12070,8827,30.431654676258994,0.04563934426229508,Very Cheap
20140623T000000,235000.0,3,1.0,1170,11100,1.0,0,0,4,6,1170,0,1968,0,98059,47.4954,-122.164,2080,8481,9930,6401,21.17117117117117,0.02098360655737705,Very Cheap
20140710T000000,545000.0,2,2.0,2930,14057,1.0,0,2,4,8,1680,1250,1980,0,98070,47.4025,-122.463,2234,61011,11127,58777,38.77071921462616,0.06163934426229508,Very Cheap
20141016T000000,343000.0,2,1.0,1230,7560,1.0,0,0,3,7,1230,0,1961,0,98133,47.7298,-122.34,1270,7560,6330,6290,45.370370370370374,0.035147540983606555,Very Cheap
20150324T000000,334950.0,3,2.5,1620,2930,2.0,0,0,3,8,1620,0,2002,0,98058,47.4491,-122.12,1900,2943,1310,1043,114.31740614334471,0.03409180327868853,Very Cheap
20140909T000000,405000.0,3,1.75,1760,5355,1.0,0,0,3,7,1160,600,1956,0,98118,47.5368,-122.267,1790,6225,3595,4435,75.63025210084034,0.043278688524590166,Very Cheap
20141215T000000,220000.0,4,1.0,1440,8250,1.0,0,0,3,7,1440,0,1959,0,98188,47.4325,-122.291,1440,8466,6810,7026,26.666666666666668,0.01901639344262295,Very Cheap
20141002T000000,173000.0,2,1.0,1740,8100,1.0,0,0,3,6,1050,690,1947,0,98168,47.4942,-122.304,960,8100,6360,7140,21.358024691358025,0.012852459016393442,Very Cheap
20141107T000000,655000.0,3,1.0,1270,3600,1.5,0,0,3,7,1270,0,1906,0,98119,47.6368,-122.37,1710,3600,2330,1890,181.94444444444446,0.0760655737704918,Very Cheap
20150107T000000,406000.0,2,1.0,880,3000,1.0,0,0,3,6,880,0,1924,0,98115,47.6749,-122.323,890,3000,2120,2110,135.33333333333334,0.04340983606557377,Very Cheap
20141217T000000,632000.0,6,2.5,2560,8320,1.0,0,0,3,7,1370,1190,1961,0,98125,47.7021,-122.287,2360,7800,5760,5440,75.96153846153847,0.07304918032786885,Very Cheap
20141126T000000,357000.0,5,2.75,1540,4000,1.0,0,0,3,7,1140,400,1990,0,98106,47.533,-122.354,1630,4000,2460,2370,89.25,0.03698360655737705,Very Cheap
20141209T000000,361000.0,3,1.75,1150,17585,1.0,0,0,3,7,1150,0,1964,0,98014,47.6503,-121.908,1200,7500,16435,6300,20.528859823713393,0.037508196721311476,Very Cheap
20140708T000000,277000.0,2,1.0,770,8149,1.0,0,0,3,6,770,0,1948,0,98155,47.7458,-122.298,1160,8149,7379,6989,33.99190084672966,0.026491803278688525,Very Cheap
20140605T000000,630000.0,4,3.75,4610,40202,1.0,0,0,4,10,2500,2110,1980,0,98027,47.4599,-122.0,3050,41056,35592,38006,15.670862146161882,0.07278688524590164,Very Cheap
20140509T000000,254000.0,3,2.5,1850,4597,2.0,0,0,3,8,1850,0,2003,0,98042,47.3755,-122.136,2210,5000,2747,2790,55.253426147487495,0.023475409836065574,Very Cheap
20141113T000000,472800.0,3,2.25,1840,8400,1.0,0,0,3,8,1290,550,1961,0,98006,47.5497,-122.172,2110,8400,6560,6290,56.285714285714285,0.052170491803278686,Very Cheap
20140922T000000,263000.0,3,1.75,1490,3800,1.0,0,0,3,6,700,790,1913,0,98118,47.5554,-122.27,2180,4000,2310,1820,69.21052631578948,0.024655737704918034,Very Cheap
20150504T000000,510000.0,3,1.75,1490,3800,1.0,0,0,3,6,700,790,1913,0,98118,47.5554,-122.27,2180,4000,2310,1820,134.21052631578948,0.057049180327868855,Very Cheap
20141107T000000,179950.0,3,1.0,960,10125,1.0,0,0,4,7,960,0,1952,0,98003,47.3335,-122.305,1250,9769,9165,8519,17.77283950617284,0.013763934426229509,Very Cheap
20141203T000000,525000.0,4,2.25,1580,7307,1.0,0,0,3,8,1160,420,1973,0,98027,47.569,-122.086,2020,7458,5727,5438,71.84891200218968,0.05901639344262295,Very Cheap
20140520T000000,479000.0,3,2.5,1260,889,3.0,0,0,3,8,1260,0,2008,0,98109,47.6277,-122.345,1340,1324,-371,-16,538.8076490438696,0.05298360655737705,Very Cheap
20140904T000000,651000.0,3,2.0,1940,6440,1.0,0,2,5,7,970,970,1940,0,98116,47.5664,-122.389,1730,4640,4500,2910,101.08695652173913,0.07554098360655738,Very Cheap
20140911T000000,949000.0,4,1.75,2490,7834,1.0,0,3,4,8,1240,1250,1958,0,98033,47.6851,-122.209,3210,7834,5344,4624,121.13862649987234,0.11462295081967214,Cheap
20150421T000000,392400.0,5,2.5,2520,27951,1.5,0,0,3,7,1890,630,1942,1970,98155,47.7733,-122.318,1830,14373,25431,12543,14.038853708275196,0.04162622950819672,Very Cheap
20141105T000000,585000.0,4,1.75,1760,5356,1.0,0,0,4,7,920,840,1950,0,98115,47.679,-122.288,1680,5184,3596,3504,109.22330097087378,0.06688524590163934,Very Cheap
20141212T000000,460000.0,4,2.5,4190,7504,2.0,0,0,3,7,4190,0,2004,0,98058,47.4394,-122.114,2480,6727,3314,4247,61.30063965884862,0.050491803278688525,Very Cheap
20140813T000000,470000.0,3,1.0,1170,4400,1.0,0,0,3,7,870,300,1951,0,98199,47.6584,-122.391,1240,4400,3230,3160,106.81818181818181,0.05180327868852459,Very Cheap
20150406T000000,245000.0,3,2.5,1600,4271,2.0,0,0,3,7,1600,0,2003,0,98038,47.386,-122.036,1520,3225,2671,1705,57.36361507843596,0.022295081967213116,Very Cheap
20141125T000000,500000.0,4,2.0,2760,27631,2.0,0,0,4,8,1800,960,1978,0,98155,47.7484,-122.291,2490,13158,24871,10668,18.095617241504108,0.05573770491803279,Very Cheap
20141113T000000,455000.0,3,2.5,2090,8653,2.0,0,0,3,8,2090,0,1989,0,98011,47.7498,-122.184,2090,6396,6563,4306,52.582919218768055,0.049836065573770495,Very Cheap
20150408T000000,485500.0,4,2.5,2320,3974,2.0,0,0,3,7,2320,0,1999,0,98065,47.532,-121.88,2620,4539,1654,1919,122.16909914443885,0.05383606557377049,Very Cheap
20141222T000000,1875000.0,5,3.25,4110,7920,2.0,0,3,3,9,3150,960,1921,0,98122,47.617,-122.282,3890,7800,3810,3910,236.74242424242425,0.2360655737704918,Cheap
20140717T000000,100000.0,2,1.0,770,17334,1.0,0,0,3,7,770,0,1978,0,98001,47.2997,-122.269,1480,17334,16564,15854,5.769008884273682,0.003278688524590164,Very Cheap
20140905T000000,307000.0,3,1.75,1410,16105,1.0,0,0,3,7,1410,0,1982,0,98014,47.6927,-121.913,1550,18615,14695,17065,19.062402980440858,0.03042622950819672,Very Cheap
20141010T000000,475000.0,4,3.5,3660,14401,2.0,0,0,3,10,2660,1000,1994,0,98023,47.3076,-122.396,2780,10653,10741,7873,32.98382056801611,0.05245901639344262,Very Cheap
20150219T000000,330000.0,4,2.5,2180,7210,1.0,0,0,3,7,1190,990,1972,0,98011,47.7419,-122.181,2070,7210,5030,5140,45.769764216366156,0.03344262295081967,Very Cheap
20150209T000000,130000.0,3,1.0,1110,7520,1.0,0,0,4,7,1110,0,1960,0,98033,47.683,-122.176,1440,8400,6410,6960,17.28723404255319,0.007213114754098361,Very Cheap
20140623T000000,320000.0,3,2.5,2280,7417,2.0,0,0,3,8,2280,0,1998,0,98001,47.3557,-122.278,2370,6443,5137,4073,43.14412835378185,0.032131147540983604,Very Cheap
20140606T000000,735000.0,4,2.5,2820,6180,2.0,0,0,3,9,2050,770,2013,0,98118,47.5529,-122.281,1390,4635,3360,3245,118.93203883495146,0.08655737704918033,Very Cheap
20150312T000000,365000.0,4,2.5,1570,9600,1.0,0,0,3,7,800,770,1972,0,98155,47.7757,-122.303,1340,9110,8030,7770,38.020833333333336,0.0380327868852459,Very Cheap
20150416T000000,234000.0,3,1.5,1200,11935,1.0,0,0,4,7,1200,0,1968,0,98042,47.3434,-122.082,1350,11935,10735,10585,19.606200251361543,0.020852459016393442,Very Cheap
20140827T000000,211000.0,4,2.0,1710,8288,1.5,0,0,3,7,1710,0,1970,0,98031,47.3947,-122.174,1710,7200,6578,5490,25.45849420849421,0.01783606557377049,Very Cheap
20150330T000000,680000.0,6,3.5,3000,6320,2.0,0,2,3,8,2400,600,1969,0,98118,47.562,-122.279,1720,6360,3320,4640,107.59493670886076,0.07934426229508197,Very Cheap
20141112T000000,457000.0,4,3.0,2800,7845,2.0,0,0,3,8,2800,0,2002,0,98038,47.3544,-122.013,2800,6977,5045,4177,58.25366475462078,0.0500983606557377,Very Cheap
20141009T000000,349000.0,3,2.25,1640,7261,2.0,0,0,3,7,1640,0,1989,0,98034,47.7192,-122.176,1640,6789,5621,5149,48.06500482027269,0.035934426229508196,Very Cheap
20141024T000000,360000.0,3,2.75,2030,6840,1.0,0,0,3,7,1210,820,1979,0,98108,47.5413,-122.299,1910,6365,4810,4455,52.63157894736842,0.037377049180327866,Very Cheap
20150414T000000,350000.0,4,2.5,2530,10155,2.0,0,0,3,8,2530,0,1998,0,98042,47.351,-122.146,2330,7205,7625,4875,34.465780403742,0.036065573770491806,Very Cheap
20150430T000000,208000.0,3,1.0,990,7420,1.0,0,0,5,6,990,0,1960,0,98002,47.2898,-122.221,1010,7420,6430,6410,28.032345013477087,0.01744262295081967,Very Cheap
20140618T000000,250275.0,2,1.0,790,11234,1.0,0,0,4,6,790,0,1942,0,98166,47.4413,-122.349,1930,11871,10444,9941,22.278351433149368,0.022986885245901638,Very Cheap
20150428T000000,435000.0,2,1.0,790,11234,1.0,0,0,4,6,790,0,1942,0,98166,47.4413,-122.349,1930,11871,10444,9941,38.72173758233933,0.04721311475409836,Very Cheap
20141205T000000,270000.0,3,1.75,1800,7763,1.0,0,0,3,6,1470,330,1984,0,98030,47.3766,-122.184,1440,7483,5963,6043,34.780368414272836,0.025573770491803278,Very Cheap
20140527T000000,438000.0,3,1.75,1650,12940,1.0,0,0,4,7,1650,0,1961,0,98028,47.7629,-122.268,2830,12600,11290,9770,33.84853168469861,0.04760655737704918,Very Cheap
20141119T000000,659000.0,4,2.0,1980,23625,2.0,0,0,3,8,1980,0,1938,1984,98072,47.7553,-122.092,2300,24640,21645,22340,27.894179894179896,0.07659016393442623,Very Cheap
20150504T000000,645000.0,4,2.75,2340,6350,1.0,0,0,4,7,1310,1030,1974,0,98126,47.5559,-122.379,2020,6350,4010,4330,101.5748031496063,0.07475409836065573,Very Cheap
20141030T000000,685100.0,4,2.5,2790,5423,2.0,0,0,3,9,2790,0,1999,0,98074,47.6085,-122.017,2450,6453,2633,4003,126.33228840125392,0.08001311475409836,Very Cheap
20140623T000000,350000.0,7,3.0,2800,9569,1.0,0,2,3,7,1400,1400,1963,0,98056,47.5102,-122.183,2150,7333,6769,5183,36.5764447695684,0.036065573770491806,Very Cheap
20150227T000000,375000.0,2,1.0,1840,81892,1.0,0,0,3,6,1840,0,1955,0,98072,47.7694,-122.124,2550,40089,80052,37539,4.579201875641088,0.03934426229508197,Very Cheap
20140715T000000,170000.0,3,1.5,1350,81549,1.0,0,0,2,7,1350,0,1966,0,98092,47.3099,-122.09,2220,93825,80199,91605,2.0846362309776945,0.012459016393442624,Very Cheap
20140624T000000,880000.0,4,2.5,3030,3841,3.0,0,0,3,9,3030,0,2005,0,98117,47.6781,-122.369,1080,4922,811,3842,229.1070033845353,0.10557377049180328,Cheap
20150419T000000,410500.0,4,2.5,1980,5000,2.0,0,0,3,8,1980,0,2008,0,98014,47.6492,-121.908,1400,8500,3020,7100,82.1,0.044,Very Cheap
20141023T000000,780000.0,4,2.5,3690,13609,2.0,0,2,3,10,3690,0,1996,0,98075,47.5872,-121.972,3600,13609,9919,10009,57.315012124329485,0.09245901639344262,Very Cheap
20140910T000000,1225000.0,5,4.5,3732,4426,2.5,0,0,3,10,2932,800,2001,0,98112,47.6189,-122.288,2950,4000,694,1050,276.77361048350656,0.15081967213114755,Cheap
20141113T000000,449000.0,2,1.75,1510,6852,1.0,0,0,3,8,1510,0,2005,0,98053,47.7073,-122.012,1510,5912,5342,4402,65.52831290134267,0.049049180327868855,Very Cheap
20140514T000000,546000.0,3,1.75,2000,5000,1.0,0,0,4,7,1110,890,1921,0,98117,47.6859,-122.399,1750,5000,3000,3250,109.2,0.06177049180327869,Very Cheap
20140516T000000,317000.0,3,2.0,1760,11410,1.0,0,0,5,7,1060,700,1977,0,98058,47.4528,-122.163,1680,9165,9650,7485,27.78264680105171,0.03173770491803279,Very Cheap
20140625T000000,276900.0,3,1.0,1270,7566,1.0,0,0,4,7,1270,0,1958,0,98056,47.5074,-122.175,1780,7520,6296,5740,36.597938144329895,0.026478688524590163,Very Cheap
20141028T000000,399000.0,5,2.0,2620,7030,1.0,0,0,3,8,1420,1200,1965,0,98133,47.7338,-122.352,1360,7964,4410,6604,56.75675675675676,0.042491803278688525,Very Cheap
20140808T000000,495000.0,5,2.75,2630,10165,1.0,0,0,4,8,1690,940,1976,0,98027,47.5196,-122.049,2440,10165,7535,7725,48.69650762420069,0.05508196721311476,Very Cheap
20140808T000000,258000.0,3,1.75,2270,9000,1.0,0,0,4,8,1330,940,1978,0,98023,47.3077,-122.381,2090,8400,6730,6310,28.666666666666668,0.024,Very Cheap
20140710T000000,600000.0,2,2.5,2410,102366,1.0,0,0,4,7,1940,470,1912,1989,98024,47.5629,-121.918,2460,310582,99956,308122,5.861321141785359,0.06885245901639345,Very Cheap
20141117T000000,265000.0,3,2.75,1120,881,3.0,0,0,3,8,1120,0,1999,0,98103,47.6914,-122.343,1120,1087,-239,-33,300.794551645857,0.024918032786885248,Very Cheap
20150424T000000,321000.0,5,2.75,3030,7000,1.0,0,0,4,7,1540,1490,1978,0,98032,47.3661,-122.28,1790,7330,3970,5540,45.857142857142854,0.032262295081967214,Very Cheap
20140829T000000,682000.0,5,2.25,2120,4000,1.5,0,0,4,7,1720,400,1910,0,98109,47.644,-122.353,1960,4000,1880,2040,170.5,0.07960655737704918,Very Cheap
20141114T000000,295700.0,4,2.5,1720,5805,2.0,0,0,3,8,1720,0,2000,0,98092,47.3286,-122.208,2360,7700,4085,5340,50.938845822566755,0.028944262295081968,Very Cheap
20140506T000000,609000.0,4,2.5,2150,37981,2.0,0,0,3,9,2150,0,1985,0,98052,47.7227,-122.098,2450,37981,35831,35531,16.03433295595166,0.0700327868852459,Very Cheap
20140625T000000,995000.0,3,4.5,4380,47044,2.0,1,3,3,9,3720,660,1968,1990,98166,47.4734,-122.365,2460,18512,42664,16052,21.15041237989967,0.12065573770491804,Cheap
20140818T000000,530000.0,3,2.25,2010,11817,2.0,0,0,4,8,2010,0,1986,0,98029,47.5665,-122.023,2190,10168,9807,7978,44.85063891004485,0.05967213114754098,Very Cheap
20141229T000000,614000.0,5,2.5,3150,5150,2.0,0,0,5,8,1870,1280,1907,2004,98118,47.5506,-122.269,1550,5150,2000,3600,119.22330097087378,0.07068852459016393,Very Cheap
20141124T000000,390000.0,3,2.5,2500,21780,1.0,0,0,3,8,1770,730,1986,0,98092,47.3282,-122.198,2670,23400,19280,20730,17.90633608815427,0.04131147540983607,Very Cheap
20141110T000000,467000.0,3,2.5,1690,6642,2.0,0,0,3,7,1690,0,2004,0,98053,47.6793,-122.033,2120,5080,4952,2960,70.3101475459199,0.05140983606557377,Very Cheap
20140813T000000,484000.0,6,2.5,3300,13501,1.0,0,0,3,8,2060,1240,1980,0,98059,47.5116,-122.163,2060,8745,10201,6685,35.84919635582549,0.05363934426229508,Very Cheap
20141113T000000,340000.0,3,2.5,1240,1115,3.0,0,0,3,8,1240,0,2003,0,98103,47.6985,-122.34,1410,1355,-125,-55,304.93273542600895,0.03475409836065574,Very Cheap
20141223T000000,302495.0,3,2.5,2200,7201,2.0,0,0,3,8,2200,0,1994,0,98030,47.3821,-122.207,2250,7240,5001,4990,42.007360088876545,0.029835409836065575,Very Cheap
20140925T000000,532500.0,3,1.75,1620,3360,1.0,0,0,5,7,980,640,1927,0,98117,47.6886,-122.361,1400,3840,1740,2440,158.48214285714286,0.06,Very Cheap
20140910T000000,441500.0,3,2.5,2420,9592,2.0,0,0,3,8,1780,640,1993,0,98059,47.5093,-122.153,2420,9145,7172,6725,46.027939949958295,0.0480655737704918,Very Cheap
20140724T000000,470000.0,4,2.5,2680,8062,1.0,0,3,4,7,1530,1150,1967,0,98198,47.4132,-122.328,1920,8600,5382,6680,58.29818903497891,0.05180327868852459,Very Cheap
20140625T000000,2300000.0,4,3.25,4250,8570,2.0,0,0,3,9,4250,0,2004,0,98004,47.6154,-122.21,2830,12821,4320,9991,268.37806301050176,0.29180327868852457,Cheap
20141217T000000,590000.0,3,2.5,2400,99752,1.0,0,0,3,9,2400,0,1996,0,98058,47.3917,-122.084,2800,98010,97352,95210,5.9146683775763895,0.06754098360655737,Very Cheap
20140729T000000,320000.0,3,1.75,2300,12000,1.0,0,0,3,8,1770,530,1942,0,98133,47.7599,-122.343,2030,6000,9700,3970,26.666666666666668,0.032131147540983604,Very Cheap
20141103T000000,363000.0,2,2.0,920,1201,2.0,0,0,3,8,800,120,2009,0,98144,47.5926,-122.295,1150,1161,281,11,302.248126561199,0.03777049180327869,Very Cheap
20140707T000000,747500.0,4,2.25,2350,18600,2.0,0,0,4,9,2350,0,1977,0,98028,47.7473,-122.257,2880,14400,16250,11520,40.18817204301075,0.0881967213114754,Very Cheap
20140723T000000,750000.0,2,2.5,2630,7957,2.0,0,0,3,8,2630,0,2003,0,98053,47.7106,-122.023,2305,7220,5327,4915,94.25662938293327,0.08852459016393442,Very Cheap
20140505T000000,831000.0,4,3.0,2170,4000,2.0,0,0,4,9,1610,560,1982,2011,98112,47.6196,-122.292,1670,4000,1830,2330,207.75,0.09914754098360656,Very Cheap
20150424T000000,403000.0,3,2.5,1700,4125,2.0,0,0,3,7,1700,0,2004,0,98065,47.5305,-121.854,1970,4105,2425,2135,97.6969696969697,0.04301639344262295,Very Cheap
20140808T000000,445000.0,3,2.5,2470,4565,2.0,0,0,3,7,2470,0,2005,0,98056,47.514,-122.189,2470,5064,2095,2594,97.48083242059145,0.04852459016393443,Very Cheap
20150326T000000,345000.0,3,1.0,1250,17380,1.0,0,0,4,7,1250,0,1970,0,98072,47.7502,-122.108,1410,18200,16130,16790,19.850402761795166,0.03540983606557377,Very Cheap
20150209T000000,2260000.0,3,3.5,3110,14872,1.0,0,0,3,10,3110,0,2003,0,98004,47.6178,-122.209,3110,12433,11762,9323,151.96342119419043,0.28655737704918033,Cheap
20140616T000000,371025.0,3,2.0,1530,8925,1.0,0,0,3,7,1530,0,1977,0,98011,47.736,-122.199,2040,8856,7395,6816,41.57142857142857,0.03882295081967213,Very Cheap
20140730T000000,355000.0,2,1.0,960,6250,1.0,0,0,3,6,960,0,1916,0,98136,47.5491,-122.386,1350,6250,5290,4900,56.8,0.036721311475409836,Very Cheap
20140909T000000,270000.0,3,1.0,1240,14110,1.0,0,0,4,7,1240,0,1972,0,98058,47.4579,-122.09,2060,19350,12870,17290,19.13536498936924,0.025573770491803278,Very Cheap
20140605T000000,425000.0,4,2.75,2440,15349,2.0,0,1,4,7,2440,0,1957,0,98198,47.4117,-122.333,2280,9250,12909,6970,27.68910026711838,0.04590163934426229,Very Cheap
20150313T000000,364808.0,3,1.75,2320,7875,1.0,0,0,3,8,1620,700,1967,0,98058,47.4524,-122.146,1990,9720,5555,7730,46.324825396825396,0.03800760655737705,Very Cheap
20150113T000000,320000.0,3,2.25,1580,6561,1.0,0,0,3,8,1200,380,1981,0,98058,47.4394,-122.14,1710,7241,4981,5531,48.773052888279224,0.032131147540983604,Very Cheap
20141014T000000,325000.0,4,2.5,2963,5797,2.0,0,0,3,9,2963,0,2006,0,98030,47.3831,-122.185,2665,6119,2834,3454,56.06348111091944,0.03278688524590164,Very Cheap
20140904T000000,350000.0,3,2.25,2470,10290,2.0,0,0,3,8,2230,240,1984,0,98058,47.4459,-122.124,1970,10150,7820,8180,34.01360544217687,0.036065573770491806,Very Cheap
20150219T000000,170000.0,3,1.5,1370,10176,1.0,0,0,3,6,1370,0,1947,0,98168,47.4738,-122.263,1650,10176,8806,8526,16.705974842767297,0.012459016393442624,Very Cheap
20140509T000000,255000.0,2,1.0,960,28717,1.0,0,0,4,6,960,0,1984,0,98070,47.3356,-122.502,1860,28717,27757,26857,8.879757634850437,0.02360655737704918,Very Cheap
20141210T000000,550000.0,3,1.0,1130,7500,1.0,0,0,3,7,880,250,1947,0,98117,47.6973,-122.389,2190,5250,6370,3060,73.33333333333333,0.06229508196721312,Very Cheap
20140703T000000,835000.0,4,4.25,4930,25714,2.0,0,0,3,12,4930,0,2005,0,98092,47.3069,-122.148,3620,23035,20784,19415,32.47258302870032,0.09967213114754099,Very Cheap
20150310T000000,420000.0,3,1.0,1150,5120,1.0,0,0,4,6,800,350,1946,0,98116,47.5588,-122.392,1220,5120,3970,3900,82.03125,0.04524590163934426,Very Cheap
20140514T000000,925000.0,4,2.5,2190,7350,2.5,0,0,5,8,2190,0,1958,0,98040,47.5786,-122.236,1880,7350,5160,5470,125.85034013605443,0.11147540983606558,Cheap
20140606T000000,389250.0,2,1.5,1490,4080,1.0,0,0,3,7,930,560,1956,0,98126,47.5344,-122.381,1320,4080,2590,2760,95.40441176470588,0.04121311475409836,Very Cheap
20150501T000000,748000.0,3,2.5,2600,10183,1.0,0,0,3,8,1300,1300,2004,0,98033,47.6984,-122.201,1860,10401,7583,8541,73.45575959933223,0.08826229508196722,Very Cheap
20150324T000000,284000.0,3,1.75,1530,9600,1.0,0,0,3,7,1200,330,1988,0,98042,47.3594,-122.076,1680,9680,8070,8000,29.583333333333332,0.027409836065573772,Very Cheap
20140611T000000,588000.0,4,2.0,1680,5000,1.0,0,0,3,7,980,700,1950,0,98115,47.6858,-122.286,1680,6000,3320,4320,117.6,0.06727868852459017,Very Cheap
20150320T000000,372500.0,3,1.75,1680,8648,1.0,0,0,4,7,1680,0,1963,0,98133,47.7338,-122.332,1290,8147,6968,6857,43.07354301572618,0.03901639344262295,Very Cheap
20150218T000000,285000.0,4,3.0,1900,7194,2.0,0,0,4,7,1900,0,1988,0,98042,47.3768,-122.117,1690,7194,5294,5504,39.616346955796494,0.02754098360655738,Very Cheap
20140527T000000,360000.0,3,1.0,1570,9467,1.0,0,0,3,7,1570,0,1954,0,98177,47.7683,-122.359,1570,9100,7897,7530,38.02683004119573,0.037377049180327866,Very Cheap
20141118T000000,275000.0,3,1.0,1370,17859,1.0,0,0,4,7,1150,220,1930,0,98024,47.5617,-121.859,1460,47044,16489,45584,15.398398566549078,0.02622950819672131,Very Cheap
20140916T000000,428000.0,2,2.0,1350,4225,1.0,0,0,3,8,1350,0,2003,0,98053,47.7106,-122.03,1660,4225,2875,2565,101.30177514792899,0.04629508196721312,Very Cheap
20150325T000000,847000.0,6,2.5,3010,17864,2.0,0,0,3,8,3010,0,1969,0,98177,47.7209,-122.372,2560,11532,14854,8972,47.41379310344828,0.10124590163934426,Cheap
20140926T000000,316000.0,3,1.0,1010,7838,1.0,0,0,4,6,1010,0,1977,0,98019,47.7422,-121.981,1380,8128,6828,6748,40.31640724674662,0.03160655737704918,Very Cheap
20150505T000000,375000.0,3,2.5,2050,7205,2.0,0,0,3,8,2050,0,2000,0,98003,47.3487,-122.304,2050,7264,5155,5214,52.047189451769604,0.03934426229508197,Very Cheap
20140508T000000,533000.0,3,1.0,1670,4080,1.0,0,0,3,7,1170,500,1967,0,98115,47.6899,-122.321,1560,4080,2410,2520,130.63725490196077,0.060065573770491806,Very Cheap
20140523T000000,556000.0,5,2.5,3840,16905,2.0,0,0,3,11,3840,0,1991,0,98023,47.2996,-122.342,3270,12133,13065,8863,32.8896776101745,0.06308196721311475,Very Cheap
20140915T000000,225000.0,4,2.0,2220,14120,1.0,0,0,3,7,1200,1020,1966,0,98042,47.361,-122.116,1300,9709,11900,8409,15.93484419263456,0.019672131147540985,Very Cheap
20141030T000000,537250.0,4,2.5,2590,9530,1.0,0,0,4,8,1640,950,1978,0,98155,47.7752,-122.285,2710,10970,6940,8260,56.37460650577125,0.06062295081967213,Very Cheap
20141217T000000,255000.0,3,1.0,1180,13650,1.0,0,0,4,7,1180,0,1967,0,98058,47.4551,-122.154,1460,11730,12470,10270,18.681318681318682,0.02360655737704918,Very Cheap
20150409T000000,530000.0,4,2.5,2950,4836,2.0,0,0,3,7,2950,0,2006,0,98059,47.479,-122.129,2120,4750,1886,2630,109.59470636889992,0.05967213114754098,Very Cheap
20150413T000000,5300000.0,6,6.0,7390,24829,2.0,1,4,4,12,5000,2390,1991,0,98040,47.5631,-122.21,4320,24619,17439,20299,213.46006685730396,0.6852459016393443,Very High
20150324T000000,595000.0,3,2.75,2150,31238,2.0,0,0,3,9,2150,0,1996,0,98014,47.6596,-121.96,2650,38307,29088,35657,19.047314168640757,0.06819672131147542,Very Cheap
20140814T000000,548000.0,4,2.0,2100,8880,1.0,0,0,4,7,2100,0,1958,0,98008,47.6115,-122.124,1280,9102,6780,7822,61.711711711711715,0.062032786885245904,Very Cheap
20150320T000000,234975.0,3,1.75,1650,8073,1.0,0,0,3,7,1100,550,1980,0,98092,47.3187,-122.182,1280,8073,6423,6793,29.106280193236714,0.02098032786885246,Very Cheap
20140819T000000,600000.0,3,1.75,1620,1325,2.5,0,0,3,9,1430,190,2005,0,98102,47.6498,-122.321,1750,1572,-295,-178,452.8301886792453,0.06885245901639345,Very Cheap
20150324T000000,432000.0,4,1.0,1750,12528,1.0,0,0,4,7,1750,0,1967,0,98072,47.743,-122.097,1550,14120,10778,12570,34.48275862068966,0.046819672131147544,Very Cheap
20150202T000000,455000.0,3,1.5,1380,6657,2.0,0,0,3,7,1380,0,1986,0,98034,47.7085,-122.217,1420,8187,5277,6767,68.34910620399579,0.049836065573770495,Very Cheap
20141024T000000,279950.0,3,1.75,1510,11234,1.0,0,0,3,7,1210,300,1965,0,98155,47.7571,-122.328,2080,9076,9724,6996,24.91988606017447,0.026878688524590164,Very Cheap
20141020T000000,267500.0,3,1.5,1600,9072,1.0,0,0,4,7,1600,0,1963,0,98030,47.3737,-122.216,1710,8000,7472,6290,29.4863315696649,0.025245901639344263,Very Cheap
20140909T000000,620000.0,4,2.5,1840,220308,2.0,0,0,3,8,1840,0,2000,0,98038,47.4306,-122.049,1890,65340,218468,63450,2.8142418795504476,0.07147540983606557,Very Cheap
20150127T000000,110000.0,2,1.0,830,7590,1.0,0,0,2,6,830,0,1943,0,98166,47.4784,-122.335,980,7590,6760,6610,14.492753623188406,0.0045901639344262295,Very Cheap
20140513T000000,625000.0,3,3.5,1810,1846,2.0,0,0,4,8,1440,370,2009,0,98122,47.607,-122.305,1480,3600,36,2120,338.56988082340195,0.07213114754098361,Very Cheap
20140529T000000,389000.0,2,1.0,910,7000,1.0,0,0,3,7,910,0,1952,0,98115,47.6999,-122.305,1260,7528,6090,6268,55.57142857142857,0.04118032786885246,Very Cheap
20140630T000000,1200000.0,4,2.0,2120,3360,2.0,0,0,3,9,2120,0,1905,0,98112,47.6227,-122.31,2090,3600,1240,1510,357.14285714285717,0.14754098360655737,Cheap
20150424T000000,788500.0,4,2.25,2510,133729,2.0,0,0,4,8,2510,0,1977,0,98027,47.4569,-122.02,2510,69696,131219,67186,5.896252869609434,0.09357377049180328,Very Cheap
20140725T000000,567000.0,5,2.25,2100,6936,1.0,0,0,3,8,1600,500,1974,0,98033,47.6737,-122.169,2100,8661,4836,6561,81.74740484429066,0.06452459016393443,Very Cheap
20150113T000000,515000.0,2,2.25,2690,15000,1.0,0,2,3,8,1870,820,1987,0,98023,47.3361,-122.353,2690,15000,12310,12310,34.333333333333336,0.057704918032786885,Very Cheap
20140902T000000,605000.0,4,2.5,2430,11870,1.0,0,0,5,8,1590,840,1968,0,98155,47.7761,-122.285,2430,9600,9440,7170,50.96882898062342,0.06950819672131148,Very Cheap
20141027T000000,430000.0,4,3.75,2452,4800,2.0,0,0,3,7,2452,0,1936,1994,98055,47.4744,-122.213,1180,4800,2348,3620,89.58333333333333,0.04655737704918033,Very Cheap
20140717T000000,805000.0,2,1.75,1550,6000,1.0,0,1,3,7,1550,0,1920,0,98199,47.6712,-122.409,2360,6000,4450,3640,134.16666666666666,0.09573770491803278,Very Cheap
20150413T000000,567500.0,3,2.5,2080,4556,2.0,0,0,3,8,2080,0,1999,0,98074,47.6036,-122.014,1530,5606,2476,4076,124.56101843722564,0.06459016393442622,Very Cheap
20140605T000000,647500.0,3,1.75,1290,3870,1.0,0,0,5,7,1290,0,1916,0,98144,47.5873,-122.29,2020,5850,2580,3830,167.31266149870802,0.07508196721311475,Very Cheap
20141126T000000,495000.0,2,1.75,1850,2530,2.5,0,0,4,7,1850,0,1903,0,98122,47.6106,-122.31,1500,1795,680,295,195.65217391304347,0.05508196721311476,Very Cheap
20141104T000000,825000.0,4,2.5,3370,5000,2.0,0,0,3,9,3370,0,2006,0,98027,47.541,-121.998,3370,5237,1630,1867,165.0,0.09836065573770492,Very Cheap
20150309T000000,435000.0,4,2.25,2730,7506,2.0,0,0,4,8,2730,0,1987,0,98058,47.4627,-122.152,2390,8015,4776,5625,57.95363709032774,0.04721311475409836,Very Cheap
20140909T000000,445950.0,3,1.75,1300,7800,1.0,0,0,5,7,1300,0,1968,0,98034,47.7321,-122.195,1520,7344,6500,5824,57.17307692307692,0.04864918032786885,Very Cheap
20140603T000000,960000.0,5,2.75,3040,10257,2.0,0,0,3,10,3040,0,1993,0,98006,47.5531,-122.119,2860,9327,7217,6467,93.59461830944721,0.1160655737704918,Cheap
20140917T000000,780000.0,4,3.0,2440,3600,1.5,0,0,5,8,1480,960,1929,0,98103,47.6853,-122.331,1770,4000,1160,2230,216.66666666666666,0.09245901639344262,Very Cheap
20140618T000000,274500.0,3,2.25,1720,9000,1.0,0,0,4,8,1320,400,1969,0,98023,47.3191,-122.383,1930,8000,7280,6070,30.5,0.02616393442622951,Very Cheap
20150429T000000,729953.0,5,3.0,3230,5167,1.5,0,0,4,8,2000,1230,1909,0,98133,47.7053,-122.34,1509,1626,1937,117,141.27211147667893,0.08589547540983607,Very Cheap
20140728T000000,464950.0,3,1.5,1200,890,2.0,0,0,3,8,1030,170,2008,0,98109,47.6384,-122.342,1230,2120,-310,890,522.4157303370787,0.051140983606557375,Very Cheap
20141112T000000,620000.0,4,1.75,2350,18800,1.0,0,2,3,8,2350,0,1959,0,98005,47.5904,-122.177,3050,14640,16450,11590,32.97872340425532,0.07147540983606557,Very Cheap
20150116T000000,735000.0,4,3.5,3100,5600,2.0,0,0,3,9,3100,0,2005,0,98075,47.5968,-121.978,3080,5600,2500,2520,131.25,0.08655737704918033,Very Cheap
20150421T000000,450000.0,4,2.25,2040,9565,1.0,0,0,3,8,1400,640,1959,0,98133,47.7356,-122.335,1890,8580,7525,6690,47.04652378463147,0.04918032786885246,Very Cheap
20140605T000000,450000.0,4,1.0,2000,4676,1.5,0,0,3,7,1250,750,1916,1986,98118,47.5529,-122.268,1140,4676,2676,3536,96.23609923011121,0.04918032786885246,Very Cheap
20140511T000000,842500.0,4,2.5,2160,5298,2.5,0,0,4,9,2160,0,1902,0,98122,47.6106,-122.31,1720,2283,3138,563,159.02227255568138,0.10065573770491804,Cheap
20141008T000000,360000.0,3,2.0,1970,79714,1.0,0,0,3,7,1070,900,1979,0,98058,47.4674,-122.107,1890,36626,77744,34736,4.516145219158491,0.037377049180327866,Very Cheap
20140624T000000,585000.0,3,2.5,2270,100545,2.0,0,0,3,8,2270,0,1998,0,98070,47.4815,-122.47,1277,100545,98275,99268,5.818290317768163,0.06688524590163934,Very Cheap
20140814T000000,461000.0,3,2.25,1850,7923,1.0,0,0,4,7,1150,700,1977,0,98033,47.7011,-122.171,1780,7420,6073,5640,58.18503092263032,0.05062295081967213,Very Cheap
20140818T000000,345000.0,2,1.0,1350,4494,1.0,0,0,3,7,920,430,1949,0,98126,47.5315,-122.38,1470,5225,3144,3755,76.7690253671562,0.03540983606557377,Very Cheap
20140702T000000,1075000.0,3,2.5,3280,10302,1.0,0,0,3,10,1680,1600,1970,0,98115,47.6948,-122.286,1550,6300,7022,4750,104.34867016113375,0.13114754098360656,Cheap
20150227T000000,643000.0,4,2.5,2270,8391,2.0,0,0,3,8,2270,0,1988,0,98029,47.574,-122.013,2420,8391,6121,5971,76.62972232153498,0.07449180327868853,Very Cheap
20140929T000000,690000.0,4,2.5,2820,8307,2.0,0,0,3,9,2820,0,1990,0,98074,47.6253,-122.027,2820,8307,5487,5487,83.06247742867461,0.08065573770491803,Very Cheap
20150401T000000,282000.0,4,1.0,1200,11111,1.5,0,0,3,7,1200,0,1949,0,98155,47.7529,-122.306,1350,9113,9911,7763,25.380253802538025,0.02714754098360656,Very Cheap
20141118T000000,549000.0,3,1.75,2000,6130,1.0,0,0,4,8,1120,880,1951,0,98117,47.6925,-122.388,2140,7150,4130,5010,89.55954323001632,0.06216393442622951,Very Cheap
20150108T000000,815000.0,3,2.0,2310,6000,2.0,0,1,4,9,1560,750,1926,0,98199,47.648,-122.395,2000,6000,3690,4000,135.83333333333334,0.09704918032786886,Very Cheap
20150511T000000,2200000.0,5,4.25,4640,22703,2.0,1,4,5,8,2860,1780,1952,0,98052,47.6393,-122.097,3140,14200,18063,11060,96.90349293044972,0.2786885245901639,Cheap
20150413T000000,700000.0,3,2.25,2330,11424,2.0,0,0,4,8,2330,0,1984,0,98052,47.6386,-122.11,2050,11448,9094,9398,61.27450980392157,0.08196721311475409,Very Cheap
20140714T000000,933399.0,3,2.5,3940,10360,2.0,0,0,3,9,3110,830,1992,0,98052,47.6468,-122.116,2720,11941,6420,9221,90.09642857142858,0.11257691803278688,Cheap
20140703T000000,290000.0,3,1.0,1440,11250,1.0,0,0,3,7,1440,0,1967,0,98055,47.4627,-122.213,2200,11250,9810,9050,25.77777777777778,0.02819672131147541,Very Cheap
20140524T000000,372000.0,4,1.75,1960,9300,1.0,0,0,5,7,1340,620,1979,0,98045,47.4487,-121.772,1500,9752,7340,8252,40.0,0.03895081967213115,Very Cheap
20140819T000000,450000.0,2,1.75,1250,2890,1.0,0,0,4,7,790,460,1920,0,98103,47.6795,-122.353,1500,3225,1640,1725,155.70934256055364,0.04918032786885246,Very Cheap
20140905T000000,303700.0,3,2.5,1981,5700,2.0,0,0,3,8,1981,0,2010,0,98030,47.3668,-122.178,1981,5894,3719,3913,53.280701754385966,0.029993442622950818,Very Cheap
20140724T000000,672000.0,4,2.5,2440,10049,2.0,0,0,4,9,2440,0,1989,0,98029,47.5744,-121.993,2820,8484,7609,5664,66.87232560453776,0.07829508196721312,Very Cheap
20140623T000000,334000.0,4,1.5,1150,9360,1.5,0,0,3,6,1150,0,1970,0,98034,47.7197,-122.173,1480,8155,8210,6675,35.68376068376068,0.0339672131147541,Very Cheap
20140625T000000,260000.0,2,1.0,1120,5650,1.0,0,0,3,6,1120,0,1944,0,98178,47.4979,-122.241,1270,6875,4530,5605,46.017699115044245,0.024262295081967214,Very Cheap
20140731T000000,749950.0,3,1.75,1800,5700,1.0,0,0,4,8,1000,800,1941,0,98119,47.6491,-122.367,1680,5350,3900,3670,131.5701754385965,0.08851803278688525,Very Cheap
20141223T000000,330000.0,4,2.25,2380,122038,2.0,0,0,4,8,2380,0,1984,0,98022,47.2624,-122.015,2030,48000,119658,45970,2.704075779675183,0.03344262295081967,Very Cheap
20141028T000000,830000.0,5,3.0,2920,2808,2.0,0,0,3,8,2140,780,1960,1992,98103,47.654,-122.342,1620,1544,-112,-76,295.5840455840456,0.09901639344262295,Very Cheap
20140708T000000,1131000.0,3,2.25,2790,13791,1.0,0,3,3,8,2790,0,2006,0,98166,47.4389,-122.351,2720,12600,11001,9880,82.01000652599521,0.1384918032786885,Cheap
20140707T000000,320000.0,3,1.0,1560,7552,1.0,0,0,4,6,910,650,1948,0,98155,47.7552,-122.327,1200,8152,5992,6952,42.3728813559322,0.032131147540983604,Very Cheap
20150414T000000,260000.0,2,1.0,1550,15250,1.5,0,0,5,7,1550,0,1920,0,98038,47.407,-122.045,1520,34929,13700,33409,17.049180327868854,0.024262295081967214,Very Cheap
20140626T000000,225000.0,3,2.0,1700,11475,1.0,0,0,5,6,970,730,1945,0,98146,47.4851,-122.338,1560,11475,9775,9915,19.607843137254903,0.019672131147540985,Very Cheap
20140917T000000,279200.0,1,1.0,640,6350,1.0,0,0,3,5,640,0,1939,0,98117,47.6976,-122.359,1270,6350,5710,5080,43.968503937007874,0.02678032786885246,Very Cheap
20140520T000000,520000.0,4,3.5,2680,10000,2.0,0,0,3,8,2040,640,1942,2014,98125,47.726,-122.296,1530,8000,7320,6470,52.0,0.058360655737704915,Very Cheap
20140625T000000,505000.0,3,2.5,1860,8060,2.0,0,0,4,8,1860,0,1987,0,98029,47.5674,-122.017,1850,4661,6200,2811,62.655086848635236,0.05639344262295082,Very Cheap
20140506T000000,234000.0,3,1.75,1490,8366,1.0,0,0,4,7,1010,480,1975,0,98042,47.375,-122.14,1490,7469,6876,5979,27.97035620368157,0.020852459016393442,Very Cheap
20140929T000000,503000.0,4,2.5,2470,5044,2.0,0,0,3,9,2470,0,2005,0,98155,47.7728,-122.271,2790,5583,2574,2793,99.72244250594765,0.056131147540983604,Very Cheap
20140806T000000,606000.0,4,2.25,2390,8858,1.0,0,0,4,8,1740,650,1979,0,98033,47.6925,-122.184,2240,8858,6468,6618,68.41273425152404,0.06963934426229508,Very Cheap
20140723T000000,433500.0,3,1.0,1230,6000,1.0,0,0,4,7,780,450,1937,0,98115,47.6839,-122.281,1570,5000,4770,3430,72.25,0.04701639344262295,Very Cheap
20150123T000000,250000.0,3,1.5,2840,10182,1.0,0,0,3,8,1510,1330,1951,0,98056,47.524,-122.2,2210,9669,7342,7459,24.55313297976822,0.022950819672131147,Very Cheap
20140805T000000,719000.0,3,2.5,2120,9307,2.0,0,0,4,9,2120,0,1984,0,98006,47.5477,-122.141,2290,11524,7187,9234,77.25368002578705,0.08445901639344262,Very Cheap
20141210T000000,381000.0,3,2.0,1770,14400,1.0,0,0,4,8,1770,0,1959,0,98166,47.415,-122.337,1900,14400,12630,12500,26.458333333333332,0.040131147540983604,Very Cheap
20140528T000000,267000.0,3,2.5,2495,4400,2.0,0,0,3,8,2495,0,2007,0,98001,47.288,-122.283,2434,4400,1905,1966,60.68181818181818,0.025180327868852458,Very Cheap
20140522T000000,275000.0,1,0.75,1170,14149,1.0,0,0,5,7,880,290,1962,0,98022,47.2653,-121.91,1130,24513,12979,23383,19.436002544349424,0.02622950819672131,Very Cheap
20140513T000000,651000.0,4,2.5,2740,7140,2.0,0,0,3,8,2740,0,1993,0,98074,47.6334,-122.021,2260,7035,4400,4775,91.17647058823529,0.07554098360655738,Very Cheap
20150204T000000,439000.0,2,1.0,1050,5671,1.0,0,0,3,7,850,200,1949,0,98115,47.6767,-122.286,1850,5243,4621,3393,77.41139128901429,0.04773770491803279,Very Cheap
20150214T000000,325000.0,2,1.0,1130,5070,1.0,0,0,4,7,1130,0,1955,0,98146,47.5141,-122.377,860,6300,3940,5440,64.1025641025641,0.03278688524590164,Very Cheap
20140502T000000,490000.0,2,1.0,880,6380,1.0,0,0,3,7,880,0,1938,1994,98115,47.6924,-122.322,1340,6380,5500,5040,76.8025078369906,0.05442622950819672,Very Cheap
20141007T000000,519900.0,4,2.5,2403,6172,2.0,0,0,3,9,2403,0,1999,0,98028,47.7361,-122.234,2380,6075,3769,3695,84.23525599481529,0.05834754098360656,Very Cheap
20140723T000000,545000.0,4,2.75,3410,35040,2.0,0,0,3,9,3410,0,1984,0,98038,47.4054,-122.03,2580,37263,31630,34683,15.55365296803653,0.06163934426229508,Very Cheap
20140714T000000,1062500.0,4,4.0,5320,20041,2.0,0,0,3,11,5320,0,2003,0,98075,47.5852,-121.966,4640,17268,14721,12628,53.016316551070304,0.12950819672131147,Cheap
20140514T000000,542000.0,4,1.75,1900,8250,1.0,0,0,4,7,950,950,1955,0,98006,47.5765,-122.147,1480,8360,6350,6880,65.6969696969697,0.06124590163934426,Very Cheap
20141208T000000,465000.0,4,1.75,1810,21650,2.0,0,0,4,7,1810,0,1961,0,98077,47.7358,-122.076,2700,29680,19840,26980,21.478060046189377,0.051147540983606556,Very Cheap
20150331T000000,408000.0,2,2.0,1200,3900,1.0,0,0,3,8,1200,0,2006,0,98053,47.72,-122.024,1440,5580,2700,4140,104.61538461538461,0.04367213114754098,Very Cheap
20141204T000000,292000.0,4,2.5,2060,5950,2.0,0,0,3,8,2060,0,2000,0,98030,47.3631,-122.192,2242,6406,3890,4164,49.075630252100844,0.028459016393442622,Very Cheap
20140507T000000,253000.0,3,1.75,1250,10122,1.0,0,0,3,7,1250,0,1994,0,98010,47.3277,-122.001,1980,10175,8872,8195,24.99506026476981,0.023344262295081967,Very Cheap
20140905T000000,280000.0,2,1.0,910,4662,1.0,0,0,5,6,910,0,1942,0,98106,47.5232,-122.354,890,6050,3752,5160,60.06006006006006,0.026885245901639345,Very Cheap
20140604T000000,658588.0,3,2.25,2560,41346,2.0,0,0,3,10,2560,0,1986,0,98027,47.4871,-122.065,3040,35395,38786,32355,15.928699269578678,0.07653613114754099,Very Cheap
20141216T000000,635000.0,4,2.25,1920,8910,1.0,0,0,4,8,1200,720,1969,0,98005,47.5897,-122.156,2250,8800,6990,6550,71.2682379349046,0.07344262295081967,Very Cheap
20141009T000000,439000.0,4,2.25,2240,8300,2.0,0,0,3,8,2240,0,1978,0,98011,47.7746,-122.197,2340,8500,6060,6160,52.89156626506024,0.04773770491803279,Very Cheap
20140806T000000,300000.0,3,2.5,1260,3855,2.0,0,0,3,8,1260,0,1999,0,98059,47.4908,-122.154,1310,3344,2595,2034,77.82101167315174,0.029508196721311476,Very Cheap
20150205T000000,345000.0,3,1.5,1360,13496,1.0,0,0,4,8,1360,0,1960,0,98198,47.4032,-122.314,1900,10538,12136,8638,25.56312981624185,0.03540983606557377,Very Cheap
20140812T000000,283500.0,4,2.25,2100,8050,2.0,0,0,3,8,2100,0,1978,0,98055,47.4391,-122.193,2190,7700,5950,5510,35.21739130434783,0.027344262295081967,Very Cheap
20140924T000000,425000.0,2,1.0,2110,4920,1.5,0,0,3,7,1460,650,1911,0,98103,47.6872,-122.339,1390,4732,2810,3342,86.3821138211382,0.04590163934426229,Very Cheap
20150319T000000,685000.0,3,1.75,2210,8955,1.0,0,1,3,8,1560,650,1974,0,98033,47.6621,-122.189,2210,8976,6745,6766,76.49357900614181,0.08,Very Cheap
20150421T000000,750000.0,3,2.5,2360,12987,2.0,0,0,3,8,2360,0,1983,0,98006,47.5471,-122.149,2480,11665,10627,9185,57.75005775005775,0.08852459016393442,Very Cheap
20150416T000000,245000.0,4,1.5,1280,8000,1.0,0,0,3,6,1280,0,1960,0,98178,47.4949,-122.255,1420,8211,6720,6791,30.625,0.022295081967213116,Very Cheap
20150403T000000,585444.0,6,3.75,2740,6924,1.0,0,2,3,7,1640,1100,1962,0,98144,47.5816,-122.296,1940,6000,4184,4060,84.5528596187175,0.06694347540983607,Very Cheap
20140917T000000,706000.0,4,2.5,2740,7571,2.0,0,0,3,9,2740,0,2009,0,98033,47.6962,-122.179,2880,7203,4831,4323,93.25056135252939,0.08275409836065574,Very Cheap
20140801T000000,445000.0,4,2.0,2630,9099,1.5,0,0,3,7,1830,800,1944,2009,98146,47.5067,-122.361,1430,6825,6469,5395,48.906473238817455,0.04852459016393443,Very Cheap
20150219T000000,241000.0,3,2.0,1650,6000,1.0,0,0,3,7,1650,0,1990,0,98023,47.2904,-122.353,1870,6000,4350,4130,40.166666666666664,0.02177049180327869,Very Cheap
20150503T000000,1175000.0,2,2.5,1770,7155,2.0,1,4,3,8,1770,0,1957,2004,98155,47.7345,-122.285,2410,10476,5385,8066,164.2208245981831,0.14426229508196722,Cheap
20150206T000000,530000.0,3,1.0,1500,5750,1.5,0,0,4,7,1050,450,1927,0,98126,47.5677,-122.376,1500,5060,4250,3560,92.17391304347827,0.05967213114754098,Very Cheap
20150302T000000,350000.0,3,1.5,1430,12199,1.0,0,0,3,7,1130,300,1948,0,98133,47.7352,-122.33,1490,8196,10769,6706,28.690876301336175,0.036065573770491806,Very Cheap
20150415T000000,1700000.0,4,3.75,3190,17186,2.0,1,4,3,10,3190,0,1999,0,98178,47.5115,-122.246,2290,13496,13996,11206,98.91772372861631,0.21311475409836064,Cheap
20150428T000000,389000.0,3,1.0,1280,9630,1.0,0,0,3,7,1280,0,1968,0,98072,47.7677,-122.163,1300,9453,8350,8153,40.39460020768432,0.04118032786885246,Very Cheap
20141105T000000,799000.0,4,2.75,2390,6820,2.0,0,0,4,7,2140,250,1945,0,98115,47.6788,-122.27,1980,6820,4430,4840,117.15542521994135,0.09495081967213115,Very Cheap
20140804T000000,1400000.0,4,2.5,4040,9630,1.0,0,3,4,9,2020,2020,1951,0,98199,47.6408,-122.41,3160,8025,5590,4865,145.3790238836968,0.1737704918032787,Cheap
20141229T000000,340895.0,2,1.0,920,8612,1.0,0,0,5,7,920,0,1947,0,98155,47.734,-122.301,1500,7956,7692,6456,39.583720390153275,0.03487147540983607,Very Cheap
20140505T000000,780000.0,4,2.5,2730,10281,2.0,0,2,3,9,2730,0,1996,0,98074,47.6227,-122.029,2750,7220,7551,4470,75.8681062153487,0.09245901639344262,Very Cheap
20141204T000000,350000.0,2,1.5,1320,73600,1.0,0,0,3,7,1320,0,1993,0,98001,47.2755,-122.271,1320,33600,72280,32280,4.755434782608695,0.036065573770491806,Very Cheap
20150217T000000,470000.0,3,2.5,2620,4874,2.0,0,0,3,7,2620,0,1999,0,98065,47.5328,-121.879,2360,4231,2254,1871,96.43003693065243,0.05180327868852459,Very Cheap
20150128T000000,914600.0,4,3.0,3180,80837,2.0,0,0,3,11,3180,0,1985,0,98072,47.7336,-122.134,3180,38715,77657,35535,11.314125957173077,0.11011147540983607,Cheap
20140923T000000,354000.0,4,2.5,2900,4762,2.0,0,0,3,8,2900,0,2005,0,98042,47.3663,-122.129,2900,5173,1862,2273,74.33851322973541,0.03659016393442623,Very Cheap
20150226T000000,470000.0,5,2.0,1900,6000,1.5,0,0,4,6,1900,0,1920,0,98033,47.6831,-122.186,2110,8400,4100,6290,78.33333333333333,0.05180327868852459,Very Cheap
20140730T000000,715000.0,3,2.0,1760,5400,1.0,0,0,5,7,1160,600,1927,0,98103,47.6558,-122.331,1640,5400,3640,3760,132.40740740740742,0.0839344262295082,Very Cheap
20141007T000000,265000.0,2,1.0,760,4000,1.0,0,0,4,6,760,0,1950,0,98108,47.5466,-122.304,1640,4500,3240,2860,66.25,0.024918032786885248,Very Cheap
20150330T000000,2537000.0,4,3.0,3710,20000,2.0,0,2,5,10,2760,950,1936,0,98105,47.6696,-122.261,3970,20000,16290,16030,126.85,0.32288524590163936,Medium
20140815T000000,640000.0,3,1.0,1530,4944,1.0,0,0,3,7,1530,0,1950,0,98103,47.6857,-122.341,1500,4944,3414,3444,129.44983818770226,0.0740983606557377,Very Cheap
20141120T000000,290000.0,4,1.75,1990,18900,2.0,0,0,4,7,1870,120,1929,0,98168,47.5131,-122.313,1710,12400,16910,10690,15.343915343915343,0.02819672131147541,Very Cheap
20140513T000000,480000.0,5,4.75,3830,35000,1.0,0,0,3,8,2130,1700,1976,0,98077,47.7597,-122.079,2750,36150,31170,33400,13.714285714285714,0.05311475409836065,Very Cheap
20140826T000000,535000.0,3,2.0,2040,5600,1.0,0,1,5,7,1120,920,1954,0,98144,47.5959,-122.293,2120,4958,3560,2838,95.53571428571429,0.06032786885245902,Very Cheap
20140829T000000,907000.0,3,1.75,2170,12220,1.0,0,0,5,8,2170,0,1965,0,98033,47.6537,-122.195,1980,9000,10050,7020,74.22258592471358,0.10911475409836066,Cheap
20140601T000000,459000.0,3,1.75,1620,7330,1.0,0,0,4,7,1090,530,1974,0,98034,47.7148,-122.213,1380,7191,5710,5811,62.6193724420191,0.050360655737704915,Very Cheap
20150424T000000,1355000.0,3,2.5,3600,21399,1.0,0,3,3,9,2310,1290,1950,2007,98008,47.6191,-122.099,2830,17559,17799,14729,63.32071592130473,0.1678688524590164,Cheap
20150305T000000,264950.0,3,1.5,1470,11599,1.0,0,0,3,7,1070,400,1967,0,98030,47.3632,-122.188,1580,9760,10129,8180,22.842486421243212,0.024911475409836067,Very Cheap
20141107T000000,352950.0,3,1.0,1760,3000,1.5,0,0,1,6,1760,0,1900,0,98103,47.6598,-122.348,1320,1266,1240,-54,117.65,0.03645245901639344,Very Cheap
20140822T000000,491500.0,3,2.25,2230,13100,1.0,0,0,4,8,1510,720,1974,0,98006,47.5413,-122.174,2010,10650,10870,8640,37.51908396946565,0.05462295081967213,Very Cheap
20140625T000000,1229000.0,4,3.5,3770,37034,2.0,0,0,3,10,2830,940,1989,0,98007,47.6463,-122.151,3200,36342,33264,33142,33.18572122914079,0.15134426229508197,Cheap
20150406T000000,369500.0,3,1.0,1200,9194,1.0,0,0,4,7,1200,0,1952,0,98155,47.7362,-122.319,1330,8650,7994,7320,40.189253861213835,0.03862295081967213,Very Cheap
20150318T000000,566000.0,3,2.5,2090,6294,2.0,0,0,3,9,2090,0,2004,0,98052,47.686,-122.095,2520,5735,4204,3215,89.92691452176676,0.06439344262295082,Very Cheap
20140825T000000,290000.0,3,2.25,1500,7308,1.0,0,0,4,7,1210,290,1968,0,98055,47.4621,-122.187,1480,7400,5808,5920,39.682539682539684,0.02819672131147541,Very Cheap
20150413T000000,5350000.0,5,5.0,8000,23985,2.0,0,4,3,12,6720,1280,2009,0,98004,47.6232,-122.22,4600,21750,15985,17150,223.0560767146133,0.6918032786885245,Very High
20140522T000000,180000.0,3,1.0,870,5330,1.0,0,0,3,6,870,0,1969,2014,98042,47.369,-122.077,840,5200,4460,4360,33.771106941838646,0.01377049180327869,Very Cheap
20140812T000000,215000.0,2,1.0,1010,6000,1.0,0,0,4,6,1010,0,1944,0,98133,47.771,-122.353,1610,7313,4990,5703,35.833333333333336,0.018360655737704918,Very Cheap
20150212T000000,302000.0,2,1.0,1010,6000,1.0,0,0,4,6,1010,0,1944,0,98133,47.771,-122.353,1610,7313,4990,5703,50.333333333333336,0.02977049180327869,Very Cheap
20150410T000000,352500.0,3,1.75,1860,7881,1.0,0,0,3,7,1160,700,1986,0,98198,47.3855,-122.322,1490,7527,6021,6037,44.727826417967265,0.03639344262295082,Very Cheap
20140626T000000,235867.0,4,2.0,1330,5926,1.0,0,0,4,5,1330,0,1942,0,98056,47.496,-122.19,1150,5485,4596,4335,39.80205872426595,0.021097311475409837,Very Cheap
20140717T000000,500000.0,3,2.25,1760,11946,2.0,0,0,3,8,1760,0,1978,0,98074,47.624,-122.05,2080,12068,10186,9988,41.85501423070484,0.05573770491803279,Very Cheap
20150326T000000,382000.0,3,2.25,1800,4500,2.0,0,0,3,7,1800,0,1995,0,98019,47.7462,-121.98,1760,6589,2700,4829,84.88888888888889,0.040262295081967214,Very Cheap
20150422T000000,515000.0,5,2.5,1690,2402,1.5,0,0,3,7,990,700,1930,0,98117,47.6903,-122.38,1200,4005,712,2805,214.40466278101582,0.057704918032786885,Very Cheap
20150501T000000,250000.0,1,1.0,660,2600,1.0,0,0,3,6,660,0,1919,0,98144,47.5723,-122.304,1560,5445,1940,3885,96.15384615384616,0.022950819672131147,Very Cheap
20140627T000000,672500.0,3,2.25,2400,5300,1.5,0,0,4,7,1250,1150,1939,0,98117,47.6876,-122.384,1540,4800,2900,3260,126.88679245283019,0.07836065573770491,Very Cheap
20141022T000000,755000.0,3,2.25,3020,13031,2.0,0,0,3,9,3020,0,1989,0,98052,47.6897,-122.098,2480,10204,10011,7724,57.9387614150871,0.08918032786885247,Very Cheap
20150320T000000,707500.0,3,1.0,1500,2555,2.0,0,2,3,7,1500,0,1910,0,98109,47.627,-122.353,1820,2555,1055,735,276.9080234833659,0.08295081967213115,Very Cheap
20140826T000000,459000.0,4,2.0,1560,3840,1.0,0,0,4,6,960,600,1924,0,98117,47.6882,-122.365,1560,4800,2280,3240,119.53125,0.050360655737704915,Very Cheap
20150204T000000,140000.0,3,1.0,1090,10620,1.5,0,0,3,7,1090,0,1959,0,98032,47.3748,-122.294,1380,10620,9530,9240,13.182674199623353,0.008524590163934427,Very Cheap
20140811T000000,495000.0,2,1.0,970,4284,1.0,0,0,3,7,970,0,1905,0,98103,47.6667,-122.333,2050,4284,3314,2234,115.54621848739495,0.05508196721311476,Very Cheap
20140513T000000,757000.0,3,3.25,3190,5283,2.0,0,0,3,9,3190,0,2007,0,98029,47.5534,-122.002,2950,5198,2093,2248,143.28979746356237,0.08944262295081967,Very Cheap
20150107T000000,765000.0,3,3.25,3190,5283,2.0,0,0,3,9,3190,0,2007,0,98029,47.5534,-122.002,2950,5198,2093,2248,144.80408858603067,0.09049180327868853,Very Cheap
20140919T000000,359000.0,4,1.5,1890,6052,1.0,0,0,4,7,1890,0,1955,0,98125,47.7055,-122.3,1510,6072,4162,4562,59.31923331130205,0.03724590163934426,Very Cheap
20140605T000000,440000.0,3,1.0,1050,7500,1.0,0,0,3,6,1050,0,1900,0,98136,47.5473,-122.396,1380,7500,6450,6120,58.666666666666664,0.04786885245901639,Very Cheap
20140529T000000,400000.0,4,1.5,1390,7200,1.0,0,0,3,7,1140,250,1965,0,98133,47.7224,-122.332,1630,7702,5810,6072,55.55555555555556,0.04262295081967213,Very Cheap
20150325T000000,652000.0,3,2.0,1700,4080,1.0,0,0,4,7,850,850,1941,0,98117,47.6785,-122.393,1480,5100,2380,3620,159.80392156862746,0.07567213114754098,Very Cheap
20140530T000000,260000.0,3,1.75,1050,5850,1.0,0,0,3,7,1050,0,1980,0,98166,47.4574,-122.358,1220,8880,4800,7660,44.44444444444444,0.024262295081967214,Very Cheap
20150420T000000,1328000.0,5,3.0,3340,10796,1.0,0,2,3,9,2120,1220,1964,1990,98040,47.5421,-122.229,3290,12955,7456,9665,123.00852167469434,0.164327868852459,Cheap
20150220T000000,519500.0,4,2.0,1540,17859,1.0,0,0,3,6,1540,0,1964,0,98027,47.5326,-122.032,1390,9688,16319,8298,29.088974746626352,0.058295081967213114,Very Cheap
20141027T000000,650000.0,3,1.0,1710,5992,1.5,0,0,4,7,1560,150,1928,0,98103,47.6861,-122.354,1240,3001,4282,1761,108.47797062750334,0.07540983606557378,Very Cheap
20150324T000000,280000.0,4,2.25,2100,8075,2.0,0,0,3,8,2100,0,1978,0,98003,47.3251,-122.329,2100,7464,5975,5364,34.6749226006192,0.026885245901639345,Very Cheap
20140910T000000,515000.0,4,1.75,1730,7980,1.0,0,0,4,8,1730,0,1965,0,98007,47.6219,-122.138,2080,8400,6250,6320,64.53634085213032,0.057704918032786885,Very Cheap
20150318T000000,400000.0,3,2.25,1500,2692,2.0,0,0,3,7,1500,0,1986,0,98034,47.7159,-122.203,1470,2418,1192,948,148.5884101040119,0.04262295081967213,Very Cheap
20150414T000000,652100.0,3,2.5,2380,5017,2.0,0,0,3,9,2380,0,2003,0,98074,47.6297,-122.021,2670,6066,2637,3396,129.97807454654176,0.07568524590163934,Very Cheap
20140623T000000,235000.0,6,3.0,2180,7956,2.0,0,0,3,7,2180,0,1980,0,98003,47.3054,-122.305,2214,7684,5776,5470,29.537456008044245,0.02098360655737705,Very Cheap
20150408T000000,701000.0,4,1.5,1840,10080,2.0,0,0,3,8,1840,0,1907,0,98118,47.5575,-122.279,1830,5040,8240,3210,69.5436507936508,0.08209836065573771,Very Cheap
20140624T000000,640000.0,4,2.5,2341,9594,2.0,0,0,3,9,2341,0,1997,0,98052,47.6993,-122.115,2850,9421,7253,6571,66.70835939128622,0.0740983606557377,Very Cheap
20140728T000000,455800.0,3,2.5,1690,4584,2.0,0,0,3,7,1690,0,2002,0,98053,47.6866,-122.043,1600,3164,2894,1564,99.4328097731239,0.049940983606557375,Very Cheap
20141218T000000,504750.0,3,2.5,2490,21937,2.0,0,0,3,8,2490,0,1993,0,98014,47.6442,-121.898,2450,21937,19447,19487,23.009071431827508,0.05636065573770492,Very Cheap
20140711T000000,483000.0,3,3.0,2440,15540,2.0,0,0,3,9,2440,0,1992,0,98074,47.6104,-122.06,2440,15283,13100,12843,31.08108108108108,0.05350819672131148,Very Cheap
20141230T000000,530000.0,3,0.75,920,20412,1.0,1,2,5,6,920,0,1950,0,98070,47.4781,-122.49,1162,54705,19492,53543,25.96511855771115,0.05967213114754098,Very Cheap
20140711T000000,250000.0,2,1.0,1030,8786,1.0,0,0,3,6,1030,0,1956,0,98146,47.4814,-122.341,1480,8121,7756,6641,28.454359207830638,0.022950819672131147,Very Cheap
20140924T000000,229950.0,5,2.75,2000,5885,1.0,0,0,3,7,1260,740,1994,0,98023,47.3155,-122.347,1960,6514,3885,4554,39.07391673746814,0.020321311475409835,Very Cheap
20140723T000000,884744.0,4,3.5,4210,9414,2.0,0,0,3,9,4210,0,2001,0,98074,47.6067,-122.022,3950,8880,5204,4930,93.98172933928193,0.1061959344262295,Cheap
20150401T000000,514000.0,3,1.5,1610,9964,1.0,0,0,3,7,1080,530,1977,0,98052,47.6681,-122.143,1610,9964,8354,8354,51.58570855078282,0.05757377049180328,Very Cheap
20150506T000000,532000.0,3,2.25,1910,35015,1.0,0,0,4,8,1430,480,1977,0,98027,47.4672,-122.006,2340,36680,33105,34340,15.19348850492646,0.059934426229508196,Very Cheap
20140911T000000,423000.0,4,2.5,2660,5539,2.0,0,0,3,8,2660,0,2004,0,98059,47.4981,-122.162,2380,5539,2879,3159,76.36757537461635,0.04563934426229508,Very Cheap
20140826T000000,420000.0,2,1.0,820,4025,1.0,0,2,5,6,820,0,1922,0,98126,47.5649,-122.38,1410,5750,3205,4340,104.34782608695652,0.04524590163934426,Very Cheap
20141110T000000,521000.0,3,1.75,1730,18250,1.0,0,0,3,8,1730,0,1988,0,98011,47.737,-122.201,2180,10027,16520,7847,28.54794520547945,0.058491803278688526,Very Cheap
20150205T000000,577000.0,4,2.25,2360,7490,2.0,0,0,3,8,2360,0,1979,0,98033,47.6988,-122.169,2360,7490,5130,5130,77.03604806408545,0.06583606557377049,Very Cheap
20140929T000000,425000.0,3,1.0,970,8040,1.0,0,0,3,7,970,0,1956,0,98007,47.603,-122.132,1250,7000,7070,5750,52.86069651741293,0.04590163934426229,Very Cheap
20141031T000000,495000.0,4,2.5,2460,4862,2.0,0,0,3,8,2460,0,2004,0,98028,47.7719,-122.235,2900,4895,2402,1995,101.80995475113122,0.05508196721311476,Very Cheap
20141001T000000,340000.0,3,2.5,2690,8577,2.0,0,0,3,9,2690,0,1987,0,98023,47.3026,-122.351,2570,8066,5887,5496,39.640900081613616,0.03475409836065574,Very Cheap
20140923T000000,499950.0,3,3.5,1820,1991,2.0,0,0,3,8,1430,390,2014,0,98144,47.596,-122.298,1550,1460,171,-90,251.1049723756906,0.05573114754098361,Very Cheap
20150316T000000,1218000.0,4,3.0,3470,4750,2.0,0,2,3,9,2370,1100,2014,0,98116,47.5917,-122.386,2420,4761,1280,2341,256.42105263157896,0.1499016393442623,Cheap
20150227T000000,720000.0,4,2.75,3370,7634,1.0,0,2,5,8,2110,1260,1977,0,98056,47.5259,-122.204,2460,7634,4264,5174,94.31490699502227,0.08459016393442623,Very Cheap
20150312T000000,249000.0,3,1.5,1700,8247,1.0,0,0,3,7,1010,690,1970,0,98031,47.4216,-122.174,1440,8400,6547,6960,30.19279738086577,0.02281967213114754,Very Cheap
20140613T000000,206135.0,3,1.0,1340,11070,1.0,0,0,4,7,1340,0,1978,0,98030,47.3527,-122.178,1650,7630,9730,5980,18.62104787714544,0.017198032786885246,Very Cheap
20141006T000000,300000.0,5,2.75,2000,9276,2.0,0,0,4,7,2000,0,1968,0,98055,47.444,-122.19,1240,8270,7276,7030,32.341526520051744,0.029508196721311476,Very Cheap
20150318T000000,612000.0,6,3.0,3840,14040,1.5,0,3,3,8,2460,1380,1949,0,98178,47.506,-122.241,2170,6765,10200,4595,43.58974358974359,0.07042622950819673,Very Cheap
20141106T000000,1102030.0,5,2.5,3890,27311,2.0,0,2,3,10,3890,0,1950,1990,98177,47.7291,-122.363,3160,22641,23421,19481,40.35114056607228,0.13469245901639343,Cheap
20150224T000000,230000.0,4,2.0,1220,9100,1.5,0,0,4,7,1220,0,1970,0,98023,47.2964,-122.376,1160,7700,7880,6540,25.274725274725274,0.020327868852459016,Very Cheap
20150504T000000,850000.0,3,1.0,2280,4600,1.0,0,2,3,8,1250,1030,1936,0,98119,47.6378,-122.372,1910,4000,2320,2090,184.7826086956522,0.10163934426229508,Cheap
20140925T000000,355000.0,4,2.5,2770,7000,1.0,0,0,4,7,1940,830,1979,0,98001,47.3396,-122.256,2140,7684,4230,5544,50.714285714285715,0.036721311475409836,Very Cheap
20140623T000000,442000.0,4,2.5,2520,7253,2.0,0,0,3,9,2520,0,1990,0,98059,47.5148,-122.159,2570,8359,4733,5789,60.94030056528333,0.048131147540983604,Very Cheap
20140626T000000,399000.0,4,3.0,3060,5000,2.0,0,0,3,8,3060,0,2001,0,98042,47.3786,-122.126,3060,5668,1940,2608,79.8,0.042491803278688525,Very Cheap
20141106T000000,360000.0,4,2.5,2390,7115,2.0,0,0,3,9,2390,0,1999,0,98092,47.2593,-122.222,2600,7916,4725,5316,50.597329585382994,0.037377049180327866,Very Cheap
20150213T000000,390000.0,3,1.75,1320,7725,1.0,0,0,3,8,1320,0,1978,0,98058,47.4425,-122.133,2020,7210,6405,5190,50.48543689320388,0.04131147540983607,Very Cheap
20150318T000000,413000.0,5,2.5,2900,8711,1.0,0,0,3,8,1650,1250,1977,0,98011,47.7752,-122.197,2340,8869,5811,6529,47.4113190219263,0.04432786885245902,Very Cheap
20150211T000000,190000.0,2,1.0,700,9500,1.0,0,0,3,6,700,0,1951,0,98118,47.5294,-122.276,1020,5617,8800,4597,20.0,0.015081967213114755,Very Cheap
20141013T000000,432900.0,3,2.5,2210,9226,2.0,0,0,3,8,2210,0,1998,0,98045,47.4849,-121.782,2430,8902,7016,6472,46.92174290049859,0.046937704918032785,Very Cheap
20140528T000000,621138.0,3,2.25,2180,7741,2.0,0,0,3,9,2180,0,1986,0,98074,47.6482,-122.072,2300,8581,5561,6281,80.2400206691642,0.07162465573770492,Very Cheap
20140604T000000,270000.0,3,2.25,2080,4252,1.5,0,0,3,7,1550,530,2003,0,98042,47.4203,-122.157,2080,2275,2172,195,63.49952963311383,0.025573770491803278,Very Cheap
20150109T000000,610000.0,4,2.25,2090,35040,1.0,0,0,3,8,1490,600,1980,0,98075,47.5739,-122.032,2910,21132,32950,18222,17.408675799086758,0.07016393442622951,Very Cheap
20140602T000000,500000.0,3,2.0,1720,5525,1.0,0,2,5,7,960,760,1941,0,98108,47.559,-122.298,1760,5525,3805,3765,90.49773755656109,0.05573770491803279,Very Cheap
20140807T000000,715000.0,4,2.25,2460,40635,1.0,0,0,5,8,2460,0,1968,0,98053,47.6627,-122.032,2250,40635,38175,38385,17.595668758459457,0.0839344262295082,Very Cheap
20140529T000000,264000.0,3,1.5,1470,14821,1.0,0,0,4,7,1470,0,1958,0,98042,47.3658,-122.148,1760,15370,13351,13610,17.812563254841105,0.02478688524590164,Very Cheap
20140828T000000,550000.0,3,1.75,1650,3200,1.5,0,0,3,8,1650,0,1901,0,98102,47.6209,-122.317,1500,2400,1550,900,171.875,0.06229508196721312,Very Cheap
20141015T000000,337000.0,3,2.0,1690,9087,1.0,0,0,3,8,1690,0,1997,0,98042,47.3724,-122.108,2090,8100,7397,6010,37.085946957191595,0.034360655737704915,Very Cheap
20150513T000000,170000.0,3,1.0,970,8710,1.0,0,0,4,6,970,0,1962,0,98198,47.4167,-122.302,1280,11805,7740,10525,19.51779563719862,0.012459016393442624,Very Cheap
20140829T000000,405000.0,4,2.5,2030,9095,1.0,0,0,4,7,1130,900,1972,0,98034,47.7321,-122.185,1940,8000,7065,6060,44.529961517317204,0.043278688524590166,Very Cheap
20140911T000000,775000.0,4,2.5,2540,28563,1.0,0,0,3,10,2540,0,1984,0,98052,47.7185,-122.114,2790,20301,26023,17511,27.133004236249693,0.09180327868852459,Very Cheap
20140825T000000,425000.0,3,2.25,1570,7475,1.0,0,0,4,7,1200,370,1983,0,98034,47.7223,-122.174,1700,7230,5905,5530,56.8561872909699,0.04590163934426229,Very Cheap
20140922T000000,713000.0,5,2.75,2580,9242,2.0,0,2,4,8,1720,860,1967,0,98007,47.5943,-122.133,2240,9316,6662,7076,77.14780350573469,0.08367213114754099,Very Cheap
20141103T000000,555000.0,5,2.5,2090,8712,1.0,0,0,3,8,1420,670,1966,0,98008,47.5968,-122.127,2490,8712,6622,6222,63.705234159779614,0.06295081967213115,Very Cheap
20150506T000000,810000.0,4,2.5,3260,5608,2.0,0,0,3,9,3260,0,2003,0,98029,47.5453,-121.995,3010,5608,2348,2598,144.43651925820257,0.09639344262295083,Very Cheap
20140827T000000,1250000.0,4,3.75,3830,41263,2.0,0,0,4,11,3830,0,1990,0,98077,47.7237,-122.042,5600,56568,37433,50968,30.293483265879843,0.1540983606557377,Cheap
20140624T000000,819000.0,3,3.5,2130,6150,2.0,0,2,5,8,1530,600,1908,0,98199,47.6491,-122.405,2040,5381,4020,3341,133.17073170731706,0.09757377049180328,Very Cheap
20150327T000000,409900.0,3,2.5,1690,1200,2.0,0,0,3,8,1410,280,2013,0,98106,47.5389,-122.367,1690,1760,-490,70,341.5833333333333,0.043921311475409834,Very Cheap
20140630T000000,935000.0,2,2.5,1780,2067,2.0,0,0,5,9,1780,0,1974,0,98004,47.6132,-122.21,2320,2067,287,-253,452.3463957426222,0.11278688524590164,Cheap
20150420T000000,657500.0,4,1.75,1620,7560,1.0,0,3,4,7,1380,240,1947,0,98117,47.6981,-122.4,2170,8650,5940,6480,86.97089947089947,0.07639344262295082,Very Cheap
20150428T000000,900000.0,6,3.75,4210,6105,2.0,0,0,3,9,3280,930,2008,0,98059,47.5211,-122.157,3820,6368,1895,2548,147.42014742014743,0.10819672131147541,Cheap
20150402T000000,932800.0,5,3.25,2980,7095,2.5,0,0,3,9,2980,0,1998,2007,98115,47.6919,-122.294,1670,7140,4115,5470,131.47286821705427,0.1124983606557377,Cheap
20150420T000000,391000.0,3,2.0,1490,9000,1.0,0,0,4,8,1490,0,1977,0,98006,47.5455,-122.184,2190,9000,7510,6810,43.44444444444444,0.04144262295081967,Very Cheap
20141230T000000,420000.0,4,2.5,2110,9825,2.0,0,0,3,8,2110,0,2000,0,98059,47.4979,-122.153,1650,9900,7715,8250,42.74809160305343,0.04524590163934426,Very Cheap
20141124T000000,1300000.0,6,3.5,6563,32670,2.0,0,0,3,10,5153,1410,2002,0,98005,47.6078,-122.157,2610,22651,26107,20041,39.79185797367616,0.16065573770491803,Cheap
20150409T000000,415000.0,3,1.5,1510,16800,1.0,0,0,5,8,1510,0,1956,0,98133,47.751,-122.338,1560,7276,15290,5716,24.702380952380953,0.04459016393442623,Very Cheap
20150225T000000,350000.0,3,1.75,1830,9425,1.0,0,0,3,8,1590,240,1946,0,98146,47.5038,-122.379,1670,8430,7595,6760,37.13527851458886,0.036065573770491806,Very Cheap
20140621T000000,375000.0,2,1.0,1230,1820,2.0,0,0,4,7,830,400,1948,0,98107,47.6684,-122.401,1660,3056,590,1396,206.04395604395606,0.03934426229508197,Very Cheap
20141117T000000,860000.0,3,1.75,2180,14135,1.0,0,2,5,8,1300,880,1947,0,98033,47.673,-122.187,3540,10318,11955,6778,60.84188185355501,0.10295081967213114,Cheap
20140603T000000,495000.0,4,2.25,2220,8872,1.0,0,0,4,8,1110,1110,1961,0,98006,47.5491,-122.17,2220,9106,6652,6886,55.79350766456267,0.05508196721311476,Very Cheap
20150414T000000,250000.0,4,2.25,1730,8400,1.0,0,0,3,7,1730,0,1962,0,98001,47.3386,-122.288,1550,7920,6670,6370,29.761904761904763,0.022950819672131147,Very Cheap
20141013T000000,365000.0,4,2.25,1990,21312,1.0,0,0,4,8,1990,0,1968,0,98058,47.439,-122.144,2400,19210,19322,16810,17.1265015015015,0.0380327868852459,Very Cheap
20140507T000000,503000.0,3,2.75,1540,6760,1.0,0,0,5,7,1210,330,1980,0,98034,47.7163,-122.212,1540,7416,5220,5876,74.40828402366864,0.056131147540983604,Very Cheap
20150325T000000,150000.0,2,1.0,1100,7200,1.0,0,0,4,6,1100,0,1944,0,98058,47.4752,-122.172,1390,7200,6100,5810,20.833333333333332,0.009836065573770493,Very Cheap
20141008T000000,450000.0,4,1.75,1640,1480,1.0,0,0,4,7,820,820,1912,0,98105,47.6684,-122.314,1420,2342,-160,922,304.05405405405406,0.04918032786885246,Very Cheap
20141208T000000,355000.0,4,3.0,2590,7213,2.0,0,0,3,8,2590,0,2001,0,98001,47.2609,-122.289,2550,6800,4623,4250,49.2166920837377,0.036721311475409836,Very Cheap
20141018T000000,245000.0,3,2.0,1450,9333,2.0,0,0,4,7,1450,0,1972,0,98003,47.346,-122.315,1910,7701,7883,5791,26.250937533483338,0.022295081967213116,Very Cheap
20140703T000000,265900.0,3,2.0,1180,7793,1.0,0,0,4,7,1180,0,1992,0,98031,47.4053,-122.181,1720,7793,6613,6073,34.12036442961632,0.025036065573770493,Very Cheap
20141125T000000,299000.0,4,2.5,1820,7575,1.0,0,0,3,7,1220,600,1975,0,98058,47.4339,-122.167,1840,7650,5755,5810,39.47194719471947,0.02937704918032787,Very Cheap
20150409T000000,957500.0,4,2.25,2360,11523,2.0,0,0,4,10,2360,0,1968,0,98040,47.5318,-122.224,2850,11362,9163,8512,83.09468020480777,0.11573770491803279,Cheap
20140908T000000,343000.0,3,1.0,1120,7250,1.0,0,0,4,7,1120,0,1972,0,98034,47.7143,-122.211,1340,7302,6130,5962,47.310344827586206,0.035147540983606555,Very Cheap
20141027T000000,307500.0,3,2.25,1646,7364,2.0,0,0,3,7,1646,0,1994,0,98038,47.3646,-122.037,1975,9161,5718,7186,41.75719717544813,0.030491803278688525,Very Cheap
20150105T000000,937500.0,5,3.75,4210,14599,2.0,0,3,3,10,4210,0,2004,0,98065,47.5364,-121.858,3950,13591,10389,9641,64.21672717309404,0.11311475409836065,Cheap
20140509T000000,610000.0,3,3.0,2480,45302,1.0,0,0,4,8,1620,860,1976,0,98077,47.7591,-122.073,1260,14100,42822,12840,13.465189174870867,0.07016393442622951,Very Cheap
20140917T000000,720000.0,3,1.5,1590,7080,1.0,0,2,3,8,1310,280,1952,0,98136,47.5244,-122.386,2080,7200,5490,5120,101.69491525423729,0.08459016393442623,Very Cheap
20141016T000000,610000.0,4,2.0,2130,2620,1.5,0,0,5,7,1650,480,1919,0,98103,47.6515,-122.346,1330,2719,490,1389,232.82442748091603,0.07016393442622951,Very Cheap
20150331T000000,434500.0,3,1.75,1650,7965,1.0,0,0,4,7,1650,0,1967,0,98034,47.7335,-122.193,1560,7350,6315,5790,54.551161330822346,0.04714754098360656,Very Cheap
20150512T000000,602500.0,2,2.5,3090,47044,1.0,0,0,4,10,2250,840,1979,0,98058,47.4291,-122.177,1860,62829,43954,60969,12.807159255165377,0.06918032786885246,Very Cheap
20141118T000000,607010.0,4,2.5,2180,4000,2.0,0,0,3,8,1700,480,2002,0,98118,47.5553,-122.269,2180,4000,1820,1820,151.7525,0.06977180327868852,Very Cheap
20150204T000000,610000.0,3,1.0,1800,5750,1.0,0,0,3,7,1040,760,1947,0,98117,47.686,-122.395,1320,5625,3950,4305,106.08695652173913,0.07016393442622951,Very Cheap
20140919T000000,828500.0,4,2.5,3720,35000,2.0,0,0,3,10,3720,0,1983,0,98072,47.7582,-122.13,3720,35000,31280,31280,23.67142857142857,0.09881967213114753,Very Cheap
20140707T000000,199990.0,3,1.0,1100,8560,1.0,0,0,3,6,1100,0,1961,0,98023,47.329,-122.338,1120,8470,7460,7350,23.363317757009344,0.016392131147540984,Very Cheap
20150401T000000,294000.0,3,1.75,1530,9362,1.0,0,0,3,7,1530,0,1987,0,98038,47.3643,-122.049,1480,8125,7832,6645,31.40354625080111,0.028721311475409836,Very Cheap
20140612T000000,789500.0,4,2.5,3010,6100,2.0,0,0,3,9,3010,0,2005,0,98052,47.6647,-122.08,2890,5176,3090,2286,129.4262295081967,0.09370491803278688,Very Cheap
20150212T000000,797000.0,3,3.5,3500,9473,2.0,0,0,3,10,3500,0,2008,0,98075,47.5807,-121.972,3510,7833,5973,4323,84.13385411168585,0.09468852459016393,Very Cheap
20140818T000000,539950.0,5,3.0,3100,5250,2.0,0,0,3,7,3100,0,2006,0,98065,47.5369,-121.888,2460,5250,2150,2790,102.84761904761905,0.06097704918032787,Very Cheap
20150323T000000,284950.0,4,1.5,2000,6778,1.0,0,0,4,7,1170,830,1962,0,98198,47.3708,-122.311,1940,7531,4778,5591,42.040424904101506,0.027534426229508198,Very Cheap
20150429T000000,776500.0,4,1.5,2290,10372,1.0,0,0,3,7,1510,780,1965,1987,98033,47.6888,-122.199,1900,8109,8082,6209,74.86502121095256,0.092,Very Cheap
20150424T000000,525000.0,4,2.5,2400,10070,1.0,0,0,3,7,1510,890,1967,0,98034,47.7104,-122.24,2030,9964,7670,7934,52.13505461767627,0.05901639344262295,Very Cheap
20150425T000000,303000.0,3,2.5,1850,4957,2.0,0,0,3,8,1850,0,1999,0,98092,47.3311,-122.17,2400,6367,3107,3967,61.12568085535606,0.029901639344262296,Very Cheap
20150310T000000,722080.0,3,3.25,3680,7650,2.0,0,0,3,9,2340,1340,1988,0,98074,47.6272,-122.033,2280,8515,3970,6235,94.38954248366014,0.08486295081967213,Very Cheap
20140627T000000,140000.0,3,1.0,1060,7473,1.0,0,0,3,7,1060,0,1959,0,98198,47.3699,-122.309,1320,7912,6413,6592,18.73410946072528,0.008524590163934427,Very Cheap
20150401T000000,235000.0,3,1.0,1060,7473,1.0,0,0,3,7,1060,0,1959,0,98198,47.3699,-122.309,1320,7912,6413,6592,31.446540880503143,0.02098360655737705,Very Cheap
20141120T000000,440000.0,3,1.0,1610,5500,1.5,0,0,3,7,1610,0,1903,1973,98103,47.698,-122.351,1200,5701,3890,4501,80.0,0.04786885245901639,Very Cheap
20140718T000000,605000.0,3,1.75,2330,6000,1.5,0,0,4,7,1630,700,1940,0,98126,47.5765,-122.378,1600,4000,3670,2400,100.83333333333333,0.06950819672131148,Very Cheap
20140602T000000,380000.0,2,1.0,1210,4800,1.0,0,0,3,8,1060,150,1950,0,98108,47.5625,-122.316,1380,4800,3590,3420,79.16666666666667,0.04,Very Cheap
20140625T000000,352000.0,4,1.0,1530,8890,1.0,0,0,3,7,980,550,1925,0,98106,47.5308,-122.35,1100,5203,7360,4103,39.595050618672666,0.03632786885245902,Very Cheap
20150413T000000,420000.0,4,2.25,2270,12000,1.0,0,0,4,7,1360,910,1979,0,98072,47.7559,-122.148,2500,10120,9730,7620,35.0,0.04524590163934426,Very Cheap
20150430T000000,1175000.0,4,2.0,2590,7220,2.0,0,2,4,10,2590,0,1930,0,98199,47.647,-122.41,2530,6380,4630,3850,162.74238227146813,0.14426229508196722,Cheap
20141022T000000,1375000.0,3,1.5,1850,10572,1.0,0,0,4,8,1850,0,1953,0,98004,47.6194,-122.208,3030,12752,8722,9722,130.06053726825576,0.17049180327868851,Cheap
20140926T000000,300000.0,3,1.5,1500,14750,1.5,0,0,4,6,1500,0,1933,0,98168,47.495,-122.318,1270,15100,13250,13830,20.338983050847457,0.029508196721311476,Very Cheap
20141112T000000,1150000.0,4,3.25,4740,49091,2.0,0,0,3,11,4740,0,1990,0,98053,47.6624,-122.071,4800,42387,44351,37587,23.425882544661956,0.14098360655737704,Cheap
20141013T000000,453500.0,2,1.5,1710,4189,1.0,0,1,5,7,1160,550,1951,0,98136,47.5286,-122.383,1530,5608,2479,4078,108.2597278586775,0.04963934426229508,Very Cheap
20141014T000000,443500.0,3,2.0,1920,7598,1.0,0,0,4,8,1920,0,1972,0,98177,47.7735,-122.363,2220,7598,5678,5378,58.37062384838115,0.048327868852459016,Very Cheap
20150326T000000,332000.0,2,1.0,1150,8138,1.0,0,0,3,7,1150,0,1954,0,98155,47.737,-122.325,1300,8139,6988,6839,40.796264438436964,0.033704918032786885,Very Cheap
20150327T000000,655000.0,3,2.5,2320,4721,2.0,0,0,3,8,2320,0,2004,0,98075,47.591,-122.017,2250,4356,2401,2106,138.74179199322177,0.0760655737704918,Very Cheap
20140903T000000,475000.0,4,1.0,1420,6000,1.5,0,0,3,7,1420,0,1950,0,98115,47.6844,-122.302,1420,6180,4580,4760,79.16666666666667,0.05245901639344262,Very Cheap
20141024T000000,372500.0,3,1.75,1550,12956,1.0,0,0,3,7,1210,340,1988,0,98045,47.4711,-121.752,1630,15360,11406,13730,28.751157764742203,0.03901639344262295,Very Cheap
20140527T000000,1050000.0,4,2.5,2920,7200,1.0,0,3,3,8,1470,1450,1921,2006,98144,47.5947,-122.288,3210,6825,4280,3615,145.83333333333334,0.12786885245901639,Cheap
20140603T000000,500000.0,3,1.75,1620,4200,1.0,0,0,5,7,830,790,1945,0,98115,47.6743,-122.285,1580,5000,2580,3420,119.04761904761905,0.05573770491803279,Very Cheap
20140528T000000,900000.0,6,2.75,2300,24773,1.5,0,0,4,9,2300,0,1950,1985,98040,47.5833,-122.242,2720,11740,22473,9020,36.32987526742825,0.10819672131147541,Cheap
20140604T000000,327500.0,3,1.0,1070,7140,1.0,0,0,3,7,1070,0,1989,0,98118,47.5427,-122.288,1390,2374,6070,984,45.86834733893557,0.033114754098360656,Very Cheap
20150406T000000,390000.0,3,1.75,1790,7123,1.0,0,0,3,7,1790,0,1913,1995,98019,47.7429,-121.981,1660,8128,5333,6468,54.75221114698863,0.04131147540983607,Very Cheap
20150113T000000,451101.0,2,1.5,1510,1962,2.0,0,0,4,8,1510,0,1985,0,98007,47.6214,-122.153,1510,2182,452,672,229.91896024464833,0.04932472131147541,Very Cheap
20141014T000000,455000.0,4,1.0,1340,5800,1.5,0,2,3,7,1340,0,1914,0,98116,47.5658,-122.389,1900,5800,4460,3900,78.44827586206897,0.049836065573770495,Very Cheap
20140701T000000,650000.0,4,2.5,3350,46748,2.0,0,0,3,10,3350,0,2004,0,98010,47.3432,-122.025,3350,39683,43398,36333,13.904338153503893,0.07540983606557378,Very Cheap
20140806T000000,895000.0,3,2.5,2500,7746,2.0,0,0,4,10,1910,590,1993,0,98112,47.6393,-122.311,2480,5099,5246,2619,115.5435063258456,0.10754098360655738,Cheap
20150326T000000,800000.0,4,2.25,2350,10664,1.0,0,1,2,7,1510,840,1952,0,98040,47.5743,-122.238,2350,10140,8314,7790,75.01875468867217,0.09508196721311475,Very Cheap
20141113T000000,703770.0,4,2.25,2550,12918,2.0,0,0,3,9,2550,0,1987,0,98006,47.5623,-122.109,2550,11036,10368,8486,54.47979563399907,0.08246163934426229,Very Cheap
20140814T000000,249950.0,3,1.75,1320,10454,1.0,0,0,4,7,1320,0,1968,0,98002,47.2844,-122.216,1680,10183,9134,8503,23.90950832217333,0.022944262295081966,Very Cheap
20150428T000000,512000.0,2,2.0,1270,3881,1.0,0,0,4,6,610,660,1926,0,98105,47.6694,-122.298,1370,5000,2611,3630,131.92476165936614,0.05731147540983607,Very Cheap
20150506T000000,780000.0,5,2.5,3480,74052,1.0,0,0,4,8,1980,1500,1972,0,98027,47.4961,-122.063,2610,65775,70572,63165,10.533138875384864,0.09245901639344262,Very Cheap
20140716T000000,336000.0,3,2.25,2820,11625,2.0,0,0,3,8,2820,0,1986,0,98092,47.2621,-122.218,2290,8488,8805,6198,28.903225806451612,0.03422950819672131,Very Cheap
20140822T000000,285000.0,3,2.0,2110,6900,1.5,0,0,5,6,1220,890,1955,0,98178,47.504,-122.26,1350,7683,4790,6333,41.30434782608695,0.02754098360655738,Very Cheap
20141021T000000,229900.0,3,1.75,1100,7224,1.0,0,0,3,7,1100,0,1981,0,98032,47.3717,-122.277,1700,8447,6124,6747,31.824473975636767,0.020314754098360657,Very Cheap
20150415T000000,667500.0,4,3.0,1920,4000,1.5,0,0,4,8,1540,380,1931,0,98116,47.5718,-122.385,1660,4000,2080,2340,166.875,0.07770491803278688,Very Cheap
20140620T000000,378000.0,4,2.5,1890,12236,1.0,0,0,3,7,1230,660,1978,0,98045,47.4491,-121.78,1390,11360,10346,9970,30.892448512585812,0.03973770491803279,Very Cheap
20140905T000000,454000.0,3,2.5,2530,43733,2.0,0,0,3,8,1530,1000,1991,0,98045,47.46,-121.708,1730,43548,41203,41818,10.38117668579791,0.049704918032786885,Very Cheap
20140508T000000,537500.0,4,2.5,2550,4630,2.0,0,0,3,7,2550,0,2005,0,98075,47.5928,-122.004,2550,5151,2080,2601,116.09071274298056,0.060655737704918035,Very Cheap
20140903T000000,425000.0,3,1.0,1550,4160,1.5,0,0,4,6,1550,0,1926,0,98118,47.5387,-122.265,1590,5000,2610,3410,102.16346153846153,0.04590163934426229,Very Cheap
20141124T000000,290000.0,3,2.0,1760,6600,1.0,0,0,3,7,1760,0,1998,0,98030,47.3836,-122.184,2590,6600,4840,4010,43.93939393939394,0.02819672131147541,Very Cheap
20140701T000000,349500.0,3,2.0,1270,3600,1.0,0,0,3,7,1270,0,1963,0,98122,47.6099,-122.297,1660,3600,2330,1940,97.08333333333333,0.036,Very Cheap
20141202T000000,370000.0,3,2.75,1250,1655,2.0,0,0,3,7,830,420,2006,0,98136,47.5554,-122.382,1520,3001,405,1481,223.56495468277944,0.038688524590163934,Very Cheap
20150309T000000,549500.0,3,1.75,1620,8438,1.0,0,0,4,8,1620,0,1961,0,98125,47.703,-122.281,2040,9450,6818,7410,65.12206684048353,0.06222950819672131,Very Cheap
20150130T000000,245000.0,2,1.0,710,6322,1.0,0,0,3,6,710,0,1942,0,98126,47.5165,-122.376,740,6720,5612,5980,38.75355900031636,0.022295081967213116,Very Cheap
20140729T000000,208000.0,3,1.75,1070,7200,1.0,0,0,3,7,1070,0,1994,0,98010,47.3134,-122.023,1480,7200,6130,5720,28.88888888888889,0.01744262295081967,Very Cheap
20141220T000000,248000.0,4,2.25,2320,8760,1.0,0,0,4,8,1160,1160,1966,0,98032,47.3627,-122.285,1970,8690,6440,6720,28.310502283105023,0.022688524590163933,Very Cheap
20141003T000000,610000.0,4,3.25,5450,37058,1.5,0,0,5,9,5450,0,1984,0,98042,47.351,-122.087,2800,35716,31608,32916,16.460683253278646,0.07016393442622951,Very Cheap
20150401T000000,550000.0,4,2.5,1670,5116,2.0,0,0,3,8,1670,0,1999,0,98155,47.7667,-122.33,1910,7210,3446,5300,107.50586395621579,0.06229508196721312,Very Cheap
20141028T000000,750000.0,3,2.75,3010,206910,2.0,0,2,3,10,3010,0,2001,0,98045,47.4881,-121.721,1580,120675,203900,119095,3.6247643903146294,0.08852459016393442,Very Cheap
20141030T000000,192000.0,2,1.75,1340,7380,1.0,0,0,3,6,1340,0,1940,0,98055,47.4785,-122.229,1980,9600,6040,7620,26.016260162601625,0.015344262295081967,Very Cheap
20150218T000000,169317.0,2,1.0,790,4000,1.0,0,2,3,7,790,0,1908,0,98112,47.6248,-122.301,1700,4200,3210,2500,42.32925,0.012369442622950819,Very Cheap
20140701T000000,1198000.0,4,3.5,3400,3850,2.5,0,0,3,10,2790,610,2008,0,98112,47.6258,-122.302,2030,4000,450,1970,311.16883116883116,0.14727868852459017,Cheap
20141029T000000,880000.0,2,1.0,1530,6350,1.5,0,0,4,7,1530,0,1923,0,98112,47.6325,-122.303,2640,6350,4820,3710,138.58267716535434,0.10557377049180328,Cheap
20140617T000000,210000.0,1,1.0,930,7129,1.0,0,0,3,6,930,0,1948,0,98133,47.7234,-122.333,1300,8075,6199,6775,29.45714686491794,0.017704918032786884,Very Cheap
20150107T000000,180500.0,3,1.5,1540,9800,1.0,0,0,3,7,1010,530,1973,0,98058,47.4676,-122.184,1600,8250,8260,6650,18.418367346938776,0.013836065573770491,Very Cheap
20140728T000000,540000.0,4,2.0,1990,29078,2.0,0,0,3,9,1990,0,1984,0,98074,47.6471,-122.057,2310,28353,27088,26043,18.570740766215007,0.06098360655737705,Very Cheap
20140624T000000,520000.0,3,1.75,2300,35722,1.0,0,0,3,9,2300,0,1984,0,98072,47.7455,-122.112,2600,34798,33422,32198,14.55685571916466,0.058360655737704915,Very Cheap
20140626T000000,177500.0,3,1.5,1220,6000,1.0,0,0,3,7,1220,0,1968,0,98055,47.4904,-122.222,1660,6000,4780,4340,29.583333333333332,0.013442622950819673,Very Cheap
20141105T000000,415000.0,3,1.75,2380,5650,1.0,0,2,4,8,1190,1190,1956,0,98118,47.5119,-122.255,2350,6554,3270,4204,73.45132743362832,0.04459016393442623,Very Cheap
20140909T000000,495000.0,4,2.5,2020,7200,1.0,0,0,5,7,1010,1010,1968,0,98034,47.7289,-122.201,1620,7275,5180,5655,68.75,0.05508196721311476,Very Cheap
20150304T000000,325000.0,3,2.25,1890,9646,1.0,0,0,3,8,1890,0,1966,0,98168,47.4838,-122.299,1580,9488,7756,7908,33.692722371967655,0.03278688524590164,Very Cheap
20150220T000000,440000.0,2,1.75,1330,4903,1.0,0,0,3,7,1330,0,1985,0,98052,47.6819,-122.161,1470,2735,3573,1265,89.74097491331838,0.04786885245901639,Very Cheap
20140723T000000,411000.0,3,1.75,1490,9844,1.0,0,0,4,7,1190,300,1959,0,98155,47.7626,-122.297,1840,10150,8354,8310,41.75132060138155,0.044065573770491806,Very Cheap
20141029T000000,810000.0,5,3.5,3550,9600,2.0,0,0,3,9,2550,1000,1998,0,98118,47.5484,-122.269,2030,9600,6050,7570,84.375,0.09639344262295083,Very Cheap
20141016T000000,561750.0,5,1.75,2040,8996,1.0,0,2,4,7,1020,1020,1962,0,98008,47.588,-122.118,1950,8270,6956,6320,62.444419742107605,0.06383606557377049,Very Cheap
20140722T000000,835100.0,4,2.5,2380,12573,1.0,0,0,4,9,2380,0,1963,0,98005,47.5984,-122.176,2900,10700,10193,7800,66.42010657758689,0.09968524590163934,Very Cheap
20140901T000000,450000.0,3,2.25,1780,9969,1.0,0,0,3,8,1450,330,1985,0,98034,47.7286,-122.168,1950,7974,8189,6024,45.13993379476377,0.04918032786885246,Very Cheap
20141104T000000,238000.0,3,2.5,1650,2807,2.0,0,0,3,7,1650,0,2004,0,98055,47.4328,-122.196,1460,1875,1157,415,84.78802992518703,0.02137704918032787,Very Cheap
20141205T000000,299000.0,3,1.0,1510,142803,1.0,0,0,3,7,1510,0,1974,0,98001,47.3192,-122.287,1330,46609,141293,45279,2.093793547754599,0.02937704918032787,Very Cheap
20141017T000000,570000.0,2,1.0,1100,6240,1.0,0,0,4,7,1100,0,1941,0,98199,47.6446,-122.403,1250,6240,5140,4990,91.34615384615384,0.06491803278688525,Very Cheap
20140604T000000,340000.0,3,1.75,2190,12626,2.0,0,0,4,8,2190,0,1978,0,98042,47.3845,-122.154,3110,14592,10436,11482,26.928560114050374,0.03475409836065574,Very Cheap
20150429T000000,450000.0,2,1.75,1760,2275,1.5,0,0,3,6,1040,720,1912,0,98116,47.5803,-122.393,1380,3750,515,2370,197.8021978021978,0.04918032786885246,Very Cheap
20140910T000000,272750.0,4,1.5,1800,8786,1.0,0,0,3,7,1330,470,1966,0,98146,47.4982,-122.345,1780,8664,6986,6884,31.043705895743226,0.025934426229508197,Very Cheap
20140724T000000,520000.0,4,2.0,2000,6380,2.0,0,0,4,6,1860,140,1949,0,98115,47.6956,-122.303,1600,6380,4380,4780,81.50470219435736,0.058360655737704915,Very Cheap
20140618T000000,284950.0,3,1.0,990,10723,1.0,0,0,5,7,990,0,1960,0,98059,47.4887,-122.133,1460,10723,9733,9263,26.573720041033294,0.027534426229508198,Very Cheap
20150424T000000,255000.0,2,1.5,1480,9660,1.0,0,0,3,7,1480,0,1949,0,98188,47.4577,-122.289,1990,9660,8180,7670,26.39751552795031,0.02360655737704918,Very Cheap
20141112T000000,231500.0,2,1.0,1200,9488,1.0,0,0,5,7,1200,0,1941,0,98168,47.4832,-122.299,1200,9488,8288,8288,24.399241146711635,0.020524590163934427,Very Cheap
20141210T000000,415000.0,1,2.0,3000,204732,2.5,0,2,3,8,3000,0,1979,0,98014,47.6331,-121.945,2330,213008,201732,210678,2.02704022820077,0.04459016393442623,Very Cheap
20150105T000000,330000.0,4,2.5,3504,6000,2.0,0,0,3,7,3504,0,2006,0,98001,47.3012,-122.285,2790,5231,2496,2441,55.0,0.03344262295081967,Very Cheap
20140528T000000,365000.0,3,1.5,1300,12240,1.0,0,0,3,7,1300,0,1963,0,98028,47.737,-122.243,2040,9326,10940,7286,29.820261437908496,0.0380327868852459,Very Cheap
20141007T000000,425000.0,4,2.0,1330,9188,1.5,0,0,3,7,1330,0,1928,2004,98198,47.401,-122.319,1770,10419,7858,8649,46.255986068785376,0.04590163934426229,Very Cheap
20141104T000000,400000.0,4,1.75,1850,6480,1.0,0,0,4,7,1120,730,1958,0,98108,47.5525,-122.313,1610,5040,4630,3430,61.72839506172839,0.04262295081967213,Very Cheap
20140922T000000,335000.0,4,2.5,2240,9701,2.0,0,0,3,9,2240,0,1989,0,98023,47.3086,-122.392,2240,9410,7461,7170,34.532522420369034,0.03409836065573771,Very Cheap
20140930T000000,342000.0,3,3.0,1260,1251,2.0,0,0,3,7,1040,220,2003,0,98144,47.5943,-122.296,1780,7715,-9,5935,273.38129496402877,0.03501639344262295,Very Cheap
20141204T000000,490000.0,8,5.0,2800,2580,2.0,0,0,3,8,1880,920,1997,0,98122,47.6086,-122.303,1800,2580,-220,780,189.92248062015503,0.05442622950819672,Very Cheap
20141106T000000,331500.0,4,1.75,1820,14319,1.0,0,0,4,7,1820,0,1969,0,98059,47.4757,-122.148,1440,10018,12499,8578,23.151058034778966,0.03363934426229508,Very Cheap
20150330T000000,960000.0,3,2.5,1730,4102,3.0,1,4,3,8,1730,0,1996,0,98074,47.645,-122.084,2340,16994,2372,14654,234.0321794246709,0.1160655737704918,Cheap
20140709T000000,720500.0,4,2.5,3350,35298,2.0,0,0,4,9,3350,0,1985,0,98053,47.6506,-122.036,2620,35604,31948,32984,20.41192135531758,0.08465573770491804,Very Cheap
20140820T000000,830000.0,3,2.5,3370,6550,2.0,0,2,4,8,2840,530,1912,2001,98126,47.5442,-122.38,1500,6550,3180,5050,126.7175572519084,0.09901639344262295,Very Cheap
20140523T000000,662990.0,3,1.75,1240,3600,1.5,0,0,5,7,1240,0,1926,0,98116,47.5797,-122.405,1660,3600,2360,1940,184.1638888888889,0.07711344262295082,Very Cheap
20150330T000000,220000.0,4,2.0,2340,10507,1.5,0,0,4,6,2340,0,1959,0,98030,47.3578,-122.178,990,10507,8167,9517,20.938422004378033,0.01901639344262295,Very Cheap
20150108T000000,349950.0,5,2.0,1880,4179,1.0,0,0,3,7,940,940,1952,2000,98118,47.5536,-122.283,1350,5150,2299,3800,83.74012921751616,0.036059016393442625,Very Cheap
20150107T000000,550000.0,3,2.0,1810,2159,1.0,0,0,3,7,1010,800,1922,0,98109,47.6273,-122.345,1810,2159,349,349,254.74756831866605,0.06229508196721312,Very Cheap
20140915T000000,396000.0,3,1.75,2340,5668,1.0,0,0,4,6,1200,1140,1941,0,98106,47.5588,-122.364,860,4800,3328,3940,69.86591390261115,0.0420983606557377,Very Cheap
20150116T000000,635000.0,4,1.5,2820,4000,2.0,0,0,3,7,2820,0,1911,0,98103,47.6638,-122.348,1470,1627,1180,157,158.75,0.07344262295081967,Very Cheap
20141118T000000,293000.0,3,1.0,1020,7650,1.0,0,0,3,7,1020,0,1940,0,98133,47.7198,-122.352,1440,7650,6630,6210,38.30065359477124,0.02859016393442623,Very Cheap
20140711T000000,339000.0,3,2.25,2090,10120,1.0,0,0,4,7,1290,800,1979,0,98058,47.4654,-122.174,1820,7983,8030,6163,33.49802371541502,0.03462295081967213,Very Cheap
20140630T000000,285000.0,4,2.25,1830,8734,2.0,0,0,4,7,1830,0,1991,0,98030,47.3679,-122.179,1870,7212,6904,5342,32.6310968628349,0.02754098360655738,Very Cheap
20140710T000000,775000.0,6,2.75,2980,5000,1.5,0,0,3,7,2480,500,1916,0,98103,47.6684,-122.331,1470,5000,2020,3530,155.0,0.09180327868852459,Very Cheap
20140626T000000,224000.0,4,1.5,1600,9289,1.0,0,0,4,7,1600,0,1959,0,98002,47.3107,-122.212,1540,9918,7689,8378,24.114544084400904,0.01954098360655738,Very Cheap
20141029T000000,2250000.0,4,3.5,4440,8125,2.0,0,3,5,10,3140,1300,1922,0,98144,47.5744,-122.283,3990,8505,3685,4515,276.9230769230769,0.28524590163934427,Cheap
20140701T000000,165050.0,3,1.0,1200,8514,1.0,0,0,3,7,1200,0,1959,0,98022,47.2043,-122.008,1210,8985,7314,7775,19.385717641531595,0.011809836065573771,Very Cheap
20141027T000000,275000.0,3,1.25,1230,4500,1.5,0,0,4,7,1230,0,1913,0,98118,47.5301,-122.271,1310,5000,3270,3690,61.111111111111114,0.02622950819672131,Very Cheap
20140911T000000,445000.0,5,3.0,2930,5500,1.0,0,0,3,7,1750,1180,1951,0,98118,47.5572,-122.281,1400,5500,2570,4100,80.9090909090909,0.04852459016393443,Very Cheap
20150401T000000,510000.0,3,2.25,2370,38639,1.0,0,0,3,8,1930,440,1978,0,98077,47.771,-122.099,2900,37452,36269,34552,13.199099355573384,0.057049180327868855,Very Cheap
20140610T000000,1230000.0,4,2.5,3040,7000,2.0,0,0,3,9,3040,0,2001,0,98040,47.5934,-122.244,2320,17511,3960,15191,175.71428571428572,0.15147540983606558,Cheap
20141029T000000,390000.0,3,1.5,1610,13500,1.0,0,0,3,7,1060,550,1970,0,98155,47.7674,-122.31,1540,11479,11890,9939,28.88888888888889,0.04131147540983607,Very Cheap
20140513T000000,460000.0,3,2.25,2350,10450,1.0,0,0,3,8,1390,960,1977,0,98028,47.7433,-122.259,2250,10450,8100,8200,44.01913875598086,0.050491803278688525,Very Cheap
20150327T000000,700000.0,3,1.75,2000,14733,1.0,0,0,4,8,2000,0,1958,0,98005,47.6001,-122.178,2620,14733,12733,12113,47.5123871580805,0.08196721311475409,Very Cheap
20140622T000000,874150.0,4,3.5,3530,14406,2.0,0,1,3,10,2570,960,1987,0,98034,47.7073,-122.244,3170,15181,10876,12011,60.679577953630435,0.10480655737704918,Cheap
20140731T000000,470000.0,3,2.25,2220,9800,2.0,0,0,3,8,2220,0,1987,0,98155,47.7635,-122.286,2420,10232,7580,7812,47.95918367346939,0.05180327868852459,Very Cheap
20140521T000000,374000.0,3,1.75,2000,9416,1.0,0,0,4,6,2000,0,1961,0,98033,47.697,-122.175,1440,9555,7416,8115,39.7196261682243,0.03921311475409836,Very Cheap
20140717T000000,510000.0,2,1.75,1210,131115,1.5,0,0,5,7,1210,0,1950,0,98070,47.4599,-122.45,2020,185565,129905,183545,3.8897151355680126,0.057049180327868855,Very Cheap
20140711T000000,467000.0,2,2.5,1140,1181,3.0,0,0,3,8,1140,0,2007,0,98107,47.6713,-122.383,1220,1189,41,-31,395.42760372565624,0.05140983606557377,Very Cheap
20140616T000000,576000.0,4,2.5,2440,28405,2.0,0,0,3,8,2440,0,2002,0,98028,47.7386,-122.238,2480,11429,25965,8949,20.278120049287097,0.06570491803278689,Very Cheap
20140530T000000,196440.0,3,2.0,1560,7352,1.0,0,0,3,6,1560,0,1992,0,98001,47.2804,-122.251,1120,7950,5792,6830,26.719260065288356,0.01592655737704918,Very Cheap
20141231T000000,825000.0,4,2.5,3210,18901,2.0,0,0,3,10,3210,0,1993,0,98077,47.709,-122.073,3330,18901,15691,15571,43.64848420718481,0.09836065573770492,Very Cheap
20150408T000000,281000.0,2,1.0,930,2600,1.0,0,0,3,7,930,0,1981,0,98034,47.7242,-122.161,1370,3488,1670,2118,108.07692307692308,0.027016393442622952,Very Cheap
20140812T000000,326000.0,3,2.5,1782,1577,3.0,0,0,3,7,1782,0,2000,0,98125,47.7114,-122.301,1550,1744,-205,194,206.72162333544705,0.032918032786885244,Very Cheap
20150410T000000,340000.0,3,1.75,1740,46580,1.0,0,0,4,7,1740,0,1980,0,98010,47.3583,-121.927,1576,54685,44840,53109,7.299270072992701,0.03475409836065574,Very Cheap
20141208T000000,440000.0,5,1.75,3690,36036,1.0,0,0,3,9,1890,1800,1985,0,98042,47.3473,-122.085,2680,44131,32346,41451,12.21001221001221,0.04786885245901639,Very Cheap
20140522T000000,749000.0,4,2.5,2930,18199,2.0,0,0,3,9,2930,0,1998,0,98075,47.5937,-122.047,2930,33976,15269,31046,41.15610747843288,0.08839344262295082,Very Cheap
20150227T000000,340000.0,4,1.0,1230,8316,1.5,0,0,3,7,1230,0,1963,0,98034,47.7269,-122.24,1490,8316,7086,6826,40.88504088504089,0.03475409836065574,Very Cheap
20140506T000000,561000.0,3,2.0,2000,7000,2.0,0,0,3,7,2000,0,1916,1986,98136,47.5452,-122.393,1840,7000,5000,5160,80.14285714285714,0.06373770491803278,Very Cheap
20141031T000000,270000.0,3,2.25,1520,7930,1.0,0,0,3,7,1160,360,1988,0,98038,47.3605,-122.049,1530,7930,6410,6400,34.04791929382093,0.025573770491803278,Very Cheap
20140620T000000,600000.0,2,1.0,1040,3600,1.0,0,0,4,7,1040,0,1919,1980,98112,47.619,-122.311,2250,4800,2560,2550,166.66666666666666,0.06885245901639345,Very Cheap
20140505T000000,219900.0,4,1.5,1120,5427,1.0,0,0,3,6,1120,0,1969,2014,98042,47.3628,-122.087,1150,5304,4307,4154,40.51962410171365,0.01900327868852459,Very Cheap
20141208T000000,617000.0,3,1.75,3020,360241,2.0,0,0,3,8,3020,0,1992,0,98092,47.2662,-122.088,1890,209959,357221,208069,1.712742303069334,0.07108196721311476,Very Cheap
20140904T000000,469000.0,3,2.25,1820,8446,2.0,0,0,3,8,1820,0,1978,0,98034,47.7208,-122.236,1850,8437,6626,6587,55.529244612834475,0.05167213114754098,Very Cheap
20140811T000000,229000.0,3,1.0,1370,56628,1.0,0,0,3,7,1370,0,1942,0,98003,47.3058,-122.306,1768,8702,55258,6934,4.043935862117681,0.02019672131147541,Very Cheap
20150422T000000,1265000.0,4,3.0,3130,2646,2.5,0,0,5,9,2290,840,1906,0,98102,47.6272,-122.316,2920,4500,-484,1580,478.0801209372638,0.1560655737704918,Cheap
20140805T000000,365000.0,3,1.5,1640,8301,1.0,0,0,3,7,1290,350,1958,0,98155,47.7443,-122.327,1640,8955,6661,7315,43.97060595109023,0.0380327868852459,Very Cheap
20141212T000000,429000.0,4,2.5,2650,9301,2.0,0,0,3,9,2650,0,2001,0,98001,47.3477,-122.271,2730,8688,6651,5958,46.12407268035695,0.04642622950819672,Very Cheap
20141208T000000,550000.0,4,2.5,2850,6809,2.0,0,0,3,9,2850,0,2003,0,98019,47.7353,-121.973,2820,7500,3959,4680,80.77544426494346,0.06229508196721312,Very Cheap
20150116T000000,453000.0,3,2.5,1820,16300,1.0,0,0,4,7,1220,600,1955,0,98166,47.4582,-122.365,1870,16300,14480,14430,27.791411042944784,0.04957377049180328,Very Cheap
20140617T000000,187500.0,3,1.5,1180,7000,1.0,0,0,4,7,1180,0,1977,0,98023,47.2966,-122.374,1180,7370,5820,6190,26.785714285714285,0.014754098360655738,Very Cheap
20150415T000000,520500.0,6,2.5,1880,14350,1.0,0,0,5,7,1640,240,1955,0,98133,47.7556,-122.352,1510,9840,12470,8330,36.271777003484324,0.058426229508196724,Very Cheap
20150204T000000,300000.0,3,1.75,1280,12776,1.0,0,0,4,7,1280,0,1977,0,98031,47.4212,-122.199,1680,11704,11496,10024,23.4815278647464,0.029508196721311476,Very Cheap
20140516T000000,799000.0,4,3.25,3120,5000,2.0,0,0,3,9,2370,750,2005,0,98115,47.69,-122.299,2520,6000,1880,3480,159.8,0.09495081967213115,Very Cheap
20150203T000000,338000.0,3,2.5,2470,4948,2.0,0,0,3,8,2470,0,2003,0,98038,47.3438,-122.039,2500,4993,2478,2493,68.31042845594179,0.034491803278688525,Very Cheap
20140514T000000,800000.0,3,1.0,1700,4400,1.5,0,0,4,8,1700,0,1906,0,98122,47.612,-122.292,1610,4180,2700,2570,181.8181818181818,0.09508196721311475,Very Cheap
20140825T000000,360000.0,2,2.0,1180,3200,1.0,0,1,4,6,590,590,1945,0,98136,47.5275,-122.383,1350,4000,2020,2650,112.5,0.037377049180327866,Very Cheap
20140728T000000,442500.0,6,2.5,2800,10490,1.0,0,0,3,7,1400,1400,1968,0,98177,47.7735,-122.378,2290,8716,7690,6426,42.183031458531936,0.04819672131147541,Very Cheap
20150327T000000,700000.0,4,1.0,1300,1651359,1.0,0,3,4,6,1300,0,1920,0,98022,47.2313,-122.023,2560,425581,1650059,423021,0.42389329031421996,0.08196721311475409,Very Cheap
20140508T000000,830000.0,5,3.0,3040,9601,1.0,0,0,5,9,1970,1070,1968,0,98040,47.5562,-122.22,3180,12390,6561,9210,86.44932819497969,0.09901639344262295,Very Cheap
20141118T000000,360400.0,3,2.5,1630,11592,2.0,0,0,3,8,1630,0,1987,0,98011,47.7574,-122.228,1700,8850,9962,7150,31.090407177363698,0.03742950819672131,Very Cheap
20141121T000000,345000.0,3,1.0,1340,9339,1.0,0,0,5,7,1340,0,1960,0,98056,47.5407,-122.177,1310,9350,7999,8040,36.9418567298426,0.03540983606557377,Very Cheap
20140909T000000,300000.0,3,1.75,1830,51836,1.0,0,0,4,7,1430,400,1966,0,98059,47.4774,-122.098,1320,51400,50006,50080,5.787483602129794,0.029508196721311476,Very Cheap
20140904T000000,350000.0,3,1.0,1240,10800,1.0,0,0,5,7,1240,0,1959,0,98056,47.5233,-122.185,1810,10800,9560,8990,32.407407407407405,0.036065573770491806,Very Cheap
20141008T000000,368000.0,4,2.0,2500,36900,1.0,0,0,3,7,1540,960,1972,0,98038,47.3708,-122.049,1960,36900,34400,34940,9.97289972899729,0.03842622950819672,Very Cheap
20140623T000000,264000.0,3,1.75,1760,7482,1.0,0,0,4,8,1760,0,1966,0,98023,47.3129,-122.369,2000,7500,5722,5500,35.28468323977546,0.02478688524590164,Very Cheap
20150312T000000,435000.0,3,2.0,2660,16677,1.0,0,0,3,9,2210,450,1990,0,98038,47.3689,-122.055,2660,11355,14017,8695,26.083828026623493,0.04721311475409836,Very Cheap
20140604T000000,200000.0,3,1.5,2060,15837,1.5,0,0,3,6,2060,0,1903,0,98055,47.4819,-122.223,2190,8549,13777,6359,12.628654416871882,0.01639344262295082,Very Cheap
20140514T000000,620000.0,5,2.5,2540,3832,2.0,0,0,5,8,1760,780,1929,0,98117,47.6848,-122.398,2000,5289,1292,3289,161.79540709812107,0.07147540983606557,Very Cheap
20141120T000000,1679000.0,5,4.25,4830,11466,2.0,0,0,3,10,3720,1110,2014,0,98040,47.5774,-122.222,2180,11017,6636,8837,146.43293214721785,0.2103606557377049,Cheap
20141209T000000,337000.0,3,1.75,1400,6000,1.0,0,0,4,7,700,700,1919,0,98108,47.5283,-122.321,1030,6000,4600,4970,56.166666666666664,0.034360655737704915,Very Cheap
20141001T000000,1928000.0,4,3.25,4280,20296,2.0,0,0,4,11,4280,0,1984,0,98004,47.6377,-122.212,3420,16351,16016,12931,94.99408750492708,0.24301639344262296,Cheap
20140528T000000,544500.0,4,2.5,2230,10414,1.0,0,0,5,7,1450,780,1974,0,98075,47.5816,-122.0,1960,10240,8184,8280,52.285385058574995,0.06157377049180328,Very Cheap
20150102T000000,252000.0,1,1.0,680,1638,1.0,0,4,1,6,680,0,1910,1992,98116,47.5832,-122.399,1010,3621,958,2611,153.84615384615384,0.02321311475409836,Very Cheap
20140605T000000,445000.0,4,2.5,2340,3784,2.0,0,0,3,8,2340,0,2008,0,98106,47.535,-122.348,1730,4000,1444,2270,117.60042283298097,0.04852459016393443,Very Cheap
20140725T000000,379500.0,3,2.25,2070,14196,2.0,0,0,3,7,2070,0,1989,0,98059,47.4617,-122.07,1550,13860,12126,12310,26.73288250211327,0.0399344262295082,Very Cheap
20150311T000000,189950.0,4,2.0,1910,4225,1.0,0,0,4,6,910,1000,1919,0,98001,47.3084,-122.234,1060,4800,2315,3740,44.9585798816568,0.015075409836065574,Very Cheap
20140602T000000,469000.0,3,1.0,950,4250,1.5,0,0,5,6,950,0,1948,0,98122,47.609,-122.307,2130,5120,3300,2990,110.3529411764706,0.05167213114754098,Very Cheap
20140611T000000,600000.0,5,2.75,2910,53898,1.0,0,0,5,7,1510,1400,1979,0,98077,47.7201,-122.062,3210,216928,50988,213718,11.132138483802738,0.06885245901639345,Very Cheap
20141107T000000,785000.0,3,2.5,2930,33981,2.0,0,2,3,9,2930,0,2000,0,98059,47.5151,-122.12,3720,35230,31051,31510,23.10114475736441,0.09311475409836066,Very Cheap
20150210T000000,372000.0,4,2.75,2610,8967,2.0,0,0,4,8,2610,0,1990,0,98042,47.3747,-122.124,2390,7852,6357,5462,41.485446637671465,0.03895081967213115,Very Cheap
20150225T000000,445000.0,5,3.0,3880,7180,2.0,0,0,3,7,3880,0,2004,0,98056,47.4797,-122.179,2160,4793,3300,2633,61.977715877437326,0.04852459016393443,Very Cheap
20141014T000000,508000.0,4,2.25,3320,53392,2.0,0,0,4,8,2000,1320,1986,0,98027,47.4724,-122.014,3230,43129,50072,39899,9.514534012586155,0.05678688524590164,Very Cheap
20150318T000000,780000.0,5,1.5,1940,4800,2.0,0,0,3,8,1940,0,1905,0,98103,47.6845,-122.332,1750,4800,2860,3050,162.5,0.09245901639344262,Very Cheap
20150316T000000,541100.0,4,2.25,2510,9800,2.0,0,0,3,9,2510,0,1978,0,98072,47.753,-122.145,2440,11000,7290,8560,55.214285714285715,0.061127868852459015,Very Cheap
20150105T000000,729000.0,4,2.5,2660,5608,2.0,0,0,3,9,2660,0,2003,0,98029,47.5449,-121.995,3010,5608,2948,2598,129.9928673323823,0.08577049180327868,Very Cheap
20141104T000000,397000.0,3,2.0,1710,134489,1.0,0,2,5,7,1710,0,1952,0,98022,47.2207,-121.984,1700,63823,132779,62123,2.951914282952509,0.04222950819672131,Very Cheap
20140515T000000,451555.0,2,1.0,1320,4520,1.0,0,1,3,6,1320,0,1912,1971,98116,47.5655,-122.394,1420,4560,3200,3140,99.90154867256638,0.049384262295081964,Very Cheap
20140630T000000,300000.0,2,1.0,960,8153,1.0,0,0,3,6,960,0,1947,0,98155,47.7341,-122.3,1160,8199,7193,7039,36.796271311173804,0.029508196721311476,Very Cheap
20150407T000000,416000.0,3,2.5,1790,11542,1.0,0,0,5,7,1190,600,1969,0,98059,47.5124,-122.16,1790,9131,9752,7341,36.04228036735401,0.044721311475409836,Very Cheap
20141021T000000,490000.0,2,1.0,950,3060,1.0,0,0,3,6,810,140,1925,0,98105,47.6698,-122.323,1510,3780,2110,2270,160.13071895424838,0.05442622950819672,Very Cheap
20150129T000000,480000.0,6,3.75,2940,5054,2.0,0,0,3,7,2940,0,1942,2003,98146,47.5122,-122.385,1530,5320,2114,3790,94.97427779976256,0.05311475409836065,Very Cheap
20150203T000000,368000.0,2,2.0,930,1662,1.0,0,0,3,7,670,260,2002,0,98199,47.6518,-122.4,1780,2343,732,563,221.41997593261132,0.03842622950819672,Very Cheap
20140918T000000,1038000.0,3,2.5,4570,10615,2.0,0,0,3,12,4570,0,1991,0,98027,47.5533,-122.097,3860,11576,6045,7716,97.78615167216203,0.12629508196721312,Cheap
20150120T000000,545000.0,3,2.5,2370,9000,1.0,0,3,4,8,1570,800,1952,0,98146,47.4922,-122.365,2120,9500,6630,7380,60.55555555555556,0.06163934426229508,Very Cheap
20150323T000000,850000.0,5,2.75,3430,15119,2.0,0,0,3,10,3430,0,1998,0,98075,47.5678,-122.032,3430,12045,11689,8615,56.220649513856735,0.10163934426229508,Cheap
20141204T000000,550000.0,4,3.5,3540,4750,2.0,0,0,3,10,3540,0,2003,0,98055,47.473,-122.193,3310,5655,1210,2345,115.78947368421052,0.06229508196721312,Very Cheap
20150217T000000,600000.0,3,2.25,2240,9314,2.0,0,0,3,9,2240,0,1984,0,98074,47.6216,-122.032,2240,9314,7074,7074,64.41915396177797,0.06885245901639345,Very Cheap
20140827T000000,535000.0,4,2.5,2710,12138,1.0,0,0,3,8,1700,1010,1968,0,98155,47.7657,-122.29,2390,10052,9428,7662,44.07645411105619,0.06032786885245902,Very Cheap
20140520T000000,599950.0,3,2.5,2660,4975,2.0,0,0,3,8,2660,0,2014,0,98118,47.5487,-122.272,1840,6653,2315,4813,120.5929648241206,0.06884590163934426,Very Cheap
20140718T000000,531000.0,5,2.75,2540,5022,1.0,0,0,4,8,1540,1000,1955,0,98108,47.5593,-122.3,2510,5182,2482,2672,105.73476702508961,0.05980327868852459,Very Cheap
20140605T000000,530000.0,4,2.25,2210,7665,2.0,0,0,4,8,2210,0,1968,0,98006,47.5424,-122.168,1960,7903,5455,5943,69.14546640574038,0.05967213114754098,Very Cheap
20140625T000000,597326.0,4,4.0,3570,8250,2.0,0,0,3,10,2860,710,2015,0,98040,47.5784,-122.226,2230,10000,4680,7770,72.40315151515152,0.06850177049180328,Very Cheap
20150429T000000,805000.0,4,2.5,3450,33460,2.0,0,0,3,9,3450,0,1997,0,98077,47.7673,-122.1,2820,35250,30010,32430,24.05857740585774,0.09573770491803278,Very Cheap
20141027T000000,390000.0,4,1.75,2330,8364,1.0,0,0,4,8,2330,0,1968,0,98058,47.4568,-122.146,2180,9630,6034,7450,46.62840746054519,0.04131147540983607,Very Cheap
20140519T000000,487250.0,4,2.0,1690,3250,1.5,0,0,3,7,1550,140,1901,0,98103,47.6637,-122.346,1620,3250,1560,1630,149.92307692307693,0.0540655737704918,Very Cheap
20140909T000000,301000.0,3,1.5,1030,8414,1.0,0,0,4,7,1030,0,1967,0,98155,47.7654,-122.297,1750,8414,7384,6664,35.77371048252912,0.029639344262295083,Very Cheap
20150205T000000,1175000.0,5,2.75,2560,5618,1.5,0,2,3,8,2220,340,1923,0,98109,47.6416,-122.355,2740,4000,3058,1260,209.1491634033464,0.14426229508196722,Cheap
20140926T000000,299000.0,4,2.5,1950,3000,2.0,0,0,3,7,1950,0,2002,0,98178,47.4977,-122.226,1170,6000,1050,4830,99.66666666666667,0.02937704918032787,Very Cheap
20140903T000000,2350000.0,4,2.25,4370,22863,2.5,0,3,4,10,3670,700,1907,1994,98033,47.6878,-122.215,2980,22863,18493,19883,102.7861610462319,0.2983606557377049,Cheap
20141014T000000,400000.0,4,2.5,2350,3904,2.5,0,0,3,7,2350,0,1999,0,98106,47.5305,-122.351,1120,4000,1554,2880,102.45901639344262,0.04262295081967213,Very Cheap
20141201T000000,467500.0,4,2.5,3160,7210,1.0,0,0,4,7,1880,1280,1969,0,98034,47.7368,-122.183,2070,7560,4050,5490,64.84049930651872,0.05147540983606557,Very Cheap
20150220T000000,305000.0,4,2.5,2430,9103,2.0,0,0,3,8,2430,0,1990,0,98023,47.2939,-122.368,2260,8090,6673,5830,33.50543776776887,0.03016393442622951,Very Cheap
20140505T000000,210000.0,3,1.0,1340,306848,1.0,0,0,3,5,1340,0,1953,0,98019,47.7534,-121.912,1800,128066,305508,126266,0.6843779330482845,0.017704918032786884,Very Cheap
20150428T000000,300000.0,3,1.0,1010,10168,1.0,0,0,3,6,1010,0,1979,0,98014,47.6453,-121.912,1180,10318,9158,9138,29.50432730133753,0.029508196721311476,Very Cheap
20140908T000000,327500.0,3,2.25,1770,8755,1.0,0,0,3,8,1330,440,1981,0,98058,47.4464,-122.123,1910,8710,6985,6800,37.40719588806396,0.033114754098360656,Very Cheap
20140805T000000,269000.0,3,2.0,1210,7136,1.0,0,0,3,7,1210,0,2003,0,98031,47.3996,-122.203,1210,5765,5926,4555,37.696188340807176,0.02544262295081967,Very Cheap
20150331T000000,975000.0,4,3.25,3330,17533,1.0,0,2,3,9,1750,1580,1969,0,98033,47.652,-122.2,3340,12798,14203,9458,55.60942223236183,0.1180327868852459,Cheap
20141210T000000,355000.0,3,1.0,1240,5400,1.0,0,0,4,7,1060,180,1940,0,98133,47.7115,-122.355,1429,5400,4160,3971,65.74074074074075,0.036721311475409836,Very Cheap
20140508T000000,712000.0,3,1.0,1250,4620,1.5,0,0,4,7,1150,100,1900,0,98103,47.651,-122.341,1900,4400,3370,2500,154.1125541125541,0.08354098360655737,Very Cheap
20140614T000000,883000.0,4,2.5,2960,41656,2.0,0,0,3,10,2960,0,1985,0,98072,47.7319,-122.132,3900,35104,38696,31204,21.197426541194545,0.1059672131147541,Cheap
20140815T000000,190000.0,2,1.0,840,12252,1.0,0,0,3,6,840,0,1994,0,98010,47.3069,-122.013,1010,11876,11412,10866,15.507672216780934,0.015081967213114755,Very Cheap
20150406T000000,443000.0,3,1.75,1530,8028,1.0,0,0,3,7,1200,330,1967,0,98177,47.7768,-122.361,1530,8028,6498,6498,55.181863477827605,0.048262295081967214,Very Cheap
20140509T000000,920000.0,4,3.0,3750,11025,2.0,0,0,3,10,3750,0,1976,0,98074,47.6367,-122.059,2930,12835,7275,9905,83.44671201814059,0.11081967213114755,Cheap
20141222T000000,285000.0,4,2.25,2150,8250,1.0,0,0,4,7,1240,910,1978,0,98023,47.3045,-122.378,2050,7875,6100,5825,34.54545454545455,0.02754098360655738,Very Cheap
20150423T000000,901000.0,4,3.25,1560,4080,1.0,0,0,3,7,1560,0,1916,0,98126,47.5347,-122.38,1370,4080,2520,2710,220.83333333333334,0.10832786885245901,Cheap
20150305T000000,552500.0,3,1.75,2040,5775,1.0,0,0,3,7,1410,630,1958,0,98199,47.6592,-122.393,1360,4400,3735,3040,95.67099567099567,0.06262295081967213,Very Cheap
20150303T000000,256000.0,2,1.0,860,5000,1.0,0,0,3,6,860,0,1915,1945,98146,47.5133,-122.356,1220,5000,4140,3780,51.2,0.023737704918032787,Very Cheap
20140512T000000,341000.0,3,1.5,1720,7119,1.5,0,0,4,7,1720,0,1952,0,98155,47.7535,-122.314,1590,7616,5399,6026,47.899985953083295,0.03488524590163934,Very Cheap
20150326T000000,279000.0,4,2.25,2090,8941,2.0,0,0,3,7,2090,0,1975,0,98058,47.4332,-122.167,1890,7946,6851,6056,31.20456324795884,0.02675409836065574,Very Cheap
20140726T000000,686000.0,4,2.25,2130,10650,2.0,0,0,4,8,2130,0,1977,0,98006,47.5567,-122.159,3380,10050,8520,6670,64.4131455399061,0.0801311475409836,Very Cheap
20140523T000000,225000.0,2,1.0,1300,11867,1.5,0,0,4,6,1300,0,1975,0,98010,47.3221,-121.903,820,11867,10567,11047,18.96014156905705,0.019672131147540985,Very Cheap
20140627T000000,215500.0,2,1.75,1220,15600,1.0,0,0,3,6,1220,0,1972,0,98001,47.2853,-122.265,1510,17818,14380,16308,13.814102564102564,0.01842622950819672,Very Cheap
20150414T000000,950000.0,4,3.0,2420,4800,1.5,0,0,3,7,1520,900,1919,0,98119,47.6453,-122.358,1090,3800,2380,2710,197.91666666666666,0.11475409836065574,Cheap
20141105T000000,503000.0,4,2.5,2940,156988,2.0,0,2,3,9,1870,1070,1996,0,98014,47.6214,-121.946,2940,71002,154048,68062,3.2040665528575434,0.056131147540983604,Very Cheap
20150122T000000,780000.0,3,2.5,2610,7567,2.0,0,0,3,9,2610,0,1997,0,98052,47.6654,-122.137,2610,8458,4957,5848,103.0791595083917,0.09245901639344262,Very Cheap
20150223T000000,212000.0,4,2.0,1880,7500,1.0,0,0,5,6,980,900,1946,0,98178,47.495,-122.266,1670,14350,5620,12680,28.266666666666666,0.017967213114754098,Very Cheap
20140729T000000,580000.0,4,2.75,2330,6703,1.5,0,0,3,7,1710,620,1983,0,98177,47.7066,-122.359,2060,7500,4373,5440,86.52842011039833,0.06622950819672131,Very Cheap
20141111T000000,465000.0,4,2.5,2200,3141,2.0,0,0,3,7,2060,140,1994,0,98144,47.5726,-122.305,1660,3175,941,1515,148.0420248328558,0.051147540983606556,Very Cheap
20141119T000000,206000.0,4,2.0,1720,7560,1.0,0,0,3,7,1720,0,1959,0,98001,47.2845,-122.25,1750,7988,5840,6238,27.24867724867725,0.017180327868852457,Very Cheap
20150223T000000,615000.0,3,2.5,2250,10171,2.0,0,0,3,9,2250,0,1987,0,98006,47.5613,-122.11,2440,13390,7921,10950,60.46603087208731,0.07081967213114754,Very Cheap
20140719T000000,519000.0,4,1.0,1640,6305,1.5,0,0,5,6,1640,0,1907,0,98118,47.5563,-122.28,1590,4816,4665,3226,82.3156225218081,0.05822950819672131,Very Cheap
20150423T000000,1135000.0,4,3.25,4130,11444,2.0,0,0,3,11,4130,0,2001,0,98059,47.5208,-122.15,3720,11431,7314,7711,99.17860887801469,0.13901639344262295,Cheap
20140808T000000,330000.0,5,2.5,2600,3839,2.0,0,0,3,7,2600,0,2005,0,98058,47.4324,-122.145,2180,4800,1239,2620,85.95988538681948,0.03344262295081967,Very Cheap
20150506T000000,240000.0,4,1.5,1920,7973,1.0,0,0,3,8,1920,0,1955,0,98178,47.4961,-122.235,2020,8840,6053,6820,30.101592875956353,0.021639344262295083,Very Cheap
20141107T000000,574000.0,3,2.0,2060,7000,1.0,0,0,4,9,2060,0,1988,0,98029,47.5644,-122.012,2110,7000,4940,4890,82.0,0.06544262295081968,Very Cheap
20141103T000000,930000.0,4,4.25,5710,24663,2.0,0,0,3,11,5710,0,2007,0,98092,47.3065,-122.158,4060,23847,18953,19787,37.7083079917285,0.1121311475409836,Cheap
20140714T000000,850000.0,4,3.0,2720,183823,2.0,0,0,3,8,2720,0,1975,2007,98053,47.6749,-122.002,2140,173804,181103,171664,4.6240133171583535,0.10163934426229508,Cheap
20141212T000000,415000.0,3,1.5,1490,7275,1.0,0,0,3,7,1090,400,1974,0,98034,47.7148,-122.213,1420,7330,5785,5910,57.044673539518904,0.04459016393442623,Very Cheap
20141118T000000,480000.0,3,2.5,2360,9005,1.0,0,0,5,7,1340,1020,1929,0,98133,47.7076,-122.337,1520,9005,6645,7485,53.303720155469186,0.05311475409836065,Very Cheap
20140721T000000,300000.0,5,1.0,1940,8875,1.0,0,0,3,7,1940,0,1957,0,98188,47.4407,-122.275,1380,8875,6935,7495,33.80281690140845,0.029508196721311476,Very Cheap
20140708T000000,439000.0,4,2.25,2570,9503,2.0,0,0,3,8,2570,0,1980,0,98011,47.764,-122.167,1950,9600,6933,7650,46.195938124802694,0.04773770491803279,Very Cheap
20150327T000000,450000.0,3,1.0,1160,36831,1.0,0,0,3,7,1160,0,1938,0,98028,47.7507,-122.237,1800,15640,35671,13840,12.217968559094242,0.04918032786885246,Very Cheap
20150426T000000,589000.0,3,2.5,2660,206480,1.0,0,0,3,8,2660,0,1989,0,98024,47.6042,-121.956,2660,206736,203820,204076,2.8525765207284,0.06740983606557377,Very Cheap
20150407T000000,477000.0,3,2.25,1260,3000,2.0,0,0,3,7,1260,0,2003,0,98029,47.5459,-121.997,1630,3023,1740,1393,159.0,0.052721311475409836,Very Cheap
20140924T000000,587500.0,4,2.25,1780,6120,1.0,0,0,3,8,1310,470,1951,0,98115,47.6955,-122.287,1780,6120,4340,4340,95.99673202614379,0.06721311475409836,Very Cheap
20140924T000000,1315000.0,4,2.25,3180,6105,2.0,0,0,3,10,3180,0,1905,0,98112,47.6255,-122.314,3180,6029,2925,2849,215.3972153972154,0.16262295081967212,Cheap
20140911T000000,1430000.0,4,2.5,3380,27589,2.0,0,0,3,10,3380,0,1966,0,98004,47.6292,-122.225,3390,20075,24209,16685,51.83225198448657,0.17770491803278687,Cheap
20150413T000000,700000.0,4,2.25,2690,15000,2.0,0,0,3,9,1890,800,1978,0,98074,47.612,-122.064,2670,15030,12310,12360,46.666666666666664,0.08196721311475409,Very Cheap
20140623T000000,275000.0,2,1.0,1180,6552,1.0,0,0,4,6,1180,0,1949,0,98133,47.7477,-122.342,1070,7200,5372,6130,41.97191697191697,0.02622950819672131,Very Cheap
20140624T000000,367500.0,3,1.0,1660,11783,1.0,0,0,4,7,1160,500,1978,0,98077,47.7563,-122.075,1320,10541,10123,9221,31.189001103284394,0.03836065573770492,Very Cheap
20150505T000000,453250.0,4,2.5,2260,6300,2.0,0,0,3,7,2260,0,2001,0,98019,47.7235,-121.958,2300,6300,4040,4000,71.94444444444444,0.04960655737704918,Very Cheap
20150417T000000,607000.0,5,1.75,1910,5428,1.0,0,0,3,8,1390,520,1954,0,98136,47.5333,-122.392,1820,5900,3518,4080,111.82756079587325,0.06977049180327868,Very Cheap
20140702T000000,255000.0,4,2.0,2430,8960,1.0,0,0,3,7,1430,1000,1960,0,98178,47.4979,-122.232,2430,8960,6530,6530,28.459821428571427,0.02360655737704918,Very Cheap
20150501T000000,501000.0,2,2.0,1300,2500,1.0,0,0,4,7,770,530,1926,0,98117,47.6831,-122.373,1160,5000,1200,3840,200.4,0.05586885245901639,Very Cheap
20150331T000000,450000.0,3,1.0,1060,4650,1.0,0,0,3,7,910,150,1950,0,98116,47.5784,-122.393,1480,4750,3590,3270,96.7741935483871,0.04918032786885246,Very Cheap
20140820T000000,360000.0,3,2.25,2200,8000,2.0,0,0,3,8,2200,0,1981,0,98055,47.4522,-122.208,2170,8000,5800,5830,45.0,0.037377049180327866,Very Cheap
20141114T000000,460000.0,4,1.75,1720,3050,1.5,0,0,5,7,1040,680,1929,0,98116,47.5654,-122.384,1570,6100,1330,4530,150.81967213114754,0.050491803278688525,Very Cheap
20150303T000000,753000.0,3,1.75,2360,8290,1.0,0,0,4,7,1180,1180,1950,0,98115,47.6738,-122.281,1880,7670,5930,5790,90.83232810615199,0.08891803278688525,Very Cheap
20150506T000000,389950.0,2,1.0,820,4234,1.0,0,1,3,6,820,0,1951,0,98136,47.5294,-122.386,1550,4236,3414,2686,92.09966934341048,0.04130491803278689,Very Cheap
20140506T000000,469000.0,2,1.0,1030,4400,1.0,0,0,3,7,1030,0,1924,0,98117,47.681,-122.361,1400,4200,3370,2800,106.5909090909091,0.05167213114754098,Very Cheap
20140912T000000,550000.0,4,1.75,2030,5688,2.0,0,4,4,9,1730,300,1939,0,98146,47.5071,-122.387,2320,11107,3658,8787,96.69479606188467,0.06229508196721312,Very Cheap
20140904T000000,565000.0,5,3.5,2700,11675,1.5,0,2,4,6,1950,750,1948,0,98133,47.7172,-122.349,2160,8114,8975,5954,48.394004282655246,0.06426229508196721,Very Cheap
20140521T000000,189650.0,2,1.75,1100,7600,1.0,0,0,3,6,1100,0,1980,0,98198,47.4136,-122.318,1230,7350,6500,6120,24.95394736842105,0.015036065573770492,Very Cheap
20140619T000000,1525000.0,4,3.25,3620,5131,2.0,0,3,4,11,2350,1270,1927,0,98119,47.6499,-122.37,2550,5174,1511,2624,297.2130189046969,0.1901639344262295,Cheap
20140820T000000,260000.0,3,1.75,1340,8000,1.0,0,0,3,7,1340,0,1980,0,98038,47.3651,-122.044,1690,8000,6660,6310,32.5,0.024262295081967214,Very Cheap
20140601T000000,243000.0,3,1.75,1790,12000,1.0,0,0,3,7,1040,750,1960,0,98198,47.3945,-122.313,1840,12000,10210,10160,20.25,0.022032786885245903,Very Cheap
20141201T000000,1100000.0,4,2.5,3830,13800,1.0,0,4,4,9,2030,1800,1969,0,98006,47.5671,-122.157,3460,9875,9970,6415,79.71014492753623,0.13442622950819672,Cheap
20140820T000000,249000.0,3,1.5,1580,7200,1.0,0,0,4,7,1080,500,1976,0,98092,47.2761,-122.152,1580,7470,5620,5890,34.583333333333336,0.02281967213114754,Very Cheap
20140516T000000,720000.0,2,1.0,2020,7200,1.0,0,3,4,7,1700,320,1947,0,98146,47.506,-122.384,2020,7200,5180,5180,100.0,0.08459016393442623,Very Cheap
20150325T000000,905000.0,4,2.5,3330,9557,2.0,0,0,3,10,3330,0,1995,0,98006,47.5526,-122.102,3360,9755,6227,6395,94.69498796693523,0.10885245901639344,Cheap
20150423T000000,824500.0,4,2.5,2610,3500,1.5,0,0,5,7,1610,1000,1927,0,98115,47.6848,-122.326,1820,3900,890,2080,235.57142857142858,0.09829508196721312,Very Cheap
20140624T000000,762500.0,4,2.75,2610,8760,1.0,0,0,4,8,1760,850,1978,0,98040,47.5875,-122.229,2550,10376,6150,7826,87.04337899543378,0.09016393442622951,Very Cheap
20150413T000000,580000.0,3,2.5,1740,1280,3.0,0,2,3,8,1740,0,2008,0,98116,47.589,-122.387,1740,1308,-460,-432,453.125,0.06622950819672131,Very Cheap
20140818T000000,380000.0,3,2.0,1840,8580,1.0,0,0,3,8,1840,0,1990,0,98058,47.4626,-122.132,2190,8580,6740,6390,44.28904428904429,0.04,Very Cheap
20150401T000000,805000.0,3,1.75,1080,3200,1.0,0,0,4,7,880,200,1926,0,98103,47.6503,-122.338,1780,5200,2120,3420,251.5625,0.09573770491803278,Very Cheap
20140716T000000,520000.0,4,1.75,1240,4532,1.5,0,0,4,7,1240,0,1944,0,98117,47.6892,-122.378,1260,4468,3292,3208,114.7396293027361,0.058360655737704915,Very Cheap
20150203T000000,1569500.0,5,4.5,5620,5800,3.0,0,3,3,11,4700,920,1999,0,98199,47.6482,-122.412,2360,5800,180,3440,270.6034482758621,0.196,Cheap
20140514T000000,175000.0,2,1.0,1170,8925,1.0,0,2,3,6,1170,0,1911,0,98198,47.4017,-122.321,1380,7440,7755,6060,19.607843137254903,0.013114754098360656,Very Cheap
20140616T000000,353500.0,4,2.25,1760,9602,2.0,0,0,3,7,1760,0,1987,0,98058,47.4248,-122.158,1860,9656,7842,7796,36.81524682357842,0.036524590163934424,Very Cheap
20150102T000000,500000.0,4,2.5,2230,26989,1.0,0,1,4,8,1400,830,1962,0,98166,47.4285,-122.345,2570,17702,24759,15132,18.526066175108376,0.05573770491803279,Very Cheap
20150211T000000,386500.0,3,1.75,1520,7350,1.0,0,0,4,7,1140,380,1972,0,98034,47.7167,-122.17,1380,7350,5830,5970,52.585034013605444,0.04085245901639344,Very Cheap
20140716T000000,210000.0,2,1.0,1450,4750,1.0,0,0,3,7,850,600,1950,0,98118,47.5293,-122.272,1190,5000,3300,3810,44.21052631578947,0.017704918032786884,Very Cheap
20150423T000000,439500.0,3,2.5,1600,6510,1.0,0,0,3,7,940,660,1983,0,98155,47.7679,-122.308,1600,10507,4910,8907,67.51152073732719,0.04780327868852459,Very Cheap
20140813T000000,315000.0,5,2.5,3220,5751,2.0,0,0,3,8,3220,0,2002,0,98042,47.3717,-122.104,2740,5500,2531,2760,54.77308294209703,0.031475409836065574,Very Cheap
20140519T000000,339000.0,4,2.5,1830,8601,2.0,0,0,3,7,1830,0,2003,0,98038,47.3576,-122.016,1830,5184,6771,3354,39.414021625392394,0.03462295081967213,Very Cheap
20140924T000000,655000.0,4,2.25,2200,9163,1.0,0,0,4,8,1430,770,1971,0,98006,47.5653,-122.146,2420,9163,6963,6743,71.48313871002946,0.0760655737704918,Very Cheap
20140828T000000,740000.0,2,2.5,2170,8678,1.0,0,0,3,8,2170,0,2008,0,98053,47.7161,-122.014,2170,5890,6508,3720,85.27310440193592,0.08721311475409836,Very Cheap
20150306T000000,685000.0,5,2.5,1900,7843,2.0,0,0,5,7,1900,0,1966,0,98008,47.6273,-122.123,1900,7350,5943,5450,87.33902843299758,0.08,Very Cheap
20150310T000000,550000.0,5,2.5,2960,9877,1.0,0,0,4,7,1480,1480,1960,0,98005,47.5866,-122.171,1900,9877,6917,7977,55.684924572238536,0.06229508196721312,Very Cheap
20140602T000000,405000.0,2,1.75,1710,4234,2.0,0,0,3,7,1330,380,1920,1979,98136,47.5319,-122.386,1530,4556,2524,3026,95.65422768068021,0.043278688524590166,Very Cheap
20150416T000000,765000.0,4,2.25,2620,17366,1.0,0,3,3,9,1430,1190,1984,0,98075,47.584,-122.077,2620,15335,14746,12715,44.05159507082806,0.09049180327868853,Very Cheap
20150304T000000,625000.0,3,2.0,2140,3600,2.0,0,0,3,8,1680,460,1911,1997,98116,47.5846,-122.383,2340,5400,1460,3060,173.61111111111111,0.07213114754098361,Very Cheap
20141006T000000,207000.0,4,2.5,2100,19680,1.5,0,0,3,6,2100,0,1914,0,98055,47.4787,-122.23,1340,12300,17580,10960,10.518292682926829,0.017311475409836064,Very Cheap
20150312T000000,370000.0,4,2.5,2100,19680,1.5,0,0,3,6,2100,0,1914,0,98055,47.4787,-122.23,1340,12300,17580,10960,18.80081300813008,0.038688524590163934,Very Cheap
20141202T000000,475000.0,3,2.5,1460,4961,1.0,0,0,4,8,1150,310,1988,0,98033,47.6955,-122.183,1550,5449,3501,3899,95.74682523684741,0.05245901639344262,Very Cheap
20140829T000000,365000.0,2,1.0,990,8250,1.0,0,0,3,7,990,0,1955,0,98133,47.7252,-122.331,1080,8168,7260,7088,44.24242424242424,0.0380327868852459,Very Cheap
20141222T000000,411800.0,4,2.25,2190,6800,1.0,0,0,5,7,1340,850,1969,0,98011,47.7367,-122.195,1560,7611,4610,6051,60.55882352941177,0.044170491803278686,Very Cheap
20140721T000000,668000.0,5,3.5,3990,42436,2.0,0,0,3,9,2710,1280,2002,0,98027,47.461,-122.0,3030,41684,38446,38654,15.741351682533697,0.07777049180327869,Very Cheap
20140911T000000,618000.0,3,2.5,2340,3630,2.0,0,0,3,9,2340,0,1998,0,98122,47.6059,-122.307,1820,5120,1290,3300,170.2479338842975,0.07121311475409836,Very Cheap
20141226T000000,247500.0,4,2.0,2460,5921,1.0,0,0,4,7,1230,1230,1948,0,98002,47.308,-122.209,1260,6648,3461,5388,41.8003715588583,0.02262295081967213,Very Cheap
20140730T000000,345000.0,5,3.0,2080,6150,1.0,0,0,3,7,1040,1040,1950,0,98116,47.5707,-122.394,1420,6150,4070,4730,56.09756097560975,0.03540983606557377,Very Cheap
20150311T000000,616300.0,3,2.0,1700,8400,2.0,0,2,3,7,1700,0,1927,0,98033,47.6825,-122.19,1820,9000,6700,7180,73.36904761904762,0.07099016393442623,Very Cheap
20150116T000000,348000.0,3,1.5,1330,6768,1.0,0,0,4,7,1330,0,1952,0,98155,47.7366,-122.319,1320,6910,5438,5590,51.41843971631206,0.03580327868852459,Very Cheap
20141202T000000,425000.0,3,2.5,1630,10762,1.0,0,0,3,7,1630,0,1994,0,98011,47.7508,-122.175,1770,10762,9132,8992,39.49080096636313,0.04590163934426229,Very Cheap
20140614T000000,850000.0,5,2.75,2920,11880,1.0,0,0,5,8,1660,1260,1968,0,98027,47.5133,-122.031,3910,14491,8960,10581,71.54882154882155,0.10163934426229508,Cheap
20140717T000000,820000.0,5,2.75,2830,6137,2.0,0,0,3,9,2830,0,2010,0,98074,47.5932,-122.058,3170,6285,3307,3115,133.61577317907773,0.09770491803278689,Very Cheap
20150113T000000,832000.0,4,2.25,3190,52953,2.0,0,0,4,10,3190,0,1980,0,98075,47.5933,-122.075,3190,51400,49763,48210,15.712046531830113,0.09927868852459017,Very Cheap
20141203T000000,835000.0,3,1.75,1490,3840,2.0,0,0,3,8,1490,0,1984,2014,98033,47.6916,-122.214,3450,8500,2350,5050,217.44791666666666,0.09967213114754099,Very Cheap
20150410T000000,350000.0,3,2.5,1630,3425,2.0,0,0,3,8,1630,0,1999,0,98059,47.4913,-122.154,1420,3425,1795,2005,102.18978102189782,0.036065573770491806,Very Cheap
20140722T000000,349000.0,4,2.5,2280,4096,2.0,0,0,3,7,2280,0,2003,0,98056,47.4834,-122.182,2280,3600,1816,1320,85.205078125,0.035934426229508196,Very Cheap
20140613T000000,1125000.0,6,3.75,3010,4360,2.0,0,0,3,9,2000,1010,2014,0,98103,47.6873,-122.333,1600,5160,1350,3560,258.0275229357798,0.1377049180327869,Cheap
20150309T000000,320000.0,3,2.5,1590,3480,2.0,0,0,3,7,1590,0,2004,0,98056,47.4805,-122.178,1680,3480,1890,1800,91.95402298850574,0.032131147540983604,Very Cheap
20150305T000000,150000.0,3,1.0,1250,7210,1.0,0,0,4,7,1250,0,1968,0,98031,47.4169,-122.168,1010,7210,5960,6200,20.804438280166437,0.009836065573770493,Very Cheap
20141125T000000,340000.0,3,1.0,1710,10190,1.0,0,0,3,6,1310,400,1949,0,98168,47.506,-122.331,1200,6251,8480,5051,33.36604514229637,0.03475409836065574,Very Cheap
20141013T000000,785500.0,4,4.0,3280,8448,2.0,0,0,3,10,3280,0,2007,0,98075,47.5818,-121.973,3730,8030,5168,4300,92.98058712121212,0.09318032786885246,Very Cheap
20150217T000000,410500.0,4,2.5,3362,8601,2.0,0,0,3,8,3362,0,2004,0,98003,47.2592,-122.304,2770,8601,5239,5831,47.727008487385184,0.044,Very Cheap
20140701T000000,580000.0,3,2.5,2200,11000,2.0,0,2,3,9,2200,0,1978,0,98008,47.5916,-122.112,2200,12851,8800,10651,52.72727272727273,0.06622950819672131,Very Cheap
20150421T000000,345000.0,2,1.5,830,920,2.0,0,0,3,7,830,0,2005,0,98144,47.5998,-122.306,830,1200,90,370,375.0,0.03540983606557377,Very Cheap
20140929T000000,550000.0,3,2.25,2160,37000,1.5,0,0,4,7,1760,400,1933,0,98052,47.7297,-122.139,2540,37000,34840,34460,14.864864864864865,0.06229508196721312,Very Cheap
20141021T000000,449500.0,4,3.0,2580,7299,2.0,0,0,3,8,2580,0,1998,0,98058,47.4646,-122.15,2250,6165,4719,3915,61.58377859980819,0.049114754098360656,Very Cheap
20140624T000000,300000.0,3,1.0,2150,7007,1.0,0,0,3,6,2150,0,1954,0,98177,47.7615,-122.362,1720,9000,4857,7280,42.81432852861424,0.029508196721311476,Very Cheap
20141111T000000,915000.0,4,2.5,3510,28052,2.0,0,0,3,10,3510,0,1988,0,98053,47.6671,-122.057,2890,28295,24542,25405,32.61799515186083,0.11016393442622952,Cheap
20150127T000000,1575000.0,4,3.75,3810,9916,2.0,0,0,3,11,3810,0,1989,0,98040,47.5739,-122.234,3040,11250,6106,8210,158.83420734167004,0.19672131147540983,Cheap
20140528T000000,599000.0,4,2.75,2020,2750,1.0,0,0,3,8,1010,1010,1917,2014,98122,47.6053,-122.291,1840,4000,730,2160,217.8181818181818,0.06872131147540983,Very Cheap
20140505T000000,755000.0,4,2.5,2120,10202,1.0,0,0,4,7,1620,500,1960,0,98005,47.5858,-122.17,1570,10762,8082,9192,74.00509703979611,0.08918032786885247,Very Cheap
20150402T000000,400000.0,3,1.0,1250,7157,1.0,0,0,3,7,1250,0,1944,2010,98125,47.7323,-122.304,1300,6796,5907,5496,55.88933910856504,0.04262295081967213,Very Cheap
20150330T000000,133000.0,3,1.0,980,9115,1.0,0,0,3,7,980,0,1968,0,98198,47.3737,-122.312,1470,8716,8135,7246,14.591332967635765,0.00760655737704918,Very Cheap
20150116T000000,330000.0,4,1.5,1250,8400,1.0,0,0,3,7,960,290,1951,0,98155,47.7505,-122.315,1560,8400,7150,6840,39.285714285714285,0.03344262295081967,Very Cheap
20150218T000000,330000.0,4,1.0,1100,5000,1.5,0,0,5,6,1100,0,1904,0,98055,47.4868,-122.204,1560,4838,3900,3278,66.0,0.03344262295081967,Very Cheap
20140905T000000,375000.0,3,1.75,1330,9417,1.0,0,0,5,6,710,620,1936,0,98125,47.7231,-122.301,1690,7937,8087,6247,39.821599235425296,0.03934426229508197,Very Cheap
20141211T000000,485000.0,4,2.75,2560,8956,1.0,0,0,4,7,1500,1060,1968,0,98034,47.7278,-122.177,2280,9234,6396,6954,54.153640017865115,0.05377049180327869,Very Cheap
20140722T000000,470000.0,4,2.5,1850,11250,1.5,0,0,3,7,1210,640,1981,0,98074,47.6264,-122.062,1650,7623,9400,5973,41.77777777777778,0.05180327868852459,Very Cheap
20141221T000000,1045000.0,4,3.0,2790,3600,2.0,0,0,3,8,1880,910,1905,2013,98119,47.6362,-122.363,1360,3600,810,2240,290.27777777777777,0.12721311475409836,Cheap
20140707T000000,548800.0,4,1.0,1660,4704,1.5,0,0,3,7,1260,400,1930,0,98115,47.6918,-122.32,1360,5413,3044,4053,116.66666666666667,0.062137704918032784,Very Cheap
20140708T000000,315000.0,2,1.0,1080,2674,1.0,0,0,4,6,720,360,1919,0,98108,47.5595,-122.317,1250,5000,1594,3750,117.80104712041884,0.031475409836065574,Very Cheap
20140919T000000,590000.0,3,2.0,3030,9374,1.0,0,1,4,7,2100,930,1959,0,98136,47.5289,-122.391,1990,6012,6344,4022,62.94004693834009,0.06754098360655737,Very Cheap
20140523T000000,439950.0,4,2.5,2380,12067,2.0,0,0,3,7,2380,0,2002,0,98059,47.4873,-122.144,2330,8621,9687,6291,36.45893759840888,0.04786229508196721,Very Cheap
20140603T000000,325000.0,3,1.75,2250,26337,1.0,0,0,3,8,2250,0,1980,0,98092,47.3032,-122.123,1830,26337,24087,24507,12.340053916543265,0.03278688524590164,Very Cheap
20141208T000000,400000.0,2,1.0,880,5111,1.0,0,0,3,6,880,0,1931,0,98115,47.6997,-122.314,1370,5111,4231,3741,78.2625709254549,0.04262295081967213,Very Cheap
20141211T000000,685000.0,4,2.5,2770,10051,2.0,0,0,3,10,2770,0,1987,0,98074,47.6288,-122.043,2730,10675,7281,7945,68.15242264451298,0.08,Very Cheap
20140918T000000,339950.0,3,2.0,1340,10200,1.5,0,0,3,7,1340,0,1953,0,98133,47.7756,-122.351,1420,10200,8860,8780,33.32843137254902,0.03474754098360656,Very Cheap
20141023T000000,315000.0,3,1.75,1660,8160,1.0,0,0,4,7,1660,0,1951,0,98166,47.4608,-122.358,1490,8100,6500,6610,38.60294117647059,0.031475409836065574,Very Cheap
20150211T000000,411753.0,3,2.5,1710,3795,2.0,0,0,3,7,1710,0,2009,0,98053,47.6968,-122.024,1600,3821,2085,2221,108.498814229249,0.04416432786885246,Very Cheap
20140828T000000,577000.0,2,1.75,1620,4879,1.0,0,0,3,7,1040,580,1924,2011,98116,47.5703,-122.385,1500,5000,3259,3500,118.26193892191023,0.06583606557377049,Very Cheap
20141017T000000,500000.0,3,1.75,1530,8829,1.0,0,0,5,8,1530,0,1972,0,98006,47.545,-122.171,2060,9226,7299,7166,56.631555102503114,0.05573770491803279,Very Cheap
20141202T000000,210000.0,3,2.0,1440,10111,1.0,0,0,3,7,1440,0,1963,0,98001,47.345,-122.283,1580,10200,8671,8620,20.769459005044013,0.017704918032786884,Very Cheap
20140827T000000,640000.0,4,1.75,2020,16120,1.0,0,0,3,7,2020,0,1969,0,98010,47.3413,-122.048,1940,16350,14100,14410,39.702233250620345,0.0740983606557377,Very Cheap
20150417T000000,460000.0,4,1.75,1870,8663,1.0,0,0,5,7,1870,0,1949,0,98133,47.7366,-122.35,1560,7800,6793,6240,53.09938820270114,0.050491803278688525,Very Cheap
20150218T000000,265000.0,2,1.0,620,4760,1.0,0,0,3,6,620,0,1941,0,98126,47.5286,-122.376,620,4760,4140,4140,55.67226890756302,0.024918032786885248,Very Cheap
20140514T000000,740000.0,5,5.0,5774,31675,1.0,0,2,3,11,4490,1284,1984,0,98003,47.3466,-122.323,3260,13200,25901,9940,23.362273086029994,0.08721311475409836,Very Cheap
20140718T000000,230000.0,3,1.0,1240,6195,1.0,0,0,3,6,1240,0,1948,0,98028,47.7681,-122.266,1760,11080,4955,9320,37.12671509281679,0.020327868852459016,Very Cheap
20150217T000000,315000.0,3,1.75,1890,10661,1.0,0,0,5,7,1460,430,1978,0,98038,47.3583,-122.056,1680,9604,8771,7924,29.546946815495733,0.031475409836065574,Very Cheap
20141223T000000,432000.0,3,1.75,2410,51763,1.0,0,0,4,8,1410,1000,1981,0,98077,47.7429,-122.056,2410,49207,49353,46797,8.345729575179183,0.046819672131147544,Very Cheap
20150203T000000,467000.0,3,2.5,1530,3984,2.0,0,0,3,8,1530,0,1995,0,98029,47.569,-122.007,1720,4005,2454,2285,117.21887550200803,0.05140983606557377,Very Cheap
20140925T000000,255000.0,5,3.75,2800,9900,1.0,0,0,3,7,2800,0,1964,0,98023,47.319,-122.344,1700,13200,7100,11500,25.757575757575758,0.02360655737704918,Very Cheap
20150408T000000,316500.0,3,1.75,1460,6360,1.0,0,2,3,7,1010,450,1979,0,98106,47.5311,-122.353,1400,4240,4900,2840,49.764150943396224,0.031672131147540986,Very Cheap
20150403T000000,190000.0,4,2.0,1580,6250,1.0,0,0,3,7,860,720,1977,0,98155,47.7659,-122.31,1580,6250,4670,4670,30.4,0.015081967213114755,Very Cheap
20140516T000000,490000.0,3,2.0,1450,2400,1.5,0,0,3,8,1450,0,1900,2003,98107,47.6726,-122.381,1450,4275,950,2825,204.16666666666666,0.05442622950819672,Very Cheap
20150417T000000,378000.0,4,1.75,1990,23200,1.0,0,0,4,7,1990,0,1976,0,98059,47.486,-122.129,1950,17040,21210,15090,16.29310344827586,0.03973770491803279,Very Cheap
20150211T000000,598800.0,6,4.0,4470,17877,3.0,0,3,3,9,3230,1240,2013,0,98188,47.4514,-122.273,1790,18260,13407,16470,33.49555294512502,0.06869508196721312,Very Cheap
20140902T000000,333800.0,5,3.0,1980,3868,1.0,0,0,3,7,1220,760,1990,0,98118,47.5173,-122.275,1970,3868,1888,1898,86.29782833505688,0.033940983606557375,Very Cheap
20140529T000000,690000.0,4,2.5,2920,9904,2.0,0,0,4,9,2920,0,1990,0,98029,47.5759,-121.995,1810,5617,6984,3807,69.66882067851373,0.08065573770491803,Very Cheap
20141021T000000,320000.0,4,1.75,1660,6200,1.0,0,0,4,6,830,830,1948,0,98108,47.56,-122.316,1780,5968,4540,4188,51.61290322580645,0.032131147540983604,Very Cheap
20150414T000000,1249000.0,4,3.5,3190,6000,1.5,0,3,4,9,2410,780,1912,0,98144,47.5846,-122.29,2840,4000,2810,1160,208.16666666666666,0.1539672131147541,Cheap
20140721T000000,335000.0,3,1.5,1560,9600,1.0,0,0,4,7,1560,0,1961,0,98033,47.6918,-122.163,1520,10000,8040,8480,34.895833333333336,0.03409836065573771,Very Cheap
20140811T000000,840000.0,3,2.5,3050,33920,1.0,0,0,3,8,3050,0,2004,0,98052,47.7034,-122.072,1970,60984,30870,59014,24.764150943396228,0.10032786885245902,Cheap
20140714T000000,608250.0,4,2.75,3030,21780,2.0,0,0,3,8,3030,0,1986,0,98166,47.4481,-122.338,3020,28027,18750,25007,27.926997245179063,0.0699344262295082,Very Cheap
20140609T000000,550000.0,3,2.5,2260,4165,2.0,0,0,3,7,2260,0,2005,0,98075,47.5922,-122.008,2770,4566,1905,1796,132.05282112845137,0.06229508196721312,Very Cheap
20150422T000000,240000.0,3,1.0,1260,7920,1.0,0,0,3,7,1260,0,1966,0,98003,47.3452,-122.308,1300,7920,6660,6620,30.303030303030305,0.021639344262295083,Very Cheap
20150414T000000,998000.0,3,2.25,3370,11757,2.0,0,2,4,9,3370,0,1980,0,98006,47.5573,-122.16,2690,10500,8387,7810,84.88560006804457,0.12104918032786885,Cheap
20140829T000000,275000.0,3,1.75,1490,8000,1.0,0,0,3,8,1490,0,1978,0,98030,47.3817,-122.166,1740,8165,6510,6425,34.375,0.02622950819672131,Very Cheap
20150424T000000,284200.0,3,2.5,1570,9292,1.0,0,0,3,7,1110,460,1977,0,98001,47.3386,-122.272,1470,9222,7722,7752,30.58544984933276,0.027436065573770492,Very Cheap
20140724T000000,1715000.0,4,3.75,4490,7623,2.0,0,0,4,10,3090,1400,1941,0,98112,47.6315,-122.29,3760,7653,3133,3893,224.97704315886133,0.21508196721311476,Cheap
20141119T000000,2400000.0,4,3.75,4090,24825,2.0,0,0,4,11,3400,690,1926,0,98102,47.6338,-122.319,3910,11500,20735,7590,96.67673716012085,0.30491803278688523,Medium
20140905T000000,930800.0,5,2.5,4150,96574,2.0,0,0,3,10,4150,0,1988,0,98053,47.6664,-122.045,3320,40803,92424,37483,9.63820489986953,0.11223606557377049,Cheap
20140729T000000,930000.0,4,3.0,2900,10400,1.0,0,3,5,8,1530,1370,1959,0,98008,47.5854,-122.114,2820,10400,7500,7580,89.42307692307692,0.1121311475409836,Cheap
20140828T000000,215000.0,4,1.5,1430,8775,1.0,0,0,3,7,1030,400,1979,0,98023,47.3034,-122.383,1390,7800,7345,6410,24.501424501424502,0.018360655737704918,Very Cheap
20150420T000000,480000.0,2,1.5,1008,26487,1.0,1,4,4,6,1008,0,1943,2002,98070,47.3853,-122.479,1132,24079,25479,22947,18.122097632800998,0.05311475409836065,Very Cheap
20140520T000000,483945.0,2,1.75,1480,5120,1.0,0,0,4,6,840,640,1951,0,98116,47.558,-122.392,1090,5120,3640,4030,94.5205078125,0.053632131147540986,Very Cheap
20140609T000000,347000.0,3,1.75,1240,8050,1.0,0,0,4,7,1240,0,1978,0,98074,47.6108,-122.044,1370,9856,6810,8486,43.1055900621118,0.03567213114754098,Very Cheap
20150330T000000,232500.0,3,2.0,1370,9760,1.0,0,0,4,7,1110,260,1979,0,98023,47.3009,-122.384,1640,9040,8390,7400,23.82172131147541,0.020655737704918034,Very Cheap
20140520T000000,390000.0,4,2.25,1770,33132,1.0,0,0,4,8,1190,580,1965,0,98058,47.4413,-122.151,2490,20000,31362,17510,11.771097428467947,0.04131147540983607,Very Cheap
20140918T000000,550000.0,3,2.25,2160,15360,1.0,0,0,3,8,1410,750,1965,2000,98007,47.6232,-122.138,2180,8480,13200,6300,35.807291666666664,0.06229508196721312,Very Cheap
20140812T000000,590000.0,4,2.5,2340,8971,2.0,0,0,3,9,2340,0,1987,0,98029,47.5679,-122.011,2510,9219,6631,6709,65.7674729684539,0.06754098360655737,Very Cheap
20140521T000000,420850.0,1,1.0,960,40946,1.0,0,0,5,5,960,0,1945,0,98014,47.6951,-121.864,1320,20350,39986,19030,10.278171249938945,0.04535737704918033,Very Cheap
20150205T000000,345000.0,4,2.5,2280,8190,1.0,0,3,3,7,1390,890,1983,0,98188,47.4414,-122.272,1990,9000,5910,7010,42.124542124542124,0.03540983606557377,Very Cheap
20150227T000000,429800.0,3,2.0,1970,7000,1.0,0,0,3,8,1970,0,1986,0,98038,47.3744,-122.043,1970,7365,5030,5395,61.4,0.04653114754098361,Very Cheap
20140626T000000,302000.0,4,1.75,1530,17664,1.5,0,0,3,7,1530,0,1968,0,98058,47.4549,-122.155,1530,11625,16134,10095,17.096920289855074,0.02977049180327869,Very Cheap
20141104T000000,800000.0,4,1.5,1790,3952,1.5,0,0,4,8,1790,0,1932,0,98103,47.689,-122.352,1200,3876,2162,2676,202.42914979757086,0.09508196721311475,Very Cheap
20141215T000000,250000.0,3,2.5,1700,6000,2.0,0,0,3,8,1700,0,1997,0,98092,47.2615,-122.221,1940,6626,4300,4686,41.666666666666664,0.022950819672131147,Very Cheap
20140729T000000,605000.0,3,2.0,2660,4500,1.0,0,0,4,7,1330,1330,1922,0,98199,47.6391,-122.403,1790,5000,1840,3210,134.44444444444446,0.06950819672131148,Very Cheap
20140529T000000,412000.0,3,1.75,1950,52256,1.0,0,0,4,8,1950,0,1985,0,98042,47.3133,-122.078,2450,51836,50306,49386,7.88426209430496,0.04419672131147541,Very Cheap
20141112T000000,252000.0,3,2.0,1340,5670,2.0,0,0,3,6,1340,0,1994,0,98055,47.4498,-122.194,1290,4892,4330,3602,44.44444444444444,0.02321311475409836,Very Cheap
20140919T000000,375000.0,3,1.0,1130,12500,1.5,0,0,3,7,1130,0,1954,0,98118,47.5491,-122.268,2280,8750,11370,6470,30.0,0.03934426229508197,Very Cheap
20140710T000000,725000.0,2,1.75,1950,2719,1.0,0,0,5,7,1010,940,1919,0,98103,47.6513,-122.346,1360,1256,769,-104,266.6421478484737,0.08524590163934426,Very Cheap
20141013T000000,471750.0,5,3.5,3790,8200,1.0,0,1,3,8,2120,1670,2001,0,98056,47.4891,-122.19,1740,8676,4410,6936,57.53048780487805,0.0520327868852459,Very Cheap
20141208T000000,490000.0,4,2.25,2020,85813,2.0,0,0,3,7,2020,0,1995,0,98027,47.483,-122.026,2120,85813,83793,83693,5.710090545721511,0.05442622950819672,Very Cheap
20141001T000000,439000.0,2,1.0,800,5100,1.0,0,0,3,7,800,0,1945,0,98117,47.6775,-122.388,1330,5100,4300,3770,86.07843137254902,0.04773770491803279,Very Cheap
20140822T000000,355000.0,4,2.0,1770,8890,1.0,0,0,5,6,1770,0,1949,0,98166,47.4589,-122.353,1010,7620,7120,6610,39.932508436445445,0.036721311475409836,Very Cheap
20150505T000000,250000.0,1,0.75,940,87120,1.0,0,0,3,6,940,0,1944,0,98019,47.7182,-121.956,1930,165528,86180,163598,2.869605142332415,0.022950819672131147,Very Cheap
20150326T000000,780000.0,4,2.25,2260,16188,1.0,0,0,3,10,2260,0,1984,0,98006,47.5637,-122.112,2840,10158,13928,7318,48.183839881393624,0.09245901639344262,Very Cheap
20141105T000000,409000.0,2,1.0,890,3271,1.0,0,0,4,6,890,0,1918,0,98116,47.5631,-122.381,1190,5175,2381,3985,125.03821461326811,0.04380327868852459,Very Cheap
20140610T000000,420000.0,2,1.0,860,3880,1.0,0,0,4,6,860,0,1916,0,98117,47.6862,-122.391,1230,4260,3020,3030,108.24742268041237,0.04524590163934426,Very Cheap
20141113T000000,200000.0,1,0.75,680,9600,1.0,0,0,3,5,680,0,1947,0,98115,47.6964,-122.306,1580,6624,8920,5044,20.833333333333332,0.01639344262295082,Very Cheap
20150105T000000,830000.0,2,1.5,2130,35679,1.0,0,0,4,7,2130,0,1963,0,98033,47.6638,-122.171,2670,35679,33549,33009,23.262983828022087,0.09901639344262295,Very Cheap
20140529T000000,695000.0,3,2.5,2390,4555,2.0,0,0,3,9,2390,0,2006,0,98074,47.6199,-122.025,2540,4500,2165,1960,152.57958287596048,0.08131147540983606,Very Cheap
20140521T000000,815000.0,4,2.75,3488,9614,2.0,0,0,3,10,3488,0,1998,0,98074,47.6055,-122.013,3600,10891,6126,7291,84.7722071978365,0.09704918032786886,Very Cheap
20141113T000000,210000.0,3,1.75,1260,6223,1.0,0,0,3,7,820,440,1983,0,98042,47.3574,-122.158,1260,6553,4963,5293,33.74578177727784,0.017704918032786884,Very Cheap
20140915T000000,635000.0,3,1.75,2940,6000,1.0,0,2,4,8,1590,1350,1957,0,98177,47.7235,-122.369,2880,8100,3060,5220,105.83333333333333,0.07344262295081967,Very Cheap
20140721T000000,562500.0,4,2.5,2440,7322,2.0,0,0,3,9,2440,0,1991,0,98056,47.5357,-122.179,2590,9927,4882,7337,76.8232723299645,0.06393442622950819,Very Cheap
20140509T000000,402500.0,4,2.5,2600,11951,2.0,0,0,3,10,2600,0,1988,0,98023,47.3053,-122.34,2820,12093,9351,9273,33.67919002593925,0.04295081967213115,Very Cheap
20141219T000000,555000.0,3,2.0,2080,7020,1.0,0,0,4,7,1040,1040,1951,0,98115,47.6768,-122.285,1920,7000,4940,5080,79.05982905982906,0.06295081967213115,Very Cheap
20140909T000000,310000.0,3,1.0,1990,7173,1.0,0,0,3,7,1990,0,1972,0,98034,47.7116,-122.213,1320,7245,5183,5925,43.21762163669315,0.03081967213114754,Very Cheap
20140905T000000,500000.0,4,2.5,2840,18001,2.0,0,0,3,9,2840,0,1994,0,98019,47.7359,-121.962,2500,18001,15161,15501,27.776234653630354,0.05573770491803279,Very Cheap
20140723T000000,430000.0,6,3.0,2630,8800,1.0,0,0,3,7,1610,1020,1959,0,98125,47.7166,-122.293,1220,1173,6170,-47,48.86363636363637,0.04655737704918033,Very Cheap
20140628T000000,1600000.0,3,4.25,2820,7200,2.0,0,0,4,10,2460,360,1930,0,98112,47.6298,-122.29,3300,7522,4380,4222,222.22222222222223,0.2,Cheap
20141001T000000,627500.0,4,1.0,1560,4080,1.5,0,0,3,7,1560,0,1923,0,98103,47.6711,-122.331,1890,4080,2520,2190,153.79901960784315,0.07245901639344263,Very Cheap
20141124T000000,335000.0,4,2.5,2330,7050,2.0,0,0,3,8,2330,0,1998,0,98178,47.5001,-122.231,1810,5424,4720,3614,47.5177304964539,0.03409836065573771,Very Cheap
20150317T000000,962000.0,4,2.25,3320,20100,1.0,0,0,4,8,1810,1510,1981,0,98006,47.5566,-122.153,2450,9821,16780,7371,47.86069651741293,0.11632786885245902,Cheap
20140725T000000,299000.0,3,1.75,1730,14270,1.0,0,0,3,7,1730,0,1959,0,98065,47.5318,-121.833,1600,11232,12540,9632,20.953048353188507,0.02937704918032787,Very Cheap
20150414T000000,399950.0,4,2.5,3110,5868,2.0,0,0,3,8,3110,0,2001,0,98042,47.3781,-122.126,2950,5924,2758,2974,68.1578050443081,0.04261639344262295,Very Cheap
20150325T000000,322000.0,3,1.0,1230,9660,1.0,0,0,3,7,1230,0,1968,0,98053,47.6829,-122.06,1380,10125,8430,8745,33.333333333333336,0.03239344262295082,Very Cheap
20140623T000000,430000.0,2,1.5,950,4625,1.0,0,0,4,7,950,0,1949,0,98103,47.6912,-122.34,1440,4625,3675,3185,92.97297297297297,0.04655737704918033,Very Cheap
20140508T000000,307000.0,3,1.75,1890,13860,1.0,0,0,5,7,1890,0,1966,0,98042,47.4156,-122.149,1500,14536,11970,13036,22.150072150072152,0.03042622950819672,Very Cheap
20141105T000000,194000.0,3,1.5,1010,5000,1.0,0,0,3,6,1010,0,1943,0,98178,47.4925,-122.278,980,5000,3990,4020,38.8,0.01560655737704918,Very Cheap
20141114T000000,180000.0,3,1.0,1010,8581,1.0,0,0,4,6,1010,0,1920,0,98002,47.3043,-122.216,1060,10354,7571,9294,20.976576156625104,0.01377049180327869,Very Cheap
20140718T000000,465000.0,4,2.25,2340,13383,1.0,0,0,3,8,1170,1170,1983,0,98074,47.6211,-122.037,1810,12532,11043,10722,34.74557274153777,0.051147540983606556,Very Cheap
20150323T000000,722500.0,4,2.5,2460,9296,2.0,0,0,3,9,2460,0,1978,0,98007,47.6125,-122.152,2730,9900,6836,7170,77.72160068846816,0.08491803278688524,Very Cheap
20140924T000000,470450.0,2,1.0,1010,3400,1.0,0,0,3,7,1010,0,1921,0,98103,47.6711,-122.329,1800,3600,2390,1800,138.36764705882354,0.051862295081967213,Very Cheap
20150127T000000,280000.0,3,2.5,1650,6000,2.0,0,0,3,7,1650,0,1990,0,98030,47.36,-122.194,1750,6000,4350,4250,46.666666666666664,0.026885245901639345,Very Cheap
20150410T000000,176250.0,4,2.0,1440,6702,1.0,0,0,4,7,1440,0,1966,0,98002,47.3056,-122.217,1030,6702,5262,5672,26.298119964189794,0.013278688524590163,Very Cheap
20140617T000000,560000.0,5,1.0,1710,9100,1.5,0,0,4,7,1320,390,1926,0,98126,47.5379,-122.378,1880,9100,7390,7220,61.53846153846154,0.06360655737704918,Very Cheap
20141022T000000,830000.0,3,2.5,2760,11287,2.0,0,3,3,10,2000,760,1991,0,98028,47.739,-122.264,2760,13719,8527,10959,73.5359262868787,0.09901639344262295,Very Cheap
20140611T000000,276900.0,2,1.0,1350,10096,1.0,0,2,4,7,1350,0,1952,0,98045,47.4967,-121.778,1280,10095,8746,8815,27.426703645007922,0.026478688524590163,Very Cheap
20141001T000000,625000.0,3,1.75,1660,4800,2.0,0,0,3,7,1660,0,1906,2014,98112,47.6296,-122.308,1660,4800,3140,3140,130.20833333333334,0.07213114754098361,Very Cheap
20150304T000000,1015000.0,4,2.5,2960,4760,2.0,0,0,3,8,2160,800,1900,0,98102,47.6367,-122.318,1600,4760,1800,3160,213.23529411764707,0.12327868852459016,Cheap
20140930T000000,463500.0,1,1.0,1090,8750,1.0,0,0,4,6,1090,0,1924,0,98118,47.54,-122.269,1830,5000,7660,3170,52.97142857142857,0.05095081967213115,Very Cheap
20140905T000000,485000.0,3,2.5,3110,9015,2.0,0,0,3,9,3110,0,1990,0,98058,47.4369,-122.147,2650,8960,5905,6310,53.79922351636162,0.05377049180327869,Very Cheap
20140617T000000,272000.0,3,2.0,1380,7476,1.0,0,0,3,7,1380,0,1989,0,98001,47.3336,-122.272,1600,7227,6096,5627,36.383092562867844,0.02583606557377049,Very Cheap
20141217T000000,305000.0,2,1.0,1290,3140,2.0,0,0,3,7,1290,0,2008,0,98053,47.6971,-122.026,1290,2628,1850,1338,97.13375796178345,0.03016393442622951,Very Cheap
20140626T000000,760000.0,3,2.5,1980,13964,1.0,0,0,5,7,1980,0,1959,0,98040,47.571,-122.227,2040,13964,11984,11924,54.425665998281296,0.0898360655737705,Very Cheap
20150213T000000,387500.0,2,1.0,870,6126,1.0,0,0,4,7,870,0,1938,0,98125,47.7024,-122.322,1620,6126,5256,4506,63.25497877897486,0.040983606557377046,Very Cheap
20140908T000000,352000.0,4,2.5,2470,5015,2.0,0,0,3,8,2470,0,2004,0,98038,47.3457,-122.041,2470,5100,2545,2630,70.18943170488535,0.03632786885245902,Very Cheap
20140709T000000,507000.0,3,1.75,2140,40098,1.0,0,0,5,8,1490,650,1950,0,98058,47.4296,-122.111,2220,35371,37958,33151,12.64402214574293,0.05665573770491803,Very Cheap
20140718T000000,156000.0,3,1.0,770,9750,1.0,0,0,3,6,770,0,1941,0,98188,47.4509,-122.275,1560,10707,8980,9147,16.0,0.010622950819672131,Very Cheap
20141118T000000,580000.0,3,3.25,1490,857,3.0,0,0,3,8,1220,270,2001,0,98102,47.6357,-122.324,1550,1092,-633,-458,676.779463243874,0.06622950819672131,Very Cheap
20140714T000000,630000.0,4,2.5,2510,35020,1.0,0,0,4,8,1610,900,1977,0,98075,47.5834,-122.003,2080,34398,32510,32318,17.989720159908625,0.07278688524590164,Very Cheap
20141218T000000,275000.0,5,1.5,1950,9000,1.0,0,0,3,7,1130,820,1964,0,98146,47.4882,-122.339,1680,9526,7050,7846,30.555555555555557,0.02622950819672131,Very Cheap
20140724T000000,835000.0,5,4.0,3600,14720,1.0,0,2,5,8,1800,1800,1960,0,98034,47.7022,-122.227,3600,15358,11120,11758,56.72554347826087,0.09967213114754099,Very Cheap
20141205T000000,340000.0,4,2.5,2380,7850,2.0,0,0,3,8,2380,0,1995,0,98055,47.4356,-122.201,1940,7334,5470,5394,43.31210191082803,0.03475409836065574,Very Cheap
20140506T000000,329350.0,2,1.0,720,6687,1.0,0,0,3,6,720,0,1942,0,98117,47.7001,-122.362,840,6687,5967,5847,49.25228054433976,0.03335737704918033,Very Cheap
20140728T000000,1480000.0,3,3.5,4070,26000,2.0,0,0,3,11,4070,0,1991,0,98033,47.659,-122.174,3770,26000,21930,22230,56.92307692307692,0.1842622950819672,Cheap
20150325T000000,475000.0,3,1.0,1250,150117,1.0,0,0,3,7,1250,0,1975,0,98075,47.5956,-122.009,3060,50055,148867,46995,3.16419859176509,0.05245901639344262,Very Cheap
20141118T000000,719950.0,3,2.25,2190,2416,3.0,0,0,3,8,2190,0,2014,0,98117,47.6758,-122.38,1510,3615,226,2105,297.9925496688742,0.08458360655737705,Very Cheap
20140512T000000,235000.0,1,1.0,810,2451,1.0,0,0,5,7,810,0,1941,0,98126,47.5188,-122.376,980,1198,1641,218,95.87923296613627,0.02098360655737705,Very Cheap
20150331T000000,875000.0,3,1.5,2440,5750,1.0,0,0,3,8,1320,1120,1939,0,98115,47.6991,-122.296,2160,6820,3310,4660,152.17391304347825,0.10491803278688525,Cheap
20150421T000000,380000.0,4,1.75,1740,9150,1.0,0,0,3,7,1740,0,1974,0,98188,47.4498,-122.28,1540,9147,7410,7607,41.53005464480874,0.04,Very Cheap
20150309T000000,325000.0,3,2.25,1480,97138,1.5,0,0,3,7,1480,0,1984,0,98010,47.3317,-121.927,1730,176418,95658,174688,3.345755523070271,0.03278688524590164,Very Cheap
20140819T000000,475000.0,4,2.5,2120,57050,2.0,0,0,3,9,2120,0,1989,0,98072,47.7611,-122.128,3320,39082,54930,35762,8.326029798422436,0.05245901639344262,Very Cheap
20150324T000000,152900.0,1,1.0,900,4368,1.0,0,0,5,6,900,0,1915,1950,98022,47.2107,-121.99,1290,5000,3468,3710,35.00457875457875,0.010216393442622951,Very Cheap
20140805T000000,210000.0,2,2.0,1190,7570,1.0,0,0,3,6,1190,0,1939,0,98146,47.5113,-122.338,1190,7635,6380,6445,27.74108322324967,0.017704918032786884,Very Cheap
20140926T000000,350000.0,4,1.0,1010,6000,1.0,0,0,3,6,750,260,1925,0,98136,47.5518,-122.383,1450,6000,4990,4550,58.333333333333336,0.036065573770491806,Very Cheap
20150323T000000,505000.0,3,2.5,2100,17882,2.0,0,0,4,8,2100,0,1985,0,98059,47.4754,-122.119,2080,16686,15782,14606,28.240688960966335,0.05639344262295082,Very Cheap
20140627T000000,464900.0,4,2.25,2020,8424,1.0,0,0,4,7,1380,640,1979,0,98034,47.7262,-122.233,2030,7236,6404,5206,55.18755935422602,0.051134426229508194,Very Cheap
20140922T000000,650000.0,3,2.0,2520,5980,1.0,0,0,3,8,1790,730,1957,0,98116,47.5767,-122.383,1590,5750,3460,4160,108.69565217391305,0.07540983606557378,Very Cheap
20150504T000000,369950.0,2,2.75,1370,1140,2.0,0,0,3,8,1080,290,2009,0,98133,47.7053,-122.342,1370,1090,-230,-280,324.5175438596491,0.03868196721311475,Very Cheap
20140728T000000,250000.0,3,2.5,1530,2890,2.0,0,0,3,7,1530,0,2001,0,98108,47.5434,-122.293,1540,2890,1360,1350,86.50519031141869,0.022950819672131147,Very Cheap
20150429T000000,320000.0,3,2.5,1530,2890,2.0,0,0,3,7,1530,0,2001,0,98108,47.5434,-122.293,1540,2890,1360,1350,110.72664359861592,0.032131147540983604,Very Cheap
20150325T000000,2532000.0,4,4.25,5040,16048,1.0,0,3,3,10,3420,1620,1950,0,98105,47.6702,-122.26,3960,14000,11008,10040,157.77666999002992,0.3222295081967213,Medium
20140903T000000,340000.0,4,2.25,2530,24700,2.0,0,0,3,7,2530,0,1974,0,98031,47.3939,-122.177,2650,24700,22170,22050,13.765182186234817,0.03475409836065574,Very Cheap
20140519T000000,440000.0,2,1.5,1010,1968,1.5,0,0,5,5,1010,0,1906,0,98107,47.6757,-122.385,1760,4200,958,2440,223.5772357723577,0.04786885245901639,Very Cheap
20150402T000000,219950.0,3,1.0,1200,7727,1.0,0,0,4,7,1200,0,1959,0,98022,47.2021,-121.999,1300,7718,6527,6418,28.46512229843406,0.01900983606557377,Very Cheap
20140915T000000,940000.0,4,3.0,2720,11740,1.0,0,0,5,9,2720,0,1957,0,98040,47.5833,-122.242,2640,11740,9020,9100,80.06814310051108,0.11344262295081967,Cheap
20140722T000000,399950.0,4,1.5,1850,6125,1.5,0,0,3,6,1110,740,1945,0,98126,47.5352,-122.37,990,6125,4275,5135,65.29795918367347,0.04261639344262295,Very Cheap
20150102T000000,1568000.0,3,2.75,2340,8828,1.0,0,0,4,9,2340,0,1954,0,98112,47.632,-122.289,3480,8526,6488,5046,177.616674218396,0.1958032786885246,Cheap
20150401T000000,528000.0,4,1.75,1860,9750,1.0,0,0,3,7,1460,400,1969,0,98034,47.7097,-122.202,1900,8913,7890,7013,54.15384615384615,0.05940983606557377,Very Cheap
20140828T000000,545000.0,4,1.75,1940,8990,1.0,0,0,4,8,1560,380,1956,0,98034,47.7021,-122.241,2310,11745,7050,9435,60.622914349276975,0.06163934426229508,Very Cheap
20150427T000000,575000.0,2,2.0,1680,6194,1.0,0,0,3,8,1680,0,2004,0,98053,47.7136,-122.03,1900,5850,4514,3950,92.83177268324185,0.06557377049180328,Very Cheap
20141104T000000,235000.0,4,2.75,1770,10184,1.0,0,0,3,8,1250,520,1979,0,98023,47.3074,-122.385,2070,8320,8414,6250,23.07541241162608,0.02098360655737705,Very Cheap
20140723T000000,272000.0,3,2.5,1790,6371,2.0,0,0,3,8,1790,0,1998,0,98092,47.3291,-122.168,1850,6371,4581,4521,42.693454716684975,0.02583606557377049,Very Cheap
20150428T000000,380000.0,4,1.75,1720,9600,1.0,0,0,4,8,1720,0,1969,0,98059,47.4764,-122.155,1660,10720,7880,9060,39.583333333333336,0.04,Very Cheap
20150426T000000,195000.0,3,1.0,1280,6967,1.5,0,0,3,7,1280,0,1949,0,98155,47.7512,-122.329,1280,7245,5687,5965,27.98909143103201,0.015737704918032787,Very Cheap
20141014T000000,297000.0,3,2.5,1690,4988,2.0,0,0,3,7,1690,0,2002,0,98038,47.3561,-122.015,1830,4733,3298,2903,59.542902967121094,0.029114754098360656,Very Cheap
20150415T000000,349000.0,4,2.5,2190,7294,2.0,0,0,3,8,2190,0,2003,0,98023,47.2923,-122.357,2240,7379,5104,5139,47.84754592816013,0.035934426229508196,Very Cheap
20140929T000000,320000.0,2,1.0,710,5200,1.0,0,2,4,6,710,0,1942,0,98126,47.5376,-122.371,1610,5200,4490,3590,61.53846153846154,0.032131147540983604,Very Cheap
20140725T000000,319990.0,4,1.5,1890,10707,1.0,0,0,3,7,1890,0,1962,0,98148,47.428,-122.326,1610,8827,8817,7217,29.886055851312225,0.03212983606557377,Very Cheap
20140602T000000,439900.0,2,2.0,1410,12282,1.5,0,0,5,8,1410,0,1909,1988,98024,47.5242,-121.926,1410,8931,10872,7521,35.81664224067742,0.047855737704918036,Very Cheap
20140811T000000,429000.0,3,3.25,2210,3600,2.0,0,0,3,8,1820,390,1995,0,98125,47.7031,-122.279,2010,6690,1390,4680,119.16666666666667,0.04642622950819672,Very Cheap
20140730T000000,272500.0,3,2.0,1540,6250,1.0,0,0,3,7,1540,0,1998,0,98038,47.3539,-122.025,2070,6250,4710,4180,43.6,0.025901639344262296,Very Cheap
20140916T000000,400000.0,4,2.0,1350,7255,1.0,0,0,4,7,1350,0,1959,0,98125,47.7287,-122.31,1050,7288,5905,6238,55.13439007580978,0.04262295081967213,Very Cheap
20150402T000000,462000.0,5,2.0,1380,4300,1.5,0,0,3,7,1380,0,1916,0,98103,47.6647,-122.337,1830,3800,2920,1970,107.44186046511628,0.05075409836065574,Very Cheap
20150310T000000,510000.0,2,1.0,890,6095,1.0,0,0,3,7,890,0,1947,0,98115,47.6823,-122.298,1450,5985,5205,4535,83.67514356029533,0.057049180327868855,Very Cheap
20140623T000000,550000.0,3,2.5,1900,3255,2.0,0,0,3,8,1900,0,1988,2000,98007,47.6075,-122.147,1880,3350,1355,1470,168.97081413210446,0.06229508196721312,Very Cheap
20150425T000000,150000.0,3,1.0,1240,5200,1.0,0,0,3,6,1240,0,1969,0,98042,47.3701,-122.079,870,5200,3960,4330,28.846153846153847,0.009836065573770493,Very Cheap
20140626T000000,460000.0,3,2.5,1730,8490,1.0,0,0,3,7,1210,520,1969,0,98034,47.7187,-122.219,1870,7400,6760,5530,54.18138987043581,0.050491803278688525,Very Cheap
20140620T000000,632500.0,4,2.5,2090,10306,2.0,0,0,3,10,2090,0,1986,0,98074,47.6304,-122.051,2660,11481,8216,8821,61.37201630118378,0.07311475409836066,Very Cheap
20140925T000000,361000.0,3,1.75,1650,11220,1.0,0,0,4,7,1650,0,1969,0,98077,47.7567,-122.071,1340,10129,9570,8789,32.174688057040996,0.037508196721311476,Very Cheap
20140801T000000,437000.0,3,2.25,1130,1221,2.0,0,0,3,8,1030,100,2004,0,98117,47.6799,-122.375,1300,5000,91,3700,357.9033579033579,0.047475409836065574,Very Cheap
20150505T000000,370000.0,6,2.75,3240,5750,1.0,0,0,4,6,2160,1080,1950,0,98002,47.3054,-122.221,1230,5750,2510,4520,64.34782608695652,0.038688524590163934,Very Cheap
20150417T000000,884250.0,4,2.5,3840,12151,2.0,0,0,3,10,3840,0,1998,0,98075,47.5953,-121.986,3560,11044,8311,7484,72.77178833017858,0.1061311475409836,Cheap
20140603T000000,225000.0,3,1.0,1200,9936,1.0,0,0,4,6,1200,0,1969,0,98038,47.3609,-122.029,1200,10189,8736,8989,22.644927536231883,0.019672131147540985,Very Cheap
20140805T000000,235000.0,2,1.0,870,5000,1.0,0,0,3,6,870,0,1949,0,98126,47.5186,-122.375,820,5000,4130,4180,47.0,0.02098360655737705,Very Cheap
20140720T000000,767500.0,6,3.5,2410,6000,2.0,0,4,3,9,2220,190,1916,1990,98136,47.54,-122.382,1980,6000,3590,4020,127.91666666666667,0.09081967213114754,Very Cheap
20140512T000000,1200000.0,3,1.75,1560,8078,1.5,1,4,4,6,1560,0,1928,0,98040,47.5779,-122.246,2890,16710,6518,13820,148.55162168853676,0.14754098360655737,Cheap
20141215T000000,715000.0,3,2.5,2410,46609,2.0,0,0,3,9,2410,0,1989,0,98053,47.6789,-122.048,3370,40072,44199,36702,15.34038490420305,0.0839344262295082,Very Cheap
20140627T000000,417000.0,4,2.25,2300,7700,1.0,0,0,3,7,1380,920,1959,0,98125,47.7137,-122.322,2010,8820,5400,6810,54.15584415584416,0.04485245901639344,Very Cheap
20140718T000000,199000.0,3,1.0,1390,12145,1.0,0,0,4,7,1390,0,1964,0,98042,47.4225,-122.15,1030,10800,10755,9770,16.385343762865375,0.016262295081967214,Very Cheap
20140605T000000,875000.0,5,2.5,2920,5568,2.0,0,0,3,8,2320,600,1906,0,98112,47.6265,-122.312,2970,5568,2648,2598,157.14798850574712,0.10491803278688525,Cheap
20141110T000000,545000.0,4,1.5,1370,3708,1.5,0,0,3,7,1370,0,1926,0,98117,47.6849,-122.363,2030,3708,2338,1678,146.9795037756203,0.06163934426229508,Very Cheap
20140520T000000,192500.0,2,1.0,950,7692,1.0,0,0,3,6,950,0,1926,0,98168,47.4909,-122.298,1820,8221,6742,6401,25.026001040041603,0.01540983606557377,Very Cheap
20150210T000000,822500.0,3,2.5,3090,7708,2.0,0,0,3,10,3090,0,1999,0,98052,47.6868,-122.108,3140,8592,4618,5452,106.70731707317073,0.0980327868852459,Very Cheap
20141208T000000,800000.0,4,2.5,2390,10000,1.0,0,0,3,9,1590,800,1975,0,98040,47.5801,-122.229,1900,9752,7610,7852,80.0,0.09508196721311475,Very Cheap
20141215T000000,1250000.0,3,2.5,2070,4944,2.0,0,0,3,9,2070,0,1930,0,98112,47.6256,-122.284,3300,6179,2874,2879,252.83171521035598,0.1540983606557377,Cheap
20141114T000000,3850000.0,4,4.25,5770,21300,2.0,1,4,4,11,5770,0,1980,0,98040,47.585,-122.222,4620,22748,15530,18128,180.7511737089202,0.49508196721311476,High
20141001T000000,295000.0,3,2.5,1460,7936,2.0,0,0,3,7,1460,0,1995,0,98038,47.3673,-122.017,1830,7936,6476,6106,37.172379032258064,0.028852459016393443,Very Cheap
20140630T000000,419000.0,2,1.75,1510,4980,1.0,0,0,3,8,1510,0,2006,0,98053,47.7191,-122.023,1350,4157,3470,2807,84.13654618473896,0.04511475409836065,Very Cheap
20140910T000000,1195000.0,5,3.25,5180,19606,1.0,0,0,3,11,2610,2570,1993,0,98006,47.555,-122.114,4050,15296,14426,11246,60.950729368560644,0.14688524590163934,Cheap
20141222T000000,750000.0,4,2.75,3430,13907,2.0,0,0,3,11,3430,0,1995,0,98075,47.5879,-121.993,3250,13851,10477,10601,53.92967570288344,0.08852459016393442,Very Cheap
20150428T000000,502000.0,4,1.5,1700,8400,1.0,0,0,3,7,1700,0,1953,0,98177,47.7677,-122.359,1750,8475,6700,6725,59.76190476190476,0.056,Very Cheap
20140604T000000,1025000.0,3,1.75,2640,8000,1.0,0,3,4,9,1320,1320,1960,0,98040,47.5826,-122.246,2740,6000,5360,3260,128.125,0.12459016393442623,Cheap
20150313T000000,398500.0,3,1.0,1200,15960,1.5,0,0,3,6,1200,0,1945,0,98125,47.7163,-122.299,1120,7800,14760,6680,24.968671679197996,0.042426229508196724,Very Cheap
20150414T000000,700000.0,2,1.5,1850,4945,1.5,0,2,4,7,1850,0,1907,1969,98126,47.5742,-122.379,1850,4950,3095,3100,141.5571284125379,0.08196721311475409,Very Cheap
20140611T000000,248000.0,5,1.5,1510,9078,1.0,0,0,4,7,1510,0,1959,0,98168,47.4852,-122.305,1480,9078,7568,7598,27.31879268561357,0.022688524590163933,Very Cheap
20140826T000000,800000.0,4,2.0,2130,2800,1.0,0,0,5,7,1070,1060,1922,0,98103,47.6545,-122.333,1990,3990,670,2000,285.7142857142857,0.09508196721311475,Very Cheap
20150121T000000,383000.0,4,2.5,2640,8055,2.0,0,0,3,9,2640,0,2004,0,98092,47.315,-122.193,1650,8055,5415,6405,47.54810676598386,0.04039344262295082,Very Cheap
20140527T000000,688000.0,4,3.0,3000,4000,1.5,0,3,3,8,1970,1030,1913,2014,98144,47.5744,-122.307,1900,4000,1000,2100,172.0,0.08039344262295083,Very Cheap
20141008T000000,521000.0,3,2.0,1870,5455,1.0,0,0,5,7,1060,810,1926,0,98125,47.7029,-122.297,1870,7435,3585,5565,95.50870760769936,0.058491803278688526,Very Cheap
20141105T000000,365000.0,2,1.0,990,9223,1.0,0,0,3,7,990,0,1949,0,98125,47.72,-122.32,1230,7244,8233,6014,39.57497560446709,0.0380327868852459,Very Cheap
20141007T000000,491000.0,3,2.0,2005,7000,1.0,0,0,3,7,1605,400,1980,0,98122,47.6039,-122.298,1750,4500,4995,2750,70.14285714285714,0.05455737704918033,Very Cheap
20141122T000000,643000.0,3,2.75,2030,7700,1.0,0,0,5,8,1400,630,1965,0,98008,47.626,-122.112,1780,8160,5670,6380,83.50649350649351,0.07449180327868853,Very Cheap
20150202T000000,279000.0,3,2.5,1500,7350,1.0,0,0,2,7,1060,440,1979,0,98023,47.3025,-122.382,1390,7770,5850,6380,37.95918367346939,0.02675409836065574,Very Cheap
20150202T000000,583500.0,4,1.0,1530,3900,1.5,0,0,4,7,1530,0,1908,0,98107,47.6748,-122.379,1300,3900,2370,2600,149.6153846153846,0.06668852459016393,Very Cheap
20140723T000000,310000.0,3,2.5,1990,3600,2.0,0,0,3,7,1990,0,2004,0,98038,47.3841,-122.041,1790,3600,1610,1810,86.11111111111111,0.03081967213114754,Very Cheap
20140610T000000,310000.0,3,1.75,1420,7650,1.0,0,0,4,7,1100,320,1984,0,98056,47.4892,-122.182,1810,7650,6230,5840,40.52287581699346,0.03081967213114754,Very Cheap
20150323T000000,280000.0,3,1.0,1400,13975,1.0,0,0,4,6,1400,0,1956,0,98198,47.4195,-122.33,1260,7500,12575,6240,20.03577817531306,0.026885245901639345,Very Cheap
20141117T000000,272000.0,4,2.5,1870,5692,2.0,0,0,3,7,1870,0,2004,0,98058,47.4334,-122.148,2390,5293,3822,2903,47.786366830639494,0.02583606557377049,Very Cheap
20140707T000000,870000.0,4,3.0,3040,36246,1.5,0,0,3,9,2680,360,1923,2014,98074,47.6093,-122.07,3520,13178,33206,9658,24.002648568117863,0.10426229508196722,Cheap
20141118T000000,307000.0,3,2.0,1790,7259,1.0,0,0,3,7,1390,400,1980,0,98058,47.4643,-122.171,1790,7700,5469,5910,42.292326766772284,0.03042622950819672,Very Cheap
20140717T000000,490000.0,2,1.5,1590,4500,1.0,0,0,4,7,920,670,1946,0,98116,47.5831,-122.392,1900,4450,2910,2550,108.88888888888889,0.05442622950819672,Very Cheap
20141008T000000,399950.0,3,2.0,2050,9396,1.0,0,0,5,7,1170,880,1960,0,98155,47.7447,-122.328,1680,9391,7346,7711,42.56598552575564,0.04261639344262295,Very Cheap
20140609T000000,1635000.0,5,3.5,4220,26784,1.0,0,0,3,10,2110,2110,1958,2006,98004,47.6003,-122.206,3450,33945,22564,30495,61.04390681003584,0.20459016393442622,Cheap
20140709T000000,989000.0,5,4.5,4030,13474,2.0,0,0,3,11,4030,0,2000,0,98075,47.5812,-121.995,3860,12438,9444,8578,73.40062342288853,0.11986885245901639,Cheap
20140618T000000,264950.0,4,1.75,1770,9011,1.0,0,0,5,7,1050,720,1983,0,98042,47.3646,-122.076,1410,8530,7241,7120,29.402951947619577,0.024911475409836067,Very Cheap
20140725T000000,491500.0,4,2.75,2100,7236,1.0,0,0,3,8,1400,700,1979,0,98034,47.7267,-122.232,1900,7519,5136,5619,67.92426755113323,0.05462295081967213,Very Cheap
20140514T000000,345000.0,3,2.25,2120,15003,2.0,0,0,3,7,2120,0,1984,0,98059,47.4745,-122.12,2070,15203,12883,13133,22.99540091981604,0.03540983606557377,Very Cheap
20150119T000000,339900.0,4,1.75,2600,18042,1.0,0,0,4,8,2020,580,1969,0,98092,47.2969,-122.189,2200,9408,15442,7208,18.839374792151645,0.03474098360655738,Very Cheap
20150427T000000,852000.0,3,3.0,2400,4000,2.0,0,0,3,7,1860,540,1905,0,98102,47.6288,-122.321,1750,3940,1600,2190,213.0,0.1019016393442623,Cheap
20141222T000000,585000.0,5,3.5,3180,40946,1.0,0,3,3,7,1690,1490,1968,0,98075,47.5833,-122.073,2430,29620,37766,27190,14.287109852000196,0.06688524590163934,Very Cheap
20150211T000000,723000.0,4,2.0,2790,8793,1.0,0,0,4,8,1640,1150,1977,0,98006,47.5509,-122.16,2400,9286,6003,6886,82.22449675878539,0.08498360655737705,Very Cheap
20150126T000000,594000.0,3,2.25,2080,70567,2.0,0,0,3,8,2080,0,1990,0,98072,47.7221,-122.124,3730,43560,68487,39830,8.417532274292517,0.0680655737704918,Very Cheap
20141201T000000,405000.0,2,1.5,1370,4102,2.0,0,0,4,7,1370,0,1987,0,98033,47.6943,-122.184,1380,3211,2732,1831,98.73232569478303,0.043278688524590166,Very Cheap
20140801T000000,725500.0,4,2.5,2790,74495,2.0,0,0,3,9,2790,0,1997,0,98053,47.6628,-122.056,2790,24643,71705,21853,9.738908651587355,0.08531147540983607,Very Cheap
20140625T000000,800000.0,2,1.0,1740,5719,1.0,0,0,3,8,1740,0,1955,0,98103,47.6729,-122.335,1980,5000,3979,3020,139.88459520895262,0.09508196721311475,Very Cheap
20140729T000000,1325000.0,3,3.75,6400,76665,1.0,0,2,4,10,3810,2590,1966,0,98177,47.7313,-122.37,3430,60548,70265,57118,17.282984412704625,0.16393442622950818,Cheap
20141015T000000,180500.0,3,2.5,1800,8518,2.0,0,0,3,7,1800,0,1996,0,98030,47.3643,-122.185,1770,7570,6718,5800,21.19042028645222,0.013836065573770491,Very Cheap
20150428T000000,325000.0,3,2.5,1800,8518,2.0,0,0,3,7,1800,0,1996,0,98030,47.3643,-122.185,1770,7570,6718,5800,38.15449636064804,0.03278688524590164,Very Cheap
20140617T000000,235000.0,3,1.75,1190,7280,1.0,0,0,4,7,1190,0,1968,0,98092,47.3151,-122.19,1250,7800,6090,6550,32.28021978021978,0.02098360655737705,Very Cheap
20140520T000000,330000.0,2,1.0,860,8308,1.0,0,0,4,7,860,0,1948,0,98146,47.5075,-122.377,1310,8308,7448,6998,39.72075108329321,0.03344262295081967,Very Cheap
20140612T000000,678500.0,3,2.0,2460,6600,1.0,0,2,4,8,1370,1090,1952,0,98136,47.5215,-122.383,2150,6600,4140,4450,102.8030303030303,0.07914754098360656,Very Cheap
20140709T000000,463000.0,4,2.5,1980,6660,2.0,0,0,4,7,1980,0,1974,0,98034,47.7158,-122.167,1980,7150,4680,5170,69.51951951951952,0.05088524590163934,Very Cheap
20140912T000000,250000.0,2,1.0,670,4640,1.0,0,0,3,6,670,0,1943,0,98106,47.53,-122.351,870,4501,3970,3631,53.87931034482759,0.022950819672131147,Very Cheap
20140716T000000,655000.0,3,2.0,1410,4800,1.5,0,0,4,8,1410,0,1927,0,98118,47.5597,-122.267,1820,7200,3390,5380,136.45833333333334,0.0760655737704918,Very Cheap
20140516T000000,239900.0,4,2.25,1860,7000,1.0,0,0,3,8,1120,740,1979,0,98023,47.3127,-122.339,1990,8937,5140,6947,34.27142857142857,0.02162622950819672,Very Cheap
20141117T000000,185000.0,3,1.0,980,9135,1.0,0,0,3,7,980,0,1955,0,98001,47.3496,-122.289,1780,9135,8155,7355,20.251778872468527,0.014426229508196721,Very Cheap
20140616T000000,1735000.0,4,2.25,3040,5000,2.0,0,3,4,9,2080,960,1926,0,98105,47.6565,-122.278,2870,5000,1960,2130,347.0,0.21770491803278688,Cheap
20140905T000000,251700.0,3,2.25,1810,11800,1.0,0,0,3,7,1240,570,1977,0,98178,47.4997,-122.231,1810,5641,9990,3831,21.33050847457627,0.02317377049180328,Very Cheap
20150209T000000,400000.0,4,2.0,1560,8250,1.0,0,0,3,8,1320,240,1964,0,98177,47.7565,-122.358,1870,8258,6690,6388,48.484848484848484,0.04262295081967213,Very Cheap
20140904T000000,735000.0,4,1.75,2100,7960,1.0,0,0,3,8,1340,760,1955,0,98004,47.6079,-122.195,2060,7960,5860,5900,92.33668341708542,0.08655737704918033,Very Cheap
20141027T000000,1700000.0,5,2.0,2500,15250,2.0,1,4,5,8,2500,0,1942,0,98008,47.5883,-122.111,1880,18782,12750,16902,111.47540983606558,0.21311475409836064,Cheap
20140508T000000,82500.0,2,1.0,520,22334,1.0,0,0,2,5,520,0,1951,0,98168,47.4799,-122.296,1572,10570,21814,8998,3.6939195844900152,0.0009836065573770492,Very Cheap
20140708T000000,765000.0,4,4.0,3010,7221,2.0,0,0,3,10,3010,0,2004,0,98075,47.5833,-121.97,3490,7518,4211,4028,105.941005400914,0.09049180327868853,Very Cheap
20140923T000000,292500.0,4,1.75,2140,8162,1.0,0,0,3,7,1420,720,1968,0,98023,47.3096,-122.377,2040,7632,6022,5592,35.83680470472923,0.028524590163934428,Very Cheap
20150325T000000,270000.0,3,2.25,2390,7000,1.0,0,0,4,7,1990,400,1970,0,98058,47.4568,-122.169,1610,7000,4610,5390,38.57142857142857,0.025573770491803278,Very Cheap
20141224T000000,415000.0,2,1.0,1510,6807,1.0,0,0,3,7,1090,420,1939,0,98133,47.711,-122.353,1460,6807,5297,5347,60.966651975907155,0.04459016393442623,Very Cheap
20141124T000000,950000.0,4,1.75,2210,19025,1.0,0,0,4,7,1460,750,1952,0,98004,47.5927,-122.203,2640,14999,16815,12359,49.93429697766097,0.11475409836065574,Cheap
20140916T000000,353000.0,3,2.75,2170,8396,2.0,0,0,3,7,2170,0,1995,0,98038,47.3812,-122.023,2170,8378,6226,6208,42.04383039542639,0.03645901639344262,Very Cheap
20141210T000000,670950.0,3,2.5,1790,2375,3.0,0,0,3,8,1790,0,2007,0,98107,47.6726,-122.38,1450,2400,585,950,282.5052631578947,0.07815737704918033,Very Cheap
20140509T000000,280950.0,3,1.75,1390,8700,1.0,0,3,4,7,840,550,1912,0,98055,47.4725,-122.202,1390,10875,7310,9485,32.293103448275865,0.02700983606557377,Very Cheap
20140527T000000,585000.0,3,1.75,1850,7735,1.0,0,0,4,8,1850,0,1983,0,98027,47.5608,-122.082,2220,7639,5885,5419,75.63025210084034,0.06688524590163934,Very Cheap
20141211T000000,525000.0,2,1.5,1480,43645,1.0,0,0,3,8,1480,0,1974,2006,98027,47.5484,-122.045,1600,34326,42165,32726,12.028869286287089,0.05901639344262295,Very Cheap
20140801T000000,605000.0,3,1.75,1850,8823,1.0,0,0,4,8,1370,480,1973,0,98008,47.6379,-122.112,1880,7580,6973,5700,68.57078091352147,0.06950819672131148,Very Cheap
20141119T000000,1010000.0,4,3.5,3350,3752,2.0,0,0,3,9,2550,800,2007,0,98117,47.6782,-122.365,1050,4960,402,3910,269.1897654584222,0.12262295081967213,Cheap
20140926T000000,245990.0,3,1.0,1040,8410,1.0,0,0,3,7,1040,0,1942,2014,98188,47.453,-122.289,1350,8410,7370,7060,29.249702734839477,0.022424918032786886,Very Cheap
20150203T000000,535000.0,4,2.25,2810,12607,2.0,0,0,3,10,2810,0,1985,0,98058,47.4585,-122.13,2810,17400,9797,14590,42.43674149282145,0.06032786885245902,Very Cheap
20140630T000000,410000.0,1,1.5,1010,5750,1.0,0,0,3,7,1010,0,1911,1948,98136,47.5411,-122.392,1230,5750,4740,4520,71.30434782608695,0.043934426229508196,Very Cheap
20150424T000000,550000.0,3,2.5,2250,7752,2.0,0,0,4,8,2250,0,1988,0,98011,47.7489,-122.185,2080,7033,5502,4953,70.94943240454076,0.06229508196721312,Very Cheap
20140911T000000,665000.0,3,1.75,1800,8000,1.0,0,0,3,8,1800,0,1972,0,98008,47.6357,-122.119,1950,8500,6200,6550,83.125,0.07737704918032787,Very Cheap
20150427T000000,455000.0,3,1.0,2400,17239,1.0,0,0,4,7,1890,510,1940,0,98028,47.75,-122.245,2390,7350,14839,4960,26.393642322640524,0.049836065573770495,Very Cheap
20140826T000000,440000.0,4,1.0,1780,4000,1.5,0,0,3,7,1780,0,1922,0,98103,47.6624,-122.354,1750,4000,2220,2250,110.0,0.04786885245901639,Very Cheap
20140708T000000,332000.0,3,2.25,2120,14915,1.0,0,0,3,9,1720,400,1979,0,98001,47.3524,-122.285,2320,13100,12795,10780,22.259470331880657,0.033704918032786885,Very Cheap
20140611T000000,280000.0,3,2.5,1860,6607,2.0,0,0,3,7,1860,0,1989,0,98023,47.2891,-122.351,1760,6766,4747,5006,42.3792946874527,0.026885245901639345,Very Cheap
20140915T000000,570000.0,3,3.5,1460,1021,2.0,0,0,3,8,1150,310,2006,0,98122,47.6169,-122.309,1460,1245,-439,-215,558.2761998041136,0.06491803278688525,Very Cheap
20140515T000000,250000.0,3,1.0,1230,10350,1.0,0,0,4,7,1230,0,1957,0,98055,47.428,-122.199,1510,10427,9120,8917,24.154589371980677,0.022950819672131147,Very Cheap
20150501T000000,238000.0,2,1.0,1088,8453,1.0,0,0,3,6,1088,0,1952,2009,98001,47.2685,-122.231,1088,8016,7365,6928,28.15568437241216,0.02137704918032787,Very Cheap
20141103T000000,265000.0,3,1.0,800,5760,1.0,0,0,3,6,700,100,1949,0,98155,47.7505,-122.317,1060,6628,4960,5568,46.00694444444444,0.024918032786885248,Very Cheap
20150305T000000,306000.0,3,1.0,1190,10350,1.0,0,0,4,7,1190,0,1959,0,98028,47.7428,-122.244,1850,10500,9160,8650,29.565217391304348,0.030295081967213113,Very Cheap
20150507T000000,345000.0,5,2.75,1940,4182,1.0,0,0,3,7,1240,700,2002,0,98056,47.4911,-122.17,1950,4182,2242,2232,82.49641319942612,0.03540983606557377,Very Cheap
20140904T000000,765000.0,4,2.5,3300,10764,1.0,0,0,4,9,1720,1580,1971,0,98177,47.7119,-122.365,2290,10975,7464,8685,71.07023411371237,0.09049180327868853,Very Cheap
20150430T000000,346300.0,4,2.5,2590,11018,2.0,0,0,3,8,2590,0,1998,0,98092,47.2634,-122.211,2400,8042,8428,5642,31.430386640043565,0.03558032786885246,Very Cheap
20140612T000000,342500.0,3,2.0,2080,11375,1.0,0,0,3,8,2080,0,2002,0,98022,47.214,-121.993,1080,12899,9295,11819,30.10989010989011,0.035081967213114754,Very Cheap
20150424T000000,501000.0,4,2.25,2680,5439,2.0,0,0,3,7,2680,0,2000,0,98011,47.7534,-122.218,2460,4473,2759,2013,92.11252068394926,0.05586885245901639,Very Cheap
20140625T000000,270000.0,3,2.5,1670,8364,1.0,0,0,4,7,1300,370,1990,0,98042,47.369,-122.084,1490,8143,6694,6653,32.281205164992826,0.025573770491803278,Very Cheap
20150422T000000,638000.0,3,1.0,1830,4400,1.5,0,0,4,8,1720,110,1930,0,98122,47.6052,-122.3,1650,4400,2570,2750,145.0,0.0738360655737705,Very Cheap
20140912T000000,460000.0,3,1.75,1400,2003,1.0,0,0,4,8,700,700,1908,2006,98119,47.6508,-122.368,1370,1281,603,-89,229.65551672491264,0.050491803278688525,Very Cheap
20141015T000000,760000.0,4,1.75,2770,8521,1.0,0,0,4,7,1470,1300,1953,0,98004,47.6255,-122.199,1910,9380,5751,7470,89.19140945898368,0.0898360655737705,Very Cheap
20150316T000000,1085000.0,3,2.5,3630,11019,1.0,0,0,4,9,2150,1480,1972,0,98040,47.561,-122.226,3150,13555,7389,10405,98.4662855068518,0.13245901639344262,Cheap
20140628T000000,234000.0,3,1.0,1040,8128,1.0,0,0,3,6,1040,0,1983,0,98019,47.7425,-121.981,1520,7500,7088,5980,28.78937007874016,0.020852459016393442,Very Cheap
20150302T000000,1650000.0,3,2.75,2690,8890,2.0,1,4,4,10,2690,0,1975,1991,98006,47.5487,-122.197,2940,8890,6200,5950,185.60179977502813,0.20655737704918034,Cheap
20140506T000000,488000.0,5,2.0,2020,5000,1.5,0,0,4,7,2020,0,1938,0,98117,47.6949,-122.37,1510,6600,2980,5090,97.6,0.05416393442622951,Very Cheap
20150226T000000,1550000.0,5,2.5,2450,20805,2.0,0,0,4,9,2450,0,1963,0,98004,47.6275,-122.227,3020,20324,18355,17304,74.50132179764479,0.19344262295081968,Cheap
20150327T000000,499000.0,4,3.0,2030,12675,2.0,0,0,3,7,2030,0,1982,0,98177,47.7689,-122.379,1990,7705,10645,5715,39.36883629191321,0.05560655737704918,Very Cheap
20140904T000000,150000.0,3,1.0,1450,6776,1.0,0,0,3,7,1450,0,1952,0,98178,47.5056,-122.244,1680,7200,5326,5520,22.136953955135773,0.009836065573770493,Very Cheap
20150326T000000,333000.0,4,2.5,2400,7270,2.0,0,0,3,8,2400,0,1993,0,98003,47.2697,-122.312,2150,6584,4870,4434,45.804676753782665,0.033836065573770495,Very Cheap
20150218T000000,700000.0,4,2.75,2870,8625,1.0,0,1,4,8,1860,1010,1959,0,98155,47.7425,-122.289,2430,8479,5755,6049,81.15942028985508,0.08196721311475409,Very Cheap
20140918T000000,275000.0,4,1.0,1340,22500,1.5,0,0,3,7,1340,0,1926,0,98168,47.489,-122.316,1620,10800,21160,9180,12.222222222222221,0.02622950819672131,Very Cheap
20140701T000000,330000.0,3,2.5,1680,11312,1.0,0,0,3,7,1080,600,1959,0,98146,47.5051,-122.344,1390,10700,9632,9310,29.172560113154173,0.03344262295081967,Very Cheap
20141124T000000,360000.0,4,2.0,1850,8827,1.0,0,0,3,7,1850,0,1969,0,98155,47.7406,-122.313,1310,6901,6977,5591,40.7839583097315,0.037377049180327866,Very Cheap
20150511T000000,467000.0,3,1.0,1220,8040,1.5,0,0,3,7,1220,0,1965,0,98125,47.7133,-122.308,1360,8040,6820,6680,58.08457711442786,0.05140983606557377,Very Cheap
20141029T000000,568000.0,3,2.5,2320,57063,1.0,0,0,4,9,1790,530,1979,0,98074,47.6163,-122.056,3290,7314,54743,4024,9.953910590049594,0.06465573770491803,Very Cheap
20141103T000000,605000.0,5,2.25,3220,9603,2.0,0,0,3,8,3220,0,1972,0,98052,47.6474,-122.11,2260,10093,6383,7833,63.00114547537228,0.06950819672131148,Very Cheap
20141002T000000,750000.0,4,2.75,3190,9023,2.0,0,0,3,9,3190,0,2005,0,98075,47.5898,-121.989,3159,5615,5833,2456,83.1209132217666,0.08852459016393442,Very Cheap
20141014T000000,760000.0,3,2.75,3530,69834,2.0,0,0,3,10,3530,0,1994,0,98053,47.6377,-121.995,3560,74256,66304,70696,10.882950998081164,0.0898360655737705,Very Cheap
20140804T000000,265000.0,3,1.75,2050,10519,1.0,0,0,3,7,1240,810,1979,0,98058,47.4257,-122.146,1770,9605,8469,7835,25.19250879361156,0.024918032786885248,Very Cheap
20140718T000000,490000.0,3,1.75,1720,12540,1.0,0,0,4,7,1720,0,1956,0,98006,47.5699,-122.177,1440,11850,10820,10410,39.07496012759171,0.05442622950819672,Very Cheap
20140619T000000,360000.0,4,2.5,2850,4650,2.0,0,0,3,8,2850,0,2004,0,98038,47.3552,-122.026,2850,4650,1800,1800,77.41935483870968,0.037377049180327866,Very Cheap
20150206T000000,311750.0,4,2.25,2270,12000,1.0,0,0,4,7,1290,980,1976,0,98023,47.3287,-122.353,2030,23980,9730,21950,25.979166666666668,0.031049180327868853,Very Cheap
20141003T000000,399000.0,3,2.25,1880,12473,1.0,0,0,3,8,1420,460,1958,0,98028,47.7623,-122.256,2300,10469,10593,8169,31.98909644832839,0.042491803278688525,Very Cheap
20140725T000000,347000.0,4,2.5,2770,9751,2.0,0,0,3,8,2770,0,1989,0,98042,47.3739,-122.126,2370,6950,6981,4580,35.586093733976,0.03567213114754098,Very Cheap
20140904T000000,1680000.0,4,3.75,4490,34982,2.0,0,0,3,12,4490,0,1998,0,98005,47.6406,-122.156,4470,37525,30492,33055,48.0246984163284,0.21049180327868852,Cheap
20140903T000000,585000.0,4,2.5,3110,6479,2.0,0,0,3,9,3110,0,2005,0,98065,47.5408,-121.861,3110,7075,3369,3965,90.29171168390184,0.06688524590163934,Very Cheap
20140912T000000,340000.0,4,2.5,2360,7475,2.0,0,0,3,8,2360,0,1992,0,98031,47.4052,-122.17,2280,7570,5115,5290,45.48494983277592,0.03475409836065574,Very Cheap
20150415T000000,612000.0,3,2.5,2180,5496,2.0,0,0,3,8,2180,0,1994,0,98029,47.5723,-122.007,2120,5496,3316,3376,111.353711790393,0.07042622950819673,Very Cheap
20140628T000000,230000.0,2,1.75,1910,3376,2.0,0,0,3,8,1910,0,1980,0,98038,47.3733,-122.057,1470,3623,1466,2153,68.12796208530806,0.020327868852459016,Very Cheap
20140509T000000,604000.0,4,2.5,2260,7753,2.0,0,0,3,9,2260,0,1989,0,98029,47.5752,-121.995,2690,8924,5493,6234,77.90532697020508,0.06937704918032787,Very Cheap
20140703T000000,250000.0,3,1.75,1770,8868,1.0,0,0,4,7,1770,0,1959,0,98002,47.3188,-122.212,1630,9706,7098,8076,28.19124943617501,0.022950819672131147,Very Cheap
20150309T000000,258500.0,3,2.0,1460,7930,1.0,0,0,3,7,1460,0,1989,0,98038,47.359,-122.049,1630,7930,6470,6300,32.59773013871374,0.024065573770491802,Very Cheap
20150324T000000,783000.0,4,2.75,2080,5000,1.0,0,0,5,8,1470,610,1940,0,98199,47.6422,-122.403,1970,5000,2920,3030,156.6,0.09285245901639344,Very Cheap
20141030T000000,1050000.0,5,2.25,2960,7680,1.0,0,2,5,8,1550,1410,1958,0,98199,47.6456,-122.389,2860,7680,4720,4820,136.71875,0.12786885245901639,Cheap
20150318T000000,760000.0,4,2.5,3220,4031,2.0,0,0,3,9,3220,0,2002,0,98033,47.688,-122.163,3150,5083,811,1933,188.5388241131233,0.0898360655737705,Very Cheap
20140526T000000,276000.0,3,1.0,1140,5000,1.0,0,0,3,7,1140,0,1960,0,98106,47.5535,-122.362,1140,5000,3860,3860,55.2,0.026360655737704918,Very Cheap
20150323T000000,550000.0,4,2.0,1660,12377,1.0,0,0,3,8,1660,0,1966,0,98008,47.6231,-122.102,1820,8968,10717,7148,44.43726266461986,0.06229508196721312,Very Cheap
20150428T000000,398000.0,4,1.0,1430,6240,1.5,0,0,5,7,1430,0,1953,0,98125,47.7272,-122.311,1410,6240,4810,4830,63.782051282051285,0.042360655737704915,Very Cheap
20150313T000000,775000.0,3,3.0,1820,4300,1.5,0,0,4,8,1620,200,1914,1983,98107,47.6711,-122.364,1440,4300,2480,2860,180.2325581395349,0.09180327868852459,Very Cheap
20150409T000000,1027500.0,4,3.0,3540,10202,2.0,0,0,3,8,2720,820,1988,0,98006,47.5471,-122.155,2780,10714,6662,7934,100.71554597137816,0.12491803278688525,Cheap
20141023T000000,327000.0,4,1.0,1620,6000,1.5,0,0,5,7,1620,0,1905,0,98055,47.4763,-122.206,1310,6000,4380,4690,54.5,0.033049180327868855,Very Cheap
20150421T000000,564500.0,4,2.75,3100,14568,2.0,0,0,3,8,3100,0,1995,0,98019,47.7302,-121.974,2860,14396,11468,11536,38.74931356397584,0.06419672131147541,Very Cheap
20141017T000000,782000.0,4,1.75,1500,6820,1.5,0,0,5,7,1500,0,1905,0,98117,47.6794,-122.37,1360,4125,5320,2765,114.66275659824046,0.09272131147540984,Very Cheap
20150128T000000,398000.0,4,2.5,2820,5510,2.0,0,0,3,9,2820,0,2005,0,98038,47.3477,-122.024,2820,5510,2690,2690,72.23230490018149,0.042360655737704915,Very Cheap
20150130T000000,257000.0,3,1.75,1850,10920,1.5,0,0,3,6,1850,0,1915,0,98034,47.7244,-122.222,1510,7871,9070,6361,23.534798534798536,0.023868852459016394,Very Cheap
20140625T000000,235000.0,4,2.0,1570,9415,2.0,0,0,4,7,1570,0,1984,0,98092,47.3168,-122.174,1550,8978,7845,7428,24.96016994158258,0.02098360655737705,Very Cheap
20140627T000000,453000.0,4,2.75,2300,37533,1.0,0,3,5,8,1550,750,1979,0,98070,47.3714,-122.431,2130,10092,35233,7962,12.069378946527056,0.04957377049180328,Very Cheap
20150316T000000,535000.0,2,1.0,920,9000,1.0,0,0,1,6,920,0,1954,0,98033,47.6831,-122.189,1760,8400,8080,6640,59.44444444444444,0.06032786885245902,Very Cheap
20140507T000000,275000.0,3,2.5,1600,7000,2.0,0,0,4,8,1600,0,1993,0,98038,47.3534,-122.057,1700,7000,5400,5300,39.285714285714285,0.02622950819672131,Very Cheap
20140915T000000,665000.0,3,2.5,2630,10047,2.0,0,0,3,9,2630,0,1996,0,98027,47.5515,-122.083,2640,10620,7417,7980,66.18891211306858,0.07737704918032787,Very Cheap
20140806T000000,670000.0,4,2.75,3020,13530,1.0,0,0,4,8,1540,1480,1977,0,98052,47.6299,-122.099,2230,11896,10510,9666,49.51958610495196,0.0780327868852459,Very Cheap
20150427T000000,465000.0,3,1.75,1490,10757,1.0,0,0,3,7,1060,430,1966,0,98034,47.72,-122.229,1490,10609,9267,9119,43.22766570605187,0.051147540983606556,Very Cheap
20141023T000000,210000.0,3,1.5,1160,5200,1.0,0,0,5,7,1160,0,1970,0,98042,47.364,-122.094,1170,5200,4040,4030,40.38461538461539,0.017704918032786884,Very Cheap
20141204T000000,265000.0,4,2.5,2040,4443,2.0,0,0,3,8,2040,0,2001,0,98092,47.3182,-122.189,2040,4637,2403,2597,59.6443844249381,0.024918032786885248,Very Cheap
20150413T000000,426000.0,2,2.5,1550,2657,2.0,0,0,4,8,1550,0,1987,0,98033,47.7034,-122.188,1570,2442,1107,872,160.33120060218292,0.046032786885245904,Very Cheap
20141029T000000,529219.0,4,2.25,1990,7610,1.0,0,0,4,8,1290,700,1966,0,98008,47.6236,-122.103,1820,8198,5620,6378,69.54257555847569,0.05956970491803279,Very Cheap
20140708T000000,600000.0,3,2.25,1900,46609,1.5,0,0,4,7,1440,460,1969,0,98072,47.7529,-122.116,2460,43560,44709,41100,12.873050269261302,0.06885245901639345,Very Cheap
20140701T000000,875000.0,5,3.5,3840,8279,2.0,0,0,3,9,3840,0,2001,0,98074,47.6039,-122.059,3570,8279,4439,4709,105.6890928856142,0.10491803278688525,Cheap
20150106T000000,608000.0,4,3.0,2400,7680,1.0,0,0,3,7,1200,1200,1956,0,98199,47.6466,-122.389,2670,6342,5280,3672,79.16666666666667,0.0699016393442623,Very Cheap
20141112T000000,220000.0,3,1.0,1660,21514,1.0,0,0,4,7,1660,0,1973,0,98022,47.2159,-121.964,1660,21600,19854,19940,10.225899414334851,0.01901639344262295,Very Cheap
20140811T000000,1760000.0,4,5.0,6055,21630,1.0,0,3,4,12,3555,2500,1996,0,98006,47.5524,-122.112,4890,19223,15575,14333,81.36846971798428,0.22098360655737706,Cheap
20140818T000000,295450.0,3,2.0,2030,17120,1.0,0,2,4,8,1890,140,1966,0,98092,47.2953,-122.185,1870,13662,15090,11792,17.257593457943926,0.028911475409836067,Very Cheap
20141111T000000,315000.0,2,1.0,840,5087,1.0,0,0,3,7,840,0,1925,0,98118,47.5557,-122.278,1590,5087,4247,3497,61.92254767053273,0.031475409836065574,Very Cheap
20150213T000000,205000.0,4,2.0,1450,8175,1.0,0,0,4,7,1450,0,1967,0,98031,47.3933,-122.195,1570,9024,6725,7454,25.07645259938838,0.017049180327868854,Very Cheap
20140709T000000,310000.0,3,1.5,1460,9908,1.0,0,0,3,7,1460,0,1952,0,98148,47.4275,-122.331,1420,9582,8448,8162,31.287848203471942,0.03081967213114754,Very Cheap
20150503T000000,1000000.0,5,1.0,2010,5210,1.5,0,0,3,9,1890,120,1927,0,98119,47.6501,-122.37,2330,5000,3200,2670,191.93857965451056,0.12131147540983607,Cheap
20140602T000000,525000.0,4,2.5,2910,7631,2.0,0,2,3,9,2910,0,2006,0,98038,47.3552,-122.001,3190,5552,4721,2362,68.79832263137203,0.05901639344262295,Very Cheap
20140709T000000,284000.0,4,1.75,1880,8800,1.0,0,0,3,7,1130,750,1960,0,98168,47.5137,-122.333,1340,8733,6920,7393,32.27272727272727,0.027409836065573772,Very Cheap
20140514T000000,510000.0,3,1.75,2170,26460,1.0,0,0,3,8,1450,720,1986,0,98074,47.6147,-122.045,2090,29075,24290,26985,19.27437641723356,0.057049180327868855,Very Cheap
20140619T000000,405000.0,2,1.0,1260,4377,1.0,0,0,4,7,1260,0,1947,0,98103,47.6988,-122.354,1420,6376,3117,4956,92.52912954078135,0.043278688524590166,Very Cheap
20140916T000000,509950.0,3,2.5,1970,9153,2.0,0,0,3,8,1970,0,2007,0,98028,47.7698,-122.268,1800,9800,7183,8000,55.71397356058123,0.057042622950819674,Very Cheap
20141027T000000,600000.0,4,2.25,2090,45738,2.0,0,0,3,8,2090,0,1987,0,98053,47.6876,-122.049,3420,45738,43648,42318,13.118194936376755,0.06885245901639345,Very Cheap
20150423T000000,990000.0,4,3.75,3450,4940,2.0,0,0,3,10,2570,880,2006,0,98103,47.692,-122.338,1880,5387,1490,3507,200.40485829959513,0.12,Cheap
20150414T000000,280005.0,3,1.5,1130,7200,1.0,0,0,3,7,1130,0,1954,0,98178,47.5041,-122.253,1130,7200,6070,6070,38.889583333333334,0.026885901639344262,Very Cheap
20140903T000000,700000.0,3,1.75,2600,7668,1.0,0,0,4,8,1300,1300,1968,0,98010,47.3402,-122.046,1980,13664,5068,11684,91.2884715701617,0.08196721311475409,Very Cheap
20140804T000000,330000.0,3,1.0,1030,7620,1.0,0,0,3,7,1030,0,1953,0,98126,47.5281,-122.375,1030,7560,6590,6530,43.30708661417323,0.03344262295081967,Very Cheap
20150223T000000,340000.0,2,1.0,1700,6718,1.0,0,2,3,7,1230,470,1956,0,98198,47.4131,-122.331,2040,7500,5018,5460,50.6103006847276,0.03475409836065574,Very Cheap
20140818T000000,468000.0,2,2.5,1480,2167,2.0,0,0,3,8,1390,90,2007,0,98052,47.6658,-122.132,2130,2556,687,426,215.96677434240885,0.05154098360655738,Very Cheap
20140609T000000,1339000.0,4,2.5,4250,19387,2.0,0,2,4,9,3260,990,1972,0,98040,47.5578,-122.212,3690,17024,15137,13334,69.06690050033528,0.16577049180327869,Cheap
20140919T000000,515000.0,3,1.75,1600,20873,1.0,0,0,3,8,1600,0,1955,0,98006,47.5632,-122.182,2640,18364,19273,15724,24.67302256503617,0.057704918032786885,Very Cheap
20141112T000000,245000.0,4,2.0,1870,8750,1.0,0,2,3,7,1870,0,1977,0,98022,47.1985,-122.001,1770,8207,6880,6437,28.0,0.022295081967213116,Very Cheap
20140527T000000,265000.0,3,2.5,1440,7741,1.0,0,0,4,7,1000,440,1983,0,98031,47.4042,-122.194,1680,7316,6301,5636,34.233303190802225,0.024918032786885248,Very Cheap
20150317T000000,372400.0,3,2.5,2720,11937,2.0,0,0,3,9,2720,0,1990,0,98031,47.4185,-122.212,2590,9683,9217,7093,31.197118203903827,0.03900327868852459,Very Cheap
20150504T000000,390000.0,3,1.5,1240,8410,1.0,0,0,5,6,1240,0,1948,0,98155,47.753,-122.328,1630,8410,7170,6780,46.37336504161712,0.04131147540983607,Very Cheap
20150203T000000,208000.0,3,1.0,1020,6120,1.0,0,0,4,7,1020,0,1967,0,98002,47.278,-122.205,1370,8000,5100,6630,33.98692810457516,0.01744262295081967,Very Cheap
20141003T000000,273000.0,2,0.5,1180,7750,1.0,0,0,4,6,590,590,1945,0,98155,47.769,-122.316,1380,8976,6570,7596,35.225806451612904,0.025967213114754098,Very Cheap
20141009T000000,455000.0,5,3.5,3080,7759,2.0,0,0,3,8,2310,770,2003,0,98019,47.7454,-121.977,2980,8223,4679,5243,58.64157752287666,0.049836065573770495,Very Cheap
20150330T000000,270000.0,4,2.5,1750,6397,2.0,0,0,3,7,1750,0,1988,0,98023,47.3082,-122.358,1940,6502,4647,4562,42.20728466468657,0.025573770491803278,Very Cheap
20140730T000000,618000.0,4,2.25,2530,8736,1.0,0,0,4,7,1210,1320,1958,0,98008,47.6049,-122.126,1720,8500,6206,6780,70.74175824175825,0.07121311475409836,Very Cheap
20141021T000000,213550.0,3,2.5,1580,8541,2.0,0,0,3,7,1580,0,1990,0,98001,47.3334,-122.289,1640,7542,6961,5902,25.00292705772158,0.018170491803278687,Very Cheap
20140729T000000,210000.0,5,1.75,2340,9148,2.0,0,0,3,7,2340,0,1957,0,98198,47.4232,-122.324,1390,10019,6808,8629,22.95583734149541,0.017704918032786884,Very Cheap
20150112T000000,2750000.0,5,4.0,6300,16065,2.0,0,1,3,12,4360,1940,2004,0,98004,47.5922,-122.207,3260,17287,9765,14027,171.17958294428882,0.35081967213114756,Medium
20141215T000000,403500.0,4,2.75,2400,3844,1.0,0,0,5,7,1200,1200,1974,0,98133,47.7027,-122.347,1100,3844,1444,2744,104.9687825182102,0.043081967213114754,Very Cheap
20150225T000000,235000.0,3,1.5,1300,7600,1.0,0,0,4,7,1300,0,1963,0,98022,47.2083,-122.005,1570,7600,6300,6030,30.92105263157895,0.02098360655737705,Very Cheap
20150421T000000,287500.0,3,2.0,1760,7147,1.0,0,0,4,6,880,880,1936,0,98055,47.4799,-122.232,1720,7147,5387,5427,40.226668532251296,0.027868852459016394,Very Cheap
20140929T000000,546800.0,4,1.5,1520,5910,1.0,0,0,3,7,1020,500,1946,0,98115,47.6904,-122.295,1710,5910,4390,4200,92.52115059221659,0.06187540983606558,Very Cheap
20140616T000000,183000.0,3,1.75,1070,8100,1.0,0,0,4,6,1070,0,1957,0,98002,47.2853,-122.22,1260,8100,7030,6840,22.59259259259259,0.014163934426229508,Very Cheap
20140512T000000,560000.0,3,2.0,2560,216777,1.0,0,0,3,8,2560,0,1986,0,98092,47.295,-122.086,2360,108463,214217,106103,2.5832998888258443,0.06360655737704918,Very Cheap
20141205T000000,299500.0,3,1.0,1280,6726,1.0,0,0,3,6,1280,0,1958,0,98144,47.5724,-122.301,1630,5000,5446,3370,44.52869461790068,0.02944262295081967,Very Cheap
20141027T000000,610000.0,4,2.25,1660,7350,1.0,0,0,3,8,1660,0,1965,2014,98008,47.6263,-122.124,1790,7455,5690,5665,82.99319727891157,0.07016393442622951,Very Cheap
20140609T000000,288350.0,3,1.5,1860,7963,1.0,0,0,3,7,1200,660,1963,0,98188,47.4513,-122.268,1800,10400,6103,8600,36.21122692452593,0.027980327868852458,Very Cheap
20140701T000000,500000.0,2,1.0,950,4500,1.0,0,2,3,7,850,100,1926,0,98103,47.6562,-122.354,1670,4000,3550,2330,111.11111111111111,0.05573770491803279,Very Cheap
20141205T000000,625000.0,4,2.75,2140,4000,1.0,0,0,3,7,1190,950,1951,0,98115,47.6792,-122.287,2140,4770,1860,2630,156.25,0.07213114754098361,Very Cheap
20150429T000000,418000.0,2,1.5,1480,1349,2.0,0,0,3,7,1240,240,2007,0,98136,47.5439,-122.386,1550,1349,-131,-201,309.85915492957747,0.04498360655737705,Very Cheap
20140825T000000,660000.0,3,3.0,2260,1825,2.0,0,0,3,8,1660,600,2002,0,98122,47.6108,-122.308,2260,1834,-435,-426,361.64383561643837,0.07672131147540984,Very Cheap
20140623T000000,775000.0,4,2.5,2300,6158,2.0,0,0,3,9,2300,0,1999,0,98115,47.6943,-122.299,2170,6434,3858,4264,125.85254952906789,0.09180327868852459,Very Cheap
20150123T000000,429500.0,3,2.75,1650,7272,1.0,0,0,4,7,1230,420,1972,0,98034,47.7232,-122.174,1770,7272,5622,5502,59.06215621562156,0.04649180327868852,Very Cheap
20141124T000000,569000.0,3,2.0,1990,3000,1.5,0,0,3,7,1230,760,1908,1970,98112,47.6272,-122.29,1600,4080,1010,2480,189.66666666666666,0.06478688524590163,Very Cheap
20140520T000000,250000.0,4,2.0,1960,7560,1.0,0,0,5,7,1160,800,1978,0,98031,47.4081,-122.178,1950,7560,5600,5610,33.06878306878307,0.022950819672131147,Very Cheap
20141209T000000,225000.0,3,1.5,1310,10491,1.0,0,0,4,7,1310,0,1969,0,98042,47.3682,-122.148,1430,9664,9181,8234,21.44695453245639,0.019672131147540985,Very Cheap
20140514T000000,530000.0,4,2.75,2450,15002,1.0,0,0,5,9,2450,0,1974,0,98166,47.4268,-122.343,2650,15055,12552,12405,35.32862285028663,0.05967213114754098,Very Cheap
20140905T000000,306000.0,3,1.0,910,8658,1.0,0,0,3,7,910,0,1955,0,98155,47.7586,-122.303,1170,10200,7748,9030,35.343035343035346,0.030295081967213113,Very Cheap
20150413T000000,517100.0,3,1.75,1580,9719,1.0,0,0,5,7,1580,0,1962,0,98056,47.5396,-122.18,1760,8539,8139,6779,53.20506224920259,0.05798032786885246,Very Cheap
20140822T000000,354950.0,3,1.75,1780,9689,1.0,0,0,3,7,1130,650,1976,0,98072,47.7628,-122.163,1660,9786,7909,8126,36.63432758798638,0.036714754098360655,Very Cheap
20150414T000000,348000.0,3,1.5,1040,1824,1.0,0,0,3,6,1040,0,1925,0,98115,47.6793,-122.3,1010,5100,784,4090,190.78947368421052,0.03580327868852459,Very Cheap
20140718T000000,522250.0,4,2.5,2340,41600,1.0,0,0,3,8,1640,700,1977,0,98077,47.7466,-122.077,2340,34960,39260,32620,12.554086538461538,0.05865573770491803,Very Cheap
20140604T000000,275000.0,3,2.5,1720,8755,1.0,0,0,3,8,1000,720,1983,0,98023,47.3186,-122.391,1720,8690,7035,6970,31.410622501427756,0.02622950819672131,Very Cheap
20141218T000000,390000.0,3,1.5,1600,10440,1.0,0,0,3,7,1600,0,1954,0,98125,47.7109,-122.311,1600,8816,8840,7216,37.35632183908046,0.04131147540983607,Very Cheap
20140910T000000,260000.0,3,1.5,1320,9750,1.0,0,0,3,7,1320,0,1954,0,98148,47.4267,-122.331,1530,9750,8430,8220,26.666666666666668,0.024262295081967214,Very Cheap
20140728T000000,585000.0,5,2.75,2350,4178,1.5,0,0,3,8,1520,830,1922,2015,98112,47.6388,-122.3,1920,4178,1828,2258,140.01914791766396,0.06688524590163934,Very Cheap
20140603T000000,605000.0,5,2.75,2740,5616,1.5,0,0,5,7,1670,1070,1925,0,98115,47.6866,-122.317,1600,4592,2876,2992,107.72792022792022,0.06950819672131148,Very Cheap
20140703T000000,342000.0,4,2.5,2300,6448,2.0,0,0,3,8,2300,0,2001,0,98030,47.3813,-122.204,1860,5872,4148,4012,53.03970223325062,0.03501639344262295,Very Cheap
20140827T000000,900000.0,5,3.0,4350,37169,2.0,0,0,3,10,2950,1400,1972,0,98005,47.6518,-122.16,3280,41631,32819,38351,24.213726492507195,0.10819672131147541,Cheap
20150330T000000,252000.0,3,1.75,1430,7700,1.0,0,0,4,7,980,450,1981,0,98031,47.3993,-122.183,1430,8625,6270,7195,32.72727272727273,0.02321311475409836,Very Cheap
20150219T000000,357000.0,3,1.75,2400,14012,1.0,0,0,3,9,2400,0,1971,0,98003,47.3371,-122.325,2800,13988,11612,11188,25.47816157579218,0.03698360655737705,Very Cheap
20141224T000000,370000.0,3,1.0,940,7910,1.0,0,0,4,6,940,0,1959,0,98008,47.6181,-122.117,1000,7700,6970,6700,46.77623261694058,0.038688524590163934,Very Cheap
20150406T000000,322500.0,3,1.0,1020,13504,1.0,0,0,5,7,1020,0,1959,0,98056,47.5121,-122.17,1110,11158,12484,10048,23.881812796208532,0.032459016393442626,Very Cheap
20140620T000000,210000.0,2,2.0,1680,5756,2.0,0,0,4,7,1680,0,1910,0,98002,47.3065,-122.222,1340,5447,4076,4107,36.48366921473245,0.017704918032786884,Very Cheap
20141208T000000,290000.0,2,1.0,1340,9840,1.0,0,0,3,7,1340,0,1949,0,98133,47.7202,-122.339,1610,8949,8500,7339,29.471544715447155,0.02819672131147541,Very Cheap
20140612T000000,860000.0,4,3.25,3960,7012,2.0,0,0,3,10,3960,0,2005,0,98075,47.5854,-122.08,3680,8522,3052,4842,122.6468910439247,0.10295081967213114,Cheap
20150225T000000,302000.0,6,2.0,2650,4621,1.5,0,0,3,8,2650,0,1911,0,98118,47.5543,-122.275,1640,4879,1971,3239,65.3538195195845,0.02977049180327869,Very Cheap
20140821T000000,369160.0,4,2.25,2120,9680,2.0,0,2,4,8,2120,0,1965,0,98003,47.3367,-122.332,2360,9647,7560,7287,38.13636363636363,0.038578360655737706,Very Cheap
20150507T000000,1185000.0,4,2.75,2850,3000,2.5,0,0,3,9,2530,320,2003,0,98112,47.6406,-122.304,2083,4500,150,2417,395.0,0.14557377049180328,Cheap
20140902T000000,993000.0,4,2.0,2850,14810,2.0,0,0,5,8,2490,360,1954,0,98004,47.5892,-122.203,2430,10454,11960,8024,67.04929101958136,0.12039344262295082,Cheap
20141114T000000,380000.0,6,2.0,1870,6969,1.0,0,0,4,7,1870,0,1968,0,98027,47.5342,-122.036,1500,6969,5099,5469,54.52719184961975,0.04,Very Cheap
20140910T000000,635000.0,4,2.0,2660,8160,1.0,0,0,4,7,1380,1280,1949,0,98177,47.7229,-122.359,1660,8160,5500,6500,77.81862745098039,0.07344262295081967,Very Cheap
20141030T000000,260000.0,3,1.0,1190,11120,1.0,0,0,3,6,1190,0,1947,0,98024,47.5687,-121.898,1230,12720,9930,11490,23.381294964028775,0.024262295081967214,Very Cheap
20140520T000000,243000.0,2,1.0,1770,5522,1.5,0,0,4,7,960,810,1943,0,98178,47.4974,-122.231,1830,7378,3752,5548,44.00579500181094,0.022032786885245903,Very Cheap
20150402T000000,1400000.0,4,2.5,2770,8879,2.0,0,0,3,9,2770,0,2001,0,98004,47.5831,-122.193,2770,8882,6109,6112,157.67541389796148,0.1737704918032787,Cheap
20140915T000000,665000.0,4,2.5,2080,8100,1.0,0,2,5,8,1220,860,1952,0,98177,47.7228,-122.369,2090,8100,6020,6010,82.09876543209876,0.07737704918032787,Very Cheap
20140909T000000,898000.0,5,2.25,2700,9000,2.0,0,0,5,9,2700,0,1987,0,98007,47.6599,-122.146,2630,9000,6300,6370,99.77777777777777,0.10793442622950819,Cheap
20140725T000000,583000.0,4,2.75,2200,9453,1.0,0,0,5,8,1100,1100,1955,0,98144,47.5744,-122.305,1390,5355,7253,3965,61.67354279064847,0.06662295081967214,Very Cheap
20141204T000000,429000.0,4,1.75,2160,7700,2.0,0,0,2,8,2160,0,1977,0,98033,47.6976,-122.169,2080,7700,5540,5620,55.714285714285715,0.04642622950819672,Very Cheap
20141216T000000,471000.0,3,2.5,2010,4059,2.0,0,0,3,8,2010,0,1998,0,98034,47.7317,-122.197,2010,5779,2049,3769,116.03843311160384,0.051934426229508196,Very Cheap
20150312T000000,1810000.0,3,3.5,3780,8295,2.0,0,0,3,9,2430,1350,1951,0,98112,47.6394,-122.29,3780,9127,4515,5347,218.20373719107897,0.2275409836065574,Cheap
20141015T000000,739500.0,3,3.25,4460,51177,2.0,0,0,3,9,4460,0,2005,0,98042,47.3648,-122.143,2670,38925,46717,36255,14.449850518787736,0.08714754098360655,Very Cheap
20140512T000000,450000.0,3,1.5,1770,17208,1.0,0,0,3,8,1160,610,1959,0,98006,47.5659,-122.117,2450,17118,15438,14668,26.15062761506276,0.04918032786885246,Very Cheap
20150408T000000,552500.0,3,1.0,1430,5000,1.0,0,0,3,7,1430,0,1949,0,98117,47.6895,-122.37,1210,5000,3570,3790,110.5,0.06262295081967213,Very Cheap
20150217T000000,437000.0,4,1.75,1700,10642,1.0,0,0,4,7,850,850,1954,0,98006,47.5674,-122.142,1610,11200,8942,9590,41.06370982897951,0.047475409836065574,Very Cheap
20150109T000000,270000.0,4,2.0,1830,5220,1.5,0,0,3,7,1830,0,1951,0,98118,47.5331,-122.278,1760,5757,3390,3997,51.724137931034484,0.025573770491803278,Very Cheap
20140716T000000,226740.0,3,1.5,1410,8800,1.0,0,0,4,7,1410,0,1965,0,98092,47.2927,-122.183,2180,10108,7390,7928,25.76590909090909,0.019900327868852458,Very Cheap
20150218T000000,446500.0,4,2.5,3060,7920,1.0,0,0,3,8,1810,1250,1974,0,98028,47.7675,-122.261,2690,7767,4860,5077,56.37626262626262,0.04872131147540983,Very Cheap
20141125T000000,283000.0,3,2.0,1820,15068,2.0,0,2,3,7,1520,300,1920,2014,98022,47.2103,-121.999,1490,9589,13248,8099,18.781523758959384,0.027278688524590165,Very Cheap
20140715T000000,445000.0,4,1.75,2430,13211,1.5,0,0,4,7,2430,0,1909,1978,98024,47.5245,-121.926,1330,10500,10781,9170,33.68405116947998,0.04852459016393443,Very Cheap
20140816T000000,250000.0,2,1.0,740,6840,1.0,0,0,5,6,740,0,1942,0,98126,47.5172,-122.375,740,6840,6100,6100,36.54970760233918,0.022950819672131147,Very Cheap
20150309T000000,307000.0,3,1.0,770,6552,1.0,0,0,3,6,670,100,1942,0,98146,47.5133,-122.372,920,7200,5782,6280,46.855921855921856,0.03042622950819672,Very Cheap
20140721T000000,315000.0,4,2.75,2200,8580,1.0,0,0,3,8,1860,340,1991,0,98023,47.295,-122.37,2290,7816,6380,5526,36.71328671328671,0.031475409836065574,Very Cheap
20150106T000000,555000.0,3,3.0,2920,23085,1.5,0,2,3,7,1540,1380,1908,0,98136,47.5159,-122.395,2270,18180,20165,15910,24.041585445094217,0.06295081967213115,Very Cheap
20150424T000000,264900.0,4,2.5,2040,7000,1.0,0,0,3,7,1250,790,1979,0,98031,47.4056,-122.176,1900,7378,4960,5478,37.84285714285714,0.024904918032786886,Very Cheap
20140922T000000,510000.0,3,2.0,1600,4510,1.0,0,0,3,7,990,610,1978,0,98103,47.6939,-122.34,1580,4561,2910,2981,113.0820399113082,0.057049180327868855,Very Cheap
20140814T000000,328000.0,4,2.5,1990,3980,2.0,0,0,3,7,1990,0,2002,0,98058,47.4445,-122.17,1990,4373,1990,2383,82.41206030150754,0.03318032786885246,Very Cheap
20150504T000000,358000.0,4,2.5,1830,7308,2.0,0,0,3,7,1830,0,2002,0,98038,47.3565,-122.015,1830,5692,5478,3862,48.98741105637657,0.03711475409836065,Very Cheap
20150421T000000,325000.0,3,2.5,2540,4260,2.0,0,0,3,7,2540,0,2005,0,98042,47.3989,-122.164,2190,4260,1720,2070,76.29107981220658,0.03278688524590164,Very Cheap
20140714T000000,1365000.0,2,3.25,2700,3444,3.0,1,3,3,9,2700,0,1990,0,98075,47.5684,-122.06,2710,3444,744,734,396.3414634146341,0.16918032786885245,Cheap
20150305T000000,230000.0,4,2.0,1440,10800,1.0,0,0,4,7,1440,0,1967,0,98001,47.3417,-122.283,1190,7380,9360,6190,21.296296296296298,0.020327868852459016,Very Cheap
20150423T000000,545000.0,3,2.0,1550,4000,1.0,0,0,3,7,940,610,1955,0,98199,47.6379,-122.387,1880,4000,2450,2120,136.25,0.06163934426229508,Very Cheap
20140505T000000,705380.0,3,2.5,2490,4343,2.0,0,0,3,9,2490,0,2003,0,98029,47.5493,-121.993,2130,4106,1853,1976,162.417683628828,0.0826727868852459,Very Cheap
20140820T000000,459000.0,5,2.5,2650,12987,1.0,0,0,4,7,1350,1300,1979,0,98028,47.7482,-122.244,2160,12726,10337,10566,35.343035343035346,0.050360655737704915,Very Cheap
20140528T000000,815000.0,4,2.25,2000,3800,2.0,0,0,3,8,2000,0,2001,0,98115,47.6852,-122.311,1610,3800,1800,2190,214.47368421052633,0.09704918032786886,Very Cheap
20140611T000000,495000.0,6,5.0,3440,4500,2.0,0,0,3,8,3280,160,2007,0,98055,47.4871,-122.219,1400,5500,1060,4100,110.0,0.05508196721311476,Very Cheap
20141110T000000,520000.0,3,2.5,2280,58712,2.5,0,3,3,9,2280,0,1987,0,98010,47.3053,-122.0,2240,24332,56432,22092,8.85679247853931,0.058360655737704915,Very Cheap
20141217T000000,430000.0,2,1.5,1320,1194,3.0,0,0,3,7,1320,0,2001,0,98107,47.6704,-122.39,1320,1250,-126,-70,360.13400335008373,0.04655737704918033,Very Cheap
20140515T000000,255000.0,4,2.5,2070,7800,2.0,0,0,3,8,2070,0,1989,0,98003,47.3487,-122.315,1950,7815,5730,5865,32.69230769230769,0.02360655737704918,Very Cheap
20140707T000000,588000.0,3,2.0,1860,4777,2.0,0,0,5,7,1860,0,1908,0,98115,47.6892,-122.311,1580,3822,2917,2242,123.08980531714465,0.06727868852459017,Very Cheap
20141110T000000,350000.0,3,1.0,940,7811,1.0,0,0,3,6,940,0,1959,0,98008,47.6195,-122.118,1180,7490,6871,6310,44.80860325182435,0.036065573770491806,Very Cheap
20150313T000000,625000.0,4,2.75,2290,21486,1.0,0,2,5,7,2290,0,1963,0,98006,47.5515,-122.189,2540,15936,19196,13396,29.088708926742996,0.07213114754098361,Very Cheap
20150424T000000,172500.0,2,2.0,1510,20685,1.0,0,0,2,6,1250,260,1958,0,98059,47.481,-122.116,1490,29527,19175,28037,8.339376359680928,0.012786885245901639,Very Cheap
20140825T000000,554000.0,3,2.0,1830,3500,1.5,0,0,5,7,1290,540,1909,0,98116,47.573,-122.383,1530,4000,1670,2470,158.28571428571428,0.06281967213114754,Very Cheap
20140728T000000,775000.0,4,2.5,3090,7112,2.0,0,0,3,9,3090,0,2001,0,98052,47.705,-122.118,3050,6000,4022,2950,108.97075365579303,0.09180327868852459,Very Cheap
20141107T000000,1187500.0,4,3.5,4340,217800,2.0,0,0,3,11,4340,0,2003,0,98053,47.6471,-122.013,3430,219106,213460,215676,5.452249770431589,0.14590163934426228,Cheap
20141028T000000,618000.0,3,2.75,3200,12682,2.0,0,1,3,9,3200,0,1977,0,98028,47.7443,-122.26,2880,10432,9482,7552,48.730484150764866,0.07121311475409836,Very Cheap
20140929T000000,305000.0,4,1.0,1560,8450,1.5,0,0,4,6,1560,0,1954,0,98166,47.4552,-122.354,1380,8100,6890,6720,36.094674556213015,0.03016393442622951,Very Cheap
20141205T000000,232000.0,3,2.0,1280,13356,1.0,0,0,3,7,1280,0,1994,0,98042,47.3715,-122.074,1590,8071,12076,6481,17.37047020065888,0.02059016393442623,Very Cheap
20140508T000000,262000.0,4,2.5,2020,6236,2.0,0,0,3,7,2020,0,2002,0,98001,47.2796,-122.247,1940,5076,4216,3136,42.01411161000642,0.024524590163934427,Very Cheap
20150325T000000,234000.0,3,1.0,1040,8122,1.0,0,0,5,7,1040,0,1971,0,98198,47.3731,-122.312,1470,8676,7082,7206,28.810637773947303,0.020852459016393442,Very Cheap
20150402T000000,500000.0,4,2.75,2260,7209,1.0,0,3,3,7,1330,930,2002,0,98125,47.7088,-122.302,1790,10860,4949,9070,69.35774726036898,0.05573770491803279,Very Cheap
20140827T000000,278000.0,3,1.0,860,7632,1.0,0,0,3,6,860,0,1920,0,98166,47.4623,-122.345,890,7632,6772,6742,36.42557651991614,0.02662295081967213,Very Cheap
20140904T000000,230000.0,5,1.0,1920,19040,1.0,0,0,3,7,1160,760,1961,0,98168,47.4756,-122.294,1920,11520,17120,9600,12.079831932773109,0.020327868852459016,Very Cheap
20140922T000000,500000.0,4,1.75,2290,9215,1.0,0,0,5,8,1270,1020,1969,0,98027,47.5328,-122.051,2290,10200,6925,7910,54.25935973955507,0.05573770491803279,Very Cheap
20140519T000000,366500.0,4,2.75,2070,9300,1.0,0,0,5,7,1120,950,1945,0,98155,47.7416,-122.32,1010,8308,7230,7298,39.40860215053763,0.03822950819672131,Very Cheap
20140611T000000,665000.0,6,3.0,4250,4400,2.5,0,0,4,7,3020,1230,1902,0,98118,47.5584,-122.283,1520,4950,150,3430,151.13636363636363,0.07737704918032787,Very Cheap
20150316T000000,1101000.0,3,1.5,2220,4830,2.0,0,3,3,9,1790,430,1928,2010,98116,47.5825,-122.4,1670,4830,2610,3160,227.9503105590062,0.13455737704918033,Cheap
20141201T000000,575000.0,2,1.75,1840,4076,1.0,0,0,3,8,1140,700,1957,0,98117,47.6875,-122.393,1540,4076,2236,2536,141.06967615309128,0.06557377049180328,Very Cheap
20141103T000000,674750.0,4,2.5,2590,9753,2.0,0,0,3,10,2590,0,1993,0,98075,47.5848,-122.027,2800,9917,7163,7117,69.18384086947606,0.07865573770491803,Very Cheap
20140916T000000,719000.0,5,2.0,3110,6131,1.0,0,0,5,7,1560,1550,1940,0,98118,47.5615,-122.279,1720,6600,3021,4880,117.27287555048116,0.08445901639344262,Very Cheap
20140925T000000,482000.0,3,1.75,2600,105587,1.0,0,0,4,7,1300,1300,1980,0,98070,47.4464,-122.497,1941,208438,102987,206497,4.564955913133246,0.05337704918032787,Very Cheap
20140528T000000,254000.0,2,1.0,1060,8187,1.0,0,0,4,6,1060,0,1952,0,98133,47.7508,-122.349,1260,8188,7127,6928,31.02479540735312,0.023475409836065574,Very Cheap
20140819T000000,443725.0,3,1.75,1250,3880,1.0,0,0,4,7,750,500,1944,0,98117,47.6869,-122.392,1240,3880,2630,2640,114.36211340206185,0.048357377049180326,Very Cheap
20141106T000000,575000.0,4,2.5,2520,35636,2.0,0,0,3,8,2520,0,1980,0,98053,47.652,-122.031,2230,35673,33116,33443,16.135368728252327,0.06557377049180328,Very Cheap
20150127T000000,469000.0,3,2.25,2070,9957,1.0,0,0,3,8,1440,630,1977,0,98155,47.7766,-122.277,2070,10158,7887,8088,47.10254092598172,0.05167213114754098,Very Cheap
20140523T000000,175000.0,2,1.0,1300,44431,1.0,0,0,5,6,1300,0,1958,0,98001,47.327,-122.267,1470,14850,43131,13380,3.9386914541648848,0.013114754098360656,Very Cheap
20140909T000000,437000.0,5,2.0,2190,8316,1.0,0,0,3,7,1390,800,1961,0,98108,47.5488,-122.298,2010,8316,6126,6306,52.54930254930255,0.047475409836065574,Very Cheap
20140820T000000,550000.0,4,3.0,2760,13113,1.0,0,0,4,8,1760,1000,1974,0,98028,47.7669,-122.268,1900,13113,10353,11213,41.943109890947916,0.06229508196721312,Very Cheap
20150420T000000,172040.0,3,2.25,1710,7134,1.0,0,0,4,7,1130,580,1979,0,98031,47.3911,-122.191,1790,7455,5424,5665,24.115503223997756,0.01272655737704918,Very Cheap
20141224T000000,363000.0,3,2.0,1750,7000,1.0,0,0,3,8,1750,0,1993,0,98038,47.3693,-122.041,1840,6969,5250,5129,51.857142857142854,0.03777049180327869,Very Cheap
20150430T000000,282000.0,3,2.25,1552,3600,2.0,0,0,3,7,1552,0,2012,0,98092,47.3198,-122.178,1677,3600,2048,1923,78.33333333333333,0.02714754098360656,Very Cheap
20140814T000000,400000.0,6,2.0,2350,6554,2.0,0,1,3,8,2000,350,1905,0,98178,47.5115,-122.256,1560,6554,4204,4994,61.03143118706134,0.04262295081967213,Very Cheap
20140924T000000,650000.0,5,3.5,5110,10018,2.0,0,0,3,10,3850,1260,2003,0,98034,47.7261,-122.17,1790,10018,4908,8228,64.88321022160112,0.07540983606557378,Very Cheap
20140603T000000,365000.0,3,2.5,1720,99916,2.0,0,0,4,7,1720,0,1990,0,98042,47.3391,-122.093,1340,73180,98196,71840,3.6530685776051883,0.0380327868852459,Very Cheap
20141024T000000,269950.0,4,2.5,1960,7230,2.0,0,0,3,8,1960,0,2002,0,98023,47.2855,-122.36,1850,7208,5270,5358,37.33748271092669,0.025567213114754097,Very Cheap
20140718T000000,260000.0,2,1.0,1270,19602,1.0,0,0,3,6,1270,0,1977,0,98010,47.3375,-122.048,1270,17699,18332,16429,13.263952657892052,0.024262295081967214,Very Cheap
20141024T000000,193000.0,3,1.5,1180,7000,1.0,0,0,4,7,1180,0,1977,0,98023,47.2959,-122.373,1630,7500,5820,5870,27.571428571428573,0.015475409836065573,Very Cheap
20140725T000000,340000.0,4,2.25,2230,6791,2.0,0,0,3,8,2230,0,2005,0,98038,47.3769,-122.028,2420,6297,4561,3877,50.066264173170374,0.03475409836065574,Very Cheap
20140512T000000,900000.0,4,3.25,4700,38412,2.0,0,0,3,10,3420,1280,1978,0,98005,47.6445,-122.167,3640,35571,33712,31931,23.430178069353328,0.10819672131147541,Cheap
20141021T000000,371000.0,3,2.5,2150,8361,2.0,0,0,3,8,2150,0,1991,0,98058,47.4627,-122.129,2150,9368,6211,7218,44.37268269345772,0.038819672131147544,Very Cheap
20140827T000000,592000.0,3,2.5,2400,81892,2.0,0,0,3,8,2400,0,1985,0,98045,47.5028,-121.769,1370,37270,79492,35900,7.229033361012065,0.06780327868852459,Very Cheap
20140815T000000,300000.0,3,2.5,1830,12750,2.0,0,0,3,7,1830,0,1991,0,98168,47.5003,-122.328,1610,10000,10920,8390,23.529411764705884,0.029508196721311476,Very Cheap
20140827T000000,449950.0,4,3.0,2800,6977,2.0,0,0,3,8,2800,0,2003,0,98038,47.3542,-122.014,2800,6600,4177,3800,64.49046868281496,0.04917377049180328,Very Cheap
20141022T000000,299500.0,3,2.5,2090,7163,2.0,0,0,3,8,2090,0,1989,0,98003,47.2735,-122.295,2320,8634,5073,6314,41.812089906463775,0.02944262295081967,Very Cheap
20150326T000000,995000.0,4,2.25,2340,13406,1.0,0,0,4,9,2340,0,1963,0,98040,47.5377,-122.221,2340,10743,11066,8403,74.22049828435028,0.12065573770491804,Cheap
20140923T000000,335000.0,4,1.75,1670,9472,1.0,0,0,3,7,1100,570,1960,0,98106,47.5299,-122.357,1080,5195,7802,4115,35.367398648648646,0.03409836065573771,Very Cheap
20141110T000000,280000.0,4,2.25,1990,7350,1.0,0,0,4,8,1180,810,1978,0,98003,47.3258,-122.328,2030,7210,5360,5180,38.095238095238095,0.026885245901639345,Very Cheap
20140516T000000,446000.0,4,2.25,2270,7800,1.0,0,0,3,7,1290,980,1977,0,98034,47.7278,-122.192,1480,7280,5530,5800,57.17948717948718,0.04865573770491803,Very Cheap
20140927T000000,1544500.0,4,2.75,4910,15139,1.0,0,0,4,10,2560,2350,1964,0,98004,47.6444,-122.22,3980,15139,10229,11159,102.02126956866371,0.19272131147540983,Cheap
20150407T000000,325000.0,3,1.0,950,4500,1.0,0,0,4,6,950,0,1943,0,98118,47.5273,-122.265,1140,4500,3550,3360,72.22222222222223,0.03278688524590164,Very Cheap
20140619T000000,450000.0,3,1.75,1610,11200,1.0,0,0,3,7,1610,0,1955,0,98033,47.6641,-122.176,1610,11200,9590,9590,40.17857142857143,0.04918032786885246,Very Cheap
20141027T000000,322500.0,4,2.5,1940,7107,2.0,0,0,3,7,1940,0,2000,0,98038,47.3843,-122.032,1850,5705,5167,3855,45.37779653862389,0.032459016393442626,Very Cheap
20140915T000000,453000.0,3,1.0,1210,9473,1.0,0,0,5,7,1210,0,1955,0,98006,47.5637,-122.139,1700,11465,8263,9765,47.8201203420247,0.04957377049180328,Very Cheap
20141008T000000,655000.0,4,2.5,2570,4412,2.0,0,0,3,9,2570,0,2001,0,98034,47.7076,-122.232,2460,5470,1842,3010,148.45874886672712,0.0760655737704918,Very Cheap
20150504T000000,603000.0,3,2.25,1700,2800,2.0,0,0,5,7,1150,550,1926,0,98115,47.6819,-122.311,1500,3400,1100,1900,215.35714285714286,0.06924590163934426,Very Cheap
20140902T000000,235000.0,4,1.0,1610,24000,1.5,0,0,3,6,1610,0,1947,0,98001,47.2751,-122.252,1270,9600,22390,8330,9.791666666666666,0.02098360655737705,Very Cheap
20140728T000000,968933.0,4,3.5,4120,7304,2.0,0,0,3,11,3070,1050,2006,0,98033,47.681,-122.167,2470,9600,3184,7130,132.6578587075575,0.11723711475409836,Cheap
20141114T000000,1015000.0,3,3.5,2880,11340,1.0,0,0,3,8,1690,1190,1980,2013,98074,47.6113,-122.058,2530,11340,8460,8810,89.50617283950618,0.12327868852459016,Cheap
20141203T000000,435000.0,4,2.25,1990,8548,2.0,0,0,3,8,1990,0,1973,0,98033,47.667,-122.178,2320,8926,6558,6606,50.88909686476369,0.04721311475409836,Very Cheap
20140618T000000,242000.0,3,2.0,1260,8092,1.0,0,0,3,7,1260,0,1986,0,98038,47.3635,-122.054,1950,8092,6832,6142,29.906080079090458,0.021901639344262296,Very Cheap
20141027T000000,487000.0,6,3.25,4750,248600,2.0,0,0,4,8,4750,0,1947,0,98022,47.1879,-121.973,2230,311610,243850,309380,1.9589702333065164,0.054032786885245904,Very Cheap
20140801T000000,810000.0,4,2.75,3010,10450,2.0,0,0,3,9,3010,0,1996,0,98052,47.6979,-122.112,3010,10530,7440,7520,77.51196172248804,0.09639344262295083,Very Cheap
20140624T000000,625000.0,3,2.5,2410,64073,1.0,0,0,4,8,1820,590,1976,0,98072,47.7457,-122.141,2980,48760,61663,45780,9.754498774834953,0.07213114754098361,Very Cheap
20141023T000000,165000.0,3,1.5,1280,7742,1.0,0,0,3,7,1280,0,1973,0,98001,47.3323,-122.276,1566,7696,6462,6130,21.312322397313356,0.01180327868852459,Very Cheap
20150427T000000,335000.0,3,1.0,2320,6750,1.0,0,0,3,7,1160,1160,1960,0,98118,47.5327,-122.276,1230,6075,4430,4845,49.629629629629626,0.03409836065573771,Very Cheap
20140724T000000,286700.0,3,1.0,1220,6600,1.0,0,0,3,6,1220,0,1958,0,98065,47.5297,-121.827,1100,6600,5380,5500,43.43939393939394,0.027763934426229507,Very Cheap
20150424T000000,699000.0,2,1.5,1400,4050,1.0,0,0,4,8,1400,0,1954,0,98115,47.6768,-122.269,1900,5940,2650,4040,172.59259259259258,0.08183606557377049,Very Cheap
20150327T000000,280000.0,3,1.75,1590,7280,1.0,0,0,3,7,1140,450,1974,0,98058,47.4288,-122.153,1590,9634,5690,8044,38.46153846153846,0.026885245901639345,Very Cheap
20140602T000000,580000.0,4,2.5,2220,7064,2.0,0,0,3,8,2220,0,1988,0,98029,47.5716,-122.022,2220,7451,4844,5231,82.10645526613817,0.06622950819672131,Very Cheap
20140620T000000,754800.0,2,2.5,2770,7781,2.0,0,0,3,8,2770,0,2006,0,98053,47.7072,-122.017,1870,5984,5011,4114,97.0055262819689,0.08915409836065574,Very Cheap
20150210T000000,525000.0,4,2.5,2303,16801,2.0,0,0,3,8,2303,0,1995,0,98019,47.7266,-121.966,2080,14013,14498,11933,31.248139991667163,0.05901639344262295,Very Cheap
20150217T000000,562000.0,3,1.75,1600,10530,1.0,0,2,3,8,1600,0,1962,0,98155,47.7437,-122.291,2590,8274,8930,5684,53.371320037986706,0.0638688524590164,Very Cheap
20140520T000000,575000.0,4,1.75,1280,6060,1.0,0,0,3,7,860,420,1926,0,98117,47.6805,-122.364,1490,4680,4780,3190,94.88448844884489,0.06557377049180328,Very Cheap
20140711T000000,808900.0,5,2.5,2900,5901,2.0,0,0,3,9,2900,0,2006,0,98027,47.5396,-121.998,3200,5775,3001,2575,137.07846127774954,0.09624918032786885,Very Cheap
20150303T000000,992000.0,3,2.25,2950,15207,1.0,0,0,4,10,2070,880,1966,0,98040,47.5571,-122.216,2950,22000,12257,19050,65.23311632800684,0.12026229508196722,Cheap
20140919T000000,335000.0,3,2.5,1700,6698,2.0,0,0,3,7,1700,0,1997,0,98038,47.3826,-122.028,2190,7346,4998,5156,50.01492982979994,0.03409836065573771,Very Cheap
20141226T000000,473000.0,3,2.75,1050,7200,1.0,0,0,3,7,1050,0,1985,0,98125,47.7163,-122.303,1860,9000,6150,7140,65.69444444444444,0.05219672131147541,Very Cheap
20150325T000000,350000.0,4,2.75,2990,11210,1.0,0,1,4,8,1880,1110,1977,0,98023,47.3357,-122.336,2790,9858,8220,7068,31.222123104371097,0.036065573770491806,Very Cheap
20150424T000000,1600000.0,5,2.5,3100,5374,2.5,0,0,4,9,3100,0,1906,0,98122,47.6154,-122.283,2180,5800,2274,3620,297.729810197246,0.2,Cheap
20141217T000000,305500.0,3,1.0,1240,6090,1.0,0,0,4,7,1240,0,1950,0,98155,47.7542,-122.307,1550,9096,4850,7546,50.164203612479476,0.03022950819672131,Very Cheap
20140523T000000,306000.0,2,1.0,780,13500,1.0,0,0,4,7,780,0,1946,1989,98077,47.7383,-122.074,2200,67518,12720,65318,22.666666666666668,0.030295081967213113,Very Cheap
20141202T000000,233000.0,2,2.25,850,1656,2.0,0,0,3,8,850,0,2001,0,98133,47.7064,-122.344,850,1312,806,462,140.70048309178745,0.020721311475409836,Very Cheap
20150331T000000,490000.0,3,1.75,1540,9000,1.0,0,0,3,8,1540,0,1971,0,98125,47.7152,-122.322,1710,7488,7460,5778,54.44444444444444,0.05442622950819672,Very Cheap
20140701T000000,445000.0,4,2.5,2280,42077,2.0,0,0,3,8,2280,0,1994,0,98042,47.3424,-122.077,2280,36236,39797,33956,10.575849038667206,0.04852459016393443,Very Cheap
20141120T000000,355000.0,3,2.25,2550,9674,1.0,0,0,3,7,1850,700,1959,0,98178,47.4856,-122.247,2240,9674,7124,7434,36.69629935910688,0.036721311475409836,Very Cheap
20150402T000000,360000.0,2,2.0,1770,7607,1.0,0,0,4,8,1770,0,1987,0,98058,47.4287,-122.163,2090,7109,5837,5019,47.324832391218614,0.037377049180327866,Very Cheap
20140709T000000,737500.0,3,1.75,2320,10900,2.0,0,0,3,7,2320,0,1935,1974,98115,47.6877,-122.283,1610,5800,8580,4190,67.66055045871559,0.08688524590163935,Very Cheap
20141215T000000,985000.0,3,3.5,2600,11920,2.0,0,0,5,8,2600,0,1969,0,98004,47.582,-122.194,2430,10050,9320,7620,82.63422818791946,0.11934426229508197,Cheap
20140806T000000,349950.0,2,3.25,1570,2031,2.0,0,0,3,8,1310,260,2006,0,98126,47.548,-122.375,1570,2039,461,469,172.3042836041359,0.036059016393442625,Very Cheap
20150220T000000,520000.0,4,2.5,3060,7161,2.0,0,0,3,8,2860,200,2005,0,98065,47.5383,-121.879,2950,6822,4101,3872,72.61555648652423,0.058360655737704915,Very Cheap
20141217T000000,355950.0,4,2.5,1960,8540,1.0,0,0,3,7,1220,740,1955,0,98177,47.7654,-122.359,1910,9120,6580,7210,41.68032786885246,0.036845901639344265,Very Cheap
20141229T000000,485000.0,5,2.5,3270,6129,2.0,0,0,3,9,3270,0,2004,0,98055,47.4461,-122.208,2980,5928,2859,2948,79.1319954315549,0.05377049180327869,Very Cheap
20141212T000000,143000.0,3,1.0,1090,3315,1.0,0,0,4,6,1090,0,1969,0,98092,47.3159,-122.183,960,3120,2225,2160,43.13725490196079,0.008918032786885246,Very Cheap
20141210T000000,3278000.0,2,1.75,6840,10000,2.5,1,4,3,11,4350,2490,2001,0,98008,47.6042,-122.112,3120,12300,3160,9180,327.8,0.4200655737704918,High
20140723T000000,355000.0,3,1.0,940,8512,1.0,0,0,4,7,940,0,1967,0,98033,47.7002,-122.191,1060,8512,7572,7452,41.705827067669176,0.036721311475409836,Very Cheap
20140604T000000,1126000.0,5,3.5,3880,13885,2.0,0,3,4,9,2540,1340,1979,0,98006,47.5696,-122.156,3690,13885,10005,10195,81.09470651782499,0.13783606557377048,Cheap
20140818T000000,200000.0,5,1.75,1770,15525,1.0,0,0,4,7,1770,0,1959,0,98059,47.5025,-122.142,1370,10395,13755,9025,12.882447665056361,0.01639344262295082,Very Cheap
20140618T000000,913000.0,4,2.5,3640,10576,2.0,0,0,3,11,3640,0,1999,0,98075,47.5899,-121.979,3370,10351,6936,6981,86.32753403933434,0.1099016393442623,Cheap
20140522T000000,1600000.0,3,2.5,3160,12824,1.0,0,2,4,9,1820,1340,1966,0,98004,47.6151,-122.216,3390,11985,9664,8595,124.76606363069246,0.2,Cheap
20140625T000000,409900.0,2,2.5,1590,1845,2.0,0,0,3,9,1590,0,1997,0,98033,47.6897,-122.175,2320,3174,255,854,222.1680216802168,0.043921311475409834,Very Cheap
20150501T000000,265000.0,4,1.0,1290,6034,1.0,0,0,3,6,1050,240,1950,0,98118,47.5223,-122.286,1060,6034,4744,4974,43.91779913821677,0.024918032786885248,Very Cheap
20150410T000000,740000.0,5,3.0,3655,51836,1.0,0,0,5,8,2174,1481,1955,0,98008,47.6434,-122.115,2530,8606,48181,6076,14.275792885253491,0.08721311475409836,Very Cheap
20140612T000000,306000.0,4,2.5,2490,8124,2.0,0,0,3,7,2490,0,2001,0,98092,47.3347,-122.17,2760,6300,5634,3540,37.66617429837518,0.030295081967213113,Very Cheap
20141007T000000,381000.0,3,2.5,1470,3999,2.0,0,0,3,7,1470,0,2003,0,98065,47.5328,-121.871,1960,4444,2529,2484,95.27381845461365,0.040131147540983604,Very Cheap
20150505T000000,1220000.0,3,3.25,3960,6132,2.0,0,3,3,10,2600,1360,1933,0,98199,47.6396,-122.409,2730,5221,2172,2491,198.95629484670582,0.1501639344262295,Cheap
20150320T000000,1050000.0,3,3.5,3190,29982,1.0,0,3,4,8,2630,560,1941,0,98166,47.458,-122.368,2600,19878,26792,17278,35.021012607564536,0.12786885245901639,Cheap
20140903T000000,408000.0,2,1.0,810,7440,1.0,0,0,5,6,810,0,1948,0,98133,47.7346,-122.352,830,7500,6630,6670,54.83870967741935,0.04367213114754098,Very Cheap
20140625T000000,739900.0,5,2.5,2980,5377,2.0,0,0,3,9,2980,0,2006,0,98052,47.7074,-122.101,3150,6593,2397,3443,137.60461223730704,0.0872,Very Cheap
20141121T000000,674250.0,4,2.5,2780,35000,1.0,0,0,4,9,2780,0,1985,0,98072,47.7386,-122.091,2740,35072,32220,32332,19.264285714285716,0.07859016393442624,Very Cheap
20140911T000000,438400.0,2,1.0,1340,8100,1.0,0,0,4,7,1340,0,1953,0,98177,47.7218,-122.37,1700,8100,6760,6400,54.123456790123456,0.047659016393442624,Very Cheap
20141230T000000,1700000.0,5,5.0,4930,14649,2.0,0,3,3,11,4160,770,2000,0,98040,47.5829,-122.247,3030,8479,9719,5449,116.04887705645436,0.21311475409836064,Cheap
20140619T000000,703000.0,3,2.0,1360,5980,1.5,0,0,3,8,1360,0,1945,2008,98116,47.5852,-122.388,1520,4440,4620,2920,117.55852842809365,0.08236065573770492,Very Cheap
20141229T000000,262000.0,3,1.75,1320,6530,1.0,0,0,4,7,1320,0,1989,0,98023,47.2871,-122.354,1620,6817,5210,5197,40.12251148545176,0.024524590163934427,Very Cheap
20150423T000000,353000.0,3,2.0,1210,14499,1.0,0,0,3,7,1210,0,1984,0,98045,47.4705,-121.754,1570,15360,13289,13790,24.346506655631423,0.03645901639344262,Very Cheap
20150114T000000,500000.0,4,2.5,1940,7607,2.0,0,0,3,8,1940,0,1995,0,98052,47.685,-122.158,2250,7600,5667,5350,65.72893387669252,0.05573770491803279,Very Cheap
20140706T000000,1280000.0,4,2.5,3160,4620,1.5,0,4,3,9,2020,1140,1917,2005,98116,47.5875,-122.382,2790,5308,1460,2518,277.05627705627705,0.1580327868852459,Cheap
20150408T000000,332000.0,4,2.5,1980,6566,2.0,0,0,3,8,1980,0,2004,0,98042,47.3809,-122.097,2590,6999,4586,4409,50.563508985683825,0.033704918032786885,Very Cheap
20140821T000000,824000.0,4,2.5,2320,14240,1.0,0,0,4,9,1620,700,1974,0,98008,47.6269,-122.09,2810,13200,11920,10390,57.86516853932584,0.09822950819672131,Very Cheap
20150220T000000,290000.0,4,2.0,1660,4788,1.0,0,0,3,7,1660,0,1968,0,98144,47.5878,-122.312,1150,5000,3128,3850,60.568086883876354,0.02819672131147541,Very Cheap
20140627T000000,700000.0,3,2.5,1660,1545,2.0,0,2,3,9,1400,260,2002,0,98109,47.6268,-122.353,1820,2570,-115,750,453.0744336569579,0.08196721311475409,Very Cheap
20141006T000000,550000.0,2,1.0,1080,3420,1.0,0,0,4,7,780,300,1922,0,98107,47.6715,-122.393,1380,3656,2340,2276,160.8187134502924,0.06229508196721312,Very Cheap
20140903T000000,549000.0,2,1.0,1510,11165,1.5,0,0,4,7,1510,0,1921,0,98133,47.7212,-122.331,2210,8851,9655,6641,49.17151813703538,0.06216393442622951,Very Cheap
20150306T000000,1865000.0,4,2.5,2950,43560,1.0,0,2,4,9,2550,400,1951,0,98004,47.5988,-122.207,3260,41016,40610,37756,42.81450872359963,0.23475409836065575,Cheap
20150302T000000,858000.0,4,2.25,3070,13720,2.0,0,0,3,9,3070,0,1978,0,98007,47.6133,-122.152,3010,9657,10650,6647,62.53644314868804,0.10268852459016393,Cheap
20141030T000000,345000.0,2,1.0,970,10423,1.0,0,0,3,7,970,0,1947,0,98133,47.7252,-122.331,1200,7857,9453,6657,33.0998752758323,0.03540983606557377,Very Cheap
20141104T000000,340000.0,4,1.75,2140,11651,2.5,0,0,3,8,2140,0,1930,2001,98022,47.196,-122.006,2030,10978,9511,8948,29.18204445970303,0.03475409836065574,Very Cheap
20150425T000000,1215000.0,4,2.25,2570,9600,2.5,0,0,4,9,2570,0,1962,0,98040,47.5791,-122.241,2570,13200,7030,10630,126.5625,0.14950819672131146,Cheap
20141211T000000,275000.0,3,2.25,1260,1488,3.0,0,0,3,7,1260,0,2009,0,98133,47.7071,-122.336,1190,1095,228,-95,184.81182795698925,0.02622950819672131,Very Cheap
20140827T000000,405000.0,3,1.0,1220,7771,1.0,0,0,3,7,1220,0,1963,0,98008,47.6326,-122.119,1420,7674,6551,6254,52.1168446789345,0.043278688524590166,Very Cheap
20150116T000000,432500.0,3,2.0,1720,8145,2.0,0,0,5,7,1720,0,1949,0,98155,47.7393,-122.325,1400,8138,6425,6738,53.1000613873542,0.046885245901639346,Very Cheap
20150112T000000,236500.0,4,1.0,2140,4217,1.5,0,0,3,6,1320,820,1925,0,98118,47.5484,-122.287,1720,5413,2077,3693,56.08252312070192,0.021180327868852458,Very Cheap
20140718T000000,679000.0,4,1.5,1420,4923,1.5,0,0,4,8,1420,0,1928,0,98103,47.6901,-122.339,1470,4923,3503,3453,137.92403006296973,0.07921311475409835,Very Cheap
20141031T000000,543000.0,4,2.5,2060,8451,2.0,0,0,3,8,2060,0,1995,0,98133,47.7168,-122.333,2060,9460,6391,7400,64.25275115370962,0.06137704918032787,Very Cheap
20140926T000000,294000.0,3,1.0,1320,9520,1.0,0,0,3,7,990,330,1953,0,98178,47.4857,-122.253,1460,10610,8200,9150,30.88235294117647,0.028721311475409836,Very Cheap
20150403T000000,340500.0,3,1.75,1810,10463,1.0,0,0,4,7,1810,0,1969,0,98058,47.4581,-122.162,1620,8551,8653,6931,32.54324763452165,0.03481967213114754,Very Cheap
20140703T000000,1012000.0,4,2.5,2980,16263,2.0,0,0,3,9,2980,0,1989,0,98006,47.5457,-122.153,2730,10018,13283,7288,62.22714136383201,0.12288524590163935,Cheap
20140502T000000,335000.0,2,2.0,1350,2560,1.0,0,0,3,8,1350,0,1976,0,98052,47.6344,-122.107,1790,2560,1210,770,130.859375,0.03409836065573771,Very Cheap
20140723T000000,425000.0,3,2.0,1540,8011,1.0,0,0,3,7,1540,0,1988,0,98011,47.7342,-122.202,1630,7141,6471,5511,53.05205342653851,0.04590163934426229,Very Cheap
20150210T000000,353000.0,3,2.5,2510,9240,2.0,0,0,4,8,2510,0,2001,0,98022,47.1896,-122.013,2690,9240,6730,6550,38.2034632034632,0.03645901639344262,Very Cheap
20150504T000000,540000.0,3,2.5,1670,5146,2.0,0,0,3,8,1670,0,1991,0,98029,47.5707,-121.999,1940,5146,3476,3206,104.93587252234745,0.06098360655737705,Very Cheap
20140612T000000,640000.0,5,3.5,3690,11928,2.0,0,0,3,9,2540,1150,2006,0,98074,47.6108,-122.06,2640,11928,8238,9288,53.65526492287056,0.0740983606557377,Very Cheap
20140722T000000,339950.0,3,1.0,1320,11457,1.0,0,0,3,8,1320,0,1959,0,98028,47.7738,-122.261,1900,9800,10137,7900,29.67181635681243,0.03474754098360656,Very Cheap
20141107T000000,195000.0,3,1.75,1510,8400,1.0,0,0,2,7,980,530,1979,0,98045,47.4476,-121.771,1500,10125,6890,8625,23.214285714285715,0.015737704918032787,Very Cheap
20150226T000000,322000.0,3,1.75,1510,8400,1.0,0,0,2,7,980,530,1979,0,98045,47.4476,-121.771,1500,10125,6890,8625,38.333333333333336,0.03239344262295082,Very Cheap
20150401T000000,660000.0,4,1.75,1870,10450,1.0,0,0,3,8,1620,250,1978,0,98005,47.5938,-122.154,2060,10450,8580,8390,63.1578947368421,0.07672131147540984,Very Cheap
20140916T000000,280000.0,6,3.0,2400,9373,2.0,0,0,3,7,2400,0,1991,0,98002,47.3262,-122.214,2060,7316,6973,5256,29.873039581777444,0.026885245901639345,Very Cheap
20150422T000000,300000.0,6,3.0,2400,9373,2.0,0,0,3,7,2400,0,1991,0,98002,47.3262,-122.214,2060,7316,6973,5256,32.00682812333298,0.029508196721311476,Very Cheap
20140815T000000,207500.0,3,1.0,1170,8816,1.0,0,0,4,6,1170,0,1966,0,98023,47.3059,-122.368,1200,9108,7646,7908,23.536751361161524,0.01737704918032787,Very Cheap
20140825T000000,195000.0,3,1.5,1190,8726,1.0,0,0,3,7,1190,0,1956,0,98146,47.4887,-122.343,1390,8741,7536,7351,22.347008938803576,0.015737704918032787,Very Cheap
20140610T000000,700000.0,3,2.0,2080,3880,1.0,0,0,5,7,1160,920,1954,0,98117,47.686,-122.391,1330,3880,1800,2550,180.41237113402062,0.08196721311475409,Very Cheap
20150417T000000,560000.0,4,1.75,2150,8555,1.0,0,2,4,7,1460,690,1982,0,98106,47.5344,-122.345,1480,7405,6405,5925,65.45879602571596,0.06360655737704918,Very Cheap
20140820T000000,260000.0,3,1.75,1580,7344,1.0,0,0,5,7,1580,0,1911,0,98126,47.5256,-122.38,1580,6207,5764,4627,35.40305010893246,0.024262295081967214,Very Cheap
20150225T000000,575000.0,3,1.75,1580,7344,1.0,0,0,5,7,1580,0,1911,0,98126,47.5256,-122.38,1580,6207,5764,4627,78.29520697167756,0.06557377049180328,Very Cheap
20150417T000000,475000.0,3,2.5,2370,3239,2.0,0,0,3,8,1950,420,2006,0,98072,47.7515,-122.174,2520,3431,869,911,146.650200679222,0.05245901639344262,Very Cheap
20140613T000000,285000.0,3,1.75,1840,8601,1.0,0,0,3,7,920,920,1905,2014,98118,47.5359,-122.276,1390,7452,6761,6062,33.135681897453786,0.02754098360655738,Very Cheap
20140508T000000,753888.0,4,2.5,2660,5500,2.0,0,2,3,9,2660,0,2003,0,98029,47.5439,-121.996,3620,5500,2840,1880,137.07054545454545,0.08903449180327869,Very Cheap
20150410T000000,650000.0,3,2.5,2190,3600,2.0,0,0,3,9,2190,0,2003,0,98029,47.5506,-121.993,2300,3600,1410,1300,180.55555555555554,0.07540983606557378,Very Cheap
20140807T000000,620000.0,3,2.25,1660,3478,1.5,0,0,4,7,1100,560,1929,0,98117,47.6773,-122.372,1610,3478,1818,1868,178.26336975273145,0.07147540983606557,Very Cheap
20150313T000000,526000.0,3,1.75,1780,37801,1.0,0,0,3,7,1300,480,1977,0,98075,47.5858,-122.015,2380,47480,36021,45100,13.914975794291156,0.059147540983606556,Very Cheap
20140514T000000,155000.0,2,1.0,700,5200,1.0,0,0,5,6,700,0,1952,0,98056,47.4924,-122.175,1030,5200,4500,4170,29.807692307692307,0.010491803278688525,Very Cheap
20140827T000000,342000.0,4,2.0,1570,11200,1.0,0,0,3,7,1120,450,1959,0,98011,47.7573,-122.217,1570,11200,9630,9630,30.535714285714285,0.03501639344262295,Very Cheap
20150407T000000,390000.0,3,1.75,1220,216332,1.0,0,0,3,7,1220,0,1981,0,98019,47.7224,-121.926,1540,61419,215112,59879,1.8027846088419652,0.04131147540983607,Very Cheap
20140605T000000,685000.0,3,2.75,3150,219978,2.0,0,0,4,9,3000,150,1990,0,98024,47.553,-121.946,3180,218235,216828,215055,3.113947758412205,0.08,Very Cheap
20140625T000000,608000.0,4,2.5,2690,4736,2.0,0,0,3,7,2690,0,2001,0,98053,47.6869,-122.036,2690,4791,2046,2101,128.3783783783784,0.0699016393442623,Very Cheap
20140916T000000,179900.0,2,1.0,680,6400,1.0,0,0,3,6,680,0,1943,0,98168,47.5136,-122.316,1240,7800,5720,6560,28.109375,0.013757377049180328,Very Cheap
20140904T000000,1245000.0,6,3.25,3750,14150,2.0,0,2,5,9,2750,1000,1936,1968,98117,47.6999,-122.393,2140,7968,10400,5828,87.98586572438163,0.15344262295081967,Cheap
20150430T000000,166000.0,3,1.0,1010,11675,1.0,0,0,3,7,1010,0,1957,0,98168,47.4849,-122.301,1370,10042,10665,8672,14.218415417558887,0.011934426229508197,Very Cheap
20140519T000000,462000.0,3,1.5,1710,4500,1.5,0,0,3,8,1410,300,1928,0,98118,47.5366,-122.268,1860,6000,2790,4140,102.66666666666667,0.05075409836065574,Very Cheap
20140622T000000,545000.0,4,2.5,2090,6023,2.0,0,0,3,8,2090,0,1990,0,98029,47.5713,-121.997,2090,6023,3933,3933,90.48646853727378,0.06163934426229508,Very Cheap
20150116T000000,415000.0,3,1.0,1560,4500,1.5,0,0,3,7,1560,0,1903,0,98122,47.6118,-122.306,1660,4500,2940,2840,92.22222222222223,0.04459016393442623,Very Cheap
20140610T000000,269000.0,3,2.5,1560,4200,2.0,0,0,3,7,1560,0,2003,0,98038,47.3838,-122.026,1560,4200,2640,2640,64.04761904761905,0.02544262295081967,Very Cheap
20141212T000000,356500.0,4,2.5,2570,11473,2.0,0,0,3,8,2570,0,2008,0,98003,47.2809,-122.296,2430,5997,8903,3567,31.072953891745836,0.03691803278688525,Very Cheap
20141223T000000,225000.0,3,1.0,1010,7633,1.0,0,0,4,6,1010,0,1961,0,98198,47.3781,-122.314,1190,8386,6623,7196,29.477269749770734,0.019672131147540985,Very Cheap
20140620T000000,175000.0,2,1.0,1020,5130,1.0,0,0,4,6,1020,0,1948,0,98002,47.301,-122.226,1200,6497,4110,5297,34.113060428849906,0.013114754098360656,Very Cheap
20140801T000000,549000.0,5,2.5,1710,9720,2.0,0,0,4,8,1710,0,1974,0,98005,47.5903,-122.157,2270,9672,8010,7402,56.48148148148148,0.06216393442622951,Very Cheap
20150415T000000,535000.0,3,2.75,2300,12197,2.0,0,0,3,8,2300,0,1989,0,98166,47.4369,-122.338,1710,11220,9897,9510,43.86324506026072,0.06032786885245902,Very Cheap
20140505T000000,627000.0,4,2.25,1990,7712,1.0,0,0,3,8,1210,780,1973,0,98027,47.5688,-122.087,1720,7393,5722,5673,81.30186721991701,0.07239344262295082,Very Cheap
20140822T000000,565000.0,3,2.0,2730,15677,2.5,0,3,3,9,2730,0,1976,0,98166,47.4612,-122.365,2040,12209,12947,10169,36.04005868469733,0.06426229508196721,Very Cheap
20141112T000000,392450.0,4,2.0,2195,2681,1.0,0,0,3,7,1060,1135,1912,0,98103,47.6965,-122.342,1710,1280,486,-430,146.38194703468855,0.0416327868852459,Very Cheap
20140923T000000,509000.0,2,2.0,1560,4675,1.0,0,0,3,8,1560,0,2006,0,98053,47.7086,-122.019,1870,6361,3115,4491,108.87700534759358,0.056918032786885245,Very Cheap
20140912T000000,340000.0,3,2.5,1400,4800,1.0,0,0,3,7,1200,200,1921,0,98117,47.6865,-122.379,1440,3840,3400,2400,70.83333333333333,0.03475409836065574,Very Cheap
20150326T000000,537000.0,3,2.5,1400,4800,1.0,0,0,3,7,1200,200,1921,0,98117,47.6865,-122.379,1440,3840,3400,2400,111.875,0.060590163934426226,Very Cheap
20140505T000000,865000.0,4,3.0,3690,9892,2.0,0,0,3,10,3690,0,1998,0,98075,47.5937,-121.982,3430,11294,6202,7864,87.4443995147594,0.10360655737704919,Cheap
20141214T000000,358000.0,2,1.0,1140,8340,1.0,0,0,3,7,1140,0,1948,0,98155,47.7448,-122.3,1030,8149,7200,7119,42.92565947242206,0.03711475409836065,Very Cheap
20140919T000000,595000.0,4,2.25,1920,3225,1.5,0,0,5,7,1300,620,1923,0,98116,47.5848,-122.384,1960,3750,1305,1790,184.49612403100775,0.06819672131147542,Very Cheap
20140619T000000,661000.0,4,2.5,2496,8058,2.0,0,0,3,9,2496,0,1998,0,98052,47.6791,-122.149,2496,7757,5562,5261,82.03028046661703,0.07685245901639344,Very Cheap
20140916T000000,419950.0,3,2.25,2280,8500,1.0,0,0,4,7,1680,600,1977,0,98034,47.7211,-122.166,1890,7700,6220,5810,49.40588235294118,0.04523934426229508,Very Cheap
20150416T000000,490000.0,4,3.5,3200,6420,2.0,0,0,3,9,3200,0,2006,0,98038,47.3545,-122.001,3200,6291,3220,3091,76.32398753894081,0.05442622950819672,Very Cheap
20140918T000000,525000.0,2,1.0,880,4000,1.0,0,0,3,7,880,0,1940,0,98117,47.6847,-122.387,1310,4000,3120,2690,131.25,0.05901639344262295,Very Cheap
20140813T000000,350000.0,3,2.0,1320,1298,3.0,0,0,3,7,1320,0,1995,0,98117,47.6959,-122.376,1380,1503,-22,123,269.6456086286595,0.036065573770491806,Very Cheap
20150511T000000,552500.0,3,2.5,2450,3582,2.0,0,0,3,9,2450,0,2008,0,98072,47.7749,-122.159,2490,5449,1132,2959,154.2434394193188,0.06262295081967213,Very Cheap
20150327T000000,210000.0,3,1.0,1040,8970,1.0,0,0,4,6,1040,0,1961,0,98023,47.3283,-122.337,1040,8450,7930,7410,23.411371237458194,0.017704918032786884,Very Cheap
20150311T000000,390000.0,3,2.5,2480,53250,2.0,0,0,3,9,2480,0,1990,0,98042,47.3323,-122.079,2510,36549,50770,34039,7.323943661971831,0.04131147540983607,Very Cheap
20150129T000000,336800.0,5,1.75,1830,16650,1.5,0,0,3,7,1610,220,1958,0,98155,47.7734,-122.315,1790,12743,14820,10953,20.22822822822823,0.0343344262295082,Very Cheap
20150303T000000,465000.0,3,2.5,1440,4473,2.0,0,0,3,7,1440,0,2003,0,98053,47.6825,-122.036,1650,3322,3033,1672,103.9570757880617,0.051147540983606556,Very Cheap
20141218T000000,299900.0,4,2.5,1580,3632,2.0,0,0,3,7,1580,0,2011,0,98038,47.3672,-122.019,1950,3800,2052,1850,82.5715859030837,0.029495081967213115,Very Cheap
20140718T000000,715000.0,3,3.25,3230,5000,2.0,0,0,3,9,3230,0,2006,0,98029,47.5558,-122.002,2670,3977,1770,1307,143.0,0.0839344262295082,Very Cheap
20140523T000000,235000.0,4,2.5,1810,39639,1.0,0,0,3,7,1230,580,1970,0,98042,47.3472,-122.11,1810,44866,37829,43056,5.928504755417644,0.02098360655737705,Very Cheap
20141210T000000,276000.0,3,2.5,2495,4400,2.0,0,0,3,8,2495,0,2007,0,98001,47.2877,-122.283,2434,4400,1905,1966,62.72727272727273,0.026360655737704918,Very Cheap
20150112T000000,265000.0,4,1.5,1740,12728,1.0,0,0,4,7,1180,560,1964,0,98003,47.2808,-122.3,1830,11125,10988,9295,20.820238843494657,0.024918032786885248,Very Cheap
20140530T000000,425000.0,3,1.75,1680,3000,1.0,0,2,4,6,840,840,1900,0,98103,47.686,-122.346,1540,3700,1320,2160,141.66666666666666,0.04590163934426229,Very Cheap
20150105T000000,313000.0,4,2.5,2460,10320,2.0,0,0,3,8,2460,0,1993,0,98092,47.2599,-122.215,2210,9024,7860,6814,30.329457364341085,0.03121311475409836,Very Cheap
20150409T000000,715000.0,3,2.5,3050,6000,1.0,0,3,3,8,1720,1330,1984,0,98177,47.7701,-122.389,2340,7200,2950,4860,119.16666666666667,0.0839344262295082,Very Cheap
20141212T000000,265000.0,3,2.25,1630,10969,2.0,0,0,3,7,1630,0,1991,0,98001,47.3305,-122.285,1410,7920,9339,6510,24.158993527213056,0.024918032786885248,Very Cheap
20150324T000000,646000.0,3,2.75,2460,6413,2.0,0,0,3,9,2460,0,2004,0,98028,47.7497,-122.245,2440,6092,3953,3652,100.73288632465305,0.07488524590163935,Very Cheap
20140721T000000,175000.0,3,1.0,1030,6600,1.0,0,0,3,7,1030,0,1954,0,98146,47.4941,-122.34,1220,9040,5570,7820,26.515151515151516,0.013114754098360656,Very Cheap
20140731T000000,649000.0,3,2.5,3410,13809,1.0,0,3,4,10,2450,960,1973,0,98003,47.3424,-122.326,3410,14245,10399,10835,46.99833441958143,0.07527868852459016,Very Cheap
20150423T000000,785000.0,3,2.75,2310,5200,1.0,0,0,4,7,1520,790,1940,0,98199,47.6357,-122.397,2310,5200,2890,2890,150.96153846153845,0.09311475409836066,Very Cheap
20140922T000000,890000.0,4,2.75,2610,4400,1.0,0,0,5,8,1260,1350,1920,0,98122,47.6158,-122.293,1770,4400,1790,2630,202.27272727272728,0.10688524590163935,Cheap
20141126T000000,612000.0,3,3.0,2330,10327,1.0,0,0,3,9,2330,0,1998,0,98034,47.7239,-122.164,2200,4629,7997,2429,59.262128401278204,0.07042622950819673,Very Cheap
20141205T000000,330000.0,4,2.5,2980,5674,2.0,0,0,3,8,2980,0,2003,0,98023,47.277,-122.347,2610,5495,2694,2885,58.16002819880155,0.03344262295081967,Very Cheap
20141112T000000,493000.0,3,2.25,1790,11393,1.0,0,0,3,8,1790,0,1978,0,98052,47.6297,-122.099,2290,11894,9603,9604,43.272184674800314,0.054819672131147544,Very Cheap
20150403T000000,1600000.0,4,2.25,2940,5735,1.0,0,0,3,9,1470,1470,1957,0,98112,47.6381,-122.304,2230,5659,2795,3429,278.9886660854403,0.2,Cheap
20140627T000000,1620000.0,4,3.0,3900,9750,1.0,0,4,5,10,2520,1380,1972,0,98006,47.5605,-122.158,3410,9450,5850,6040,166.15384615384616,0.20262295081967213,Cheap
20150211T000000,1650000.0,4,3.0,3900,9750,1.0,0,4,5,10,2520,1380,1972,0,98006,47.5605,-122.158,3410,9450,5850,6040,169.23076923076923,0.20655737704918034,Cheap
20140926T000000,499000.0,3,2.5,1750,2150,2.5,0,0,3,7,1230,520,1900,2014,98122,47.6037,-122.311,1410,3300,400,1890,232.09302325581396,0.05560655737704918,Very Cheap
20140623T000000,603500.0,6,2.75,2660,8400,1.0,0,0,5,8,1550,1110,1962,0,98006,47.549,-122.173,2280,8400,5740,6120,71.8452380952381,0.06931147540983607,Very Cheap
20140624T000000,530000.0,2,1.5,1580,3680,1.0,0,2,3,8,1280,300,1941,0,98126,47.5762,-122.377,1730,3680,2100,1950,144.02173913043478,0.05967213114754098,Very Cheap
20150406T000000,895000.0,5,2.5,2350,14197,1.0,0,0,4,8,1220,1130,1962,0,98004,47.6005,-122.204,2470,11629,11847,9159,63.04148763823343,0.10754098360655738,Cheap
20140513T000000,267345.0,4,2.25,2510,8165,1.0,0,0,4,7,1610,900,1972,0,98023,47.3092,-122.372,1940,8250,5655,6310,32.742804654011024,0.025225573770491803,Very Cheap
20140516T000000,275000.0,3,2.5,1480,15639,2.0,0,0,3,8,1480,0,1987,0,98045,47.4723,-121.746,1480,16454,14159,14974,17.584244516912847,0.02622950819672131,Very Cheap
20150225T000000,439950.0,3,1.75,1720,223377,1.0,0,0,3,7,1240,480,1950,0,98019,47.7329,-121.92,2530,221442,221657,218912,1.9695402839146376,0.04786229508196721,Very Cheap
20140620T000000,455000.0,3,2.25,1470,4653,2.0,0,0,4,7,1470,0,1985,0,98029,47.5667,-122.018,1560,4119,3183,2559,97.78637438211906,0.049836065573770495,Very Cheap
20150113T000000,630000.0,3,1.75,1540,6930,1.0,0,0,3,7,1250,290,1944,0,98115,47.6782,-122.278,1760,6930,5390,5170,90.9090909090909,0.07278688524590164,Very Cheap
20141103T000000,690000.0,3,2.5,2820,5001,2.0,0,0,3,9,2820,0,2004,0,98029,47.5533,-121.992,2660,5001,2181,2341,137.9724055188962,0.08065573770491803,Very Cheap
20140826T000000,212000.0,4,1.75,1250,12705,1.0,0,0,4,7,1250,0,1971,0,98023,47.302,-122.382,1390,8550,11455,7160,16.68634395907123,0.017967213114754098,Very Cheap
20140813T000000,231500.0,4,2.25,2080,7526,1.0,0,0,4,7,1280,800,1985,0,98030,47.3762,-122.183,1200,7500,5446,6300,30.760031889449905,0.020524590163934427,Very Cheap
20150430T000000,1237500.0,4,3.25,5180,49936,2.0,0,0,4,10,5180,0,1991,0,98053,47.6676,-122.069,4240,35363,44756,31123,24.781720602371035,0.15245901639344261,Cheap
20140708T000000,378500.0,3,2.5,2860,43821,2.0,0,0,4,9,2860,0,1990,0,98092,47.3163,-122.142,2370,65340,40961,62970,8.637411286825952,0.03980327868852459,Very Cheap
20140502T000000,482000.0,4,2.5,2710,35868,2.0,0,0,3,9,2710,0,1989,0,98038,47.375,-122.022,2780,36224,33158,33444,13.438162150105944,0.05337704918032787,Very Cheap
20150505T000000,695000.0,2,1.0,1140,3990,1.0,0,0,3,7,1140,0,1924,0,98103,47.6554,-122.333,1800,5700,2850,3900,174.18546365914787,0.08131147540983606,Very Cheap
20141202T000000,965000.0,4,2.5,4070,57587,2.0,0,0,3,10,4070,0,1989,0,98052,47.6908,-122.052,3890,35960,53517,32070,16.757254241408653,0.11672131147540983,Cheap
20150204T000000,675000.0,3,1.75,1710,5913,1.0,0,0,4,8,1120,590,1941,0,98199,47.6481,-122.406,2920,5922,4203,3002,114.15525114155251,0.07868852459016394,Very Cheap
20141027T000000,387000.0,3,1.5,1340,6500,1.0,0,0,3,7,1340,0,1972,0,98034,47.7168,-122.192,1620,7107,5160,5487,59.53846153846154,0.040918032786885244,Very Cheap
20150330T000000,347500.0,4,2.75,2290,7000,2.0,0,0,3,8,2290,0,1977,0,98058,47.4442,-122.129,2000,7200,4710,5200,49.642857142857146,0.035737704918032784,Very Cheap
20140711T000000,385000.0,3,2.0,1860,7400,1.0,0,0,3,8,930,930,1922,2004,98166,47.4598,-122.352,1640,8461,5540,6821,52.027027027027025,0.04065573770491803,Very Cheap
20141204T000000,265000.0,3,1.0,1080,4930,1.0,0,0,3,6,1080,0,1950,0,98126,47.5209,-122.374,1100,5950,3850,4850,53.75253549695741,0.024918032786885248,Very Cheap
20150422T000000,406000.0,3,1.0,960,5264,1.0,0,0,3,7,960,0,1953,0,98115,47.6805,-122.301,1140,5150,4304,4010,77.12765957446808,0.04340983606557377,Very Cheap
20140508T000000,134000.0,2,1.5,980,5000,2.0,0,0,3,7,980,0,1922,2003,98014,47.7076,-121.359,1040,5000,4020,3960,26.8,0.007737704918032787,Very Cheap
20141020T000000,415000.0,3,1.0,1500,3399,2.0,0,0,5,7,1300,200,1926,0,98103,47.6838,-122.352,1360,3588,1899,2228,122.09473374521919,0.04459016393442623,Very Cheap
20140527T000000,375000.0,3,1.75,1440,8775,1.0,0,0,3,7,1440,0,1973,0,98034,47.7231,-122.17,1790,7865,7335,6075,42.73504273504273,0.03934426229508197,Very Cheap
20141210T000000,620000.0,4,2.5,2580,7465,2.0,0,0,3,8,2580,0,1993,0,98074,47.6319,-122.022,2350,7596,4885,5246,83.05425318151373,0.07147540983606557,Very Cheap
20141028T000000,337500.0,5,2.5,2070,4698,2.0,0,0,3,7,2070,0,1999,0,98038,47.3539,-122.024,2010,4698,2628,2688,71.83908045977012,0.03442622950819672,Very Cheap
20140922T000000,565000.0,3,2.5,1880,12368,1.0,0,0,4,7,1260,620,1967,0,98005,47.5901,-122.167,1950,11551,10488,9601,45.682406209573095,0.06426229508196721,Very Cheap
20140523T000000,399500.0,3,1.75,2420,12676,2.0,0,0,3,7,2420,0,1911,1986,98045,47.4943,-121.789,1210,6769,10256,5559,31.516251183338593,0.04255737704918033,Very Cheap
20140521T000000,1065000.0,2,1.75,1890,9466,2.0,0,0,3,8,1890,0,1987,0,98004,47.6144,-122.211,2180,12825,7576,10645,112.50792309317558,0.1298360655737705,Cheap
20140821T000000,352500.0,3,2.0,1920,33630,1.0,0,0,3,8,1920,0,1992,0,98056,47.4983,-122.167,2080,7505,31710,5425,10.48171275646744,0.03639344262295082,Very Cheap
20140617T000000,259000.0,3,2.0,1870,5909,1.0,0,0,3,7,1270,600,1986,0,98030,47.3665,-122.183,1870,7887,4039,6017,43.83144356067017,0.024131147540983607,Very Cheap
20150415T000000,320000.0,2,1.0,900,7620,1.0,0,0,3,7,900,0,1971,0,98106,47.5268,-122.343,1520,7620,6720,6100,41.99475065616798,0.032131147540983604,Very Cheap
20140811T000000,733000.0,3,2.5,2160,9888,2.0,0,0,4,9,2160,0,1989,0,98052,47.6712,-122.142,3060,7829,7728,4769,74.13025889967638,0.08629508196721311,Very Cheap
20140625T000000,381500.0,2,1.0,900,2910,1.0,0,0,5,7,900,0,1924,0,98115,47.6859,-122.322,1320,2910,2010,1590,131.0996563573883,0.04019672131147541,Very Cheap
20141202T000000,343000.0,2,1.0,1180,9261,1.0,0,0,4,7,940,240,1957,0,98118,47.5492,-122.274,1700,6325,8081,4625,37.03703703703704,0.035147540983606555,Very Cheap
20140818T000000,205500.0,2,1.0,900,6400,1.0,0,0,5,6,900,0,1938,0,98022,47.2113,-121.992,1320,6400,5500,5080,32.109375,0.017114754098360656,Very Cheap
20140915T000000,525000.0,3,2.0,1600,16530,1.0,0,0,5,7,1600,0,1967,0,98075,47.5821,-122.016,1850,41006,14930,39156,31.76043557168784,0.05901639344262295,Very Cheap
20150319T000000,300000.0,3,1.75,1500,8352,1.0,0,2,5,6,750,750,1943,0,98056,47.4883,-122.191,1500,8447,6852,6947,35.91954022988506,0.029508196721311476,Very Cheap
20140722T000000,299000.0,2,1.0,1070,189486,1.0,0,0,3,6,1070,0,1942,0,98077,47.7199,-122.085,1970,60548,188416,58578,1.5779529886112957,0.02937704918032787,Very Cheap
20140709T000000,561000.0,4,2.5,2570,5250,2.0,0,0,3,8,2570,0,1990,0,98029,47.5763,-122.0,2260,5392,2680,3132,106.85714285714286,0.06373770491803278,Very Cheap
20150224T000000,450000.0,3,1.0,1210,4000,1.5,0,0,3,7,1090,120,1928,0,98144,47.5934,-122.308,1210,4000,2790,2790,112.5,0.04918032786885246,Very Cheap
20140814T000000,540000.0,4,2.5,1850,7850,2.0,0,0,3,8,1850,0,1985,0,98052,47.6914,-122.103,1830,8140,6000,6310,68.78980891719745,0.06098360655737705,Very Cheap
20140624T000000,379000.0,3,2.5,1740,30886,2.0,0,0,3,8,1740,0,1992,0,98045,47.46,-121.707,1740,39133,29146,37393,12.270931813766754,0.03986885245901639,Very Cheap
20140724T000000,230000.0,3,1.0,1300,14000,1.0,0,0,4,7,1300,0,1958,0,98198,47.4213,-122.322,1390,8750,12700,7360,16.428571428571427,0.020327868852459016,Very Cheap
20150310T000000,399950.0,3,2.5,2000,30605,2.0,0,0,4,8,2000,0,1989,0,98042,47.3442,-122.062,1930,35350,28605,33420,13.068126123182486,0.04261639344262295,Very Cheap
20150507T000000,355000.0,5,2.5,3220,5806,2.0,0,0,3,8,3220,0,2002,0,98042,47.3714,-122.103,2760,5813,2586,3053,61.143644505683774,0.036721311475409836,Very Cheap
20140619T000000,580000.0,4,2.25,2160,9593,1.0,0,0,3,8,2160,0,1969,0,98008,47.5883,-122.112,2820,9628,7433,6808,60.460752632127594,0.06622950819672131,Very Cheap
20150427T000000,700000.0,3,2.0,2130,4299,1.5,0,0,4,7,1680,450,1922,0,98144,47.5779,-122.294,2040,4548,2169,2508,162.82856478250756,0.08196721311475409,Very Cheap
20140506T000000,279900.0,3,1.75,1580,8151,1.0,0,1,4,7,1100,480,1962,0,98198,47.3672,-122.312,1650,8151,6571,6501,34.33934486566066,0.026872131147540983,Very Cheap
20141113T000000,210000.0,3,1.0,1200,7500,1.0,0,0,3,6,1200,0,1905,1989,98178,47.4921,-122.275,1010,7000,6300,5990,28.0,0.017704918032786884,Very Cheap
20140630T000000,1165000.0,3,3.0,3790,5001,2.0,0,0,3,10,2810,980,1989,0,98122,47.6035,-122.285,2500,6286,1211,3786,232.95340931813638,0.14295081967213114,Cheap
20140611T000000,290300.0,2,1.0,860,3874,1.0,0,0,4,6,860,0,1931,0,98055,47.4836,-122.204,1400,5106,3014,3706,74.93546721734641,0.02823606557377049,Very Cheap
20141003T000000,1599950.0,5,4.5,5130,43123,2.0,0,0,3,11,5130,0,1996,0,98006,47.544,-122.126,4670,43560,37993,38890,37.102010528024486,0.19999344262295082,Cheap
20150416T000000,490000.0,3,1.0,1600,6380,1.5,0,0,3,7,1400,200,1939,0,98125,47.7015,-122.317,1760,6380,4780,4620,76.8025078369906,0.05442622950819672,Very Cheap
20140506T000000,606000.0,4,2.5,2110,13850,2.0,0,0,3,9,2110,0,1987,0,98027,47.5497,-122.077,2520,10194,11740,7674,43.75451263537906,0.06963934426229508,Very Cheap
20140714T000000,359950.0,3,1.0,1400,4980,1.0,0,0,3,6,950,450,1943,0,98133,47.7041,-122.34,990,4980,3580,3990,72.27911646586345,0.037370491803278685,Very Cheap
20150212T000000,677100.0,3,2.0,2110,9199,1.0,0,0,3,10,2110,0,1993,0,98074,47.6496,-122.083,3130,8841,7089,5711,73.60582672029568,0.07896393442622951,Very Cheap
20150221T000000,465000.0,3,2.0,1430,7125,1.0,0,0,4,7,1430,0,1984,0,98074,47.6256,-122.059,1570,8075,5695,6505,65.26315789473684,0.051147540983606556,Very Cheap
20140815T000000,4500000.0,5,5.5,6640,40014,2.0,1,4,3,12,6350,290,2004,0,98155,47.7493,-122.28,3030,23408,33374,20378,112.46063877642825,0.580327868852459,Very High
20150504T000000,500000.0,3,2.0,3040,41072,1.0,0,0,4,8,1520,1520,1978,0,98038,47.3944,-121.972,2230,54014,38032,51784,12.173743669653291,0.05573770491803279,Very Cheap
20150503T000000,455000.0,2,1.0,980,5000,1.0,0,0,4,7,980,0,1950,0,98155,47.7518,-122.279,1600,5965,4020,4365,91.0,0.049836065573770495,Very Cheap
20140818T000000,705000.0,6,2.0,2570,4240,1.5,0,0,4,7,1970,600,1911,0,98115,47.6754,-122.307,2030,4240,1670,2210,166.27358490566039,0.08262295081967214,Very Cheap
20140812T000000,420000.0,3,2.5,2060,7020,1.0,0,0,4,8,1460,600,1967,0,98177,47.7575,-122.364,2150,8400,4960,6250,59.82905982905983,0.04524590163934426,Very Cheap
20141005T000000,169575.0,3,1.0,1300,8284,1.0,0,0,3,7,1300,0,1968,0,98003,47.3327,-122.306,1360,7848,6984,6488,20.470183486238533,0.01240327868852459,Very Cheap
20150225T000000,250000.0,3,1.0,1300,8284,1.0,0,0,3,7,1300,0,1968,0,98003,47.3327,-122.306,1360,7848,6984,6488,30.17865765330758,0.022950819672131147,Very Cheap
20150312T000000,530000.0,3,2.25,1680,7262,1.0,0,0,5,7,1180,500,1973,0,98034,47.713,-122.225,1910,7405,5582,5495,72.98264940787662,0.05967213114754098,Very Cheap
20150206T000000,590000.0,5,3.25,4020,40341,1.0,0,0,5,8,2170,1850,1970,0,98027,47.4952,-122.068,2650,53437,36321,50787,14.625319154210358,0.06754098360655737,Very Cheap
20140923T000000,257500.0,3,1.75,1530,14087,1.0,0,0,3,7,1070,460,1979,0,98042,47.3146,-122.043,1770,13660,12557,11890,18.27926457017108,0.023934426229508195,Very Cheap
20140626T000000,415000.0,3,1.0,1170,6700,1.0,0,0,3,8,1170,0,1957,0,98125,47.7122,-122.29,2410,7620,5530,5210,61.940298507462686,0.04459016393442623,Very Cheap
20141010T000000,536000.0,3,1.75,1580,3764,1.5,0,0,3,7,1280,300,1945,0,98107,47.672,-122.397,1560,3764,2184,2204,142.4017003188098,0.06045901639344262,Very Cheap
20140529T000000,246500.0,3,1.5,1270,11600,1.0,0,0,4,7,1270,0,1964,0,98031,47.4075,-122.196,1380,9945,10330,8565,21.25,0.022491803278688525,Very Cheap
20140706T000000,395000.0,3,1.75,1480,7700,1.0,0,0,3,8,1480,0,1975,0,98034,47.7225,-122.202,1930,8560,6220,6630,51.298701298701296,0.0419672131147541,Very Cheap
20150511T000000,739000.0,3,2.25,2220,10530,1.0,0,0,4,8,1700,520,1974,0,98052,47.6383,-122.098,2500,10014,8310,7514,70.18043684710351,0.08708196721311476,Very Cheap
20140929T000000,1272000.0,4,2.75,3200,13729,2.0,0,0,3,11,3200,0,1984,0,98005,47.6402,-122.171,4050,16921,10529,12871,92.65059363391362,0.15698360655737706,Cheap
20140708T000000,190000.0,3,1.0,910,10575,1.0,0,0,4,7,910,0,1968,0,98003,47.2741,-122.301,1470,10425,9665,8955,17.96690307328605,0.015081967213114755,Very Cheap
20150410T000000,305000.0,3,1.5,1480,9086,1.0,0,0,3,7,1480,0,1962,0,98168,47.4717,-122.323,1540,9750,7606,8210,33.56812678846577,0.03016393442622951,Very Cheap
20150420T000000,925000.0,4,4.25,3770,13058,2.0,0,0,4,8,3770,0,1983,0,98028,47.7517,-122.225,2200,12255,9288,10055,70.83780058201869,0.11147540983606558,Cheap
20140821T000000,895000.0,4,3.0,3500,13444,2.0,0,0,3,10,2360,1140,1977,0,98040,47.5468,-122.231,3140,12935,9944,9795,66.57244867598929,0.10754098360655738,Cheap
20140717T000000,656000.0,3,1.75,1480,7475,1.5,0,0,3,8,1480,0,1943,0,98115,47.6732,-122.272,2120,7216,5995,5096,87.75919732441471,0.07619672131147541,Very Cheap
20140519T000000,560000.0,4,1.0,1660,4690,1.5,0,0,3,7,1260,400,1945,0,98117,47.6829,-122.378,1400,3876,3030,2476,119.40298507462687,0.06360655737704918,Very Cheap
20141020T000000,610000.0,5,2.25,2520,11700,2.0,0,0,3,9,2520,0,1977,0,98074,47.6322,-122.053,2530,12000,9180,9470,52.136752136752136,0.07016393442622951,Very Cheap
20140708T000000,645000.0,4,2.5,2850,37522,2.0,0,0,3,9,2850,0,1987,0,98075,47.5852,-121.992,2980,35280,34672,32300,17.189915249720165,0.07475409836065573,Very Cheap
20150410T000000,259000.0,3,2.5,2153,4400,2.0,0,0,3,8,2153,0,2007,0,98001,47.2872,-122.283,2434,4400,2247,1966,58.86363636363637,0.024131147540983607,Very Cheap
20140818T000000,980000.0,4,2.5,3780,10962,2.0,0,0,3,10,3780,0,1990,0,98033,47.6533,-122.183,3310,11651,7182,8341,89.39974457215837,0.11868852459016394,Cheap
20140723T000000,872000.0,4,4.0,3770,9750,1.0,0,0,4,9,1940,1830,1967,0,98177,47.7159,-122.367,2260,9878,5980,7618,89.43589743589743,0.10452459016393442,Cheap
20140805T000000,1000000.0,6,2.75,3600,9675,1.0,0,2,4,9,1940,1660,1977,0,98040,47.5726,-122.213,2990,9675,6075,6685,103.35917312661499,0.12131147540983607,Cheap
20140910T000000,900000.0,3,2.75,2980,12600,1.5,0,0,3,8,1590,1390,1941,2012,98033,47.674,-122.196,1520,9660,9620,8140,71.42857142857143,0.10819672131147541,Cheap
20150428T000000,475000.0,4,1.5,2320,5534,1.5,0,0,4,7,1540,780,1915,0,98103,47.6944,-122.355,1670,5913,3214,4243,85.83303216479942,0.05245901639344262,Very Cheap
20150107T000000,350000.0,5,2.75,2980,13482,1.0,0,0,4,8,1730,1250,1975,0,98042,47.3774,-122.16,2900,14800,10502,11900,25.96053997923157,0.036065573770491806,Very Cheap
20140515T000000,840000.0,4,1.75,2930,11562,1.0,0,3,3,9,1670,1260,1947,0,98117,47.6765,-122.404,2530,6517,8632,3987,72.6517903476907,0.10032786885245902,Cheap
20140622T000000,500000.0,4,2.5,2040,8400,1.0,0,0,3,8,1420,620,1963,0,98006,47.5512,-122.17,2540,8925,6360,6385,59.523809523809526,0.05573770491803279,Very Cheap
20150406T000000,202500.0,3,1.5,1510,9898,1.0,0,0,3,7,1110,400,1954,0,98148,47.4303,-122.334,1420,9250,8388,7830,20.458678520913317,0.016721311475409836,Very Cheap
20141223T000000,523000.0,4,2.5,2660,65340,2.0,0,0,3,8,2660,0,1988,0,98027,47.4969,-122.06,2850,74052,62680,71202,8.00428527701255,0.05875409836065574,Very Cheap
20141203T000000,225000.0,3,2.5,1740,10050,2.0,0,0,3,7,1740,0,1989,0,98001,47.2671,-122.236,1300,10125,8310,8825,22.388059701492537,0.019672131147540985,Very Cheap
20150309T000000,418200.0,3,2.25,2240,9542,1.0,0,1,3,7,1190,1050,1980,0,98198,47.3995,-122.318,2080,9542,7302,7462,43.827289876336195,0.04500983606557377,Very Cheap
20141205T000000,356500.0,4,1.75,1570,9670,1.0,0,0,3,7,1170,400,1959,0,98028,47.7432,-122.248,2080,9100,8100,7020,36.86659772492244,0.03691803278688525,Very Cheap
20140716T000000,670000.0,4,3.0,2500,5000,1.5,0,0,4,7,1460,1040,1926,0,98103,47.6895,-122.331,1720,4500,2500,2780,134.0,0.0780327868852459,Very Cheap
20141204T000000,456150.0,3,2.25,1750,12408,1.0,0,0,5,7,1150,600,1962,0,98155,47.7509,-122.3,1820,12977,10658,11157,36.76257253384913,0.04998688524590164,Very Cheap
20140603T000000,471000.0,4,2.5,3030,9687,2.0,0,0,3,8,2020,1010,1998,0,98045,47.485,-121.799,2050,10193,6657,8143,48.62186435428925,0.051934426229508196,Very Cheap
20150409T000000,558000.0,3,2.5,1680,934,3.0,0,0,3,8,1680,0,2008,0,98116,47.5891,-122.387,1740,1280,-746,-460,597.4304068522484,0.06334426229508197,Very Cheap
20150305T000000,1380000.0,6,4.5,5740,10312,2.0,0,2,3,11,3610,2130,2000,0,98006,47.5533,-122.11,4350,11917,4572,7567,133.82467028704423,0.17114754098360654,Cheap
20141212T000000,161500.0,3,1.0,1220,6000,1.0,0,0,5,7,1220,0,1961,0,98002,47.2811,-122.214,1420,13137,4780,11717,26.916666666666668,0.011344262295081967,Very Cheap
20141010T000000,311000.0,3,1.0,1310,8370,1.5,0,0,3,7,1310,0,1962,0,98034,47.7284,-122.241,1310,8370,7060,7060,37.15651135005974,0.030950819672131147,Very Cheap
20150224T000000,470000.0,6,1.75,2490,8732,1.5,0,0,4,8,2490,0,1966,0,98034,47.7252,-122.187,1840,8024,6242,6184,53.8250114521301,0.05180327868852459,Very Cheap
20140709T000000,569000.0,3,3.25,2220,8227,1.5,0,0,5,8,1770,450,1929,0,98108,47.5665,-122.316,1750,4800,6007,3050,69.16251367448645,0.06478688524590163,Very Cheap
20150318T000000,689000.0,4,2.5,2240,7350,2.0,0,0,3,9,2240,0,1989,0,98029,47.5652,-122.013,2200,8017,5110,5817,93.74149659863946,0.08052459016393443,Very Cheap
20140715T000000,271900.0,3,1.75,1890,11875,1.0,0,0,3,7,1230,660,1979,0,98045,47.4472,-121.774,1580,10920,9985,9340,22.896842105263158,0.02582295081967213,Very Cheap
20141210T000000,278000.0,4,2.5,1850,6037,2.0,0,0,3,7,1850,0,1991,0,98030,47.359,-122.191,1860,6037,4187,4177,46.04936226602617,0.02662295081967213,Very Cheap
20140723T000000,820000.0,2,2.5,2210,4440,2.0,0,0,4,8,1440,770,1931,0,98112,47.6305,-122.3,1560,4920,2230,3360,184.6846846846847,0.09770491803278689,Very Cheap
20150225T000000,399500.0,3,1.75,1410,7700,1.0,0,0,4,7,1410,0,1967,0,98056,47.5375,-122.176,1560,7700,6290,6140,51.883116883116884,0.04255737704918033,Very Cheap
20141105T000000,462000.0,3,2.75,1890,2614,2.0,0,0,4,9,1890,0,1979,0,98008,47.6102,-122.114,1800,2769,724,969,176.7406273909717,0.05075409836065574,Very Cheap
20150413T000000,347500.0,3,1.0,1830,12036,1.0,0,0,3,7,1550,280,1977,0,98042,47.3126,-122.043,1810,12036,10206,10226,28.871718178796943,0.035737704918032784,Very Cheap
20140625T000000,562100.0,2,0.75,1440,3700,1.0,0,0,3,7,1200,240,1914,0,98107,47.6707,-122.364,1440,4300,2260,2860,151.9189189189189,0.06388196721311476,Very Cheap
20140529T000000,230000.0,2,1.0,950,7560,1.0,0,0,3,6,950,0,1958,0,98058,47.4499,-122.176,1160,7560,6610,6400,30.423280423280424,0.020327868852459016,Very Cheap
20140622T000000,687000.0,4,2.5,2370,10083,2.0,0,0,5,8,2370,0,1966,0,98033,47.6715,-122.166,2370,10133,7713,7763,68.13448378458791,0.08026229508196721,Very Cheap
20141209T000000,725786.0,4,2.5,3070,5762,2.0,0,0,3,10,3070,0,2000,0,98075,47.5847,-122.08,3630,6500,2692,2870,125.9607775078098,0.08534898360655738,Very Cheap
20150126T000000,315500.0,3,1.0,1300,12600,1.0,0,0,4,7,1300,0,1969,0,98072,47.7422,-122.1,1480,13530,11300,12050,25.03968253968254,0.031540983606557375,Very Cheap
20140506T000000,312000.0,4,2.0,1300,7054,1.0,0,0,3,7,1300,0,1950,2013,98146,47.5071,-122.369,1560,7100,5754,5540,44.2302239863907,0.031081967213114754,Very Cheap
20141106T000000,343000.0,3,3.25,1210,1173,2.0,0,0,3,8,1000,210,2002,0,98133,47.7114,-122.356,1650,1493,-37,-157,292.41261722080134,0.035147540983606555,Very Cheap
20141029T000000,385195.0,1,1.0,710,6000,1.5,0,0,3,6,710,0,2015,0,98144,47.5756,-122.316,1440,4800,5290,3360,64.19916666666667,0.040681311475409834,Very Cheap
20140829T000000,415000.0,4,2.25,2240,12650,1.0,0,0,4,8,1730,510,1981,0,98059,47.4777,-122.142,2150,12650,10410,10500,32.80632411067194,0.04459016393442623,Very Cheap
20140630T000000,461000.0,3,1.75,3600,8666,2.0,0,0,4,6,2400,1200,1948,0,98033,47.6893,-122.167,2290,8200,5066,5910,53.19639972305562,0.05062295081967213,Very Cheap
20140610T000000,369990.0,4,2.5,1960,7133,2.0,0,0,3,7,1960,0,2002,0,98056,47.4941,-122.19,1960,6705,5173,4745,51.87018084957241,0.0386872131147541,Very Cheap
20140929T000000,349950.0,4,2.5,1820,3134,2.0,0,0,3,7,1820,0,1999,0,98019,47.7351,-121.985,1820,3751,1314,1931,111.66241225271219,0.036059016393442625,Very Cheap
20150412T000000,285750.0,3,2.25,1960,17126,1.0,0,0,3,8,1400,560,1966,0,98055,47.4436,-122.21,2060,11466,15166,9406,16.685157071119935,0.02763934426229508,Very Cheap
20150420T000000,542500.0,4,2.25,1750,10160,1.0,0,0,3,8,1320,430,1972,0,98005,47.5909,-122.158,2170,11165,8410,8995,53.395669291338585,0.061311475409836065,Very Cheap
20141111T000000,830000.0,5,3.5,3700,5400,2.0,0,0,3,9,2890,810,2011,0,98053,47.7085,-122.117,3620,5460,1700,1840,153.7037037037037,0.09901639344262295,Very Cheap
20141223T000000,705000.0,4,2.5,2910,20946,2.0,0,0,4,8,2350,560,1976,0,98034,47.7085,-122.24,2020,11342,18036,9322,33.657977656831854,0.08262295081967214,Very Cheap
20140624T000000,615000.0,2,1.0,1270,5000,1.0,0,0,3,8,1090,180,1949,0,98117,47.6828,-122.393,1640,5000,3730,3360,123.0,0.07081967213114754,Very Cheap
20150129T000000,184500.0,2,1.0,720,5880,1.0,0,0,3,6,720,0,1940,0,98178,47.5056,-122.27,1440,7200,5160,5760,31.377551020408163,0.014360655737704918,Very Cheap
20141001T000000,412000.0,2,1.0,1040,5120,1.0,0,0,3,7,1040,0,1901,0,98122,47.6048,-122.312,1250,4000,4080,2750,80.46875,0.04419672131147541,Very Cheap
20141215T000000,250000.0,3,1.5,2210,11111,1.5,0,0,3,7,2210,0,1934,0,98168,47.492,-122.309,1250,8422,8901,7172,22.500225002250023,0.022950819672131147,Very Cheap
20140612T000000,580000.0,5,2.0,2060,6000,2.0,0,0,3,7,2060,0,1903,0,98105,47.6685,-122.305,1770,5000,3940,3230,96.66666666666667,0.06622950819672131,Very Cheap
20150312T000000,220000.0,2,1.0,780,6000,1.0,0,0,5,6,780,0,1923,0,98055,47.4759,-122.208,1080,6000,5220,4920,36.666666666666664,0.01901639344262295,Very Cheap
20140916T000000,675000.0,4,2.75,2240,8937,1.0,0,0,4,8,1460,780,1976,0,98033,47.6495,-122.194,2360,9038,6697,6678,75.52870090634441,0.07868852459016394,Very Cheap
20140522T000000,373500.0,2,1.0,800,3330,1.0,0,0,3,7,800,0,1918,0,98107,47.6566,-122.358,1300,4320,2530,3020,112.16216216216216,0.03914754098360656,Very Cheap
20150402T000000,662700.0,2,1.5,2440,6900,2.0,0,0,3,7,1590,850,1910,0,98118,47.5568,-122.271,1770,6900,4460,5130,96.04347826086956,0.07707540983606558,Very Cheap
20140516T000000,239950.0,5,1.0,1460,6032,2.0,0,0,4,6,1460,0,1941,0,98168,47.487,-122.282,1060,10300,4572,9240,39.77950928381963,0.021632786885245902,Very Cheap
20140925T000000,383000.0,3,1.0,1150,10196,1.0,0,0,4,7,1150,0,1957,0,98052,47.6788,-122.162,1410,8925,9046,7515,37.56375049038839,0.04039344262295082,Very Cheap
20150129T000000,485000.0,3,2.75,2650,12350,1.0,0,0,4,7,1470,1180,1975,0,98028,47.7669,-122.268,1950,14075,9700,12125,39.27125506072875,0.05377049180327869,Very Cheap
20140710T000000,610000.0,4,2.75,2600,36583,1.0,0,0,5,8,1580,1020,1976,0,98075,47.593,-122.054,2300,27820,33983,25520,16.674411611950905,0.07016393442622951,Very Cheap
20140808T000000,545000.0,6,1.75,1820,6250,1.0,0,0,3,7,1130,690,1954,0,98116,47.579,-122.39,1820,5750,4430,3930,87.2,0.06163934426229508,Very Cheap
20140708T000000,780000.0,2,2.5,2560,2500,2.0,0,0,5,8,1690,870,1901,0,98112,47.6233,-122.3,1890,5000,-60,3110,312.0,0.09245901639344262,Very Cheap
20150424T000000,305000.0,3,2.5,1714,3240,2.0,0,0,3,8,1714,0,2005,0,98055,47.4288,-122.19,1714,3240,1526,1526,94.1358024691358,0.03016393442622951,Very Cheap
20140612T000000,405000.0,3,1.0,1330,15678,1.0,0,0,3,7,900,430,1984,0,98074,47.6355,-122.037,1330,12696,14348,11366,25.832376578645235,0.043278688524590166,Very Cheap
20140730T000000,1110000.0,5,3.5,7350,12231,2.0,0,4,3,11,4750,2600,2001,0,98065,47.5373,-121.865,5380,12587,4881,7207,90.75300466028943,0.13573770491803278,Cheap
20150402T000000,273000.0,3,1.75,2050,9045,2.0,0,0,4,6,2050,0,1959,0,98058,47.4572,-122.18,1200,9045,6995,7845,30.182421227197345,0.025967213114754098,Very Cheap
20140527T000000,326500.0,3,1.0,1810,12375,2.0,0,0,3,7,1810,0,1970,0,98072,47.7427,-122.172,1420,9357,10565,7937,26.383838383838384,0.032983606557377046,Very Cheap
20150424T000000,365000.0,3,1.75,1380,9134,1.0,0,0,5,7,880,500,1981,0,98056,47.5087,-122.193,1400,8190,7754,6790,39.9605868184804,0.0380327868852459,Very Cheap
20150408T000000,1000750.0,3,2.75,3070,10739,2.0,0,0,3,10,2440,630,1987,0,98004,47.6444,-122.191,3490,11913,7669,8423,93.18837880622031,0.12140983606557378,Cheap
20150325T000000,422500.0,2,1.0,800,4046,1.0,0,0,3,7,800,0,1940,0,98117,47.6895,-122.382,1400,4046,3246,2646,104.42412259021256,0.04557377049180328,Very Cheap
20150324T000000,354450.0,4,2.75,2140,9920,2.0,0,0,3,8,2140,0,1993,0,98001,47.3529,-122.274,2130,9920,7780,7790,35.73084677419355,0.036649180327868854,Very Cheap
20141204T000000,320000.0,3,1.0,1330,9540,1.0,0,0,4,7,1330,0,1971,0,98077,47.758,-122.075,1250,10350,8210,9100,33.542976939203356,0.032131147540983604,Very Cheap
20140603T000000,223000.0,3,1.0,1030,9120,1.0,0,0,3,7,1030,0,1961,0,98032,47.3607,-122.291,1470,10220,8090,8750,24.45175438596491,0.019409836065573772,Very Cheap
20140724T000000,410000.0,3,2.5,1740,4948,2.0,0,0,3,7,1740,0,2008,0,98053,47.6966,-122.025,1290,3383,3208,2093,82.86176232821342,0.043934426229508196,Very Cheap
20140829T000000,438000.0,3,1.0,1200,4000,1.5,0,0,4,6,1200,0,1923,0,98144,47.5881,-122.299,1390,4000,2800,2610,109.5,0.04760655737704918,Very Cheap
20141106T000000,390000.0,3,3.0,1490,2944,2.0,0,0,3,7,960,530,1993,0,98199,47.6506,-122.384,1590,1600,1454,10,132.47282608695653,0.04131147540983607,Very Cheap
20150219T000000,298500.0,4,2.5,1890,5954,2.0,0,0,3,7,1890,0,2004,0,98092,47.3293,-122.194,2030,5880,4064,3850,50.13436345314074,0.029311475409836064,Very Cheap
20140905T000000,749999.0,5,2.25,3060,13630,2.0,0,0,3,10,3060,0,1989,0,98006,47.5585,-122.117,3430,10700,10570,7270,55.02560528246515,0.08852445901639344,Very Cheap
20140829T000000,779000.0,6,2.5,3250,12000,1.0,0,1,3,8,1800,1450,1966,0,98115,47.6935,-122.28,3490,10320,8750,6830,64.91666666666667,0.09232786885245901,Very Cheap
20150114T000000,570000.0,3,2.75,2730,11936,2.0,0,2,3,8,1530,1200,1978,0,98034,47.6987,-122.231,2810,12333,9206,9523,47.75469168900804,0.06491803278688525,Very Cheap
20150512T000000,385000.0,3,1.0,810,4600,1.0,0,0,3,6,810,0,1918,0,98144,47.5712,-122.316,1520,4800,3790,3280,83.69565217391305,0.04065573770491803,Very Cheap
20140818T000000,649000.0,4,2.0,2240,11040,1.0,0,0,5,8,1120,1120,1961,0,98033,47.693,-122.168,1790,11040,8800,9250,58.78623188405797,0.07527868852459016,Very Cheap
20141001T000000,283000.0,3,1.0,1740,5247,1.0,0,0,3,7,1270,470,1947,0,98168,47.5049,-122.329,1070,5636,3507,4566,53.93558223746903,0.027278688524590165,Very Cheap
20140922T000000,699900.0,4,2.25,2380,16236,1.0,0,0,3,7,1540,840,1961,0,98008,47.6126,-122.12,2230,8925,13856,6695,43.10790835181079,0.08195409836065574,Very Cheap
20150220T000000,278500.0,4,1.0,1540,8400,1.0,0,0,3,7,770,770,1971,0,98058,47.4278,-122.152,1520,9891,6860,8371,33.154761904761905,0.026688524590163933,Very Cheap
20141115T000000,700000.0,4,1.75,2340,9100,1.0,0,0,3,8,1610,730,1975,0,98052,47.6401,-122.108,2470,11000,6760,8530,76.92307692307692,0.08196721311475409,Very Cheap
20140728T000000,535000.0,4,2.75,2710,45963,2.0,0,0,3,9,2710,0,1995,0,98045,47.4745,-121.724,2710,33955,43253,31245,11.639797228205296,0.06032786885245902,Very Cheap
20140923T000000,234500.0,3,1.75,1310,18400,1.0,0,0,3,7,870,440,1954,0,98168,47.5035,-122.302,1840,10790,17090,8950,12.744565217391305,0.020918032786885248,Very Cheap
20140806T000000,374150.0,3,1.75,1390,9585,1.0,0,0,4,7,1390,0,1973,0,98133,47.752,-122.35,1240,8188,8195,6948,39.03495044340115,0.0392327868852459,Very Cheap
20150317T000000,397000.0,4,2.5,2201,9542,2.0,0,0,3,8,2201,0,2006,0,98198,47.4002,-122.317,1990,9542,7341,7552,41.60553343114651,0.04222950819672131,Very Cheap
20140918T000000,613000.0,3,2.25,1960,10385,1.0,0,0,3,8,1960,0,1988,0,98008,47.5736,-122.109,2800,12632,8425,9832,59.027443428021186,0.07055737704918033,Very Cheap
20140609T000000,1150000.0,3,2.5,2850,10474,1.0,0,0,4,8,1730,1120,1954,0,98004,47.6218,-122.209,2820,10474,7624,7654,109.79568455222456,0.14098360655737704,Cheap
20150327T000000,595000.0,4,1.75,1880,4080,1.0,0,0,3,7,940,940,1924,0,98115,47.6754,-122.327,1410,4080,2200,2670,145.83333333333334,0.06819672131147542,Very Cheap
20140910T000000,340000.0,5,2.75,2440,6858,2.0,0,0,3,8,2440,0,2003,0,98030,47.3655,-122.174,2300,6858,4418,4558,49.57713619130942,0.03475409836065574,Very Cheap
20150108T000000,388000.0,4,2.5,2560,5800,2.0,0,0,3,9,2560,0,2005,0,98038,47.3474,-122.025,3040,5800,3240,2760,66.89655172413794,0.041049180327868855,Very Cheap
20140922T000000,404000.0,3,1.75,1410,15210,1.0,0,0,3,7,1410,0,1950,2014,98166,47.4181,-122.339,1970,16290,13800,14320,26.561472715318867,0.043147540983606555,Very Cheap
20140829T000000,810000.0,3,2.0,2870,6360,1.5,0,1,4,8,1790,1080,1946,0,98115,47.6813,-122.275,2310,6466,3490,4156,127.35849056603773,0.09639344262295083,Very Cheap
20150403T000000,405000.0,4,2.5,2620,9359,2.0,0,0,3,9,2620,0,1987,0,98058,47.438,-122.152,2580,7433,6739,4853,43.27385404423549,0.043278688524590166,Very Cheap
20140714T000000,726000.0,5,3.0,2970,10335,2.0,0,0,3,9,2970,0,2000,0,98075,47.598,-122.019,2970,10335,7365,7365,70.2467343976778,0.08537704918032787,Very Cheap
20140514T000000,266000.0,3,2.5,1780,7214,1.0,0,0,4,7,1400,380,1986,0,98030,47.3667,-122.182,1520,7228,5434,5708,36.872747435542,0.02504918032786885,Very Cheap
20141222T000000,722500.0,5,2.25,3700,7207,1.0,0,1,5,8,1850,1850,1970,0,98177,47.7736,-122.371,2340,7900,3507,5560,100.24975718051894,0.08491803278688524,Very Cheap
20150228T000000,352000.0,4,2.5,1252,25002,1.0,0,0,3,8,992,260,1996,0,98001,47.3216,-122.291,1860,25002,23750,23142,14.07887369010479,0.03632786885245902,Very Cheap
20150319T000000,265000.0,4,1.5,1240,8158,1.0,0,0,4,7,1110,130,1961,0,98198,47.3716,-122.31,1520,8147,6918,6627,32.483451826428045,0.024918032786885248,Very Cheap
20150206T000000,856000.0,3,2.5,2160,3920,2.0,0,0,3,9,2160,0,2014,0,98116,47.5762,-122.415,1500,4920,1760,3420,218.3673469387755,0.10242622950819671,Cheap
20140724T000000,346950.0,3,2.5,2040,4348,2.0,0,0,4,8,2040,0,2006,0,98038,47.3517,-121.999,2380,4348,2308,1968,79.79530818767249,0.0356655737704918,Very Cheap
20140617T000000,866059.0,5,3.5,3130,4797,2.0,0,0,3,9,2570,560,2014,0,98006,47.5664,-122.129,3440,5439,1667,1999,180.5417969564311,0.10374544262295082,Cheap
20150129T000000,410000.0,3,2.5,2350,4456,2.0,0,0,3,7,2350,0,2004,0,98065,47.5314,-121.854,2350,4456,2106,2106,92.01077199281868,0.043934426229508196,Very Cheap
20140708T000000,370000.0,3,1.75,1570,16817,2.0,0,0,3,7,1570,0,1982,0,98045,47.4716,-121.756,1600,16817,15247,15217,22.00154605458762,0.038688524590163934,Very Cheap
20140623T000000,230000.0,3,1.0,1530,389126,1.5,0,0,4,7,1530,0,1919,0,98022,47.1776,-122.011,1768,42148,387596,40380,0.5910681887100836,0.020327868852459016,Very Cheap
20141010T000000,400000.0,2,2.0,1520,5010,1.0,0,0,3,7,1520,0,1999,0,98117,47.6948,-122.364,1110,5040,3490,3930,79.84031936127745,0.04262295081967213,Very Cheap
20150311T000000,172000.0,3,1.0,1350,9680,1.0,0,0,4,7,820,530,1959,0,98023,47.3274,-122.346,1320,9225,8330,7905,17.768595041322314,0.012721311475409836,Very Cheap
20140714T000000,615000.0,3,1.75,1950,8480,1.0,0,0,4,8,1250,700,1962,0,98007,47.5893,-122.15,1740,8480,6530,6740,72.52358490566037,0.07081967213114754,Very Cheap
20150407T000000,860000.0,4,3.5,3950,9600,2.0,0,0,3,10,3950,0,1998,0,98075,47.5945,-121.981,3110,10213,5650,7103,89.58333333333333,0.10295081967213114,Cheap
20140618T000000,555000.0,3,1.75,2040,6000,1.0,0,0,5,7,1120,920,1958,0,98116,47.5688,-122.397,1530,6250,3960,4720,92.5,0.06295081967213115,Very Cheap
20140721T000000,579000.0,3,2.5,1990,4040,1.5,0,0,5,8,1390,600,1926,0,98103,47.6867,-122.354,1180,3030,2050,1850,143.31683168316832,0.06609836065573771,Very Cheap
20140630T000000,385000.0,3,1.75,1300,7030,1.0,0,0,3,7,1300,0,1968,0,98034,47.721,-122.179,1450,7650,5730,6200,54.76529160739687,0.04065573770491803,Very Cheap
20150414T000000,420000.0,4,2.25,2030,12000,2.0,0,0,3,7,2030,0,1977,0,98011,47.7699,-122.168,2190,9900,9970,7710,35.0,0.04524590163934426,Very Cheap
20140716T000000,645000.0,3,1.75,2340,6750,1.5,0,0,5,7,1620,720,1914,0,98103,47.6956,-122.335,1410,3388,4410,1978,95.55555555555556,0.07475409836065573,Very Cheap
20150428T000000,549950.0,3,2.5,2160,6288,2.0,0,0,3,8,2160,0,1996,0,98133,47.7655,-122.35,1830,7600,4128,5770,87.4602417302799,0.062288524590163936,Very Cheap
20140923T000000,678000.0,3,2.75,2770,10000,1.0,0,1,5,8,1640,1130,1962,0,98033,47.7011,-122.206,2450,10000,7230,7550,67.8,0.07908196721311475,Very Cheap
20140521T000000,199000.0,4,2.0,2030,8120,2.0,0,0,3,7,2030,0,1950,0,98178,47.4994,-122.261,1520,9440,6090,7920,24.507389162561577,0.016262295081967214,Very Cheap
20150218T000000,604000.0,3,1.0,1440,13824,1.0,0,0,4,7,1440,0,1957,0,98040,47.5872,-122.241,2540,12092,12384,9552,43.692129629629626,0.06937704918032787,Very Cheap
20150403T000000,268000.0,5,1.75,1730,10368,1.0,0,0,5,7,1010,720,1963,0,98059,47.5008,-122.162,1730,7728,8638,5998,25.848765432098766,0.025311475409836064,Very Cheap
20140805T000000,960000.0,5,3.5,4510,16305,2.0,0,0,3,10,2820,1690,2003,0,98074,47.6346,-122.011,4330,18741,11795,14411,58.87764489420423,0.1160655737704918,Cheap
20150218T000000,509250.0,3,2.5,2100,7600,1.0,0,0,4,7,1450,650,1980,0,98052,47.6968,-122.127,2010,7600,5500,5590,67.00657894736842,0.05695081967213115,Very Cheap
20141118T000000,416000.0,3,2.5,1800,5372,2.0,0,0,3,8,1800,0,1987,0,98034,47.7188,-122.177,1650,6014,3572,4364,77.4385703648548,0.044721311475409836,Very Cheap
20140515T000000,190000.0,3,1.0,1090,8520,1.0,0,0,3,7,1090,0,1967,0,98003,47.3364,-122.307,1190,8520,7430,7330,22.300469483568076,0.015081967213114755,Very Cheap
20150429T000000,212000.0,3,1.5,1010,10000,1.0,0,0,4,7,1010,0,1973,0,98003,47.2881,-122.294,2420,34637,8990,32217,21.2,0.017967213114754098,Very Cheap
20141029T000000,325900.0,3,2.5,2040,9765,2.0,0,0,3,8,2040,0,1985,0,98023,47.309,-122.349,2350,10150,7725,7800,33.37429595494112,0.03290491803278688,Very Cheap
20140801T000000,560000.0,3,3.5,2270,4088,2.0,0,0,3,8,1880,390,1996,0,98136,47.5356,-122.384,1760,5425,1818,3665,136.986301369863,0.06360655737704918,Very Cheap
20140924T000000,275000.0,3,2.5,1730,5799,2.0,0,0,4,7,1730,0,1987,0,98030,47.3499,-122.177,1710,6490,4069,4780,47.42196930505259,0.02622950819672131,Very Cheap
20150309T000000,665000.0,4,2.5,2480,15411,2.0,0,2,3,8,2480,0,1994,0,98059,47.5379,-122.16,2940,14679,12931,11739,43.15099604178833,0.07737704918032787,Very Cheap
20140601T000000,1505000.0,4,3.5,3480,7232,2.0,0,0,3,9,2580,900,1926,2010,98144,47.5859,-122.291,2380,5642,3752,3262,208.10287610619469,0.18754098360655738,Cheap
20141203T000000,375000.0,4,2.0,1720,2410,1.0,0,0,3,7,970,750,1930,2006,98106,47.5252,-122.361,1160,1404,690,244,155.60165975103735,0.03934426229508197,Very Cheap
20140909T000000,359950.0,3,1.75,1570,6975,1.0,0,0,3,7,1040,530,1979,0,98126,47.5137,-122.37,1280,7813,5405,6533,51.60573476702509,0.037370491803278685,Very Cheap
20150123T000000,340000.0,4,2.75,3527,7200,2.0,0,0,3,7,3527,0,2005,0,98198,47.3823,-122.3,2490,7200,3673,4710,47.22222222222222,0.03475409836065574,Very Cheap
20141031T000000,401000.0,2,1.0,840,8100,1.0,0,0,4,7,840,0,1948,0,98177,47.7019,-122.366,1100,8220,7260,7120,49.50617283950617,0.04275409836065574,Very Cheap
20140626T000000,669000.0,2,1.75,1950,10766,1.0,0,3,4,6,1160,790,1952,0,98166,47.4504,-122.377,1780,11721,8816,9941,62.14007059260636,0.0779016393442623,Very Cheap
20150429T000000,638500.0,4,2.5,1980,6568,2.0,0,0,3,8,1980,0,2004,0,98052,47.704,-122.101,2310,6496,4588,4186,97.21376370280146,0.07390163934426229,Very Cheap
20150323T000000,545000.0,2,1.5,1620,3760,2.0,0,0,5,7,1170,450,1924,0,98144,47.6012,-122.291,2130,4000,2140,1870,144.9468085106383,0.06163934426229508,Very Cheap
20141226T000000,524000.0,4,1.0,1980,7015,1.0,0,0,3,7,1260,720,1973,0,98034,47.7204,-122.18,1570,7626,5035,6056,74.69707769066287,0.05888524590163934,Very Cheap
20141108T000000,1610000.0,5,3.75,3530,13260,2.0,0,0,3,10,3530,0,2013,0,98040,47.5761,-122.205,3340,13260,9730,9920,121.41779788838612,0.20131147540983607,Cheap
20140909T000000,280000.0,2,1.0,1260,4800,1.0,0,0,3,6,1100,160,1947,0,98126,47.5196,-122.376,1260,2435,3540,1175,58.333333333333336,0.026885245901639345,Very Cheap
20140825T000000,828000.0,4,2.5,2120,10841,1.0,0,0,4,8,1500,620,1979,0,98006,47.556,-122.156,3130,10950,8721,7820,76.37671801494326,0.09875409836065574,Very Cheap
20141017T000000,223000.0,3,1.75,1360,10573,1.0,0,0,4,7,1360,0,1984,0,98023,47.2983,-122.374,1580,8280,9213,6700,21.091459377660076,0.019409836065573772,Very Cheap
20150102T000000,1289000.0,4,3.5,3100,2261,2.0,0,2,3,9,2250,850,1981,0,98033,47.6512,-122.202,2660,2000,-839,-660,570.1017249004865,0.15921311475409836,Cheap
20150504T000000,750000.0,2,2.0,2370,155130,1.0,0,0,3,7,2370,0,1970,0,98019,47.7388,-121.972,1860,14475,152760,12615,4.834654805646877,0.08852459016393442,Very Cheap
20150417T000000,430000.0,2,1.0,1460,9207,1.0,0,0,3,7,1210,250,1947,0,98125,47.7195,-122.287,1500,6898,7747,5398,46.70359509069186,0.04655737704918033,Very Cheap
20140618T000000,711000.0,4,1.75,1980,10800,1.0,0,0,5,6,990,990,1948,0,98040,47.5768,-122.222,2180,10800,8820,8620,65.83333333333333,0.08340983606557377,Very Cheap
20141204T000000,310000.0,4,2.5,1930,7014,2.0,0,0,3,8,1930,0,1994,0,98042,47.3921,-122.163,1990,7920,5084,5930,44.19731964642144,0.03081967213114754,Very Cheap
20141226T000000,415000.0,5,1.75,3700,9140,1.0,0,0,3,8,1850,1850,1957,0,98178,47.5086,-122.258,2190,6720,5440,4530,45.40481400437637,0.04459016393442623,Very Cheap
20140701T000000,274900.0,4,2.5,1970,6600,2.0,0,0,3,7,1970,0,1987,0,98030,47.3491,-122.168,1970,7682,4630,5712,41.65151515151515,0.02621639344262295,Very Cheap
20140609T000000,525000.0,3,3.0,2470,36445,2.0,0,0,4,8,2470,0,1980,0,98027,47.4661,-121.997,2310,35350,33975,33040,14.40526821237481,0.05901639344262295,Very Cheap
20141219T000000,179500.0,3,1.0,1180,32214,1.0,0,0,3,7,1180,0,1952,0,98092,47.3313,-122.198,2300,13714,31034,11414,5.572111504314894,0.013704918032786886,Very Cheap
20140523T000000,478000.0,3,1.0,1280,2580,1.5,0,0,3,8,1280,0,1910,2014,98115,47.6727,-122.32,1410,3150,1300,1740,185.27131782945736,0.05285245901639344,Very Cheap
20140521T000000,195000.0,3,1.75,1380,7350,1.0,0,0,3,7,990,390,1981,0,98042,47.369,-122.093,1660,8400,5970,6740,26.53061224489796,0.015737704918032787,Very Cheap
20150305T000000,385000.0,4,3.0,2740,10925,1.0,0,0,3,8,1670,1070,1980,0,98058,47.4538,-122.125,2330,9940,8185,7610,35.24027459954233,0.04065573770491803,Very Cheap
20141201T000000,401000.0,3,2.75,2020,9505,1.0,0,0,3,7,1260,760,1969,0,98011,47.7399,-122.197,2080,11901,7485,9821,42.188321935823254,0.04275409836065574,Very Cheap
20140926T000000,522000.0,4,2.5,2835,6598,2.0,0,0,3,8,2835,0,2002,0,98038,47.3878,-122.034,2770,6969,3763,4199,79.11488329796909,0.05862295081967213,Very Cheap
20150224T000000,330000.0,4,1.75,1520,14417,1.0,0,0,4,7,1520,0,1968,0,98065,47.526,-121.809,1600,10716,12897,9116,22.88964417007699,0.03344262295081967,Very Cheap
20140603T000000,503000.0,3,2.5,2190,4882,2.0,0,0,3,9,2190,0,1999,0,98155,47.7641,-122.306,2190,7055,2692,4865,103.03154444899631,0.056131147540983604,Very Cheap
20150212T000000,175000.0,5,1.75,1680,8400,1.0,0,0,4,7,1680,0,1979,0,98003,47.3035,-122.307,1800,8550,6720,6750,20.833333333333332,0.013114754098360656,Very Cheap
20150320T000000,963990.0,4,3.5,3915,6364,2.0,0,0,3,9,3915,0,2014,0,98053,47.6844,-122.016,3830,6507,2449,2677,151.475487115022,0.11658885245901639,Cheap
20140929T000000,845000.0,5,2.0,1720,9972,1.0,0,0,4,8,1720,0,1951,0,98004,47.6368,-122.218,2700,9023,8252,6323,84.73726434015242,0.10098360655737705,Cheap
20150122T000000,157500.0,2,1.0,670,4500,1.0,0,0,3,5,670,0,1905,0,98108,47.5271,-122.326,1210,4500,3830,3290,35.0,0.010819672131147541,Very Cheap
20141205T000000,450000.0,2,3.0,1790,1709,2.0,0,0,3,7,1400,390,2001,0,98144,47.5926,-122.296,1460,1462,-81,2,263.3118782913985,0.04918032786885246,Very Cheap
20140918T000000,925000.0,4,1.75,2440,11793,1.0,0,4,3,8,1420,1020,1950,0,98115,47.6807,-122.267,2500,8028,9353,5528,78.43636055287034,0.11147540983606558,Cheap
20150105T000000,600000.0,2,1.0,920,5029,1.0,0,0,4,7,920,0,1938,0,98115,47.6726,-122.265,1230,5029,4109,3799,119.30801352157486,0.06885245901639345,Very Cheap
20140918T000000,709000.0,4,1.0,1680,4087,1.5,0,0,3,7,1680,0,1911,0,98103,47.6667,-122.337,1740,3745,2407,2005,173.4768779055542,0.08314754098360656,Very Cheap
20141110T000000,1385000.0,5,3.75,3290,6480,2.0,0,0,5,10,2190,1100,1938,0,98199,47.653,-122.415,2010,7639,3190,5629,213.73456790123456,0.1718032786885246,Cheap
20140911T000000,248000.0,3,2.5,2120,6840,1.0,0,0,3,7,1220,900,1984,0,98092,47.278,-122.145,1820,8200,4720,6380,36.25730994152047,0.022688524590163933,Very Cheap
20150511T000000,245000.0,3,1.0,910,6630,1.0,0,0,4,6,910,0,1912,0,98103,47.6947,-122.346,950,5100,5720,4150,36.95324283559577,0.022295081967213116,Very Cheap
20140530T000000,332000.0,2,1.0,1000,4776,1.0,0,0,4,6,1000,0,1942,0,98108,47.5619,-122.315,1500,4800,3776,3300,69.5142378559464,0.033704918032786885,Very Cheap
20150313T000000,459950.0,3,2.5,2340,4273,2.0,0,0,3,7,2340,0,2002,0,98065,47.5362,-121.878,2400,4624,1933,2224,107.6410016381933,0.050485245901639345,Very Cheap
20150410T000000,425000.0,3,2.0,1180,1800,2.0,0,2,3,8,1180,0,1994,0,98122,47.6168,-122.301,1500,1948,620,448,236.11111111111111,0.04590163934426229,Very Cheap
20140903T000000,460000.0,3,2.25,2080,50965,1.0,0,0,3,8,1590,490,1979,0,98077,47.7506,-122.063,2270,51836,48885,49566,9.025802020994801,0.050491803278688525,Very Cheap
20140904T000000,838300.0,6,2.5,3760,12978,1.0,0,0,3,9,2360,1400,1967,0,98117,47.6976,-122.381,2300,7362,9218,5062,64.5939281861612,0.10010491803278689,Cheap
20141111T000000,256000.0,3,2.5,1480,7200,2.0,0,0,5,7,1480,0,1995,0,98010,47.3126,-122.023,1350,7200,5720,5850,35.55555555555556,0.023737704918032787,Very Cheap
20150120T000000,864000.0,3,2.75,3060,13554,2.0,0,0,3,10,3060,0,1984,0,98006,47.5609,-122.106,3060,11455,10494,8395,63.745019920318725,0.10347540983606557,Cheap
20150305T000000,900000.0,4,3.5,3070,4440,2.0,0,0,3,9,2030,1040,1922,2007,98116,47.5732,-122.411,1780,4800,1370,3020,202.7027027027027,0.10819672131147541,Cheap
20150401T000000,145600.0,3,1.0,1170,7560,1.0,0,0,3,6,1170,0,1958,0,98058,47.4514,-122.178,1170,7560,6390,6390,19.25925925925926,0.009259016393442622,Very Cheap
20140821T000000,865000.0,5,3.0,2900,6730,1.0,0,0,5,8,1830,1070,1977,0,98115,47.6784,-122.285,2370,6283,3830,3913,128.5289747399703,0.10360655737704919,Cheap
20140609T000000,250250.0,3,2.25,2210,8000,2.0,0,0,4,8,2210,0,1969,0,98023,47.3085,-122.381,1990,8000,5790,6010,31.28125,0.022983606557377047,Very Cheap
20140919T000000,162000.0,4,2.0,1440,7641,1.0,0,0,4,5,1440,0,1943,0,98056,47.508,-122.183,1440,7750,6201,6310,21.20141342756184,0.01140983606557377,Very Cheap
20140731T000000,450000.0,4,1.75,1980,7350,1.0,0,0,3,7,1430,550,1973,0,98034,47.7088,-122.202,1870,7920,5370,6050,61.224489795918366,0.04918032786885246,Very Cheap
20150325T000000,675500.0,4,2.75,2060,21344,1.0,0,0,2,8,1460,600,1978,0,98005,47.5934,-122.154,2060,16088,19284,14028,31.648238380809595,0.07875409836065574,Very Cheap
20141103T000000,697000.0,3,2.25,2420,5304,1.5,0,0,5,7,1640,780,1947,0,98115,47.6765,-122.285,1560,5304,2884,3744,131.4102564102564,0.08157377049180328,Very Cheap
20141111T000000,1324050.0,3,3.25,3440,4080,2.0,0,0,3,9,2560,880,2005,0,98105,47.6644,-122.28,3110,4080,640,970,324.5220588235294,0.16380983606557378,Cheap
20141201T000000,490000.0,3,1.75,1600,16510,1.0,0,0,3,8,1600,0,1984,0,98052,47.6601,-122.135,1510,10407,14910,8897,29.678982434887946,0.05442622950819672,Very Cheap
20141021T000000,590000.0,3,2.25,2210,5742,1.0,0,0,3,8,1460,750,1951,0,98115,47.6891,-122.318,1900,4590,3532,2690,102.7516544757924,0.06754098360655737,Very Cheap
20150512T000000,280000.0,4,1.75,2250,16000,1.0,0,0,3,8,1450,800,1957,0,98023,47.3303,-122.351,1930,16000,13750,14070,17.5,0.026885245901639345,Very Cheap
20140523T000000,515000.0,2,1.0,1680,6500,1.0,0,0,4,7,1140,540,1941,0,98136,47.55,-122.388,1610,6500,4820,4890,79.23076923076923,0.057704918032786885,Very Cheap
20140714T000000,576000.0,3,1.0,1140,5395,1.0,0,0,4,7,1010,130,1909,0,98115,47.6782,-122.306,1700,5376,4255,3676,106.7655236329935,0.06570491803278689,Very Cheap
20141120T000000,375000.0,3,1.75,1430,10574,2.0,0,0,3,7,1430,0,1981,0,98011,47.7668,-122.218,1900,10450,9144,8550,35.4643465103083,0.03934426229508197,Very Cheap
20150320T000000,478000.0,3,1.0,1440,7107,1.0,0,0,4,7,1000,440,1980,0,98052,47.6968,-122.124,1540,7140,5667,5600,67.2576333192627,0.05285245901639344,Very Cheap
20150128T000000,282000.0,3,1.0,1670,5200,1.0,0,0,5,7,1030,640,1977,0,98042,47.3659,-122.092,1620,6696,3530,5076,54.23076923076923,0.02714754098360656,Very Cheap
20141031T000000,1400000.0,4,4.5,3080,10550,2.0,0,3,3,8,1940,1140,1976,2007,98040,47.5806,-122.244,2780,10550,7470,7770,132.70142180094786,0.1737704918032787,Cheap
20150210T000000,593500.0,5,3.25,4300,50405,2.0,0,0,3,8,3220,1080,1972,0,98027,47.4615,-122.0,2680,41684,46105,39004,11.774625533181233,0.068,Very Cheap
20141020T000000,724950.0,4,3.5,3010,174240,2.0,0,0,3,9,3010,0,2004,0,98045,47.4775,-121.691,2720,247856,171230,245136,4.160640495867769,0.08523934426229508,Very Cheap
20140829T000000,306000.0,3,1.75,1560,7500,1.0,0,0,4,8,1560,0,1966,0,98056,47.489,-122.18,1600,7904,5940,6304,40.8,0.030295081967213113,Very Cheap
20140609T000000,341000.0,4,1.75,1920,7665,1.0,0,0,4,8,1500,420,1975,0,98058,47.4476,-122.128,2100,7344,5745,5244,44.487932159165034,0.03488524590163934,Very Cheap
20141103T000000,399950.0,3,2.5,1400,4400,1.0,0,0,3,7,1400,0,1930,2014,98106,47.553,-122.365,1060,4400,3000,3340,90.89772727272727,0.04261639344262295,Very Cheap
20141120T000000,534000.0,5,2.0,2280,3600,2.0,0,0,3,7,2280,0,1992,0,98122,47.6056,-122.305,1740,1800,1320,60,148.33333333333334,0.06019672131147541,Very Cheap
20140721T000000,635000.0,6,2.5,3880,5700,2.0,0,0,3,7,3880,0,2003,0,98053,47.6816,-122.038,2620,5070,1820,2450,111.40350877192982,0.07344262295081967,Very Cheap
20150324T000000,350000.0,2,1.0,1350,3880,1.0,0,0,3,6,950,400,1927,0,98103,47.6842,-122.344,1670,3920,2530,2250,90.20618556701031,0.036065573770491806,Very Cheap
20150217T000000,856000.0,3,1.5,1480,2700,1.5,0,0,3,7,1480,0,1928,0,98112,47.623,-122.304,1970,4200,1220,2230,317.037037037037,0.10242622950819671,Cheap
20140923T000000,582000.0,4,3.0,1670,1189,3.0,0,0,3,8,1427,243,2000,0,98122,47.6182,-122.302,1700,1401,-481,-299,489.4869638351556,0.06649180327868852,Very Cheap
20140729T000000,799000.0,4,2.5,3400,6742,2.0,0,0,3,9,3400,0,2004,0,98052,47.7067,-122.129,2970,6909,3342,3939,118.51082764758232,0.09495081967213115,Very Cheap
20140908T000000,423700.0,3,2.5,2070,3986,2.0,0,0,3,8,2070,0,1999,0,98065,47.5348,-121.877,2090,3986,1916,1896,106.29703963873557,0.045731147540983605,Very Cheap
20150127T000000,1835000.0,4,3.5,4870,39190,2.0,0,0,3,12,4870,0,1995,0,98006,47.5447,-122.124,5000,33880,34320,28880,46.82316917581016,0.23081967213114754,Cheap
20140813T000000,322000.0,3,2.0,1760,43575,1.0,0,0,3,7,1160,600,1988,0,98010,47.3565,-121.94,1760,46038,41815,44278,7.389558232931727,0.03239344262295082,Very Cheap
20141105T000000,929000.0,4,3.25,4030,57499,2.0,0,0,3,9,4030,0,2002,0,98053,47.6617,-122.026,3470,57499,53469,54029,16.15680272700395,0.112,Cheap
20141201T000000,443000.0,2,1.0,1130,5413,1.0,0,0,3,7,880,250,1939,0,98115,47.6971,-122.315,1250,5413,4283,4163,81.84001477923518,0.048262295081967214,Very Cheap
20150424T000000,441500.0,3,1.75,1510,7700,1.0,0,0,3,7,1510,0,1968,0,98034,47.7283,-122.194,1440,7416,6190,5976,57.33766233766234,0.0480655737704918,Very Cheap
20140708T000000,875000.0,4,3.5,3110,108464,2.0,0,2,4,8,3110,0,1979,0,98075,47.592,-122.018,2340,4938,105354,2598,8.067192801298127,0.10491803278688525,Cheap
20141118T000000,3600000.0,3,3.25,5020,12431,2.0,1,4,3,10,3420,1600,1941,2002,98144,47.5925,-122.287,3680,12620,7411,8940,289.5985841846995,0.46229508196721314,High
20150427T000000,450000.0,2,1.0,740,5100,1.0,0,0,4,7,740,0,1947,0,98115,47.6787,-122.301,920,5100,4360,4180,88.23529411764706,0.04918032786885246,Very Cheap
20140908T000000,425000.0,3,2.25,1630,10500,1.0,0,0,3,7,1100,530,1974,0,98034,47.7176,-122.236,1640,9794,8870,8154,40.476190476190474,0.04590163934426229,Very Cheap
20140601T000000,660000.0,4,1.75,2780,9900,2.0,0,0,4,10,2780,0,1978,0,98074,47.6348,-122.06,2600,12000,7120,9400,66.66666666666667,0.07672131147540984,Very Cheap
20140616T000000,763101.0,3,1.75,1990,5560,1.0,0,0,4,7,1100,890,1939,0,98105,47.664,-122.287,1460,3706,3570,2246,137.24838129496402,0.09024275409836066,Very Cheap
20150407T000000,499000.0,4,2.75,2250,14149,2.0,0,0,3,9,2250,0,1992,0,98019,47.7353,-121.962,2450,14027,11899,11577,35.267510071383136,0.05560655737704918,Very Cheap
20150303T000000,521000.0,3,1.75,1720,37363,1.0,0,0,4,8,1350,370,1974,0,98053,47.6608,-122.035,2740,40635,35643,37895,13.944276423199423,0.058491803278688526,Very Cheap
20140529T000000,302000.0,2,1.0,900,423838,1.0,0,2,5,6,900,0,1925,0,98022,47.228,-122.088,1810,94960,422938,93150,0.7125363936220914,0.02977049180327869,Very Cheap
20150408T000000,293000.0,4,2.25,2360,6260,2.0,0,0,3,7,2360,0,1998,0,98038,47.3882,-122.053,2144,6773,3900,4629,46.805111821086264,0.02859016393442623,Very Cheap
20140712T000000,335000.0,3,2.25,1530,4580,2.0,0,0,3,7,1530,0,2011,0,98019,47.7342,-121.968,2110,4094,3050,1984,73.14410480349345,0.03409836065573771,Very Cheap
20141215T000000,499000.0,2,1.0,1450,3090,2.0,0,0,3,7,1450,0,1919,1987,98103,47.6853,-122.356,1450,4635,1640,3185,161.48867313915858,0.05560655737704918,Very Cheap
20150505T000000,600000.0,3,1.75,2040,5000,1.5,0,0,3,7,1780,260,1924,0,98115,47.6756,-122.299,1690,5000,2960,3310,120.0,0.06885245901639345,Very Cheap
20140916T000000,720000.0,4,1.75,2620,11041,1.5,0,0,4,9,2620,0,1962,0,98005,47.5975,-122.174,2230,11041,8421,8811,65.21148446698669,0.08459016393442623,Very Cheap
20150225T000000,195000.0,2,2.0,1180,2553,2.0,0,0,3,6,1180,0,2005,0,98038,47.3501,-122.02,1310,2687,1373,1377,76.38072855464159,0.015737704918032787,Very Cheap
20140507T000000,249000.0,3,1.0,1110,8423,1.0,0,0,3,7,1110,0,1952,0,98166,47.4718,-122.342,1140,9083,7313,7943,29.56191380743203,0.02281967213114754,Very Cheap
20150202T000000,334000.0,3,2.25,1840,9781,2.0,0,0,3,7,1840,0,1989,0,98019,47.7347,-121.976,1490,10101,7941,8611,34.14783764441264,0.0339672131147541,Very Cheap
20141107T000000,599950.0,4,1.75,2720,7810,1.0,0,0,3,8,1510,1210,1952,0,98115,47.6788,-122.283,2120,7315,5090,5195,76.81818181818181,0.06884590163934426,Very Cheap
20150217T000000,149900.0,2,1.75,1090,1950,1.0,0,0,4,8,1090,0,1982,0,98198,47.3782,-122.319,1360,3426,860,2066,76.87179487179488,0.009822950819672131,Very Cheap
20141125T000000,700000.0,4,1.75,1730,6500,1.0,0,0,3,7,1250,480,1945,0,98115,47.6982,-122.282,1910,8100,4770,6190,107.6923076923077,0.08196721311475409,Very Cheap
20140807T000000,525000.0,4,1.5,1170,6240,1.0,0,0,4,6,1170,0,1960,0,98040,47.5495,-122.232,2380,8846,5070,6466,84.13461538461539,0.05901639344262295,Very Cheap
20140708T000000,1049000.0,4,3.75,4740,126759,2.0,0,0,4,10,4740,0,1991,0,98027,47.4449,-121.979,3060,118047,122019,114987,8.275546509518062,0.1277377049180328,Cheap
20140508T000000,402000.0,3,2.5,1960,8000,1.0,0,0,4,7,1290,670,1977,0,98034,47.7249,-122.178,1960,8000,6040,6040,50.25,0.04288524590163934,Very Cheap
20140620T000000,450000.0,3,2.0,1430,3480,1.0,0,0,3,7,980,450,1947,0,98103,47.6874,-122.336,1450,4650,2050,3200,129.31034482758622,0.04918032786885246,Very Cheap
20141203T000000,520000.0,3,2.25,2510,43995,2.0,0,0,3,8,2510,0,1981,0,98027,47.4545,-121.988,2470,48351,41485,45881,11.819524946016593,0.058360655737704915,Very Cheap
20141204T000000,205000.0,3,1.75,1420,6980,1.0,0,0,5,7,820,600,1980,0,98023,47.2873,-122.367,1470,7319,5560,5849,29.369627507163322,0.017049180327868854,Very Cheap
20140902T000000,635000.0,3,2.25,2680,175982,1.0,0,0,3,9,2680,0,2004,0,98038,47.4487,-122.033,3170,215186,173302,212016,3.608323578547806,0.07344262295081967,Very Cheap
20150304T000000,210500.0,3,1.0,1220,9600,1.0,0,0,5,7,1220,0,1958,0,98001,47.2622,-122.282,1310,9600,8380,8290,21.927083333333332,0.01777049180327869,Very Cheap
20140812T000000,406650.0,2,1.0,1070,6100,1.0,0,0,3,6,1070,0,1940,0,98126,47.5698,-122.377,1770,5695,5030,3925,66.6639344262295,0.04349508196721311,Very Cheap
20150408T000000,350000.0,3,1.75,1580,19998,1.0,0,0,4,7,1580,0,1968,0,98010,47.3299,-122.046,1860,19998,18418,18138,17.501750175017502,0.036065573770491806,Very Cheap
20150423T000000,425000.0,4,1.75,1820,6000,1.0,0,0,3,7,930,890,1942,0,98115,47.6872,-122.296,1590,6000,4180,4410,70.83333333333333,0.04590163934426229,Very Cheap
20140605T000000,798000.0,3,3.5,3590,6402,2.0,0,0,3,10,3590,0,1999,0,98074,47.6336,-122.063,3230,7305,2812,4075,124.6485473289597,0.09481967213114754,Very Cheap
20141201T000000,180000.0,3,1.0,1960,9583,2.0,0,0,2,5,1960,0,1908,0,98056,47.505,-122.171,1850,8324,7623,6474,18.78326202650527,0.01377049180327869,Very Cheap
20140602T000000,1250000.0,5,3.25,3160,13238,2.0,0,0,5,8,3160,0,1972,0,98040,47.5373,-122.224,2360,12042,10078,9682,94.42513974920683,0.1540983606557377,Cheap
20150303T000000,435000.0,4,2.0,2030,4033,2.0,0,0,4,7,1630,400,1925,0,98133,47.7056,-122.342,1350,1340,2003,-10,107.86015373171337,0.04721311475409836,Very Cheap
20141126T000000,355000.0,3,1.5,1240,15867,1.0,0,0,3,7,1240,0,1962,0,98034,47.7167,-122.202,1570,9600,14627,8030,22.373479548748975,0.036721311475409836,Very Cheap
20150202T000000,3000000.0,5,3.25,5370,14091,2.0,0,0,3,10,3850,1520,1918,2008,98004,47.6499,-122.216,2410,12047,8721,9637,212.90185224611454,0.3836065573770492,Medium
20140724T000000,685000.0,5,2.5,2670,14455,2.0,0,0,5,9,2670,0,1958,0,98155,47.7565,-122.284,1810,14455,11785,12645,47.3884469041854,0.08,Very Cheap
20140725T000000,311000.0,3,1.0,1640,12060,1.0,0,0,4,7,1640,0,1960,0,98059,47.4941,-122.151,1680,9147,10420,7467,25.787728026533998,0.030950819672131147,Very Cheap
20140911T000000,305000.0,4,2.25,2130,9600,1.0,0,0,4,7,2130,0,1966,0,98031,47.4119,-122.211,1710,9600,7470,7890,31.770833333333332,0.03016393442622951,Very Cheap
20140725T000000,675000.0,3,2.5,2550,4954,1.5,0,0,4,7,1850,700,1924,0,98144,47.5758,-122.287,1700,4954,2404,3254,136.25353249899072,0.07868852459016394,Very Cheap
20140829T000000,769000.0,4,2.75,3630,15405,1.0,0,2,4,8,1850,1780,1968,0,98040,47.566,-122.225,3380,11184,11775,7804,49.91885751379422,0.09101639344262295,Very Cheap
20140805T000000,430000.0,3,1.5,1690,9708,1.5,0,0,5,7,1690,0,1954,0,98006,47.5732,-122.136,1570,9858,8018,8288,44.29336629583848,0.04655737704918033,Very Cheap
20140923T000000,516250.0,6,2.0,2390,8660,1.5,0,0,4,7,2390,0,1925,0,98011,47.7589,-122.216,2250,12942,6270,10692,59.61316397228637,0.05786885245901639,Very Cheap
20141212T000000,760000.0,3,3.5,2350,10739,1.0,0,2,5,7,1340,1010,1940,0,98125,47.7288,-122.284,2580,11026,8389,8446,70.7700903249837,0.0898360655737705,Very Cheap
20141007T000000,579950.0,3,3.5,1420,1217,2.0,0,0,3,8,1180,240,2003,0,98115,47.6827,-122.324,1494,1264,-203,-230,476.5406737880033,0.06622295081967212,Very Cheap
20150211T000000,476000.0,3,2.25,1570,7187,1.0,0,0,4,8,1170,400,1980,0,98133,47.7604,-122.356,1660,8775,5617,7115,66.23069430916934,0.052590163934426226,Very Cheap
20140612T000000,510000.0,3,1.75,1600,19200,1.0,0,0,4,7,1600,0,1967,0,98034,47.7202,-122.249,2010,14850,17600,12840,26.5625,0.057049180327868855,Very Cheap
20140508T000000,205000.0,2,1.0,720,5040,1.0,0,0,3,6,720,0,1955,0,98106,47.5267,-122.36,1357,5120,4320,3763,40.67460317460318,0.017049180327868854,Very Cheap
20141007T000000,240000.0,3,1.0,1470,7350,1.0,0,0,3,7,1470,0,1969,0,98032,47.3616,-122.286,1720,8050,5880,6330,32.6530612244898,0.021639344262295083,Very Cheap
20140902T000000,738000.0,5,3.5,2790,16952,2.0,0,2,3,10,1970,820,1991,0,98166,47.4384,-122.347,2980,17281,14162,14301,43.534686172722985,0.08695081967213114,Very Cheap
20140728T000000,420000.0,3,1.75,1720,8102,1.0,0,0,5,6,860,860,1940,0,98125,47.7336,-122.29,1440,8106,6382,6666,51.83905208590471,0.04524590163934426,Very Cheap
20141114T000000,455000.0,3,1.75,1300,9600,1.0,0,0,4,7,1300,0,1969,0,98052,47.6388,-122.103,2070,9775,8300,7705,47.395833333333336,0.049836065573770495,Very Cheap
20140915T000000,765000.0,4,1.0,2520,5500,1.5,0,0,5,8,1820,700,1912,0,98144,47.5785,-122.292,2350,5000,2980,2650,139.0909090909091,0.09049180327868853,Very Cheap
20141205T000000,372000.0,4,1.5,1780,7914,1.5,0,0,4,7,1780,0,1962,0,98059,47.5142,-122.163,1350,8069,6134,6719,47.005307050796056,0.03895081967213115,Very Cheap
20141204T000000,160000.0,3,1.0,1200,8360,1.0,0,0,2,6,1200,0,1948,0,98118,47.5414,-122.281,1570,6823,7160,5253,19.138755980861244,0.011147540983606558,Very Cheap
20140815T000000,772000.0,4,2.5,2990,9643,2.0,0,0,3,9,2990,0,2003,0,98074,47.6292,-122.024,2990,8666,6653,5676,80.05807321373017,0.09140983606557378,Very Cheap
20141111T000000,1125000.0,5,1.75,1910,5640,2.0,0,0,4,9,1910,0,1906,0,98112,47.6249,-122.311,2050,5400,3730,3350,199.46808510638297,0.1377049180327869,Cheap
20140524T000000,479000.0,3,1.0,1370,3000,1.5,0,0,3,7,1370,0,1924,0,98103,47.6619,-122.351,1510,2151,1630,641,159.66666666666666,0.05298360655737705,Very Cheap
20150505T000000,570000.0,3,2.5,1910,4941,2.0,0,0,3,8,1910,0,1999,0,98075,47.5989,-122.016,1910,4941,3031,3031,115.36126290224651,0.06491803278688525,Very Cheap
20140710T000000,350000.0,4,1.0,1170,8147,1.5,0,0,3,6,1170,0,1959,0,98125,47.7281,-122.289,1260,8147,6977,6887,42.960598993494536,0.036065573770491806,Very Cheap
20141101T000000,353000.0,3,2.5,1250,864,3.0,0,0,3,8,1250,0,2004,0,98115,47.6978,-122.318,1330,2298,-386,968,408.56481481481484,0.03645901639344262,Very Cheap
20140801T000000,699000.0,5,2.5,3340,24755,2.0,0,0,3,10,3340,0,2002,0,98038,47.4565,-122.066,3420,23274,21415,19854,28.236719854574833,0.08183606557377049,Very Cheap
20140730T000000,265000.0,3,2.0,1380,8536,2.0,0,0,4,7,1380,0,1955,0,98148,47.4374,-122.335,1260,8750,7156,7490,31.04498594189316,0.024918032786885248,Very Cheap
20150430T000000,167000.0,1,1.0,780,10235,1.5,0,0,3,6,780,0,1989,0,98014,47.713,-121.315,930,10165,9455,9235,16.31656082071324,0.012065573770491804,Very Cheap
20141020T000000,500000.0,4,2.25,2080,8000,1.0,0,0,3,8,1390,690,1964,0,98008,47.6264,-122.113,1800,7700,5920,5900,62.5,0.05573770491803279,Very Cheap
20140709T000000,700000.0,3,1.0,1410,7200,2.0,0,0,4,6,1410,0,1901,0,98144,47.5924,-122.302,1640,7200,5790,5560,97.22222222222223,0.08196721311475409,Very Cheap
20141104T000000,295000.0,1,1.0,520,5600,1.0,0,0,3,6,520,0,1918,0,98116,47.5579,-122.395,1030,5265,5080,4235,52.67857142857143,0.028852459016393443,Very Cheap
20150311T000000,1010000.0,4,3.5,3500,4080,2.0,0,2,3,9,2590,910,2004,0,98115,47.6834,-122.292,2430,5100,580,2670,247.54901960784315,0.12262295081967213,Cheap
20150508T000000,209000.0,2,1.0,840,5265,1.0,0,0,5,6,840,0,1969,0,98042,47.3644,-122.082,920,5100,4425,4180,39.69610636277303,0.017573770491803278,Very Cheap
20150128T000000,276000.0,3,1.75,2240,9200,1.0,0,0,4,7,1440,800,1968,0,98001,47.2635,-122.284,1740,9600,6960,7860,30.0,0.026360655737704918,Very Cheap
20150122T000000,380000.0,4,2.5,2100,5857,2.0,0,0,3,8,2100,0,2002,0,98059,47.4956,-122.163,2090,7779,3757,5689,64.87963121051733,0.04,Very Cheap
20140606T000000,315000.0,3,1.5,1750,12500,1.0,0,0,3,7,1150,600,1954,0,98024,47.5666,-121.902,1680,13000,10750,11320,25.2,0.031475409836065574,Very Cheap
20150310T000000,685530.0,4,2.5,3130,60467,2.0,0,0,3,9,3130,0,1996,0,98014,47.6618,-121.962,2780,44224,57337,41444,11.337258339259431,0.08006950819672132,Very Cheap
20140626T000000,254600.0,3,2.0,1470,20000,1.0,0,0,4,7,1470,0,1968,0,98002,47.2973,-122.08,1390,30056,18530,28666,12.73,0.023554098360655737,Very Cheap
20140603T000000,230000.0,3,2.0,1440,5600,1.0,0,0,4,6,720,720,1942,2007,98056,47.4947,-122.185,1120,5700,4160,4580,41.07142857142857,0.020327868852459016,Very Cheap
20140717T000000,335000.0,3,3.0,1430,1249,3.0,0,0,3,8,1430,0,2003,0,98103,47.6971,-122.34,1020,1112,-181,92,268.21457165732585,0.03409836065573771,Very Cheap
20140603T000000,550000.0,4,2.5,2170,9600,1.0,0,0,3,7,1460,710,1980,0,98052,47.6789,-122.116,1940,8400,7430,6460,57.291666666666664,0.06229508196721312,Very Cheap
20141226T000000,123300.0,3,1.0,1150,8050,1.5,0,0,4,7,1150,0,1956,0,98032,47.374,-122.296,1360,8050,6900,6690,15.316770186335404,0.006334426229508197,Very Cheap
20140902T000000,275436.0,4,2.75,2170,9658,1.5,0,0,3,7,2170,0,1966,0,98030,47.3741,-122.189,1490,9731,7488,8241,28.518948022364878,0.026286688524590165,Very Cheap
20140525T000000,325000.0,4,3.5,2630,3435,1.5,0,3,3,7,1640,990,1984,0,98188,47.4355,-122.272,1920,2435,805,515,94.61426491994177,0.03278688524590164,Very Cheap
20140725T000000,635000.0,4,2.5,2490,40608,2.0,0,0,3,9,2490,0,1997,0,98053,47.6507,-122.004,3170,45441,38118,42271,15.637312844759654,0.07344262295081967,Very Cheap
20150423T000000,513000.0,3,1.75,1710,5000,1.0,0,0,4,7,1110,600,1944,0,98107,47.6689,-122.37,920,5000,3290,4080,102.6,0.05744262295081967,Very Cheap
20140708T000000,580000.0,4,2.5,2130,35752,1.0,0,0,3,8,1490,640,1980,0,98075,47.5748,-122.031,3030,34000,33622,30970,16.222868650704857,0.06622950819672131,Very Cheap
20150429T000000,225000.0,3,1.0,940,9272,1.0,0,0,3,7,940,0,1954,0,98148,47.4353,-122.335,1270,9375,8332,8105,24.26660914581536,0.019672131147540985,Very Cheap
20140922T000000,265000.0,3,1.0,1400,9460,1.0,0,0,3,7,1060,340,1961,0,98168,47.5119,-122.321,1570,7700,8060,6130,28.012684989429175,0.024918032786885248,Very Cheap
20141014T000000,313000.0,4,1.75,1630,3000,1.0,0,0,3,7,930,700,1978,0,98144,47.5961,-122.305,1630,3000,1370,1370,104.33333333333333,0.03121311475409836,Very Cheap
20150414T000000,296000.0,2,1.0,1370,8400,1.0,0,0,3,7,1370,0,1948,0,98133,47.7344,-122.336,1330,8396,7030,7066,35.23809523809524,0.02898360655737705,Very Cheap
20141020T000000,655500.0,4,2.75,2380,15800,1.0,0,0,3,8,1680,700,1957,2001,98007,47.5929,-122.133,1950,11751,13420,9801,41.4873417721519,0.0761311475409836,Very Cheap
20141210T000000,250750.0,5,1.75,2140,12058,1.0,0,0,4,8,2140,0,1951,0,98002,47.3167,-122.214,1640,10125,9918,8485,20.79532260739758,0.023049180327868853,Very Cheap
20140904T000000,438000.0,4,2.5,1970,8545,2.0,0,0,3,8,1970,0,2004,0,98059,47.4893,-122.138,2590,7200,6575,4610,51.25804564072557,0.04760655737704918,Very Cheap
20140801T000000,590000.0,3,2.75,2550,54014,2.0,0,0,4,8,1980,570,1967,0,98072,47.7596,-122.117,2180,21600,51464,19420,10.923094012663384,0.06754098360655737,Very Cheap
20141006T000000,329500.0,3,1.0,1080,5250,1.0,0,0,4,7,1080,0,1947,0,98133,47.7309,-122.336,1100,5250,4170,4150,62.76190476190476,0.03337704918032787,Very Cheap
20150316T000000,1195000.0,3,2.25,3070,9645,2.0,0,0,3,10,2110,960,1987,0,98006,47.5522,-122.144,3130,9450,6575,6320,123.89839294971488,0.14688524590163934,Cheap
20150320T000000,415000.0,2,1.0,1470,6000,1.0,0,0,3,6,900,570,1944,0,98199,47.6527,-122.386,1670,6000,4530,4330,69.16666666666667,0.04459016393442623,Very Cheap
20140922T000000,900000.0,4,2.5,3620,42580,2.0,0,0,3,10,3620,0,1984,0,98052,47.7204,-122.115,2950,33167,38960,30217,21.136683889149836,0.10819672131147541,Cheap
20150504T000000,378000.0,3,1.5,1050,57499,1.0,0,0,3,7,1050,0,1975,0,98024,47.5602,-121.86,1460,42688,56449,41228,6.57402737438912,0.03973770491803279,Very Cheap
20140812T000000,474000.0,2,1.0,1050,403365,1.0,0,3,5,6,1050,0,1905,0,98022,47.2221,-122.059,1760,108900,402315,107140,1.1751143505261983,0.05232786885245902,Very Cheap
20140619T000000,464000.0,3,1.0,1320,3625,2.0,0,0,3,7,1320,0,1900,0,98122,47.6049,-122.288,1660,5438,2305,3778,128.0,0.05101639344262295,Very Cheap
20141208T000000,310000.0,3,1.0,1210,7649,1.0,0,0,4,7,1210,0,1956,0,98155,47.7693,-122.32,1210,6760,6439,5550,40.52817361746634,0.03081967213114754,Very Cheap
20140918T000000,580000.0,3,1.5,1860,7190,2.0,0,1,5,7,1860,0,1952,0,98177,47.7716,-122.392,1670,5525,5330,3855,80.66759388038943,0.06622950819672131,Very Cheap
20141119T000000,999000.0,3,2.75,2830,505166,1.0,1,3,4,8,1830,1000,1962,0,98070,47.3782,-122.514,2120,21988,502336,19868,1.9775677698024017,0.12118032786885245,Cheap
20150317T000000,510000.0,2,1.0,810,6480,1.0,0,0,5,6,810,0,1942,0,98199,47.6493,-122.398,1920,6000,5670,4080,78.70370370370371,0.057049180327868855,Very Cheap
20140506T000000,650000.0,3,1.5,1630,7475,1.0,0,1,3,7,1160,470,1940,0,98115,47.6725,-122.272,2320,7475,5845,5155,86.95652173913044,0.07540983606557378,Very Cheap
20140912T000000,196000.0,3,1.0,880,19600,1.0,0,0,4,7,880,0,1978,0,98023,47.2707,-122.34,880,10500,18720,9620,10.0,0.015868852459016394,Very Cheap
20140822T000000,220000.0,4,1.75,1660,11664,1.0,0,0,3,6,1010,650,1952,0,98168,47.4943,-122.331,1670,9975,10004,8305,18.86145404663923,0.01901639344262295,Very Cheap
20141008T000000,855000.0,3,2.25,3440,10628,2.0,0,2,3,10,3440,0,1985,0,98006,47.5647,-122.108,3170,11434,7188,8264,80.44787354158825,0.10229508196721311,Cheap
20140829T000000,483000.0,3,1.75,2110,10454,1.0,0,0,4,8,1440,670,1978,0,98028,47.7344,-122.246,1990,10890,8344,8900,46.20241056055099,0.05350819672131148,Very Cheap
20150407T000000,400000.0,3,1.0,1060,12000,1.0,0,0,3,7,1060,0,1952,0,98133,47.7703,-122.35,1550,10500,10940,8950,33.333333333333336,0.04262295081967213,Very Cheap
20140702T000000,435000.0,3,2.5,1900,7984,2.0,0,0,3,8,1900,0,1993,0,98011,47.7433,-122.194,2650,9352,6084,6702,54.483967935871746,0.04721311475409836,Very Cheap
20140930T000000,219500.0,1,1.0,820,1060,1.0,0,0,3,8,760,60,2007,0,98126,47.5473,-122.371,1770,1924,240,154,207.0754716981132,0.018950819672131147,Very Cheap
20140829T000000,2950000.0,4,3.5,4860,23885,2.0,0,0,3,12,4860,0,1996,0,98039,47.6172,-122.23,3580,16054,19025,12474,123.50847812434583,0.3770491803278688,Medium
20140916T000000,427000.0,3,2.5,2050,3218,3.0,0,0,3,7,2050,0,2008,0,98133,47.7612,-122.344,2050,7200,1168,5150,132.6911124922312,0.04616393442622951,Very Cheap
20141201T000000,430000.0,2,1.5,1090,4013,1.5,0,0,3,7,1090,0,1900,0,98103,47.6652,-122.338,1390,4013,2923,2623,107.1517567904311,0.04655737704918033,Very Cheap
20150512T000000,685000.0,2,1.5,1090,4013,1.5,0,0,3,7,1090,0,1900,0,98103,47.6652,-122.338,1390,4013,2923,2623,170.69524046847744,0.08,Very Cheap
20140903T000000,495000.0,2,1.5,1920,6250,1.0,0,0,3,7,1060,860,1937,0,98199,47.6497,-122.393,2070,6250,4330,4180,79.2,0.05508196721311476,Very Cheap
20140625T000000,299950.0,3,2.5,1870,7942,2.0,0,0,3,7,1870,0,1990,0,98001,47.342,-122.279,1870,7392,6072,5522,37.767564845127175,0.029501639344262295,Very Cheap
20141121T000000,390000.0,4,1.75,2690,46609,1.5,0,0,3,7,2690,0,1940,0,98146,47.4951,-122.352,1920,7302,43919,5382,8.367482675019845,0.04131147540983607,Very Cheap
20140812T000000,385000.0,3,1.75,2160,5863,1.5,0,0,4,7,1260,900,1928,0,98144,47.5729,-122.315,1590,3000,3703,1410,65.66604127579737,0.04065573770491803,Very Cheap
20140625T000000,740000.0,4,2.5,3000,10392,2.0,0,0,3,9,3000,0,1995,0,98027,47.535,-122.049,3140,9213,7392,6073,71.2086220169361,0.08721311475409836,Very Cheap
20140723T000000,991700.0,4,3.0,2290,2350,2.0,0,1,3,9,1610,680,1924,2011,98116,47.574,-122.415,1610,3820,60,2210,422.0,0.12022295081967213,Cheap
20140813T000000,765000.0,3,2.75,2250,9600,2.5,0,0,4,9,1830,420,1909,1991,98122,47.6033,-122.287,2060,4980,7350,2920,79.6875,0.09049180327868853,Very Cheap
20140904T000000,802000.0,4,2.25,2130,8734,2.0,0,2,4,8,2130,0,1961,0,98006,47.5672,-122.161,2550,8800,6604,6250,91.82505152278452,0.09534426229508197,Very Cheap
20141121T000000,950000.0,4,2.75,2500,20000,1.0,0,0,4,8,1700,800,1969,0,98004,47.5901,-122.198,2650,20000,17500,17350,47.5,0.11475409836065574,Cheap
20141104T000000,392000.0,4,2.5,2300,41167,2.0,0,0,3,7,2300,0,1988,0,98042,47.3412,-122.108,2300,21765,38867,19465,9.522190103723856,0.04157377049180328,Very Cheap
20141203T000000,590000.0,3,2.5,3360,218235,1.0,0,0,3,8,3360,0,1989,0,98014,47.6601,-121.946,2650,220849,214875,218199,2.703507686668041,0.06754098360655737,Very Cheap
20150410T000000,425000.0,4,2.5,1920,9000,2.0,0,0,2,7,1920,0,1989,0,98126,47.5153,-122.37,1530,10474,7080,8944,47.22222222222222,0.04590163934426229,Very Cheap
20140722T000000,765000.0,5,1.75,2440,15143,1.5,0,4,4,8,1740,700,1944,0,98146,47.4948,-122.37,2390,10907,12703,8517,50.518391335930794,0.09049180327868853,Very Cheap
20140807T000000,313500.0,3,2.25,1440,3488,2.0,0,0,4,7,1440,0,1983,0,98034,47.7257,-122.162,1390,3488,2048,2098,89.8795871559633,0.03127868852459016,Very Cheap
20140820T000000,320000.0,3,1.0,1780,6840,2.0,0,0,4,6,1780,0,1947,0,98125,47.727,-122.3,1410,7200,5060,5790,46.78362573099415,0.032131147540983604,Very Cheap
20150210T000000,604000.0,4,1.75,1490,4485,1.0,0,0,3,8,1350,140,1960,0,98199,47.6388,-122.399,1380,4846,2995,3466,134.6711259754738,0.06937704918032787,Very Cheap
20150212T000000,570000.0,3,2.0,1400,1657,2.0,0,0,3,8,1060,340,2004,0,98112,47.6196,-122.298,1540,2275,257,735,343.995171997586,0.06491803278688525,Very Cheap
20140520T000000,639000.0,4,2.5,2150,12028,2.0,0,0,4,8,2150,0,1982,0,98052,47.7224,-122.101,1800,11777,9878,9977,53.126039241769206,0.0739672131147541,Very Cheap
20140822T000000,335000.0,4,2.0,1910,10200,1.0,0,0,4,7,1910,0,1963,0,98059,47.4804,-122.133,1820,15600,8290,13780,32.84313725490196,0.03409836065573771,Very Cheap
20141014T000000,896000.0,4,1.75,2660,3520,2.0,0,0,4,8,2080,580,1917,0,98115,47.6743,-122.308,2100,4080,860,1980,254.54545454545453,0.10767213114754098,Cheap
20140627T000000,259500.0,3,1.75,1650,12349,1.0,0,0,3,7,1650,0,1957,0,98188,47.442,-122.282,1470,10763,10699,9293,21.013847275083002,0.02419672131147541,Very Cheap
20140807T000000,637000.0,3,2.0,1980,6000,1.0,0,0,4,7,1380,600,1958,0,98115,47.6921,-122.283,1260,6000,4020,4740,106.16666666666667,0.07370491803278688,Very Cheap
20150506T000000,307450.0,4,2.75,2690,8874,1.0,0,0,3,8,1370,1320,1980,0,98023,47.3078,-122.383,1990,7875,6184,5885,34.64615731350011,0.030485245901639344,Very Cheap
20140825T000000,535000.0,3,1.75,1380,3561,1.0,0,0,4,7,860,520,1925,0,98117,47.6822,-122.399,1820,4593,2181,2773,150.23869699522606,0.06032786885245902,Very Cheap
20140630T000000,669500.0,4,2.25,2500,4046,1.5,0,0,4,7,1520,980,1940,0,98117,47.6882,-122.382,1410,4046,1546,2636,165.47207118141375,0.0779672131147541,Very Cheap
20141028T000000,259000.0,3,1.75,1590,7148,1.0,0,0,3,7,1590,0,1952,0,98166,47.4713,-122.344,1150,7280,5558,6130,36.23391158365977,0.024131147540983607,Very Cheap
20141231T000000,441000.0,4,1.5,1100,3300,1.0,0,0,1,7,1100,0,1919,0,98122,47.6033,-122.295,2020,4000,2200,1980,133.63636363636363,0.048,Very Cheap
20150512T000000,228800.0,4,2.5,1470,1612,2.0,0,0,3,7,980,490,2003,0,98118,47.5275,-122.271,1460,5027,142,3567,141.93548387096774,0.02017049180327869,Very Cheap
20140513T000000,530000.0,2,2.0,1680,4950,1.0,0,0,3,8,1680,0,2006,0,98053,47.7194,-122.022,1570,4800,3270,3230,107.07070707070707,0.05967213114754098,Very Cheap
20140728T000000,524000.0,2,2.0,1450,2272,1.0,0,0,4,6,750,700,1924,0,98112,47.633,-122.282,2170,4370,822,2200,230.6338028169014,0.05888524590163934,Very Cheap
20141211T000000,430000.0,4,2.25,2020,4840,1.5,0,0,5,8,1200,820,1925,0,98126,47.5576,-122.376,1410,4840,2820,3430,88.84297520661157,0.04655737704918033,Very Cheap
20141001T000000,1325000.0,4,3.25,2470,4760,1.5,0,0,5,9,1890,580,1906,0,98112,47.6331,-122.31,2470,4760,2290,2290,278.3613445378151,0.16393442622950818,Cheap
20141103T000000,210000.0,3,1.0,1230,12201,1.0,0,0,3,7,1230,0,1969,0,98042,47.3285,-122.134,1230,10780,10971,9550,17.21170395869191,0.017704918032786884,Very Cheap
20140623T000000,449000.0,4,2.5,1850,5040,1.0,0,0,3,7,1230,620,1930,2013,98126,47.5386,-122.373,1010,5040,3190,4030,89.08730158730158,0.049049180327868855,Very Cheap
20140619T000000,945000.0,2,2.5,2540,7089,2.0,0,0,3,9,2540,0,2004,0,98116,47.5747,-122.414,1330,7089,4549,5759,133.30512060939483,0.11409836065573771,Cheap
20150318T000000,200450.0,3,1.0,970,9130,1.0,0,0,3,6,970,0,1957,0,98188,47.4369,-122.272,1000,8886,8160,7886,21.955093099671412,0.01645245901639344,Very Cheap
20150417T000000,219950.0,3,1.5,1070,6601,1.0,0,0,3,6,1070,0,1985,0,98002,47.3115,-122.209,1030,6614,5531,5584,33.32070898348735,0.01900983606557377,Very Cheap
20140619T000000,659500.0,4,3.0,2620,18362,1.0,0,0,4,8,1870,750,1956,0,98006,47.5646,-122.184,2630,16792,15742,14162,35.91656682278619,0.07665573770491803,Very Cheap
20141126T000000,746000.0,4,2.75,2110,8190,1.5,0,0,5,8,2110,0,1966,0,98008,47.6269,-122.1,2420,8400,6080,5980,91.08669108669109,0.088,Very Cheap
20150331T000000,540000.0,3,1.75,2110,7129,1.0,0,0,3,8,1280,830,1982,0,98052,47.7219,-122.102,1810,8674,5019,6864,75.74694908121756,0.06098360655737705,Very Cheap
20140910T000000,485000.0,5,2.0,1910,5508,1.0,0,0,3,7,1020,890,1968,0,98133,47.7074,-122.349,1030,7440,3598,6410,88.05374001452432,0.05377049180327869,Very Cheap
20150127T000000,202000.0,2,1.0,670,7844,1.0,0,0,3,6,670,0,1942,0,98126,47.5165,-122.372,740,7218,7174,6478,25.752167261601222,0.016655737704918034,Very Cheap
20140929T000000,2525000.0,4,5.5,6930,45100,1.0,0,0,4,11,4310,2620,1950,1991,98006,47.5547,-122.144,2560,37766,38170,35206,55.98669623059867,0.32131147540983607,Medium
20150401T000000,502000.0,3,2.75,2010,11200,1.0,0,0,3,8,1360,650,1979,0,98028,47.7728,-122.253,2200,10640,9190,8440,44.82142857142857,0.056,Very Cheap
20150224T000000,279000.0,2,2.75,1770,10534,1.0,0,0,3,8,1210,560,2003,0,98001,47.2773,-122.276,1600,17400,8764,15800,26.485665464211127,0.02675409836065574,Very Cheap
20141117T000000,409500.0,3,1.0,1340,4120,1.0,0,0,4,7,1040,300,1921,0,98103,47.6916,-122.352,1270,4635,2780,3365,99.39320388349515,0.043868852459016394,Very Cheap
20140702T000000,453000.0,3,2.0,1660,15050,1.0,0,0,3,7,1260,400,1983,0,98034,47.7203,-122.194,1660,7320,13390,5660,30.099667774086377,0.04957377049180328,Very Cheap
20150227T000000,367000.0,4,1.0,1820,5500,1.5,0,0,3,6,1820,0,1947,0,98106,47.5185,-122.363,1140,5500,3680,4360,66.72727272727273,0.03829508196721312,Very Cheap
20140523T000000,550000.0,3,2.5,2510,5400,2.0,0,0,3,9,2510,0,1992,0,98056,47.5204,-122.206,1840,5400,2890,3560,101.85185185185185,0.06229508196721312,Very Cheap
20150127T000000,273500.0,3,1.5,1560,8314,1.0,0,0,3,7,1560,0,1962,0,98031,47.4117,-122.209,1820,8925,6754,7105,32.896319461149865,0.026032786885245903,Very Cheap
20141007T000000,505000.0,4,3.0,2280,7400,1.0,0,0,3,7,1340,940,1978,0,98125,47.711,-122.306,1540,7500,5120,5960,68.24324324324324,0.05639344262295082,Very Cheap
20140619T000000,770000.0,3,2.5,2650,40705,2.0,0,0,3,9,2650,0,1994,0,98053,47.668,-122.063,2550,42625,38055,40075,18.916595012897677,0.09114754098360656,Very Cheap
20140509T000000,565000.0,4,2.25,2470,7447,2.0,0,0,3,8,2470,0,1984,0,98155,47.7514,-122.286,2270,7400,4977,5130,75.86947764200349,0.06426229508196721,Very Cheap
20140820T000000,316000.0,3,0.75,1270,10092,1.0,0,0,5,7,1270,0,1971,0,98077,47.7567,-122.073,1300,10375,8822,9075,31.311930241775663,0.03160655737704918,Very Cheap
20140925T000000,160000.0,4,1.0,1520,7298,1.5,0,0,3,7,1520,0,1960,0,98198,47.3706,-122.31,1520,7298,5778,5778,21.923814743765416,0.011147540983606558,Very Cheap
20141027T000000,170000.0,3,1.0,1310,9529,1.0,0,0,3,7,1310,0,1956,0,98198,47.4105,-122.295,1330,9529,8219,8199,17.84027704900829,0.012459016393442624,Very Cheap
20150319T000000,235000.0,3,1.0,1310,9529,1.0,0,0,3,7,1310,0,1956,0,98198,47.4105,-122.295,1330,9529,8219,8199,24.661559450099695,0.02098360655737705,Very Cheap
20141219T000000,1799000.0,4,3.5,3930,39098,2.0,0,0,3,12,3930,0,1999,0,98005,47.6399,-122.158,4250,38682,35168,34432,46.01258376387539,0.2260983606557377,Cheap
20140918T000000,310000.0,3,1.0,990,7050,1.0,0,0,3,7,990,0,1967,0,98034,47.7274,-122.202,1200,8125,6060,6925,43.97163120567376,0.03081967213114754,Very Cheap
20140519T000000,285000.0,4,1.75,2080,13629,1.0,0,0,4,7,1040,1040,1955,0,98178,47.4866,-122.232,1780,14659,11549,12879,20.911292097732776,0.02754098360655738,Very Cheap
20140604T000000,280000.0,2,1.0,960,4920,1.0,0,0,3,6,960,0,1942,0,98117,47.6946,-122.362,1010,5040,3960,4030,56.91056910569106,0.026885245901639345,Very Cheap
20150218T000000,2298000.0,4,4.25,4070,13860,2.0,0,3,3,10,4070,0,2004,0,98040,47.59,-122.229,3430,9240,9790,5810,165.8008658008658,0.2915409836065574,Cheap
20140814T000000,763776.0,4,2.5,2750,16139,2.0,0,0,3,9,2750,0,1989,0,98075,47.5843,-122.06,2810,13093,13389,10283,47.32486523328583,0.09033127868852459,Very Cheap
20150217T000000,530000.0,5,2.75,3230,13572,1.0,0,2,3,8,1880,1350,1965,0,98166,47.4393,-122.347,2910,15292,10342,12382,39.050987326849395,0.05967213114754098,Very Cheap
20150211T000000,362000.0,1,1.0,890,211576,1.5,0,0,3,7,890,0,1996,0,98019,47.7216,-121.883,1670,217364,210686,215694,1.7109691080273755,0.03763934426229508,Very Cheap
20140725T000000,430000.0,2,1.0,990,4920,1.0,0,0,3,6,990,0,1931,0,98117,47.6939,-122.368,990,4960,3930,3970,87.39837398373983,0.04655737704918033,Very Cheap
20140725T000000,456500.0,3,1.0,1290,3880,1.5,0,0,4,7,1290,0,1919,0,98117,47.6879,-122.392,1290,4850,2590,3560,117.65463917525773,0.0500327868852459,Very Cheap
20140911T000000,445000.0,4,2.5,2170,5257,2.0,0,0,3,7,2170,0,1989,0,98115,47.6999,-122.305,1430,7528,3087,6098,84.64903937607001,0.04852459016393443,Very Cheap
20150310T000000,386900.0,3,1.0,1330,10500,1.0,0,0,3,7,960,370,1963,0,98034,47.7204,-122.196,1460,11550,9170,10090,36.84761904761905,0.04090491803278688,Very Cheap
20140708T000000,479000.0,3,1.0,1340,13750,1.0,0,0,4,7,1340,0,1955,0,98006,47.5771,-122.151,1430,11400,12410,9970,34.836363636363636,0.05298360655737705,Very Cheap
20150313T000000,525000.0,3,2.5,2200,4544,2.0,0,0,3,8,2200,0,2000,0,98065,47.5319,-121.867,2400,5431,2344,3031,115.53697183098592,0.05901639344262295,Very Cheap
20150106T000000,272000.0,4,1.75,2520,10890,1.0,0,0,3,7,1260,1260,1979,0,98023,47.3224,-122.343,2090,12375,8370,10285,24.977043158861342,0.02583606557377049,Very Cheap
20150226T000000,517000.0,4,1.0,1180,13500,1.5,0,0,3,7,1180,0,1950,0,98125,47.7165,-122.308,1580,8976,12320,7396,38.2962962962963,0.0579672131147541,Very Cheap
20150226T000000,615000.0,3,1.75,2660,7800,1.0,0,0,4,8,1330,1330,1951,0,98117,47.6993,-122.378,1950,6240,5140,4290,78.84615384615384,0.07081967213114754,Very Cheap
20140828T000000,439000.0,3,1.75,1250,7030,1.0,0,0,3,7,1250,0,1965,0,98008,47.6285,-122.118,1460,7210,5780,5750,62.44665718349929,0.04773770491803279,Very Cheap
20140724T000000,716000.0,3,2.5,2270,7866,1.0,0,0,4,10,2270,0,1988,0,98029,47.5622,-122.022,2580,8132,5596,5552,91.02466310704297,0.0840655737704918,Very Cheap
20141028T000000,308000.0,2,1.0,1080,6250,1.0,0,2,4,7,1080,0,1942,1968,98118,47.5128,-122.251,2100,6875,5170,4775,49.28,0.030557377049180327,Very Cheap
20140610T000000,800000.0,3,2.25,1620,4500,2.0,0,0,4,8,1620,0,1926,0,98119,47.643,-122.361,1210,4320,2880,3110,177.77777777777777,0.09508196721311475,Very Cheap
20150505T000000,575000.0,3,2.0,940,5000,1.0,0,0,3,7,880,60,1941,0,98117,47.6771,-122.398,1420,5000,4060,3580,115.0,0.06557377049180328,Very Cheap
20140701T000000,219950.0,3,1.5,1620,9310,1.0,0,0,4,7,1620,0,1967,0,98042,47.3665,-122.107,1610,10640,7690,9030,23.62513426423201,0.01900983606557377,Very Cheap
20140522T000000,770000.0,4,2.5,2350,8001,2.0,0,0,4,8,2350,0,1987,0,98006,47.5478,-122.153,2460,8001,5651,5541,96.23797025371829,0.09114754098360656,Very Cheap
20141230T000000,424950.0,3,1.75,2090,7505,1.0,0,0,3,7,2090,0,1967,0,98034,47.7326,-122.194,1510,7416,5415,5906,56.62225183211193,0.04589508196721311,Very Cheap
20150108T000000,387000.0,3,2.25,1760,45133,2.0,0,0,3,7,1760,0,1984,0,98065,47.5124,-121.866,1910,51773,43373,49863,8.574657124498703,0.040918032786885244,Very Cheap
20140620T000000,790000.0,4,1.75,2050,10920,1.0,0,3,3,8,1450,600,1974,0,98155,47.7431,-122.286,2440,10920,8870,8480,72.34432234432235,0.09377049180327869,Very Cheap
20150128T000000,156000.0,2,1.0,600,4000,1.0,0,0,3,5,600,0,1933,0,98146,47.5065,-122.339,1290,6973,3400,5683,39.0,0.010622950819672131,Very Cheap
20140505T000000,580000.0,2,1.0,2540,7000,1.0,0,0,5,8,1320,1220,1942,0,98118,47.5259,-122.261,2160,6000,4460,3840,82.85714285714286,0.06622950819672131,Very Cheap
20140919T000000,490000.0,4,2.25,2090,10869,2.0,0,0,3,8,2090,0,1970,0,98033,47.6715,-122.164,1800,17788,8779,15988,45.08234428190266,0.05442622950819672,Very Cheap
20140716T000000,950000.0,5,3.25,2700,3650,2.0,0,2,3,9,2070,630,1926,2014,98144,47.5959,-122.291,1940,4000,950,2060,260.2739726027397,0.11475409836065574,Cheap
20150213T000000,400000.0,2,2.5,1410,1281,2.0,0,0,3,8,1090,320,2008,0,98126,47.5659,-122.37,1410,2550,-129,1140,312.25604996096797,0.04262295081967213,Very Cheap
20150513T000000,325000.0,2,2.5,1170,1638,2.0,0,0,3,8,1170,0,2008,0,98133,47.7041,-122.351,1350,1407,468,57,198.4126984126984,0.03278688524590164,Very Cheap
20140929T000000,365000.0,4,2.5,2540,6688,2.0,0,0,3,9,2540,0,2002,0,98092,47.3314,-122.18,2810,6776,4148,3966,54.57535885167464,0.0380327868852459,Very Cheap
20150407T000000,255000.0,3,1.75,2190,6000,1.5,0,0,4,7,2190,0,1920,0,98002,47.3063,-122.223,1610,6000,3810,4390,42.5,0.02360655737704918,Very Cheap
20150323T000000,985000.0,5,3.5,3890,13261,2.0,0,1,3,9,2870,1020,1984,0,98125,47.7246,-122.284,3080,13261,9371,10181,74.27795792172536,0.11934426229508197,Cheap
20150423T000000,595000.0,4,2.5,2030,10722,1.0,0,0,3,7,1100,930,1967,0,98115,47.6955,-122.301,1610,9134,8692,7524,55.49337810110054,0.06819672131147542,Very Cheap
20140716T000000,427500.0,3,1.0,1350,7085,1.0,0,0,5,7,1350,0,1944,0,98125,47.7318,-122.305,1350,7085,5735,5735,60.33874382498236,0.04622950819672131,Very Cheap
20141016T000000,728000.0,3,1.5,1940,4000,1.5,0,0,3,8,1310,630,1915,0,98112,47.6205,-122.291,1940,4000,2060,2060,182.0,0.08563934426229508,Very Cheap
20140910T000000,549950.0,2,1.0,1260,4000,1.0,0,0,3,7,1000,260,1940,0,98117,47.6898,-122.384,1780,4000,2740,2220,137.4875,0.062288524590163936,Very Cheap
20141208T000000,650000.0,3,2.0,2800,10501,1.0,0,0,3,7,1400,1400,1954,0,98125,47.7055,-122.315,2260,6534,7701,4274,61.898866774592896,0.07540983606557378,Very Cheap
20150320T000000,1125000.0,5,3.25,3080,13394,1.0,0,2,4,9,2230,850,1968,0,98033,47.6651,-122.19,2810,10720,10314,7910,83.99283261161715,0.1377049180327869,Cheap
20150504T000000,203000.0,3,1.0,840,6500,1.0,0,0,5,6,840,0,1969,0,98042,47.3637,-122.083,920,4680,5660,3760,31.23076923076923,0.01678688524590164,Very Cheap
20140807T000000,311000.0,2,1.0,860,3300,1.0,0,0,5,6,860,0,1903,0,98118,47.5496,-122.279,1380,4400,2440,3020,94.24242424242425,0.030950819672131147,Very Cheap
20150428T000000,387500.0,6,2.0,2400,7684,1.0,0,0,3,6,1200,1200,1932,2005,98028,47.7705,-122.269,1290,9800,5284,8510,50.4294638209266,0.040983606557377046,Very Cheap
20150318T000000,370000.0,4,2.0,1640,7200,1.0,0,0,3,7,1640,0,1963,0,98155,47.7471,-122.324,1500,9000,5560,7500,51.388888888888886,0.038688524590163934,Very Cheap
20140724T000000,228000.0,2,1.0,1060,6100,1.0,0,0,3,6,1060,0,1951,0,98125,47.7317,-122.296,1550,9150,5040,7600,37.377049180327866,0.020065573770491802,Very Cheap
20140528T000000,740000.0,2,1.75,2080,4800,1.0,0,0,5,7,1080,1000,1923,0,98117,47.6896,-122.362,1310,4800,2720,3490,154.16666666666666,0.08721311475409836,Very Cheap
20140710T000000,200000.0,4,2.0,2090,6630,1.0,0,0,3,7,1070,1020,1974,0,98178,47.5077,-122.268,1550,7980,4540,6430,30.165912518853695,0.01639344262295082,Very Cheap
20140709T000000,660000.0,3,1.0,1240,3500,1.0,0,0,4,7,1240,0,1927,0,98103,47.6835,-122.347,1650,3360,2260,1710,188.57142857142858,0.07672131147540984,Very Cheap
20140709T000000,275000.0,4,2.0,2030,8426,2.0,0,0,3,7,2030,0,1944,0,98168,47.4806,-122.287,1190,7007,6396,5817,32.637075718015666,0.02622950819672131,Very Cheap
20150429T000000,708000.0,2,1.0,1120,5250,1.0,0,0,3,7,950,170,1938,0,98199,47.6496,-122.392,1510,5250,4130,3740,134.85714285714286,0.08301639344262295,Very Cheap
20140519T000000,280000.0,3,2.5,1270,9675,2.0,0,0,3,8,1270,0,1993,0,98045,47.4639,-121.744,1270,11700,8405,10430,28.940568475452196,0.026885245901639345,Very Cheap
20150106T000000,325000.0,4,2.5,2260,5702,2.0,0,0,3,8,2260,0,2002,0,98042,47.3488,-122.151,2450,6381,3442,3931,56.997544721150476,0.03278688524590164,Very Cheap
20140820T000000,495000.0,3,2.5,1780,47480,2.0,0,0,3,7,1780,0,1995,0,98045,47.4723,-121.707,1890,51836,45700,49946,10.425442291491153,0.05508196721311476,Very Cheap
20140922T000000,691000.0,2,2.0,1780,3810,1.5,0,0,3,7,980,800,1922,0,98119,47.6474,-122.362,1690,3810,2030,2120,181.36482939632546,0.08078688524590164,Very Cheap
20140702T000000,2288000.0,4,2.5,4080,18362,2.0,0,2,4,11,4080,0,1983,0,98004,47.6344,-122.214,4080,19991,14282,15911,124.60516283629234,0.29022950819672133,Cheap
20150428T000000,329500.0,3,2.5,2120,22482,1.0,0,0,5,7,1360,760,1979,0,98001,47.341,-122.265,2330,16016,20362,13686,14.656169379948404,0.03337704918032787,Very Cheap
20140805T000000,348000.0,3,2.5,2060,7458,2.0,0,0,3,9,2060,0,1989,0,98023,47.3045,-122.351,2480,7743,5398,5263,46.66130329847144,0.03580327868852459,Very Cheap
20141114T000000,425000.0,2,1.0,1670,6212,1.0,0,0,4,7,1670,0,1947,0,98125,47.7152,-122.282,1670,7272,4542,5602,68.41596909207985,0.04590163934426229,Very Cheap
20140519T000000,210000.0,3,1.0,1080,21043,1.0,0,0,3,6,1080,0,1942,0,98106,47.5515,-122.357,1380,7620,19963,6240,9.979565651285464,0.017704918032786884,Very Cheap
20141220T000000,285000.0,2,1.0,1210,4895,1.0,0,0,3,6,710,500,1951,0,98126,47.5202,-122.373,1100,6000,3685,4900,58.22267620020429,0.02754098360655738,Very Cheap
20150430T000000,222000.0,3,1.0,990,8840,1.0,0,0,3,6,990,0,1966,0,98023,47.3074,-122.371,1120,8625,7850,7505,25.1131221719457,0.019278688524590165,Very Cheap
20140527T000000,200000.0,4,2.5,1720,9600,1.0,0,0,3,7,1120,600,1961,0,98092,47.2917,-122.188,1520,9400,7880,7880,20.833333333333332,0.01639344262295082,Very Cheap
20141002T000000,247500.0,3,2.0,1530,8749,1.0,0,0,3,7,1530,0,1995,0,98023,47.2974,-122.372,1750,8749,7219,6999,28.2889473082638,0.02262295081967213,Very Cheap
20140820T000000,1500000.0,4,5.5,6550,217374,1.0,0,0,3,11,5400,1150,2006,0,98058,47.4302,-122.095,4110,50378,210824,46268,6.9005492837229845,0.18688524590163935,Cheap
20141120T000000,190000.0,3,1.75,1100,9452,1.0,0,0,3,6,1100,0,1942,0,98146,47.4864,-122.337,1350,9452,8352,8102,20.101565806178588,0.015081967213114755,Very Cheap
20141215T000000,975000.0,4,2.5,3020,4950,1.5,0,0,4,9,2020,1000,1921,0,98112,47.6467,-122.304,2300,5450,1930,3150,196.96969696969697,0.1180327868852459,Cheap
20141223T000000,1130000.0,4,3.0,3180,4649,2.0,0,0,4,9,2070,1110,1925,0,98105,47.6583,-122.273,2720,5980,1469,3260,243.06302430630242,0.13836065573770492,Cheap
20150504T000000,283200.0,4,1.75,1830,12540,1.0,0,0,4,8,1130,700,1958,0,98003,47.3348,-122.324,2020,12540,10710,10520,22.583732057416267,0.027304918032786885,Very Cheap
20140714T000000,650000.0,3,2.5,2540,8073,1.0,0,0,4,8,1880,660,1937,0,98177,47.7176,-122.36,2110,7702,5533,5592,80.51529790660226,0.07540983606557378,Very Cheap
20140513T000000,449500.0,3,2.0,1770,6610,1.0,0,0,4,7,960,810,1954,0,98133,47.7703,-122.343,2010,4361,4840,2351,68.00302571860817,0.049114754098360656,Very Cheap
20141022T000000,400000.0,3,1.75,1470,6682,1.0,0,0,3,7,1470,0,1987,0,98034,47.7315,-122.226,1790,7379,5212,5589,59.86231667165519,0.04262295081967213,Very Cheap
20150219T000000,89950.0,1,1.0,570,4080,1.0,0,0,3,5,570,0,1942,0,98146,47.5098,-122.334,890,5100,3510,4210,22.04656862745098,0.001960655737704918,Very Cheap
20141124T000000,158800.0,3,1.0,960,8291,1.0,0,0,3,6,960,0,1950,0,98146,47.5006,-122.334,1110,8231,7331,7121,19.15329875768906,0.01099016393442623,Very Cheap
20140917T000000,870000.0,4,3.0,2940,7108,2.0,0,1,3,9,2220,720,2011,0,98136,47.5437,-122.395,2240,7950,4168,5710,122.39729881823298,0.10426229508196722,Cheap
20150306T000000,196000.0,3,1.5,1000,18568,1.0,0,0,3,6,1000,0,1989,0,98001,47.2976,-122.271,1610,17420,17568,15810,10.555794915984489,0.015868852459016394,Very Cheap
20140731T000000,850000.0,3,1.75,2450,8603,1.0,0,0,5,8,1340,1110,1940,0,98199,47.6536,-122.414,2280,5779,6153,3499,98.80274322910613,0.10163934426229508,Cheap
20140923T000000,775000.0,4,2.5,3310,5101,2.0,0,0,3,9,3310,0,2005,0,98052,47.6649,-122.08,3010,5176,1791,2166,151.93099392276025,0.09180327868852459,Very Cheap
20140801T000000,483500.0,3,2.5,1670,4308,2.0,0,0,3,8,1670,0,2001,0,98027,47.5307,-122.047,1670,2897,2638,1227,112.2330547818013,0.05357377049180328,Very Cheap
20150402T000000,387000.0,3,1.5,1620,21929,2.0,0,0,3,7,1620,0,1990,0,98019,47.767,-121.903,1600,21679,20309,20079,17.647863559669844,0.040918032786885244,Very Cheap
20150124T000000,900000.0,3,3.0,2990,30869,2.0,0,0,3,10,2990,0,1951,2003,98155,47.7602,-122.278,1750,15802,27879,14052,29.15546340989342,0.10819672131147541,Cheap
20150407T000000,336000.0,3,1.5,1240,5000,1.0,0,2,3,7,1240,0,1964,0,98106,47.5659,-122.36,1050,5000,3760,3950,67.2,0.03422950819672131,Very Cheap
20150417T000000,415000.0,2,1.0,670,6000,1.0,0,0,5,6,670,0,1949,0,98118,47.561,-122.275,1240,5040,5330,3800,69.16666666666667,0.04459016393442623,Very Cheap
20150205T000000,380000.0,0,0.0,1470,979,3.0,0,2,3,8,1470,0,2006,0,98133,47.7145,-122.356,1470,1399,-491,-71,388.1511746680286,0.04,Very Cheap
20140811T000000,350000.0,3,1.5,1320,4400,1.0,0,0,3,6,1320,0,1909,0,98112,47.6231,-122.292,1350,4400,3080,3050,79.54545454545455,0.036065573770491806,Very Cheap
20141117T000000,1320000.0,4,5.25,6110,10369,2.0,0,0,3,11,6110,0,2005,0,98059,47.5285,-122.135,4190,10762,4259,6572,127.30253640659659,0.16327868852459015,Cheap
20140806T000000,765000.0,3,1.75,2440,5800,1.0,0,3,4,8,1320,1120,1945,0,98199,47.6474,-122.412,2530,5800,3360,3270,131.89655172413794,0.09049180327868853,Very Cheap
20141020T000000,527000.0,4,2.5,2900,6736,2.0,0,0,3,8,2900,0,2013,0,98059,47.4954,-122.152,2900,6736,3836,3836,78.23634204275534,0.059278688524590166,Very Cheap
20140718T000000,524000.0,4,2.75,2310,5000,1.5,0,0,5,8,1480,830,1908,0,98118,47.5502,-122.268,1100,5000,2690,3900,104.8,0.05888524590163934,Very Cheap
20140715T000000,448000.0,2,1.0,1110,5413,1.0,0,0,3,6,890,220,1937,0,98115,47.6925,-122.32,1300,5413,4303,4113,82.76371697764641,0.048918032786885245,Very Cheap
20140707T000000,775000.0,4,3.25,4100,241322,2.0,0,0,3,9,2500,1600,1981,0,98072,47.7302,-122.096,3770,87821,237222,84051,3.211476782058826,0.09180327868852459,Very Cheap
20150116T000000,176500.0,3,1.0,930,9900,1.5,0,0,4,5,930,0,1910,0,98032,47.3745,-122.231,930,7200,8970,6270,17.828282828282827,0.013311475409836066,Very Cheap
20150416T000000,750000.0,4,2.25,2420,11120,1.0,0,2,4,8,1620,800,1952,0,98146,47.4954,-122.366,2210,8497,8700,6287,67.44604316546763,0.08852459016393442,Very Cheap
20141202T000000,1265000.0,4,2.25,2870,6000,1.0,0,0,5,8,1730,1140,1951,0,98112,47.6362,-122.282,2370,5500,3130,3130,210.83333333333334,0.1560655737704918,Cheap
20150226T000000,250000.0,3,1.0,1480,6750,1.0,0,0,3,7,1480,0,1958,0,98146,47.505,-122.366,1480,7594,5270,6114,37.03703703703704,0.022950819672131147,Very Cheap
20141028T000000,759000.0,3,2.75,1960,6390,1.5,0,2,5,8,1960,0,1900,0,98122,47.6032,-122.285,2440,5870,4430,3430,118.77934272300469,0.08970491803278688,Very Cheap
20141211T000000,640000.0,3,2.0,1470,4640,1.5,0,0,4,7,1470,0,1926,0,98199,47.6398,-122.393,1700,5000,3170,3300,137.93103448275863,0.0740983606557377,Very Cheap
20150427T000000,990000.0,3,3.25,2460,4182,2.0,0,0,5,8,2100,360,1910,0,98115,47.6782,-122.311,2370,4284,1722,1914,236.72883787661405,0.12,Cheap
20141008T000000,395000.0,4,1.75,1960,7945,1.0,0,0,4,7,980,980,1946,0,98125,47.7326,-122.291,1290,7945,5985,6655,49.71680302076778,0.0419672131147541,Very Cheap
20150421T000000,275000.0,2,1.5,1160,1103,2.0,0,0,3,7,890,270,2006,0,98133,47.7677,-122.315,1160,1086,-57,-74,249.32003626473255,0.02622950819672131,Very Cheap
20150205T000000,390000.0,3,2.5,1910,4755,2.0,0,0,3,8,1910,0,1997,0,98059,47.4956,-122.162,2460,6099,2845,3639,82.01892744479495,0.04131147540983607,Very Cheap
20150324T000000,752500.0,5,2.75,2720,4680,1.5,0,0,4,8,1710,1010,1913,0,98107,47.6612,-122.363,1670,4800,1960,3130,160.7905982905983,0.08885245901639344,Very Cheap
20150227T000000,450000.0,2,1.0,1020,5000,1.5,0,0,4,6,1020,0,1906,0,98107,47.6725,-122.396,1490,5000,3980,3510,90.0,0.04918032786885246,Very Cheap
20140617T000000,473000.0,2,1.0,900,5100,1.0,0,0,4,7,900,0,1909,0,98117,47.6804,-122.378,1400,5100,4200,3700,92.74509803921569,0.05219672131147541,Very Cheap
20150323T000000,178500.0,3,1.75,1120,10450,1.0,0,0,3,7,1120,0,1973,0,98045,47.4418,-121.772,1250,10414,9330,9164,17.08133971291866,0.01357377049180328,Very Cheap
20140604T000000,485000.0,3,2.5,2340,59058,1.0,0,0,3,8,2340,0,1985,0,98038,47.4052,-122.028,2700,37263,56718,34563,8.212265908090352,0.05377049180327869,Very Cheap
20150327T000000,215000.0,3,1.5,1410,8415,1.0,0,0,4,7,780,630,1982,0,98023,47.2914,-122.368,1440,7361,7005,5921,25.5496137849079,0.018360655737704918,Very Cheap
20140812T000000,589000.0,4,1.75,1920,4862,1.0,0,0,5,7,1060,860,1919,0,98116,47.5747,-122.384,1840,4862,2942,3022,121.14356232003291,0.06740983606557377,Very Cheap
20150417T000000,325000.0,4,1.75,1370,9993,1.0,0,0,3,6,1370,0,1918,0,98028,47.7572,-122.228,1650,11592,8623,9942,32.52276593615531,0.03278688524590164,Very Cheap
20140820T000000,580000.0,3,2.5,1590,1937,2.5,0,0,3,8,1590,0,2004,0,98116,47.5903,-122.388,1620,2022,347,402,299.4321115126484,0.06622950819672131,Very Cheap
20140716T000000,181100.0,4,1.75,1850,7500,1.0,0,0,3,7,1850,0,1954,0,98198,47.4217,-122.333,1460,7500,5650,6040,24.14666666666667,0.013914754098360656,Very Cheap
20150224T000000,345000.0,3,2.0,1430,4200,1.0,0,0,4,7,830,600,1908,0,98199,47.6462,-122.384,1540,5000,2770,3460,82.14285714285714,0.03540983606557377,Very Cheap
20150330T000000,781000.0,3,1.75,1940,8729,1.0,0,0,3,8,1460,480,1960,0,98125,47.7027,-122.282,2250,9165,6789,6915,89.47187535800207,0.09259016393442623,Very Cheap
20141023T000000,402500.0,4,1.0,1270,3630,1.5,0,0,3,7,1270,0,1903,0,98122,47.6135,-122.307,1420,4848,2360,3428,110.88154269972452,0.04295081967213115,Very Cheap
20150420T000000,426000.0,3,1.5,1380,7200,1.0,0,0,3,7,1080,300,1948,0,98106,47.5292,-122.348,1220,7200,5820,5980,59.166666666666664,0.046032786885245904,Very Cheap
20140905T000000,389000.0,3,2.5,1720,4515,2.0,0,0,3,7,1720,0,2005,0,98065,47.5426,-121.879,2220,4618,2795,2398,86.15725359911407,0.04118032786885246,Very Cheap
20140707T000000,670000.0,6,3.0,4050,36171,2.0,0,0,4,8,2620,1430,1970,0,98027,47.4708,-122.015,3660,42874,32121,39214,18.523126261369605,0.0780327868852459,Very Cheap
20140521T000000,1506000.0,4,3.25,3660,5800,2.5,0,0,3,10,3360,300,1909,1995,98112,47.6283,-122.312,3240,5800,2140,2560,259.6551724137931,0.18767213114754097,Cheap
20140521T000000,288400.0,3,2.25,1870,3230,2.0,0,0,3,7,1870,0,1997,0,98056,47.4915,-122.167,1620,3363,1360,1743,89.28792569659443,0.02798688524590164,Very Cheap
20150219T000000,700000.0,4,2.0,2230,4635,1.5,0,0,5,7,1510,720,1908,0,98103,47.682,-122.349,1520,4635,2405,3115,151.02481121898597,0.08196721311475409,Very Cheap
20150331T000000,830000.0,4,3.0,2020,6000,1.0,0,0,3,8,1220,800,1968,2015,98199,47.6563,-122.401,1400,6000,3980,4600,138.33333333333334,0.09901639344262295,Very Cheap
20140911T000000,1899000.0,2,2.75,3690,32044,2.0,1,4,3,12,3690,0,1989,0,98166,47.4485,-122.369,2310,26988,28354,24678,59.26226438646861,0.23921311475409837,Cheap
20141009T000000,350500.0,2,1.0,1450,6380,1.0,0,0,3,7,1450,0,1967,0,98115,47.6924,-122.321,1240,6380,4930,5140,54.93730407523511,0.03613114754098361,Very Cheap
20150503T000000,431000.0,3,1.75,1630,9000,1.0,0,0,4,7,1630,0,1956,0,98166,47.4521,-122.36,1600,11120,7370,9520,47.888888888888886,0.046688524590163934,Very Cheap
20141031T000000,485000.0,3,2.5,1840,8250,1.0,0,1,3,8,1340,500,1958,0,98177,47.7767,-122.378,1970,7920,6410,5950,58.78787878787879,0.05377049180327869,Very Cheap
20141010T000000,780000.0,3,1.5,1620,7500,1.0,0,2,4,8,1620,0,1949,0,98117,47.7014,-122.381,2440,7800,5880,5360,104.0,0.09245901639344262,Very Cheap
20140801T000000,720000.0,2,1.5,1840,9000,1.0,0,2,3,8,1340,500,1957,0,98136,47.5281,-122.388,1880,7560,7160,5680,80.0,0.08459016393442623,Very Cheap
20150220T000000,415000.0,3,1.0,1360,73616,1.0,0,0,3,7,1360,0,1971,0,98072,47.7528,-122.119,2040,50965,72256,48925,5.637361443164529,0.04459016393442623,Very Cheap
20140620T000000,480000.0,4,1.0,2080,5500,1.0,0,0,3,7,1040,1040,1941,0,98117,47.6838,-122.386,1280,4000,3420,2720,87.27272727272727,0.05311475409836065,Very Cheap
20140916T000000,452250.0,4,2.25,2550,10000,1.0,0,0,4,7,1560,990,1979,0,98028,47.77,-122.259,2440,10000,7450,7560,45.225,0.049475409836065576,Very Cheap
20150406T000000,316000.0,3,2.5,2550,8170,2.0,0,0,3,8,2550,0,1985,0,98023,47.311,-122.345,1840,8823,5620,6983,38.6780905752754,0.03160655737704918,Very Cheap
20141010T000000,700000.0,2,1.0,1160,17635,1.0,1,4,3,6,1160,0,1945,0,98178,47.5117,-122.248,1510,13122,16475,11612,39.6937907570173,0.08196721311475409,Very Cheap
20140729T000000,285000.0,4,2.0,1760,5500,1.0,0,1,3,7,780,980,1925,2004,98118,47.5183,-122.265,1510,5500,3740,3990,51.81818181818182,0.02754098360655738,Very Cheap
20140918T000000,575000.0,3,1.75,1720,4050,1.0,0,0,5,7,860,860,1906,0,98115,47.6782,-122.314,1720,4410,2330,2690,141.97530864197532,0.06557377049180328,Very Cheap
20140722T000000,590000.0,3,2.25,2300,12430,1.0,0,2,4,8,1580,720,1960,0,98166,47.435,-122.347,2500,12430,10130,9930,47.46580852775543,0.06754098360655737,Very Cheap
20150226T000000,587500.0,4,1.75,2500,20868,1.0,0,2,3,8,1600,900,1956,0,98166,47.431,-122.338,2170,15026,18368,12856,28.153153153153152,0.06721311475409836,Very Cheap
20140922T000000,364000.0,4,2.25,1750,10270,1.5,0,0,4,8,1750,0,1968,0,98155,47.7612,-122.31,1750,10127,8520,8377,35.44303797468354,0.03790163934426229,Very Cheap
20141217T000000,490000.0,3,2.5,1890,10190,2.0,0,0,3,8,1890,0,1986,0,98074,47.6478,-122.061,2080,9794,8300,7714,48.086359175662416,0.05442622950819672,Very Cheap
20140505T000000,410000.0,3,2.25,1800,36704,1.0,0,0,4,8,1360,440,1978,0,98027,47.4688,-122.013,2730,36404,34904,33674,11.170444638186574,0.043934426229508196,Very Cheap
20141028T000000,520000.0,3,2.5,2160,4297,2.0,0,0,3,9,2160,0,1999,0,98029,47.5476,-122.012,2160,3968,2137,1808,121.01466139166861,0.058360655737704915,Very Cheap
20141008T000000,389000.0,3,1.0,1380,6591,1.0,0,0,4,7,1380,0,1947,0,98133,47.7164,-122.351,1610,6594,5211,4984,59.019875587922925,0.04118032786885246,Very Cheap
20141118T000000,450000.0,2,1.0,1180,6000,1.0,0,0,3,7,1180,0,1910,0,98119,47.6531,-122.373,1600,6000,4820,4400,75.0,0.04918032786885246,Very Cheap
20141205T000000,325000.0,3,2.5,2550,4240,2.0,0,0,3,7,2550,0,2006,0,98031,47.3986,-122.169,2550,4240,1690,1690,76.65094339622641,0.03278688524590164,Very Cheap
20150313T000000,660000.0,2,1.0,1070,5000,1.0,0,0,3,7,1070,0,1924,0,98103,47.6631,-122.337,1400,4000,3930,2600,132.0,0.07672131147540984,Very Cheap
20140620T000000,850000.0,3,2.25,2870,8170,2.0,0,0,3,10,2250,620,1995,0,98136,47.5363,-122.385,1310,8170,5300,6860,104.0391676866585,0.10163934426229508,Cheap
20140806T000000,285000.0,3,2.5,1940,9874,2.0,0,0,3,7,1940,0,1990,0,98042,47.3794,-122.113,1860,8875,7934,7015,28.86368239821754,0.02754098360655738,Very Cheap
20141211T000000,395000.0,2,1.0,870,3121,1.0,0,0,4,7,870,0,1923,0,98107,47.6659,-122.369,1570,1777,2251,207,126.56199935917975,0.0419672131147541,Very Cheap
20140717T000000,440000.0,3,2.0,1550,2401,2.0,0,0,3,7,1550,0,1996,0,98103,47.6545,-122.348,1550,3446,851,1896,183.2569762598917,0.04786885245901639,Very Cheap
20150313T000000,249000.0,3,1.75,1400,5648,1.5,0,0,5,6,1400,0,1917,0,98056,47.5133,-122.196,2320,9420,4248,7100,44.08640226628895,0.02281967213114754,Very Cheap
20150227T000000,635000.0,3,1.75,1210,4400,1.5,0,0,4,8,1210,0,1930,0,98105,47.6621,-122.288,2020,3750,3190,1730,144.3181818181818,0.07344262295081967,Very Cheap
20140811T000000,515000.0,3,2.5,3430,48993,2.0,0,0,3,9,3430,0,2001,0,98001,47.2609,-122.27,2460,36256,45563,33796,10.511705753883207,0.057704918032786885,Very Cheap
20150130T000000,1400000.0,3,3.25,3020,6073,2.0,0,0,4,9,3020,0,1954,0,98112,47.6332,-122.29,3020,7700,3053,4680,230.52856907623908,0.1737704918032787,Cheap
20150304T000000,200000.0,2,1.0,950,8100,1.0,0,0,3,6,950,0,1955,0,98166,47.4572,-122.351,1620,7630,7150,6010,24.691358024691358,0.01639344262295082,Very Cheap
20140506T000000,1135000.0,4,2.75,3370,8103,1.0,0,3,3,9,1970,1400,1970,2014,98136,47.5232,-122.383,2120,6360,4733,4240,140.07157842774282,0.13901639344262295,Cheap
20141117T000000,445000.0,4,1.0,1460,4600,1.0,0,2,3,6,780,680,1946,0,98126,47.566,-122.38,1560,4600,3140,3040,96.73913043478261,0.04852459016393443,Very Cheap
20140707T000000,555000.0,3,1.5,1740,4200,1.5,0,0,4,7,1640,100,1920,0,98117,47.6782,-122.361,1660,3750,2460,2090,132.14285714285714,0.06295081967213115,Very Cheap
20140924T000000,537000.0,4,2.0,1720,6413,1.0,0,0,4,7,860,860,1950,0,98116,47.5734,-122.395,1280,6413,4693,5133,83.7361609231249,0.060590163934426226,Very Cheap
20150127T000000,315000.0,3,1.75,1480,7500,1.0,0,0,4,7,1480,0,1968,0,98055,47.4629,-122.187,1480,7500,6020,6020,42.0,0.031475409836065574,Very Cheap
20150129T000000,805000.0,5,2.5,3320,7266,2.0,0,0,3,9,3320,0,2000,0,98075,47.5862,-122.054,3060,10269,3946,7209,110.78998073217727,0.09573770491803278,Very Cheap
20140826T000000,414000.0,4,2.5,3490,9030,1.5,0,0,4,8,3490,0,1969,0,98023,47.3198,-122.386,2540,8400,5540,5860,45.84717607973422,0.04445901639344262,Very Cheap
20140815T000000,375000.0,2,1.5,1160,1648,2.0,0,0,3,7,1160,0,2002,0,98144,47.5916,-122.293,1458,2351,488,893,227.54854368932038,0.03934426229508197,Very Cheap
20150304T000000,401000.0,4,1.75,3010,12523,1.0,0,0,3,8,1780,1230,1952,0,98125,47.707,-122.316,2040,7560,9513,5520,32.02108121057255,0.04275409836065574,Very Cheap
20150128T000000,210000.0,3,1.0,1030,4583,1.0,0,0,3,7,1030,0,1967,0,98198,47.4231,-122.329,1730,8023,3553,6293,45.8215142919485,0.017704918032786884,Very Cheap
20140722T000000,365000.0,2,1.0,980,5110,1.0,0,0,4,7,780,200,1939,0,98115,47.7002,-122.314,1430,5110,4130,3680,71.42857142857143,0.0380327868852459,Very Cheap
20150224T000000,178000.0,5,1.5,1990,18200,1.0,0,0,3,7,1990,0,1960,0,98178,47.4938,-122.262,1860,8658,16210,6798,9.780219780219781,0.013508196721311476,Very Cheap
20140520T000000,710000.0,2,1.0,1790,4000,1.0,0,0,4,7,1040,750,1923,0,98112,47.6405,-122.301,1310,4000,2210,2690,177.5,0.08327868852459017,Very Cheap
20140509T000000,255000.0,2,1.0,810,7980,1.0,0,0,1,6,810,0,1928,0,98146,47.489,-122.337,1440,7980,7170,6540,31.954887218045112,0.02360655737704918,Very Cheap
20141204T000000,528000.0,5,2.25,2940,38009,1.0,0,0,3,8,1700,1240,1977,0,98077,47.7653,-122.077,2620,38300,35069,35680,13.891446762608856,0.05940983606557377,Very Cheap
20150407T000000,537000.0,4,4.25,4883,26040,2.0,0,3,3,10,3859,1024,2006,0,98092,47.263,-122.216,3736,9870,21157,6134,20.622119815668203,0.060590163934426226,Very Cheap
20140804T000000,442000.0,4,1.5,1360,6110,1.0,0,0,3,7,1010,350,1955,0,98116,47.5755,-122.396,1520,6110,4750,4590,72.34042553191489,0.048131147540983604,Very Cheap
20150414T000000,375000.0,3,1.75,1370,19550,1.0,0,0,3,7,1370,0,1978,2006,98014,47.7002,-121.912,1430,17550,18180,16120,19.18158567774936,0.03934426229508197,Very Cheap
20141121T000000,637250.0,4,2.5,2120,3220,2.0,0,0,3,9,2120,0,2005,0,98052,47.6662,-122.083,2120,3547,1100,1427,197.90372670807454,0.07373770491803279,Very Cheap
20150330T000000,427500.0,3,1.75,1240,7200,1.0,0,0,5,7,1240,0,1942,0,98136,47.5142,-122.389,1640,7200,5960,5560,59.375,0.04622950819672131,Very Cheap
20150331T000000,700000.0,4,2.5,2770,89298,2.0,0,0,3,8,2770,0,2004,0,98053,47.6624,-122.01,2650,89298,86528,86648,7.838921364420256,0.08196721311475409,Very Cheap
20150319T000000,680000.0,3,1.75,1660,5750,1.0,0,0,4,7,1080,580,1909,0,98116,47.5843,-122.385,2060,5560,4090,3500,118.26086956521739,0.07934426229508197,Very Cheap
20140828T000000,393820.0,2,2.0,1170,8251,1.0,0,0,3,7,1170,0,1941,0,98115,47.6873,-122.291,1360,6798,7081,5438,47.72997212459096,0.041812459016393445,Very Cheap
20140820T000000,525000.0,4,2.75,2470,7200,1.0,0,0,5,7,1350,1120,1940,0,98108,47.5631,-122.317,1500,6000,4730,4500,72.91666666666667,0.05901639344262295,Very Cheap
20150115T000000,505000.0,2,1.75,1310,3816,1.0,0,0,2,7,1110,200,1929,0,98117,47.679,-122.368,1510,3816,2506,2306,132.33752620545073,0.05639344262295082,Very Cheap
20141111T000000,555565.0,3,2.0,1670,11337,1.0,0,1,4,7,1670,0,1959,0,98033,47.6602,-122.188,2210,11337,9667,9127,49.00458675134515,0.06302491803278688,Very Cheap
20141029T000000,650000.0,3,1.75,1660,10819,1.0,0,0,4,7,1240,420,1942,0,98177,47.7045,-122.379,3110,11853,9159,8743,60.07948978648674,0.07540983606557378,Very Cheap
20140917T000000,632500.0,5,3.25,3500,7254,2.0,0,0,3,8,2760,740,2005,0,98065,47.5444,-121.881,2820,6317,3754,3497,87.19327267714364,0.07311475409836066,Very Cheap
20140724T000000,269000.0,3,2.5,1440,3800,2.0,0,0,3,7,1440,0,2005,0,98038,47.3606,-122.039,1890,3819,2360,1929,70.78947368421052,0.02544262295081967,Very Cheap
20141125T000000,405000.0,4,2.75,2360,7716,1.0,0,0,3,7,1390,970,1978,0,98034,47.7301,-122.223,2160,8794,5356,6634,52.48833592534992,0.043278688524590166,Very Cheap
20140724T000000,845000.0,3,3.5,3460,15745,2.0,0,0,3,10,3460,0,1986,0,98077,47.7262,-122.06,3350,14825,12285,11475,53.667831057478566,0.10098360655737705,Cheap
20140725T000000,234000.0,3,1.0,1750,8820,1.0,0,0,4,7,1750,0,1961,0,98032,47.3608,-122.29,1400,9600,7070,8200,26.53061224489796,0.020852459016393442,Very Cheap
20150422T000000,638000.0,4,1.75,1470,4236,1.5,0,0,4,7,1470,0,1946,0,98107,47.6692,-122.399,1480,5400,2766,3920,150.6137865911237,0.0738360655737705,Very Cheap
20140804T000000,290000.0,3,1.75,1710,10950,1.0,0,0,3,7,1060,650,1967,0,98045,47.4678,-121.745,1180,10950,9240,9770,26.484018264840184,0.02819672131147541,Very Cheap
20150225T000000,262000.0,1,0.75,520,12981,1.0,0,0,5,3,520,0,1920,0,98022,47.2082,-121.995,1340,12233,12461,10893,20.18334488868346,0.024524590163934427,Very Cheap
20150218T000000,270000.0,4,2.5,2350,5835,2.0,0,0,3,8,2350,0,2003,0,98042,47.3494,-122.153,3010,5772,3485,2762,46.27249357326478,0.025573770491803278,Very Cheap
20141118T000000,875000.0,4,2.25,2380,4876,2.0,0,0,4,9,2240,140,1948,0,98117,47.6822,-122.4,1780,4559,2496,2779,179.4503691550451,0.10491803278688525,Cheap
20140717T000000,299000.0,3,2.25,1920,7840,2.0,0,0,4,8,1920,0,1982,0,98032,47.3631,-122.276,2170,7210,5920,5040,38.13775510204081,0.02937704918032787,Very Cheap
20150303T000000,551000.0,3,1.0,1580,6000,1.0,0,0,5,7,1580,0,1947,0,98027,47.5286,-122.032,1580,6000,4420,4420,91.83333333333333,0.06242622950819672,Very Cheap
20140916T000000,350000.0,3,2.75,3070,5280,2.0,0,1,3,7,2360,710,1950,1986,98166,47.4486,-122.353,2570,18983,2210,16413,66.28787878787878,0.036065573770491806,Very Cheap
20140604T000000,1901000.0,3,2.5,2660,13367,2.0,0,2,3,10,2660,0,1992,0,98004,47.6501,-122.217,2660,13367,10707,10707,142.21590484027828,0.23947540983606558,Cheap
20141027T000000,511718.0,2,1.75,1700,5000,1.0,0,0,3,6,850,850,1915,0,98117,47.6787,-122.363,1690,5000,3300,3310,102.3436,0.05727449180327869,Very Cheap
20141010T000000,965000.0,4,3.25,5010,49222,2.0,0,0,5,9,3710,1300,1978,0,98027,47.5489,-122.092,3140,54014,44212,50874,19.605054650359595,0.11672131147540983,Cheap
20141216T000000,475000.0,4,2.25,2680,4673,2.0,0,0,3,7,2680,0,1999,0,98011,47.7539,-122.219,2460,4645,1993,2185,101.64776374919752,0.05245901639344262,Very Cheap
20150415T000000,1062000.0,4,2.75,2720,4000,1.5,0,2,5,8,1840,880,1928,0,98117,47.6797,-122.359,1600,4000,1280,2400,265.5,0.12944262295081968,Cheap
20140715T000000,252000.0,2,1.0,940,15450,1.0,0,0,4,6,940,0,1926,0,98070,47.4408,-122.461,1370,34820,14510,33450,16.310679611650485,0.02321311475409836,Very Cheap
20150317T000000,580000.0,6,2.5,3596,13700,1.0,0,0,5,8,1798,1798,1964,0,98166,47.4388,-122.339,1894,10500,10104,8606,42.33576642335766,0.06622950819672131,Very Cheap
20141020T000000,374950.0,2,2.25,1240,1172,2.0,0,0,3,8,1000,240,2008,0,98144,47.5877,-122.316,1260,1111,-68,-149,319.92320819112626,0.03933770491803279,Very Cheap
20141216T000000,739000.0,5,4.0,4660,9900,2.0,0,2,4,9,2600,2060,1979,0,98056,47.5135,-122.2,3380,9900,5240,6520,74.64646464646465,0.08708196721311476,Very Cheap
20141217T000000,271000.0,4,1.75,1710,7200,1.0,0,0,5,7,910,800,1975,0,98031,47.3967,-122.174,1730,7200,5490,5470,37.638888888888886,0.025704918032786885,Very Cheap
20140613T000000,230000.0,2,1.0,930,7550,1.0,0,0,3,6,930,0,1986,0,98168,47.4866,-122.303,1370,10176,6620,8806,30.4635761589404,0.020327868852459016,Very Cheap
20150427T000000,210000.0,3,2.25,1430,9150,1.0,0,0,3,7,1070,360,1984,0,98023,47.3239,-122.35,1430,6364,7720,4934,22.950819672131146,0.017704918032786884,Very Cheap
20150224T000000,350000.0,3,2.75,1650,5700,2.0,0,0,4,7,1650,0,1988,0,98166,47.4563,-122.348,1320,7620,4050,6300,61.40350877192982,0.036065573770491806,Very Cheap
20150506T000000,491500.0,3,2.25,1560,12000,1.0,0,0,4,7,1110,450,1968,0,98034,47.7256,-122.166,2190,4612,10440,2422,40.958333333333336,0.05462295081967213,Very Cheap
20140909T000000,325000.0,3,2.5,1870,9825,1.0,0,0,4,7,1250,620,1994,0,98045,47.4639,-121.744,1380,11475,7955,10095,33.07888040712468,0.03278688524590164,Very Cheap
20141006T000000,190000.0,3,2.0,1320,7625,1.0,0,0,3,7,1320,0,1987,0,98038,47.3635,-122.045,1420,7500,6305,6080,24.918032786885245,0.015081967213114755,Very Cheap
20150504T000000,658600.0,4,2.0,1400,4690,1.5,0,0,4,7,1400,0,1945,0,98117,47.6826,-122.378,1400,4690,3290,3290,140.4264392324094,0.07653770491803279,Very Cheap
20150327T000000,299950.0,3,1.5,1940,8951,1.0,0,0,3,7,1300,640,1958,0,98168,47.473,-122.328,2000,8319,7011,6319,33.51022232152832,0.029501639344262295,Very Cheap
20150330T000000,464000.0,5,2.0,2000,3000,1.5,0,0,3,6,1200,800,1931,0,98122,47.6028,-122.298,1330,4000,1000,2670,154.66666666666666,0.05101639344262295,Very Cheap
20140625T000000,308000.0,3,1.0,1640,18144,1.5,0,0,3,6,1640,0,1942,0,98168,47.5027,-122.33,1500,9065,16504,7565,16.97530864197531,0.030557377049180327,Very Cheap
20150129T000000,625000.0,3,1.0,1020,7650,1.0,0,0,3,6,1020,0,1919,0,98033,47.6795,-122.202,1870,5500,6630,3630,81.69934640522875,0.07213114754098361,Very Cheap
20150205T000000,240000.0,3,1.75,1630,9450,1.0,0,0,4,7,1080,550,1977,0,98032,47.3729,-122.295,1280,9100,7820,7820,25.396825396825395,0.021639344262295083,Very Cheap
20150504T000000,530000.0,4,2.5,2940,35996,2.0,0,0,3,9,2940,0,1995,0,98042,47.3401,-122.067,2890,35089,33056,32199,14.723858206467385,0.05967213114754098,Very Cheap
20141020T000000,1000000.0,5,4.5,2120,8944,2.0,1,4,5,8,2120,0,1939,1963,98006,47.5488,-122.197,2870,8944,6824,6074,111.80679785330948,0.12131147540983607,Cheap
20140925T000000,439000.0,1,1.0,790,2400,1.0,0,0,3,7,790,0,1918,0,98122,47.6178,-122.299,1580,2566,1610,986,182.91666666666666,0.04773770491803279,Very Cheap
20150511T000000,575000.0,4,1.75,2020,6200,1.0,0,0,4,6,1010,1010,1948,0,98133,47.7013,-122.35,1440,4158,4180,2718,92.74193548387096,0.06557377049180328,Very Cheap
20141021T000000,418000.0,3,1.75,1530,7238,1.0,0,0,3,7,1530,0,1959,0,98155,47.7629,-122.315,1580,7238,5708,5658,57.75075987841945,0.04498360655737705,Very Cheap
20150428T000000,1208000.0,4,3.75,3250,10949,2.0,0,0,4,9,2940,310,1930,1989,98004,47.639,-122.219,2340,15234,7699,12894,110.32971047584255,0.14859016393442623,Cheap
20140603T000000,1100000.0,4,3.75,2930,3200,1.5,0,0,5,9,2130,800,1925,0,98119,47.643,-122.359,1900,4320,270,2420,343.75,0.13442622950819672,Cheap
20150415T000000,1900000.0,3,3.75,3150,8550,2.0,0,0,3,10,3150,0,2007,0,98112,47.6387,-122.284,2510,8550,5400,6040,222.22222222222223,0.23934426229508196,Cheap
20141126T000000,580000.0,3,2.5,2180,40278,2.0,0,0,3,9,2180,0,1985,0,98072,47.733,-122.09,2630,40000,38098,37370,14.39992055216247,0.06622950819672131,Very Cheap
20150311T000000,380000.0,2,1.0,1040,7372,1.0,0,0,5,7,840,200,1939,0,98126,47.5285,-122.378,1930,5150,6332,3220,51.54639175257732,0.04,Very Cheap
20140723T000000,256000.0,3,1.0,880,5375,1.0,0,0,4,5,880,0,1924,0,98055,47.4858,-122.202,980,4838,4495,3858,47.627906976744185,0.023737704918032787,Very Cheap
20140515T000000,349950.0,3,1.0,1400,7066,1.0,0,0,3,8,1400,0,1957,0,98125,47.7127,-122.325,1400,7320,5666,5920,49.525898669685816,0.036059016393442625,Very Cheap
20140701T000000,691500.0,4,2.5,2600,7200,2.0,0,0,3,7,2600,0,1962,2002,98115,47.6944,-122.274,1790,6175,4600,4385,96.04166666666667,0.08085245901639344,Very Cheap
20141031T000000,556000.0,3,1.75,1590,2500,1.5,0,0,4,7,1190,400,1908,0,98105,47.6668,-122.299,1420,3800,910,2380,222.4,0.06308196721311475,Very Cheap
20141120T000000,218000.0,3,2.25,1610,7084,1.0,0,0,4,8,1280,330,1968,0,98023,47.3146,-122.384,2170,8505,5474,6335,30.77357425183512,0.018754098360655738,Very Cheap
20141205T000000,425000.0,4,2.0,1390,4500,1.5,0,0,5,7,1390,0,1908,0,98108,47.5552,-122.311,1900,5460,3110,3560,94.44444444444444,0.04590163934426229,Very Cheap
20140822T000000,935000.0,3,3.25,3710,38509,2.0,0,0,3,10,3710,0,1998,0,98014,47.693,-121.868,1680,25865,34799,24185,24.280038432574205,0.11278688524590164,Cheap
20141007T000000,732000.0,4,1.75,2360,11300,1.0,0,0,4,9,2360,0,1974,0,98006,47.5728,-122.163,2290,11951,8940,9661,64.77876106194691,0.08616393442622951,Very Cheap
20150127T000000,805500.0,3,1.0,1440,10330,1.0,0,0,4,7,1440,0,1952,0,98004,47.6245,-122.193,2080,10327,8890,8247,77.97676669893514,0.09580327868852459,Very Cheap
20150204T000000,507250.0,3,1.75,1400,5750,1.0,0,2,3,6,1100,300,1915,0,98126,47.5659,-122.38,1500,5175,4350,3675,88.21739130434783,0.056688524590163936,Very Cheap
20141202T000000,800000.0,4,2.5,4600,67369,2.0,0,0,3,10,4600,0,1990,0,98053,47.6417,-121.992,4600,67369,62769,62769,11.874897950095741,0.09508196721311475,Very Cheap
20140903T000000,600000.0,3,2.25,2100,8276,2.0,0,1,4,8,2100,0,1979,0,98008,47.6068,-122.112,2420,18135,6176,15715,72.49879168680522,0.06885245901639345,Very Cheap
20150317T000000,627800.0,4,1.75,2010,12044,1.0,0,0,3,9,2010,0,1982,0,98074,47.6446,-122.068,2200,11144,10034,8944,52.12553968781136,0.0724983606557377,Very Cheap
20140624T000000,660000.0,2,2.25,2550,6000,2.0,0,0,5,7,1860,690,1902,0,98115,47.6739,-122.323,2010,4000,3450,1990,110.0,0.07672131147540984,Very Cheap
20141009T000000,153503.0,2,2.5,1240,3649,2.0,0,0,3,7,1240,0,1986,0,98003,47.3241,-122.322,1400,3721,2409,2321,42.06714168265278,0.010295475409836066,Very Cheap
20150120T000000,456500.0,3,2.25,2090,9163,1.0,0,0,3,7,1460,630,1975,0,98034,47.7334,-122.167,1960,7713,7073,5753,49.81992797118848,0.0500327868852459,Very Cheap
20140801T000000,1306000.0,5,2.5,2770,8100,2.0,0,0,3,9,2770,0,2002,0,98004,47.6341,-122.208,2070,8100,5330,6030,161.23456790123456,0.16144262295081968,Cheap
20141207T000000,843500.0,3,2.5,3560,11448,2.0,0,0,3,11,3560,0,1997,0,98052,47.7126,-122.104,3290,11506,7888,8216,73.68099231306779,0.10078688524590164,Cheap
20140818T000000,625000.0,3,1.0,1240,4080,1.0,0,0,3,7,1240,0,1925,0,98103,47.667,-122.333,2060,4080,2840,2020,153.18627450980392,0.07213114754098361,Very Cheap
20140611T000000,527000.0,2,1.75,1640,4080,1.0,0,0,3,7,840,800,1921,0,98105,47.6645,-122.326,1980,4080,2440,2100,129.16666666666666,0.059278688524590166,Very Cheap
20150226T000000,1965000.0,5,3.75,3940,13738,1.5,0,3,4,9,3940,0,1951,0,98004,47.6203,-122.212,2370,13320,9798,10950,143.03392051244722,0.24786885245901638,Cheap
20150326T000000,1003000.0,5,2.5,3150,50094,2.0,0,0,4,9,3150,0,1969,0,98005,47.6387,-122.177,3600,48787,46944,45187,20.022357967022,0.12170491803278688,Cheap
20150225T000000,855000.0,4,3.0,2550,5300,2.0,0,0,3,8,1720,830,1908,2013,98117,47.6786,-122.367,1590,4505,2750,2915,161.32075471698113,0.10229508196721311,Cheap
20140620T000000,725000.0,4,3.25,3940,27591,2.0,0,3,3,9,3440,500,2000,0,98059,47.5157,-122.116,3420,29170,23651,25750,26.27668442608097,0.08524590163934426,Very Cheap
20141015T000000,315000.0,1,1.0,580,7200,1.0,0,0,3,6,580,0,2000,0,98126,47.5249,-122.373,1360,7560,6620,6200,43.75,0.031475409836065574,Very Cheap
20140924T000000,180000.0,3,1.75,1330,16000,1.0,0,0,3,7,1330,0,1978,0,98001,47.28,-122.257,1330,14374,14670,13044,11.25,0.01377049180327869,Very Cheap
20150313T000000,700000.0,2,1.0,930,5000,1.0,0,3,3,7,930,0,1926,2013,98136,47.5333,-122.388,1760,5228,4070,3468,140.0,0.08196721311475409,Very Cheap
20140811T000000,476500.0,3,1.0,1060,8625,2.0,0,0,4,7,1060,0,1962,1997,98033,47.6615,-122.179,2010,8901,7565,6891,55.2463768115942,0.052655737704918035,Very Cheap
20140603T000000,193000.0,3,1.5,1180,9048,1.0,0,0,3,7,1180,0,1960,0,98148,47.4327,-122.328,1460,8942,7868,7482,21.330680813439436,0.015475409836065573,Very Cheap
20140819T000000,295000.0,4,2.5,1850,6663,2.0,0,0,3,7,1850,0,1990,0,98030,47.3618,-122.195,1850,6417,4813,4567,44.274350892991144,0.028852459016393443,Very Cheap
20140731T000000,363000.0,2,1.0,820,4880,1.0,0,0,4,6,820,0,1925,0,98136,47.5483,-122.394,1320,4880,4060,3560,74.38524590163935,0.03777049180327869,Very Cheap
20150129T000000,875000.0,4,2.5,3600,21794,2.0,0,0,4,11,3600,0,1990,0,98077,47.7121,-122.072,3410,19864,18194,16454,40.14866477012021,0.10491803278688525,Cheap
20140514T000000,257200.0,3,2.0,1850,8250,1.0,0,0,4,7,1150,700,1952,0,98002,47.3066,-122.209,1580,7153,6400,5573,31.175757575757576,0.023895081967213114,Very Cheap
20140929T000000,555000.0,3,2.0,2240,11250,1.0,0,0,3,8,2240,0,1968,0,98008,47.6371,-122.119,2200,12500,9010,10300,49.333333333333336,0.06295081967213115,Very Cheap
20140624T000000,380000.0,3,2.25,1860,15559,2.0,0,0,4,7,1860,0,1963,0,98022,47.1559,-121.646,1110,11586,13699,10476,24.423163442380616,0.04,Very Cheap
20140725T000000,282000.0,4,2.75,2390,7330,2.0,0,0,3,7,2390,0,1989,0,98023,47.3061,-122.359,1980,6735,4940,4755,38.47203274215553,0.02714754098360656,Very Cheap
20140606T000000,545000.0,4,2.5,2040,6034,2.0,0,0,3,7,2040,0,1990,0,98115,47.6952,-122.323,1380,5986,3994,4606,90.32151143520053,0.06163934426229508,Very Cheap
20140606T000000,550000.0,3,1.5,1900,5000,1.5,0,0,3,7,1640,260,1926,0,98115,47.6779,-122.294,2090,5000,3100,2910,110.0,0.06229508196721312,Very Cheap
20150313T000000,921500.0,3,1.5,1900,5000,1.5,0,0,3,7,1640,260,1926,0,98115,47.6779,-122.294,2090,5000,3100,2910,184.3,0.11101639344262296,Cheap
20150512T000000,885000.0,3,1.5,2200,2880,2.0,0,0,5,7,1440,760,1904,0,98112,47.6308,-122.312,2440,4640,680,2200,307.2916666666667,0.1062295081967213,Cheap
20140529T000000,820000.0,4,2.25,2280,6660,1.5,0,2,3,8,1960,320,1940,1984,98119,47.6503,-122.368,1720,5336,4380,3616,123.12312312312312,0.09770491803278689,Very Cheap
20140513T000000,289000.0,3,1.0,1090,7315,1.0,0,0,5,6,1090,0,1981,0,98056,47.494,-122.165,1090,5800,6225,4710,39.50786056049214,0.028065573770491802,Very Cheap
20150213T000000,334000.0,1,1.0,670,5750,1.0,0,0,3,7,670,0,1942,2011,98116,47.5624,-122.394,1170,5750,5080,4580,58.08695652173913,0.0339672131147541,Very Cheap
20141028T000000,206000.0,3,1.0,1050,5233,1.0,0,0,5,5,1050,0,1906,0,98010,47.3106,-121.999,970,7500,4183,6530,39.36556468564877,0.017180327868852457,Very Cheap
20140630T000000,491950.0,3,2.25,2090,10733,1.0,0,0,3,7,1440,650,1958,0,98115,47.6971,-122.281,1740,8100,8643,6360,45.83527438740334,0.05468196721311475,Very Cheap
20141113T000000,430000.0,3,2.5,2030,7770,2.0,0,0,3,8,2030,0,2003,0,98024,47.5253,-121.93,1360,10782,5740,9422,55.34105534105534,0.04655737704918033,Very Cheap
20140718T000000,208000.0,3,2.0,1250,7995,1.0,0,0,4,7,1250,0,1980,0,98042,47.3684,-122.092,1540,7650,6745,6110,26.016260162601625,0.01744262295081967,Very Cheap
20140708T000000,245000.0,4,2.25,2600,6390,1.0,0,0,3,8,1390,1210,1978,0,98023,47.3174,-122.366,2110,6700,3790,4590,38.341158059467915,0.022295081967213116,Very Cheap
20150318T000000,426000.0,2,1.0,640,2500,1.0,0,0,4,6,640,0,1918,0,98117,47.6776,-122.361,1460,4200,1860,2740,170.4,0.046032786885245904,Very Cheap
20140801T000000,400000.0,3,2.5,2120,3742,2.0,0,0,3,7,2120,0,2006,0,98059,47.4787,-122.129,2250,4696,1622,2446,106.89470871191877,0.04262295081967213,Very Cheap
20150414T000000,553000.0,3,1.0,1330,5100,1.0,0,0,3,7,900,430,1942,0,98115,47.6837,-122.291,1500,5100,3770,3600,108.43137254901961,0.06268852459016394,Very Cheap
20150331T000000,296000.0,2,1.0,750,4680,1.0,0,0,3,5,750,0,1948,0,98117,47.6919,-122.371,1450,4400,3930,2950,63.24786324786325,0.02898360655737705,Very Cheap
20150217T000000,428000.0,3,2.5,2230,32660,1.0,0,0,4,8,2230,0,1977,0,98042,47.3321,-122.105,2400,33120,30430,30720,13.104715248009798,0.04629508196721312,Very Cheap
20140506T000000,325000.0,4,2.5,1890,6156,1.0,0,0,3,7,980,910,1980,0,98106,47.551,-122.356,1590,6954,4266,5364,52.7940220922677,0.03278688524590164,Very Cheap
20140721T000000,294000.0,2,1.0,820,6366,1.0,0,0,5,6,820,0,1952,0,98133,47.7512,-122.34,1580,10169,5546,8589,46.182846371347786,0.028721311475409836,Very Cheap
20150319T000000,410000.0,3,1.75,1880,8424,1.0,0,0,4,7,1380,500,1977,0,98059,47.5116,-122.161,1970,8523,6544,6553,48.670465337132,0.043934426229508196,Very Cheap
20140603T000000,590000.0,4,4.25,2360,57514,2.0,0,0,4,8,2360,0,1939,1987,98003,47.2843,-122.294,2037,35733,55154,33696,10.258371874673992,0.06754098360655737,Very Cheap
20141120T000000,445000.0,3,2.25,1850,4050,2.0,0,0,4,7,1850,0,1985,0,98029,47.5669,-122.017,1650,4468,2200,2818,109.87654320987654,0.04852459016393443,Very Cheap
20150325T000000,921000.0,4,2.5,2310,5362,2.0,0,4,4,8,2010,300,1928,0,98122,47.6044,-122.284,2530,5960,3052,3430,171.76426706452816,0.11095081967213115,Cheap
20150304T000000,496000.0,3,1.5,2520,37616,1.0,0,0,3,8,2520,0,1955,0,98045,47.4777,-121.763,1470,33750,35096,32280,13.185878349638452,0.05521311475409836,Very Cheap
20141212T000000,95000.0,2,1.0,800,8550,1.0,0,0,3,7,800,0,1947,0,98198,47.4075,-122.294,1490,8550,7750,7060,11.11111111111111,0.002622950819672131,Very Cheap
20140925T000000,359000.0,4,1.75,1580,6396,1.0,0,0,4,6,790,790,1945,0,98126,47.5378,-122.369,1180,6396,4816,5216,56.12883051907442,0.03724590163934426,Very Cheap
20140502T000000,452500.0,3,2.5,2430,88426,1.0,0,0,4,7,1570,860,1985,0,98045,47.4828,-121.718,1560,56827,85996,55267,5.117273200189989,0.04950819672131147,Very Cheap
20141202T000000,555000.0,4,1.75,2350,6200,1.5,0,0,4,7,1410,940,1946,0,98116,47.559,-122.397,1800,6150,3850,4350,89.51612903225806,0.06295081967213115,Very Cheap
20140924T000000,549900.0,5,3.0,3800,42316,1.5,0,0,4,9,3800,0,1984,0,98042,47.3488,-122.095,2580,35775,38516,33195,12.995084601569147,0.062281967213114756,Very Cheap
20140610T000000,569000.0,5,3.0,3670,10583,1.0,0,0,5,8,2060,1610,1952,0,98155,47.7589,-122.277,2720,13865,6913,11145,53.765472928281206,0.06478688524590163,Very Cheap
20140716T000000,318500.0,4,2.0,1780,7350,1.0,0,0,5,7,900,880,1974,0,98058,47.4562,-122.158,1480,7350,5570,5870,43.333333333333336,0.0319344262295082,Very Cheap
20140611T000000,487028.0,2,1.5,1295,1093,2.0,0,0,3,9,1105,190,2007,0,98112,47.6192,-122.299,1295,1413,-202,118,445.5882891125343,0.054036459016393444,Very Cheap
20141015T000000,240000.0,3,1.0,1350,7560,1.0,0,0,4,7,950,400,1959,0,98032,47.3784,-122.303,1470,7560,6210,6090,31.746031746031747,0.021639344262295083,Very Cheap
20150202T000000,253000.0,3,2.25,1440,9806,1.0,0,0,3,7,1440,0,1965,0,98030,47.3857,-122.212,1590,9782,8366,8192,25.800530287579033,0.023344262295081967,Very Cheap
20140831T000000,380000.0,5,1.75,1320,38125,1.0,0,0,4,7,1120,200,1947,0,98198,47.3937,-122.323,2360,15070,36805,12710,9.967213114754099,0.04,Very Cheap
20150406T000000,250000.0,2,0.75,700,16828,1.0,0,0,4,6,700,0,1958,0,98092,47.3009,-122.125,2010,29316,16128,27306,14.856192060850963,0.022950819672131147,Very Cheap
20141010T000000,368500.0,2,1.75,2510,19141,2.0,0,0,3,9,2510,0,1977,0,98092,47.3103,-122.199,2400,13030,16631,10630,19.251867718510006,0.03849180327868852,Very Cheap
20150211T000000,340000.0,3,1.0,3180,27586,1.0,0,0,3,8,1400,1780,1969,0,98022,47.1986,-121.967,2180,27586,24406,25406,12.325092438193286,0.03475409836065574,Very Cheap
20150427T000000,400000.0,2,1.0,910,4000,1.0,0,0,3,7,910,0,1918,0,98136,47.5427,-122.388,1060,1346,3090,286,100.0,0.04262295081967213,Very Cheap
20140916T000000,835000.0,3,2.0,1570,4625,1.5,0,0,5,8,1570,0,1927,0,98117,47.68,-122.399,1760,4625,3055,2865,180.54054054054055,0.09967213114754099,Very Cheap
20141201T000000,299000.0,3,2.5,2450,7062,2.0,0,0,3,8,2450,0,1993,0,98023,47.3061,-122.36,1960,7200,4612,5240,42.33928065703767,0.02937704918032787,Very Cheap
20141107T000000,1675000.0,6,2.25,4910,6600,2.5,0,0,5,10,3580,1330,1910,0,98102,47.6458,-122.32,3280,5500,1690,2220,253.78787878787878,0.2098360655737705,Cheap
20140514T000000,265000.0,3,2.0,1570,5706,1.0,0,0,3,7,1570,0,1998,0,98092,47.3156,-122.188,1570,5706,4136,4136,46.44234139502278,0.024918032786885248,Very Cheap
20141111T000000,437500.0,4,2.5,2680,7513,2.0,0,0,3,8,2680,0,1998,0,98059,47.4956,-122.161,2640,7243,4833,4603,58.23239717822441,0.047540983606557376,Very Cheap
20140604T000000,865000.0,3,1.75,2090,4725,2.0,0,0,3,7,1610,480,1947,2013,98199,47.657,-122.394,1280,4725,2635,3445,183.06878306878306,0.10360655737704919,Cheap
20150311T000000,626000.0,3,2.0,2150,7200,1.0,0,0,3,8,2150,0,1988,0,98029,47.5709,-122.018,2510,7222,5050,4712,86.94444444444444,0.07226229508196721,Very Cheap
20141028T000000,247300.0,2,2.0,1140,1118,2.0,0,0,3,7,1040,100,2009,0,98144,47.596,-122.311,1140,1118,-22,-22,221.19856887298747,0.022596721311475408,Very Cheap
20140623T000000,2075000.0,4,3.5,4230,20377,2.0,0,0,3,11,4230,0,1997,0,98004,47.5954,-122.206,3980,20489,16147,16509,101.83049516611867,0.26229508196721313,Cheap
20141001T000000,425000.0,3,1.0,1790,6000,1.5,0,0,2,8,1790,0,1937,0,98108,47.5448,-122.32,1060,4000,4210,2940,70.83333333333333,0.04590163934426229,Very Cheap
20140625T000000,905000.0,5,3.5,3100,10200,1.0,0,4,3,9,1660,1440,1970,0,98008,47.6134,-122.112,2700,10455,7100,7755,88.72549019607843,0.10885245901639344,Cheap
20140827T000000,641250.0,3,2.5,2220,2550,3.0,0,2,3,10,2220,0,1990,0,98117,47.6963,-122.393,2200,5610,330,3410,251.47058823529412,0.07426229508196722,Very Cheap
20150331T000000,675000.0,4,2.5,2370,9679,2.0,0,0,3,8,2370,0,1984,0,98027,47.5631,-122.085,2290,7944,7309,5654,69.73860936047112,0.07868852459016394,Very Cheap
20140613T000000,845000.0,4,2.75,4070,115434,2.0,0,0,3,9,4070,0,2002,0,98045,47.4843,-121.752,2970,95832,111364,92862,7.320200287610236,0.10098360655737705,Cheap
20140907T000000,401500.0,4,1.0,1790,8400,1.0,0,0,4,7,1260,530,1954,0,98133,47.7627,-122.353,1470,8400,6610,6930,47.79761904761905,0.04281967213114754,Very Cheap
20140923T000000,395000.0,3,2.5,1610,3755,2.0,0,0,3,7,1610,0,1987,0,98052,47.6825,-122.097,1300,3823,2145,2523,105.1930758988016,0.0419672131147541,Very Cheap
20150306T000000,1100000.0,5,2.75,2830,18050,1.0,0,0,5,7,1630,1200,1958,0,98040,47.5773,-122.226,2370,14250,15220,11880,60.94182825484764,0.13442622950819672,Cheap
20140529T000000,145000.0,3,1.0,1010,5490,1.0,0,0,3,6,1010,0,1954,0,98168,47.4762,-122.293,1740,10658,4480,8918,26.41165755919854,0.009180327868852459,Very Cheap
20150416T000000,900000.0,3,1.0,1560,3825,1.5,0,0,3,8,1390,170,1930,0,98117,47.6803,-122.387,1700,5100,2265,3400,235.2941176470588,0.10819672131147541,Cheap
20150112T000000,374500.0,3,1.5,1330,8636,1.0,0,0,4,7,1330,0,1968,0,98034,47.7289,-122.203,1370,7475,7306,6105,43.36498378879111,0.03927868852459016,Very Cheap
20141118T000000,850000.0,4,2.25,2330,10451,2.0,0,0,4,8,2330,0,1965,0,98005,47.6044,-122.168,1880,8400,8121,6520,81.33192995885561,0.10163934426229508,Cheap
20150425T000000,490000.0,3,1.0,960,5750,1.0,0,0,3,7,960,0,1951,0,98116,47.5689,-122.393,1520,5750,4790,4230,85.21739130434783,0.05442622950819672,Very Cheap
20150427T000000,304000.0,3,2.5,1710,6773,2.0,0,0,3,8,1710,0,1993,0,98003,47.2635,-122.312,2220,7551,5063,5331,44.88409862690093,0.030032786885245903,Very Cheap
20140703T000000,400000.0,4,2.25,2230,7200,1.0,0,0,4,7,1300,930,1963,0,98133,47.7648,-122.33,2010,7752,4970,5742,55.55555555555556,0.04262295081967213,Very Cheap
20141114T000000,454000.0,3,2.0,1700,10000,2.0,0,0,3,8,1700,0,1992,0,98011,47.7661,-122.205,1460,9621,8300,8161,45.4,0.049704918032786885,Very Cheap
20141224T000000,160000.0,2,2.0,1040,4750,1.0,0,0,2,6,850,190,1950,0,98118,47.5293,-122.272,1350,5000,3710,3650,33.68421052631579,0.011147540983606558,Very Cheap
20140708T000000,542000.0,3,1.75,1070,8030,1.0,0,0,3,7,1070,0,1966,2014,98052,47.67,-122.155,1540,7875,6960,6335,67.49688667496886,0.06124590163934426,Very Cheap
20140618T000000,403500.0,5,2.5,3600,17300,1.0,0,0,4,8,2410,1190,1968,0,98166,47.4468,-122.341,2620,30200,13700,27580,23.32369942196532,0.043081967213114754,Very Cheap
20150316T000000,418000.0,4,2.5,2750,8471,2.0,0,0,3,7,2750,0,2003,0,98038,47.3671,-122.029,2610,7482,5721,4872,49.34482351552355,0.04498360655737705,Very Cheap
20150326T000000,406000.0,4,1.5,1920,6000,2.0,0,1,3,7,1920,0,1951,0,98198,47.4029,-122.321,1920,6000,4080,4080,67.66666666666667,0.04340983606557377,Very Cheap
20140923T000000,242500.0,3,2.25,1770,10000,1.0,0,0,3,7,1340,430,1978,0,98198,47.3814,-122.322,1270,5055,8230,3785,24.25,0.021967213114754098,Very Cheap
20150407T000000,425000.0,4,2.5,2460,5440,2.0,0,0,3,9,2460,0,2003,0,98058,47.448,-122.121,2460,5124,2980,2664,78.125,0.04590163934426229,Very Cheap
20140515T000000,613000.0,4,2.0,1550,4815,1.5,0,0,3,7,1550,0,1909,0,98103,47.667,-122.336,1680,4013,3265,2333,127.3104880581516,0.07055737704918033,Very Cheap
20141230T000000,189000.0,3,2.0,1460,11481,1.0,0,0,2,7,1170,290,1995,0,98045,47.4493,-121.777,1540,9680,10021,8140,16.46198066370525,0.014950819672131148,Very Cheap
20141030T000000,700000.0,4,2.25,2440,9450,1.5,0,0,3,7,2440,0,1947,2014,98125,47.7061,-122.307,1720,7503,7010,5783,74.07407407407408,0.08196721311475409,Very Cheap
20140902T000000,750000.0,3,1.0,1640,6516,1.5,0,0,4,7,1440,200,1935,0,98103,47.6693,-122.339,1770,4000,4876,2230,115.1012891344383,0.08852459016393442,Very Cheap
20140707T000000,494000.0,2,1.0,1290,4650,1.0,0,0,4,7,1290,0,1906,0,98115,47.6877,-122.325,1640,3900,3360,2260,106.23655913978494,0.05495081967213115,Very Cheap
20140609T000000,700000.0,4,3.0,3150,7778,2.0,0,0,3,9,3150,0,2000,0,98075,47.5972,-122.018,2970,6500,4628,3530,89.99742864489586,0.08196721311475409,Very Cheap
20150403T000000,705000.0,2,2.5,2305,5580,1.0,0,0,3,8,2305,0,2007,0,98077,47.7203,-122.024,1440,5748,3275,4308,126.34408602150538,0.08262295081967214,Very Cheap
20140522T000000,356000.0,2,1.75,1060,16470,1.0,0,0,3,7,1060,0,1977,0,98072,47.7409,-122.089,1790,16748,15410,14958,21.615057680631452,0.03685245901639344,Very Cheap
20140522T000000,625000.0,3,1.75,2060,12558,1.0,0,0,4,7,1350,710,1984,0,98052,47.6659,-122.144,1850,8722,10498,6872,49.76907150820194,0.07213114754098361,Very Cheap
20150312T000000,144975.0,2,1.0,900,7500,1.0,0,0,3,5,900,0,1940,0,98198,47.4177,-122.319,1350,7500,6600,6150,19.33,0.009177049180327869,Very Cheap
20140728T000000,970000.0,4,4.5,3890,5906,2.0,0,3,3,11,3060,830,2004,0,98029,47.5426,-121.995,4170,6052,2016,1882,164.23975618015578,0.11737704918032787,Cheap
20140606T000000,415000.0,3,1.75,1910,12596,1.0,0,0,3,7,1340,570,1977,0,98072,47.7399,-122.099,1550,13310,10686,11760,32.946967291203556,0.04459016393442623,Very Cheap
20140505T000000,485000.0,4,3.0,2340,7048,1.0,0,0,4,8,1340,1000,1979,0,98034,47.7306,-122.227,1440,8088,4708,6648,68.8138479001135,0.05377049180327869,Very Cheap
20141107T000000,799950.0,3,3.0,2900,11769,2.0,0,0,3,10,2900,0,1997,0,98052,47.6993,-122.118,2900,9611,8869,6711,67.97094060667857,0.09507540983606558,Very Cheap
20150429T000000,783350.0,4,2.5,3290,35001,2.0,0,0,3,10,3290,0,1991,0,98077,47.7231,-122.038,4090,40371,31711,36281,22.380789120310848,0.0928983606557377,Very Cheap
20141219T000000,430000.0,1,1.0,630,1362,1.0,0,0,3,7,630,0,1943,0,98109,47.6342,-122.342,1090,1376,732,286,315.712187958884,0.04655737704918033,Very Cheap
20141124T000000,2544750.0,5,4.75,5410,13431,2.0,0,0,4,10,5050,360,1941,0,98112,47.6306,-122.288,3750,11596,8021,7846,189.46839401384855,0.3239016393442623,Medium
20140618T000000,975000.0,4,2.5,4270,43386,1.0,0,0,3,10,2680,1590,1991,0,98053,47.6915,-122.053,3630,36180,39116,32550,22.47268704190292,0.1180327868852459,Cheap
20150505T000000,950000.0,3,1.5,1700,8050,1.0,0,0,3,7,1130,570,1950,0,98004,47.6304,-122.218,2920,12239,6350,9319,118.01242236024845,0.11475409836065574,Cheap
20140806T000000,350000.0,2,1.0,1430,8157,1.5,0,0,3,7,1150,280,1944,0,98177,47.7256,-122.361,1820,8157,6727,6337,42.907931837685425,0.036065573770491806,Very Cheap
20141103T000000,637000.0,4,2.75,2850,7510,2.0,0,0,3,8,2850,0,2008,0,98125,47.7097,-122.305,1510,8833,4660,7323,84.8202396804261,0.07370491803278688,Very Cheap
20150219T000000,895000.0,3,2.0,2160,105415,1.0,0,0,3,10,2160,0,1991,0,98059,47.4806,-122.152,2760,9620,103255,6860,8.490252810321111,0.10754098360655738,Cheap
20141205T000000,579000.0,2,2.0,1760,7200,1.0,0,0,5,7,880,880,1946,0,98118,47.5658,-122.276,1760,7200,5440,5440,80.41666666666667,0.06609836065573771,Very Cheap
20140624T000000,314900.0,4,1.75,2700,27072,1.0,0,0,3,7,1380,1320,1958,0,98003,47.2877,-122.293,2460,34850,24372,32390,11.631944444444445,0.03146229508196721,Very Cheap
20150127T000000,122000.0,2,1.0,860,6000,1.0,0,0,3,6,860,0,1945,0,98022,47.2109,-121.985,1300,6000,5140,4700,20.333333333333332,0.0061639344262295085,Very Cheap
20140808T000000,405000.0,2,1.0,880,3000,1.0,0,0,5,7,880,0,1927,0,98103,47.6868,-122.349,1300,3000,2120,1700,135.0,0.043278688524590166,Very Cheap
20140508T000000,553650.0,2,2.5,1360,1349,2.0,0,0,3,8,1050,310,1997,0,98112,47.6254,-122.292,1430,4400,-11,2970,410.41512231282434,0.06277377049180329,Very Cheap
20150203T000000,369900.0,2,2.5,1770,1853,3.0,0,0,3,8,1770,0,2007,0,98126,47.5472,-122.371,1770,1924,83,154,199.62223421478683,0.03867540983606557,Very Cheap
20140528T000000,225000.0,3,2.0,2030,24829,1.0,0,0,4,7,1220,810,1979,0,98001,47.2718,-122.291,1980,15204,22799,13224,9.061983970357243,0.019672131147540985,Very Cheap
20140527T000000,160000.0,2,1.0,1180,9350,1.0,0,0,3,6,1180,0,1918,0,98178,47.4889,-122.259,1780,9306,8170,7526,17.112299465240643,0.011147540983606558,Very Cheap
20141009T000000,449500.0,4,2.0,2430,199940,1.0,0,0,3,8,1310,1120,1961,0,98038,47.4116,-122.029,2220,150282,197510,148062,2.2481744523357006,0.049114754098360656,Very Cheap
20140828T000000,650000.0,3,1.0,1300,8266,1.0,0,0,4,7,1300,0,1953,0,98004,47.6337,-122.199,1300,8707,6966,7407,78.6353738204694,0.07540983606557378,Very Cheap
20140716T000000,542126.0,4,2.5,2360,43088,2.0,0,0,3,8,2360,0,1977,0,98077,47.7661,-122.071,2850,39216,40728,36366,12.581832528778314,0.0612624262295082,Very Cheap
20140919T000000,309950.0,3,1.5,1200,15606,1.0,0,0,3,7,1200,0,1985,0,98045,47.4752,-121.755,1210,15606,14406,14396,19.860950916314238,0.03081311475409836,Very Cheap
20141205T000000,115000.0,2,1.0,1000,16524,1.0,0,0,3,5,1000,0,1913,0,98001,47.2841,-122.255,1350,10208,15524,8858,6.959573953038006,0.005245901639344262,Very Cheap
20141231T000000,221700.0,2,1.5,1556,20000,1.0,0,0,4,7,1556,0,1957,0,98032,47.3891,-122.282,2250,17286,18444,15036,11.085,0.019239344262295083,Very Cheap
20150127T000000,726000.0,3,2.5,1890,3880,1.5,0,0,4,8,1460,430,1915,0,98107,47.6642,-122.362,1010,3880,1990,2870,187.11340206185568,0.08537704918032787,Very Cheap
20141119T000000,515000.0,3,1.75,1810,5733,1.0,0,0,4,7,1010,800,1926,0,98116,47.5709,-122.388,1260,4680,3923,3420,89.83080411651841,0.057704918032786885,Very Cheap
20140826T000000,756000.0,4,2.5,2730,10753,2.0,0,0,3,9,2730,0,1991,0,98006,47.5414,-122.133,3090,10740,8023,7650,70.30596112712732,0.08931147540983607,Very Cheap
20140527T000000,1570000.0,4,3.75,3070,5850,2.0,0,0,5,9,2400,670,1927,0,98112,47.633,-122.283,2940,5573,2780,2633,268.37606837606836,0.1960655737704918,Cheap
20140521T000000,442000.0,4,2.25,2080,12007,1.0,0,0,4,8,1220,860,1979,0,98074,47.6259,-122.051,2110,12459,9927,10349,36.81185974848005,0.048131147540983604,Very Cheap
20140702T000000,260000.0,4,2.0,1620,7992,2.0,0,0,4,7,1620,0,1975,0,98031,47.395,-122.176,1710,7500,6372,5790,32.532532532532535,0.024262295081967214,Very Cheap
20140910T000000,390000.0,2,1.75,1150,2723,1.0,0,0,4,7,770,380,1923,0,98102,47.6357,-122.322,1440,4000,1573,2560,143.2243848696291,0.04131147540983607,Very Cheap
20140701T000000,459500.0,2,1.0,1250,3825,1.0,0,0,3,7,850,400,1929,0,98117,47.6805,-122.38,1370,4998,2575,3628,120.13071895424837,0.050426229508196724,Very Cheap
20140930T000000,330000.0,3,1.5,1430,8000,1.0,0,0,5,7,1430,0,1948,0,98155,47.772,-122.322,1410,9820,6570,8410,41.25,0.03344262295081967,Very Cheap
20141103T000000,189000.0,2,1.0,790,7128,1.0,0,0,3,6,790,0,1944,0,98168,47.4873,-122.324,1110,7150,6338,6040,26.515151515151516,0.014950819672131148,Very Cheap
20141211T000000,280000.0,3,1.0,1200,9322,1.5,0,0,4,7,1200,0,1954,0,98030,47.3749,-122.225,1540,9677,8122,8137,30.03647285990131,0.026885245901639345,Very Cheap
20140505T000000,400000.0,2,1.75,2110,9519,1.0,0,0,2,7,2110,0,1948,0,98155,47.7504,-122.306,1480,9519,7409,8039,42.02122071646181,0.04262295081967213,Very Cheap
20150325T000000,368000.0,4,2.0,3160,11193,1.0,0,0,5,6,2410,750,1942,0,98056,47.4937,-122.184,1020,5940,8033,4920,32.87769141427678,0.03842622950819672,Very Cheap
20140609T000000,390000.0,4,1.75,2700,7875,1.5,0,0,4,8,2700,0,1968,0,98058,47.454,-122.144,2220,7875,5175,5655,49.523809523809526,0.04131147540983607,Very Cheap
20140930T000000,245000.0,2,1.0,820,7475,1.0,0,0,3,6,820,0,1945,0,98133,47.7321,-122.341,1030,5720,6655,4690,32.77591973244147,0.022295081967213116,Very Cheap
20140806T000000,375000.0,4,2.5,1800,8432,1.0,0,0,4,7,1200,600,1960,0,98133,47.7463,-122.336,1780,8432,6632,6652,44.47343453510437,0.03934426229508197,Very Cheap
20150130T000000,465000.0,5,1.5,1750,12491,1.0,0,0,3,6,1390,360,1961,0,98033,47.6995,-122.174,1560,12473,10741,10913,37.22680329837483,0.051147540983606556,Very Cheap
20150312T000000,445000.0,3,2.0,1540,67953,1.0,0,0,3,7,1540,0,1997,0,98059,47.5018,-122.126,1250,9100,66413,7850,6.54864391564758,0.04852459016393443,Very Cheap
20150305T000000,250000.0,3,1.0,1130,7800,1.0,0,0,3,7,1130,0,1952,0,98118,47.5239,-122.288,1170,7800,6670,6630,32.05128205128205,0.022950819672131147,Very Cheap
20141003T000000,475500.0,3,1.0,1500,9416,1.0,0,0,4,8,1500,0,1952,0,98133,47.7135,-122.332,1440,7200,7916,5760,50.499150382327954,0.052524590163934425,Very Cheap
20140804T000000,672324.0,2,1.75,1600,5795,1.5,0,0,3,8,1600,0,1940,0,98105,47.6709,-122.276,2310,6301,4195,3991,116.01794650560828,0.0783375737704918,Very Cheap
20140623T000000,420000.0,3,2.0,1200,5029,1.0,0,0,3,6,880,320,1937,0,98115,47.6936,-122.294,1510,5854,3829,4344,83.5156094651024,0.04524590163934426,Very Cheap
20141229T000000,515000.0,3,2.0,1690,5100,1.5,0,0,5,7,1690,0,1907,0,98117,47.6801,-122.38,1690,5100,3410,3410,100.98039215686275,0.057704918032786885,Very Cheap
20141105T000000,732350.0,4,2.5,2270,7665,2.0,0,0,3,9,2270,0,1986,0,98052,47.6612,-122.148,2450,8706,5395,6256,95.54468362687541,0.08620983606557377,Very Cheap
20140605T000000,297500.0,4,2.5,1910,5000,2.0,0,0,3,7,1910,0,2005,0,98038,47.3608,-122.036,2020,5000,3090,2980,59.5,0.029180327868852458,Very Cheap
20141008T000000,475000.0,3,1.5,1640,2720,1.5,0,0,3,8,1640,0,1929,0,98115,47.6869,-122.317,1490,4375,1080,2885,174.63235294117646,0.05245901639344262,Very Cheap
20150505T000000,414000.0,4,2.5,2120,6497,2.0,0,0,3,7,2120,0,2003,0,98019,47.7241,-121.957,2230,6300,4377,4070,63.72171771586886,0.04445901639344262,Very Cheap
20140626T000000,357250.0,3,1.5,1400,8840,1.0,0,0,4,6,1400,0,1952,0,98125,47.7273,-122.309,1260,8840,7440,7580,40.41289592760181,0.037016393442622954,Very Cheap
20141030T000000,289950.0,2,1.0,760,6000,1.0,0,0,4,6,760,0,1950,0,98133,47.7168,-122.34,950,6000,5240,5050,48.325,0.028190163934426228,Very Cheap
20150505T000000,550000.0,3,1.0,1070,3713,1.0,0,0,4,6,1070,0,1917,0,98118,47.5683,-122.285,1290,3960,2643,2670,148.12819822246163,0.06229508196721312,Very Cheap
20150423T000000,446000.0,3,1.75,1460,9998,1.0,0,0,3,7,960,500,1958,0,98028,47.7434,-122.242,1460,9998,8538,8538,44.60892178435687,0.04865573770491803,Very Cheap
20141015T000000,279000.0,3,1.5,1280,16738,1.5,0,0,4,5,1280,0,1932,0,98038,47.3895,-122.023,1590,16317,15458,14727,16.66865814314733,0.02675409836065574,Very Cheap
20140821T000000,370000.0,3,2.25,1650,4859,2.0,0,0,3,7,1650,0,1988,0,98011,47.7729,-122.172,1890,5018,3209,3128,76.14735542292652,0.038688524590163934,Very Cheap
20141017T000000,216000.0,3,2.0,1260,4125,1.0,0,0,3,6,1260,0,1998,0,98188,47.4401,-122.279,1300,9091,2865,7791,52.36363636363637,0.018491803278688525,Very Cheap
20140621T000000,1100000.0,3,2.5,2200,20000,1.0,0,1,3,7,1400,800,1952,0,98004,47.5809,-122.191,3050,11775,17800,8725,55.0,0.13442622950819672,Cheap
20141020T000000,1280600.0,4,2.5,3560,15450,1.0,0,1,5,8,2060,1500,1977,0,98040,47.5657,-122.23,3680,17314,11890,13634,82.88673139158576,0.15811147540983606,Cheap
20150217T000000,355000.0,2,1.5,1140,2500,1.0,0,1,3,7,630,510,1988,0,98106,47.5707,-122.359,1500,5000,1360,3500,142.0,0.036721311475409836,Very Cheap
20140911T000000,699000.0,4,2.5,2550,7312,2.0,0,0,3,9,2550,0,1988,0,98008,47.6441,-122.113,2330,7480,4762,5150,95.59628008752735,0.08183606557377049,Very Cheap
20140902T000000,412000.0,3,2.5,1553,1991,3.0,0,0,3,8,1553,0,2014,0,98133,47.7049,-122.34,1509,2431,438,922,206.93119035660473,0.04419672131147541,Very Cheap
20150205T000000,276000.0,2,1.0,1140,7200,1.0,0,0,3,6,1140,0,1923,1951,98065,47.5265,-121.823,1110,7200,6060,6090,38.333333333333336,0.026360655737704918,Very Cheap
20140904T000000,100000.0,2,1.0,790,6426,1.0,0,0,3,6,790,0,1944,0,98178,47.4933,-122.245,1380,6946,5636,5566,15.56178026766262,0.003278688524590164,Very Cheap
20140701T000000,955500.0,4,1.75,2130,5080,1.5,0,0,3,8,2130,0,1914,1993,98119,47.6427,-122.363,1900,5080,2950,3180,188.09055118110237,0.11547540983606558,Cheap
20150329T000000,199000.0,3,1.0,1390,21262,1.0,0,0,3,7,1390,0,1958,0,98058,47.4454,-122.185,1560,10800,19872,9240,9.359420562505878,0.016262295081967214,Very Cheap
20140625T000000,762000.0,4,3.5,4000,15253,2.0,0,0,3,9,4000,0,2007,0,98065,47.5433,-121.887,3550,8747,11253,5197,49.95738543237396,0.0900983606557377,Very Cheap
20140506T000000,425000.0,4,2.0,1520,7983,1.0,0,0,5,7,1520,0,1967,0,98034,47.7357,-122.193,1520,7783,6463,6263,53.238131028435426,0.04590163934426229,Very Cheap
20141104T000000,546000.0,2,1.0,1657,5031,2.0,0,0,3,7,1657,0,1910,0,98116,47.5699,-122.389,2050,6201,3374,4151,108.52713178294573,0.06177049180327869,Very Cheap
20150420T000000,419600.0,3,1.75,1680,8460,1.0,0,0,3,7,1180,500,1976,0,98133,47.7554,-122.353,1890,9529,6780,7639,49.59810874704492,0.045193442622950816,Very Cheap
20140623T000000,735000.0,4,2.25,2270,5102,1.0,0,0,5,8,1340,930,1954,0,98199,47.6528,-122.408,1800,5102,2832,3302,144.06115248921992,0.08655737704918033,Very Cheap
20150422T000000,1234570.0,2,2.5,2470,609,3.0,0,0,3,11,1910,560,2011,0,98112,47.6182,-122.312,2440,1229,-1861,-1211,2027.208538587849,0.15207475409836066,Cheap
20140707T000000,445000.0,2,2.0,1240,2500,2.0,0,0,3,7,1240,0,1985,0,98117,47.6793,-122.395,1660,5000,1260,3340,178.0,0.04852459016393443,Very Cheap
20150106T000000,665000.0,3,2.0,1740,41275,1.0,0,0,3,8,1740,0,1974,1989,98045,47.4914,-121.763,2630,41275,39535,38645,16.1114476075106,0.07737704918032787,Very Cheap
20150317T000000,1290000.0,5,3.5,4090,290980,1.0,0,0,3,11,2920,1170,2002,0,98034,47.7161,-122.219,1880,9255,286890,7375,4.43329438449378,0.15934426229508197,Cheap
20141208T000000,508500.0,4,2.75,2520,12500,2.0,0,0,3,8,1720,800,1979,0,98074,47.6225,-122.064,2520,13000,9980,10480,40.68,0.05685245901639344,Very Cheap
20141210T000000,345950.0,5,1.0,1340,11198,1.5,0,0,3,8,1340,0,1934,0,98155,47.736,-122.295,1390,8020,9858,6630,30.893909626719058,0.0355344262295082,Very Cheap
20150113T000000,207500.0,3,1.0,1640,9750,1.0,0,0,3,7,1640,0,1968,0,98042,47.3256,-122.141,1200,9750,8110,8550,21.28205128205128,0.01737704918032787,Very Cheap
20141204T000000,1075000.0,4,2.5,3000,10920,1.0,0,0,4,8,1550,1450,1969,0,98040,47.5347,-122.227,2380,10920,7920,8540,98.44322344322345,0.13114754098360656,Cheap
20141110T000000,640000.0,3,1.0,1210,3720,2.0,0,0,4,8,1210,0,1930,0,98112,47.6317,-122.301,1560,6000,2510,4440,172.04301075268816,0.0740983606557377,Very Cheap
20150323T000000,329500.0,3,1.0,1810,13068,1.0,0,0,4,7,1360,450,1941,0,98070,47.4482,-122.462,1400,13068,11258,11668,25.214263850627486,0.03337704918032787,Very Cheap
20141021T000000,460000.0,4,2.75,2200,9676,1.0,0,0,3,8,1500,700,1979,0,98028,47.7713,-122.259,2120,9585,7476,7465,47.54030591153369,0.050491803278688525,Very Cheap
20140630T000000,1230000.0,3,1.75,2200,14630,1.5,0,1,3,8,2200,0,1948,2003,98004,47.6074,-122.213,2850,15803,12430,12953,84.07382091592618,0.15147540983606558,Cheap
20141120T000000,805000.0,5,3.0,2350,6480,2.0,0,3,4,7,1650,700,1924,1962,98118,47.558,-122.266,1840,7200,4130,5360,124.22839506172839,0.09573770491803278,Very Cheap
20141218T000000,200000.0,3,1.5,1090,10454,1.0,0,0,3,6,1090,0,1963,0,98042,47.3425,-122.082,1230,12196,9364,10966,19.13143294432753,0.01639344262295082,Very Cheap
20150217T000000,749700.0,3,1.75,2280,77972,1.0,0,0,3,8,1460,820,1977,0,98059,47.4804,-122.151,2460,14430,75692,11970,9.614989996408967,0.08848524590163935,Very Cheap
20140805T000000,288000.0,0,1.5,1430,1650,3.0,0,0,3,7,1430,0,1999,0,98125,47.7222,-122.29,1430,1650,220,220,174.54545454545453,0.027934426229508195,Very Cheap
20141215T000000,535000.0,2,1.0,1520,3360,1.0,0,0,4,7,830,690,1927,0,98117,47.6815,-122.382,1470,3774,1840,2304,159.22619047619048,0.06032786885245902,Very Cheap
20141028T000000,330000.0,3,2.25,1620,7150,1.0,0,2,4,7,1280,340,1950,0,98178,47.5048,-122.241,1620,6930,5530,5310,46.15384615384615,0.03344262295081967,Very Cheap
20140730T000000,479200.0,3,2.0,1510,3750,1.5,0,0,4,7,1510,0,1928,0,98116,47.5737,-122.383,1500,5000,2240,3500,127.78666666666666,0.05300983606557377,Very Cheap
20140513T000000,373000.0,5,2.5,3001,5710,2.0,0,0,3,8,3001,0,2006,0,98042,47.3727,-122.177,2340,5980,2709,3640,65.32399299474606,0.03908196721311476,Very Cheap
20150319T000000,355000.0,4,1.5,2020,6000,1.0,0,0,4,7,1010,1010,1953,0,98178,47.5019,-122.235,1710,6000,3980,4290,59.166666666666664,0.036721311475409836,Very Cheap
20140602T000000,275000.0,3,2.0,1380,4500,1.0,0,0,3,7,1380,0,2008,0,98038,47.3661,-122.021,1620,4000,3120,2380,61.111111111111114,0.02622950819672131,Very Cheap
20140620T000000,380000.0,3,1.5,1520,4288,1.0,0,0,3,7,1020,500,1949,0,98136,47.5284,-122.387,1660,4288,2768,2628,88.61940298507463,0.04,Very Cheap
20150209T000000,417000.0,2,1.75,1090,4590,1.0,0,0,4,7,790,300,1915,0,98105,47.6677,-122.324,1390,4080,3500,2690,90.84967320261438,0.04485245901639344,Very Cheap
20141021T000000,1165000.0,5,3.75,4220,15959,2.0,0,0,3,11,4220,0,2004,0,98075,47.5869,-121.967,4630,16531,11739,11901,72.99956137602607,0.14295081967213114,Cheap
20140926T000000,598500.0,3,2.25,2520,12000,1.0,0,0,3,10,2520,0,1978,0,98074,47.6381,-122.062,2510,12000,9480,9490,49.875,0.06865573770491804,Very Cheap
20140602T000000,629000.0,3,2.0,1760,5000,1.0,0,0,5,7,960,800,1920,0,98199,47.6408,-122.403,1380,5000,3240,3620,125.8,0.07265573770491804,Very Cheap
20141009T000000,226950.0,2,1.0,930,6600,1.0,0,0,3,6,930,0,1957,0,98168,47.4868,-122.33,1250,6600,5670,5350,34.38636363636363,0.019927868852459018,Very Cheap
20141231T000000,1225000.0,4,2.5,2600,11542,1.5,0,0,4,9,2200,400,1939,0,98177,47.7076,-122.377,2840,10960,8942,8120,106.13411887021313,0.15081967213114755,Cheap
20150203T000000,415000.0,3,2.25,2180,11100,1.0,0,0,5,8,1700,480,1979,0,98056,47.5162,-122.176,2350,11397,8920,9047,37.387387387387385,0.04459016393442623,Very Cheap
20150422T000000,595000.0,3,2.5,1910,3075,2.0,0,0,3,8,1910,0,2001,0,98029,47.5491,-122.005,1940,3485,1165,1545,193.4959349593496,0.06819672131147542,Very Cheap
20141028T000000,209950.0,3,1.75,1100,5525,1.0,0,0,5,6,1100,0,1968,0,98042,47.3625,-122.084,1050,5200,4425,4150,38.0,0.017698360655737704,Very Cheap
20150507T000000,568000.0,3,1.75,1760,235224,1.0,0,0,3,7,1760,0,1973,0,98053,47.6735,-122.041,2320,87120,233464,84800,2.414719586436758,0.06465573770491803,Very Cheap
20141021T000000,119900.0,2,1.0,700,3180,1.0,0,0,3,6,480,220,1951,0,98178,47.4976,-122.262,1760,6360,2480,4600,37.704402515723274,0.005888524590163934,Very Cheap
20140826T000000,207000.0,3,1.0,1080,10200,1.0,0,0,4,7,1080,0,1962,0,98023,47.3215,-122.351,1230,10400,9120,9170,20.294117647058822,0.017311475409836064,Very Cheap
20141215T000000,195000.0,3,1.0,1070,22489,1.0,0,0,3,7,1070,0,1967,0,98001,47.3278,-122.262,1880,20250,21419,18370,8.670905776157232,0.015737704918032787,Very Cheap
20140624T000000,324950.0,3,1.5,1460,8710,1.0,0,0,3,7,1460,0,1955,0,98166,47.4561,-122.357,1400,8645,7250,7245,37.30769230769231,0.03278032786885246,Very Cheap
20141222T000000,210000.0,1,1.0,1050,7583,1.0,0,0,4,6,1050,0,1947,0,98133,47.7294,-122.341,1420,7560,6533,6140,27.693524990109456,0.017704918032786884,Very Cheap
20150425T000000,1078000.0,4,2.75,3160,42733,2.0,0,0,3,9,3160,0,1995,0,98053,47.6367,-121.958,1890,24000,39573,22110,25.226405822198302,0.1315409836065574,Cheap
20141204T000000,325088.0,4,1.0,1400,6739,1.0,0,0,3,7,1000,400,1954,0,98108,47.5402,-122.298,1500,6380,5339,4880,48.23979818964238,0.032798426229508196,Very Cheap
20150116T000000,790000.0,4,3.0,3120,157875,2.0,0,0,4,8,3120,0,1977,0,98058,47.444,-122.187,1580,7050,154755,5470,5.003958828186857,0.09377049180327869,Very Cheap
20141125T000000,150000.0,2,1.0,720,212137,1.0,0,0,3,5,720,0,1982,0,98058,47.422,-122.066,2010,109642,211417,107632,0.7070902294272098,0.009836065573770493,Very Cheap
20141030T000000,790000.0,3,3.0,2840,206910,2.0,0,0,3,10,2840,0,1999,0,98059,47.469,-122.063,2070,25067,204070,22997,3.8180851577980763,0.09377049180327869,Very Cheap
20140512T000000,255000.0,2,1.0,1220,2500,1.0,0,0,3,6,770,450,1910,0,98126,47.5727,-122.372,1540,3000,1280,1460,102.0,0.02360655737704918,Very Cheap
20141107T000000,697000.0,4,3.0,2820,2850,1.5,0,0,5,7,1860,960,1928,0,98117,47.6813,-122.367,1570,4500,30,2930,244.56140350877192,0.08157377049180328,Very Cheap
20141104T000000,457500.0,2,1.0,840,5000,1.0,0,0,4,7,840,0,1908,0,98117,47.6803,-122.371,1240,5000,4160,3760,91.5,0.05016393442622951,Very Cheap
20140519T000000,690000.0,3,2.0,1610,5100,1.5,0,0,5,8,1610,0,1940,0,98115,47.6825,-122.307,1740,5100,3490,3360,135.2941176470588,0.08065573770491803,Very Cheap
20150311T000000,967000.0,4,3.25,1860,4356,2.0,0,0,3,9,1860,0,1917,2005,98103,47.6785,-122.351,1860,4356,2496,2496,221.99265381083563,0.11698360655737705,Cheap
20150429T000000,980000.0,4,1.75,2260,17711,1.0,0,1,4,9,2260,0,1968,0,98040,47.5498,-122.214,2880,16594,15451,13714,55.332843995257186,0.11868852459016394,Cheap
20140521T000000,619420.0,4,2.75,2450,14803,2.0,0,0,4,9,2450,0,1988,0,98059,47.5261,-122.162,2330,14803,12353,12473,41.844220766060936,0.07139934426229508,Very Cheap
20141013T000000,389000.0,2,1.0,850,3276,1.0,0,0,3,6,850,0,1910,0,98103,47.6742,-122.35,1460,4100,2426,2640,118.74236874236874,0.04118032786885246,Very Cheap
20141210T000000,500000.0,3,1.0,1800,7200,1.0,0,0,3,7,1020,780,1964,0,98118,47.5616,-122.275,1740,5475,5400,3735,69.44444444444444,0.05573770491803279,Very Cheap
20140926T000000,569000.0,4,1.75,1230,7890,1.0,0,1,4,7,1090,140,1950,0,98004,47.5808,-122.189,2380,13176,6660,10796,72.11660329531053,0.06478688524590163,Very Cheap
20140728T000000,425000.0,4,2.25,2060,8540,1.0,0,0,4,7,1540,520,1967,0,98034,47.734,-122.19,1560,7700,6480,6140,49.76580796252927,0.04590163934426229,Very Cheap
20140521T000000,635000.0,4,2.25,2750,6180,1.0,0,0,4,8,1500,1250,1948,0,98118,47.5691,-122.284,1740,6180,3430,4440,102.75080906148867,0.07344262295081967,Very Cheap
20140519T000000,256500.0,2,1.0,1120,9912,1.0,0,0,4,6,1120,0,1980,0,98070,47.3735,-122.43,1540,9750,8792,8210,25.87772397094431,0.02380327868852459,Very Cheap
20150123T000000,695000.0,4,2.5,3010,11393,2.0,0,0,3,8,3010,0,2005,0,98028,47.7389,-122.221,2810,11282,8383,8472,61.0023698762398,0.08131147540983606,Very Cheap
20140730T000000,535000.0,4,1.5,1580,5000,1.5,0,0,3,7,1390,190,1945,0,98107,47.6735,-122.393,1580,5000,3420,3420,107.0,0.06032786885245902,Very Cheap
20150410T000000,454200.0,4,2.5,2630,5379,2.0,0,0,3,8,2630,0,2004,0,98059,47.4977,-122.163,2630,5379,2749,2749,84.43948689347462,0.04973114754098361,Very Cheap
20150123T000000,418500.0,2,1.0,790,5800,1.0,0,0,3,6,790,0,1943,0,98117,47.6973,-122.36,1460,5800,5010,4340,72.15517241379311,0.04504918032786885,Very Cheap
20140605T000000,749950.0,4,2.75,3110,35235,2.0,0,0,4,9,3110,0,1983,0,98072,47.7355,-122.095,2790,35445,32125,32655,21.28423442599688,0.08851803278688525,Very Cheap
20141019T000000,338500.0,3,1.75,2130,5489,1.0,0,0,3,8,1370,760,1999,0,98070,47.4489,-122.456,1750,7200,3359,5450,61.66879212971397,0.03455737704918033,Very Cheap
20140722T000000,1250000.0,4,3.75,4520,9240,1.5,0,2,3,10,3270,1250,1992,0,98040,47.5897,-122.229,3380,9240,4720,5860,135.28138528138527,0.1540983606557377,Cheap
20140711T000000,299950.0,3,2.5,1600,9830,2.0,0,0,4,8,1600,0,1993,0,98001,47.339,-122.266,1890,8910,8230,7020,30.513733468972532,0.029501639344262295,Very Cheap
20140731T000000,325000.0,4,1.75,1950,12500,1.0,0,0,3,7,1330,620,1963,0,98168,47.4999,-122.327,1760,11520,10550,9760,26.0,0.03278688524590164,Very Cheap
20140826T000000,434000.0,4,3.0,2010,8171,2.0,0,0,3,8,2010,0,1973,0,98011,47.7688,-122.218,2090,8203,6161,6113,53.114673846530415,0.04708196721311476,Very Cheap
20140701T000000,328950.0,4,1.75,2550,8976,1.0,0,0,5,7,1300,1250,1978,0,98058,47.4286,-122.179,2220,9477,6426,7257,36.64772727272727,0.03330491803278689,Very Cheap
20140519T000000,2095000.0,5,3.75,5340,10655,2.5,0,3,4,10,3740,1600,1912,0,98144,47.5795,-122.285,3910,9418,5315,5508,196.6213045518536,0.26491803278688525,Cheap
20150429T000000,570000.0,4,2.0,2000,46902,2.0,0,0,3,8,2000,0,1978,0,98075,47.5851,-122.072,2420,38130,44902,35710,12.152999872073686,0.06491803278688525,Very Cheap
20140916T000000,802000.0,3,2.25,2170,5001,2.0,0,0,3,8,2170,0,2014,0,98103,47.6937,-122.338,1700,6991,2831,5291,160.36792641471706,0.09534426229508197,Very Cheap
20141024T000000,525000.0,3,1.0,1550,6840,1.5,0,0,3,7,1550,0,1918,0,98103,47.6572,-122.335,2370,4560,5290,2190,76.75438596491227,0.05901639344262295,Very Cheap
20150202T000000,700000.0,6,3.0,2790,4550,2.5,0,0,4,8,2790,0,1907,0,98119,47.627,-122.361,2590,4550,1760,1960,153.84615384615384,0.08196721311475409,Very Cheap
20150319T000000,350000.0,3,1.75,1980,273556,1.0,0,0,3,6,1040,940,1956,1999,98042,47.4012,-122.11,2180,217799,271576,215619,1.27944552486511,0.036065573770491806,Very Cheap
20150218T000000,277500.0,2,1.5,1190,1236,3.0,0,0,3,7,1190,0,2005,0,98133,47.7274,-122.357,1390,1756,46,366,224.51456310679612,0.026557377049180327,Very Cheap
20140512T000000,1575000.0,5,2.75,3650,20150,1.0,0,0,4,10,2360,1290,1975,0,98004,47.6215,-122.224,3220,19800,16500,16580,78.1637717121588,0.19672131147540983,Cheap
20140919T000000,195000.0,3,1.0,1510,4350,1.5,0,0,5,6,1510,0,1913,0,98022,47.2052,-121.987,1210,5500,2840,4290,44.827586206896555,0.015737704918032787,Very Cheap
20140821T000000,222000.0,3,2.0,1200,6074,1.0,0,0,3,7,1200,0,1968,0,98002,47.325,-122.205,1430,6338,4874,4908,36.54922621007573,0.019278688524590165,Very Cheap
20150416T000000,865000.0,5,3.0,2830,8854,1.0,0,0,4,8,1500,1330,1979,0,98040,47.5743,-122.209,2260,8604,6024,6344,97.69595662977186,0.10360655737704919,Cheap
20140509T000000,445000.0,4,2.0,1650,6000,1.0,0,0,5,7,1000,650,1959,0,98144,47.5834,-122.307,1540,6000,4350,4460,74.16666666666667,0.04852459016393443,Very Cheap
20141209T000000,495800.0,4,1.5,1710,4600,1.5,0,0,3,7,1710,0,1924,0,98115,47.6847,-122.318,1740,4455,2890,2715,107.78260869565217,0.05518688524590164,Very Cheap
20150403T000000,548500.0,3,1.0,1740,4400,1.5,0,0,3,7,1740,0,1924,0,98122,47.6059,-122.3,1720,4400,2660,2680,124.6590909090909,0.062098360655737705,Very Cheap
20140507T000000,310000.0,3,1.75,1840,10723,1.0,0,0,4,7,1220,620,1974,0,98058,47.429,-122.154,1590,9820,8883,8230,28.90982001305605,0.03081967213114754,Very Cheap
20140711T000000,205000.0,3,1.5,1820,8585,1.0,0,0,4,7,1820,0,1962,0,98055,47.4479,-122.213,1740,10088,6765,8348,23.8788584740827,0.017049180327868854,Very Cheap
20140910T000000,470000.0,5,3.75,3860,6901,2.0,0,0,3,7,3860,0,2003,0,98038,47.3694,-122.032,3000,8584,3041,5584,68.10607158382842,0.05180327868852459,Very Cheap
20150423T000000,430000.0,3,1.5,1810,349351,1.5,0,0,3,7,1810,0,2002,0,98010,47.3392,-121.897,2480,339332,347541,336852,1.2308537831579127,0.04655737704918033,Very Cheap
20150501T000000,310000.0,2,2.0,1030,2271,3.0,0,0,3,7,1030,0,1999,0,98125,47.7263,-122.314,1439,1387,1241,-52,136.50374284456186,0.03081967213114754,Very Cheap
20150325T000000,355000.0,4,1.0,1410,7693,1.5,0,0,4,7,1410,0,1953,0,98133,47.7604,-122.331,1330,8395,6283,7065,46.14584687378136,0.036721311475409836,Very Cheap
20150127T000000,621500.0,5,2.5,2140,15950,1.0,0,2,4,8,1370,770,1968,0,98166,47.4797,-122.358,2600,14273,13810,11673,38.96551724137931,0.07167213114754098,Very Cheap
20140610T000000,175000.0,6,1.5,1930,8400,1.0,0,0,3,7,1030,900,1971,0,98146,47.4869,-122.34,1780,9520,6470,7740,20.833333333333332,0.013114754098360656,Very Cheap
20150107T000000,326000.0,6,1.5,1930,8400,1.0,0,0,3,7,1030,900,1971,0,98146,47.4869,-122.34,1780,9520,6470,7740,38.80952380952381,0.032918032786885244,Very Cheap
20140912T000000,690000.0,4,3.5,1930,5400,1.5,0,2,3,7,1930,0,1920,0,98116,47.5679,-122.409,1500,3340,3470,1840,127.77777777777777,0.08065573770491803,Very Cheap
20140819T000000,335000.0,4,2.5,2210,7214,2.0,0,0,3,8,2210,0,2003,0,98003,47.3554,-122.298,2270,7246,5004,4976,46.43748267258109,0.03409836065573771,Very Cheap
20150224T000000,197000.0,4,1.0,1360,11175,1.0,0,0,3,7,1360,0,1961,0,98188,47.4551,-122.272,1340,9702,9815,8362,17.628635346756152,0.016,Very Cheap
20140703T000000,312500.0,3,1.75,1830,7969,1.0,0,0,3,7,930,900,1950,2008,98055,47.4667,-122.214,1790,7425,6139,5635,39.214456017066134,0.03114754098360656,Very Cheap
20141029T000000,436000.0,3,2.25,2120,6710,1.0,0,0,5,7,1420,700,1959,0,98155,47.7461,-122.324,1880,6960,4590,5080,64.97764530551416,0.047344262295081964,Very Cheap
20141001T000000,1015000.0,4,2.5,2700,4590,2.0,0,0,3,8,2700,0,2002,0,98103,47.6734,-122.329,2080,3570,1890,1490,221.13289760348584,0.12327868852459016,Cheap
20140826T000000,805000.0,4,2.5,3160,35225,2.0,0,1,3,9,2250,910,1992,0,98006,47.5672,-122.111,3460,17223,32065,13763,22.853087295954577,0.09573770491803278,Very Cheap
20150105T000000,652427.0,4,2.25,2770,13129,2.0,0,0,4,8,2770,0,1979,0,98074,47.6268,-122.05,2400,13129,10359,10729,49.693579099702944,0.07572813114754098,Very Cheap
20141018T000000,1008000.0,3,2.5,2240,41339,1.0,0,0,4,9,2240,0,1945,1992,98005,47.6483,-122.163,2900,45738,39099,42838,24.38375384019933,0.12236065573770492,Cheap
20141106T000000,355000.0,4,2.5,2570,6466,2.0,0,0,3,9,2570,0,1999,0,98092,47.3324,-122.17,2520,6667,3896,4147,54.9025672749768,0.036721311475409836,Very Cheap
20140729T000000,334550.0,2,1.0,880,12000,1.0,0,0,3,7,880,0,1939,0,98133,47.7436,-122.356,1960,9395,11120,7435,27.879166666666666,0.03403934426229508,Very Cheap
20140708T000000,557500.0,3,2.25,1820,9670,2.0,0,0,3,8,1820,0,1984,0,98052,47.6382,-122.11,2160,11424,7850,9264,57.65253360910031,0.06327868852459016,Very Cheap
20141103T000000,277500.0,4,2.25,1660,7184,1.0,0,0,3,7,1110,550,1963,0,98188,47.4678,-122.294,1640,7200,5524,5560,38.62750556792873,0.026557377049180327,Very Cheap
20140707T000000,300000.0,4,3.0,2200,10800,1.0,0,0,3,6,2200,0,1960,0,98058,47.4476,-122.169,1430,10800,8600,9370,27.77777777777778,0.029508196721311476,Very Cheap
20150225T000000,325000.0,4,1.0,1640,3844,1.5,0,0,4,7,1460,180,1928,0,98133,47.7017,-122.354,1230,3844,2204,2614,84.54734651404787,0.03278688524590164,Very Cheap
20150319T000000,402500.0,4,2.0,1650,3504,1.0,0,0,3,7,760,890,1951,2013,98144,47.5803,-122.294,1480,3504,1854,2024,114.86872146118722,0.04295081967213115,Very Cheap
20140820T000000,461000.0,3,1.75,1420,5170,1.0,0,0,4,7,1420,0,1963,0,98007,47.6151,-122.145,2250,7700,3750,5450,89.16827852998065,0.05062295081967213,Very Cheap
20150327T000000,540000.0,3,1.0,1270,3840,1.5,0,0,3,7,1270,0,1926,0,98103,47.6896,-122.357,1270,4175,2570,2905,140.625,0.06098360655737705,Very Cheap
20150316T000000,385000.0,3,1.0,1070,4000,1.0,0,0,4,7,1070,0,1971,0,98108,47.5529,-122.305,1090,4000,2930,2910,96.25,0.04065573770491803,Very Cheap
20140708T000000,480000.0,2,1.0,1060,3040,1.0,0,0,3,7,860,200,1924,0,98103,47.6725,-122.329,1470,3814,1980,2344,157.89473684210526,0.05311475409836065,Very Cheap
20140609T000000,539950.0,3,2.25,2190,7149,1.0,0,1,4,8,1240,950,1963,0,98056,47.5243,-122.204,3500,7149,4959,3649,75.52804588054273,0.06097704918032787,Very Cheap
20140718T000000,529000.0,3,2.25,1940,217800,2.0,0,0,3,9,1940,0,1990,0,98024,47.5636,-121.932,2580,83558,215860,80978,2.428833792470156,0.05954098360655738,Very Cheap
20140820T000000,417000.0,3,2.5,1300,877,2.0,0,0,3,7,1060,240,2008,0,98199,47.6591,-122.392,1320,1414,-423,94,475.48460661345496,0.04485245901639344,Very Cheap
20150217T000000,405000.0,3,1.5,1330,12500,1.0,0,0,3,7,1330,0,1966,0,98027,47.5263,-122.051,2310,12500,11170,10190,32.4,0.043278688524590166,Very Cheap
20140723T000000,299000.0,3,2.25,1940,9100,1.0,0,0,4,8,1630,310,1966,0,98023,47.3133,-122.364,2080,9100,7160,7020,32.857142857142854,0.02937704918032787,Very Cheap
20140813T000000,299000.0,3,1.75,2100,15480,1.0,0,0,3,7,2100,0,1983,0,98001,47.2924,-122.271,1330,15657,13380,14327,19.315245478036175,0.02937704918032787,Very Cheap
20140514T000000,372220.0,3,1.0,1290,5500,1.0,0,0,3,7,980,310,1951,0,98136,47.5266,-122.392,1680,5000,4210,3320,67.67636363636363,0.038979672131147544,Very Cheap
20140522T000000,494400.0,2,1.75,1560,1750,1.0,0,0,4,6,780,780,1904,0,98109,47.6347,-122.355,1850,3600,190,1750,282.51428571428573,0.05500327868852459,Very Cheap
20140924T000000,280000.0,3,1.75,2630,6500,1.0,0,0,3,7,1330,1300,1958,0,98055,47.4878,-122.221,2520,6500,3870,3980,43.07692307692308,0.026885245901639345,Very Cheap
20141121T000000,277950.0,3,2.5,2100,6021,2.0,0,0,3,7,2100,0,1992,0,98023,47.2917,-122.375,2091,7547,3921,5456,46.163428001993026,0.02661639344262295,Very Cheap
20141219T000000,770000.0,3,2.75,2070,54557,2.0,0,0,3,8,2070,0,1996,0,98058,47.4659,-122.116,2190,49658,52487,47468,14.113679271220924,0.09114754098360656,Very Cheap
20141008T000000,760000.0,4,2.5,2960,28005,2.0,0,0,3,10,2960,0,1989,0,98072,47.7477,-122.117,3510,35248,25045,31738,27.138011069451885,0.0898360655737705,Very Cheap
20150126T000000,230000.0,2,2.0,1300,3608,1.0,0,0,3,7,1300,0,2004,0,98198,47.3623,-122.309,1510,3608,2308,2098,63.747228381374725,0.020327868852459016,Very Cheap
20141002T000000,525000.0,4,2.5,2520,7731,2.0,0,0,3,9,2520,0,1994,0,98155,47.7709,-122.297,2000,7704,5211,5704,67.90842064415988,0.05901639344262295,Very Cheap
20140701T000000,307000.0,3,1.0,1150,6000,1.5,0,0,3,7,1150,0,1927,0,98045,47.4963,-121.787,1210,7700,4850,6490,51.166666666666664,0.03042622950819672,Very Cheap
20140618T000000,253779.0,4,2.0,2030,9600,1.5,0,0,3,6,1430,600,1947,0,98188,47.4459,-122.272,1820,14600,7570,12780,26.4353125,0.023446426229508197,Very Cheap
20140617T000000,405000.0,3,1.5,1880,7400,1.0,0,0,3,8,1480,400,1968,0,98155,47.7743,-122.27,1820,8660,5520,6840,54.729729729729726,0.043278688524590166,Very Cheap
20150312T000000,360000.0,2,1.0,2320,11250,2.0,0,0,4,6,2320,0,1942,0,98146,47.504,-122.362,1620,11250,8930,9630,32.0,0.037377049180327866,Very Cheap
20150511T000000,521000.0,2,1.0,1050,7500,1.5,0,3,4,6,1050,0,1910,0,98116,47.5577,-122.399,2540,13680,6450,11140,69.46666666666667,0.058491803278688526,Very Cheap
20140926T000000,680000.0,4,2.5,3030,13068,2.0,0,0,3,9,3030,0,1978,0,98005,47.6313,-122.172,2940,11999,10038,9059,52.035506580961126,0.07934426229508197,Very Cheap
20141203T000000,355000.0,1,0.75,530,33278,1.0,0,2,4,4,530,0,1950,0,98074,47.6412,-122.079,2830,14311,32748,11481,10.667708395937256,0.036721311475409836,Very Cheap
20140623T000000,200000.0,3,1.5,1090,9600,1.0,0,0,4,7,1090,0,1968,0,98042,47.3639,-122.109,1240,9620,8510,8380,20.833333333333332,0.01639344262295082,Very Cheap
20140708T000000,330000.0,3,2.25,2220,4060,1.0,0,0,3,7,1330,890,1993,0,98118,47.5188,-122.265,1930,5625,1840,3695,81.2807881773399,0.03344262295081967,Very Cheap
20140812T000000,221000.0,3,2.25,1430,5999,2.0,0,0,3,7,1430,0,1987,0,98023,47.3116,-122.358,1600,5999,4569,4399,36.83947324554092,0.01914754098360656,Very Cheap
20150204T000000,1598890.0,4,4.5,3780,6000,2.0,0,4,4,11,2770,1010,1910,1977,98116,47.5922,-122.388,2660,6000,2220,3340,266.4816666666667,0.1998544262295082,Cheap
20140723T000000,310000.0,2,1.0,1560,4920,1.0,0,0,4,6,780,780,1947,0,98125,47.7248,-122.325,1760,7510,3360,5750,63.00813008130081,0.03081967213114754,Very Cheap
20150409T000000,862000.0,4,2.25,2220,4200,1.5,0,0,5,8,1310,910,1932,0,98199,47.6418,-122.394,2020,4940,1980,2920,205.23809523809524,0.10321311475409836,Cheap
20140619T000000,200000.0,3,1.5,1140,8340,1.0,0,0,3,7,1140,0,1960,0,98168,47.4773,-122.28,1140,8340,7200,7200,23.980815347721823,0.01639344262295082,Very Cheap
20140930T000000,630000.0,4,2.5,2540,11100,1.0,0,0,5,7,2540,0,1957,0,98008,47.6317,-122.124,1560,11100,8560,9540,56.75675675675676,0.07278688524590164,Very Cheap
20150320T000000,432250.0,3,2.25,1440,6232,2.0,0,0,3,7,1440,0,1985,0,98029,47.5658,-122.018,1740,5999,4792,4259,69.35975609756098,0.04685245901639344,Very Cheap
20150123T000000,478000.0,3,2.25,1570,9500,1.0,0,0,4,7,1070,500,1977,0,98033,47.6843,-122.185,2250,9583,7930,7333,50.31578947368421,0.05285245901639344,Very Cheap
20140723T000000,249000.0,4,2.25,1860,9576,1.0,0,0,3,7,1400,460,1962,0,98032,47.3612,-122.284,1860,9576,7716,7716,26.00250626566416,0.02281967213114754,Very Cheap
20140605T000000,495000.0,5,3.0,2440,4750,1.0,0,0,3,9,1450,990,2006,0,98108,47.5485,-122.302,1420,5940,2310,4520,104.21052631578948,0.05508196721311476,Very Cheap
20141113T000000,630000.0,4,2.5,2100,8800,1.0,0,2,4,7,1240,860,1960,0,98008,47.6146,-122.114,2000,8800,6700,6800,71.5909090909091,0.07278688524590164,Very Cheap
20140626T000000,550000.0,4,2.5,2150,27540,2.0,0,0,3,8,2150,0,1997,0,98053,47.637,-121.969,2150,27540,25390,25390,19.970951343500364,0.06229508196721312,Very Cheap
20140919T000000,350000.0,3,2.5,2440,18674,2.0,0,0,4,8,2440,0,1994,0,98042,47.3672,-122.126,2530,10603,16234,8073,18.742636821248794,0.036065573770491806,Very Cheap
20141202T000000,270000.0,5,1.5,1930,7480,2.0,0,0,3,7,1930,0,1966,0,98058,47.4503,-122.157,1480,7705,5550,6225,36.096256684491976,0.025573770491803278,Very Cheap
20141007T000000,488250.0,4,2.0,1830,9610,1.0,0,0,3,7,1830,0,1963,0,98033,47.695,-122.176,1970,10754,7780,8784,50.806451612903224,0.05419672131147541,Very Cheap
20140516T000000,248000.0,4,3.5,1850,6519,2.0,0,0,3,7,1130,720,1986,0,98023,47.3087,-122.354,1280,6664,4669,5384,38.04264457738917,0.022688524590163933,Very Cheap
20140814T000000,889000.0,4,3.5,3210,5000,3.0,0,0,3,9,3210,0,2014,0,98136,47.5203,-122.393,1360,5000,1790,3640,177.8,0.10675409836065573,Cheap
20140827T000000,375000.0,1,1.0,1090,5250,1.0,0,0,3,6,980,110,1927,0,98117,47.6999,-122.391,2160,5250,4160,3090,71.42857142857143,0.03934426229508197,Very Cheap
20141126T000000,933000.0,3,1.5,1870,3300,2.0,0,2,3,7,1870,0,1906,0,98102,47.6221,-122.325,1820,2460,1430,640,282.72727272727275,0.11252459016393443,Cheap
20150102T000000,625000.0,3,2.25,1920,8412,1.0,0,2,3,8,1460,460,1977,0,98006,47.5578,-122.132,2490,8700,6492,6210,74.29862101759392,0.07213114754098361,Very Cheap
20140728T000000,328000.0,2,1.0,700,4350,1.0,0,0,3,6,700,0,1943,0,98116,47.5577,-122.391,1620,5100,3650,3480,75.40229885057471,0.03318032786885246,Very Cheap
20140718T000000,470000.0,4,2.25,3380,9900,1.0,0,2,4,8,1690,1690,1969,0,98166,47.4438,-122.34,2390,9900,6520,7510,47.474747474747474,0.05180327868852459,Very Cheap
20150213T000000,502500.0,5,2.5,2430,6168,2.0,0,0,3,8,2430,0,2007,0,98056,47.5237,-122.199,2150,8400,3738,6250,81.46887159533074,0.0560655737704918,Very Cheap
20150407T000000,484000.0,3,1.75,1950,17400,1.0,0,0,3,7,1210,740,1976,0,98072,47.7424,-122.091,1900,17250,15450,15350,27.816091954022987,0.05363934426229508,Very Cheap
20140807T000000,252500.0,2,1.0,900,7500,1.0,0,0,4,6,900,0,1961,0,98014,47.6481,-121.916,1190,10000,6600,8810,33.666666666666664,0.023278688524590165,Very Cheap
20140821T000000,610000.0,3,2.5,2060,8893,2.0,0,0,3,8,2060,0,1987,0,98006,47.5615,-122.165,2650,8500,6833,5850,68.59327561003036,0.07016393442622951,Very Cheap
20140725T000000,419000.0,4,2.0,2180,10447,1.0,0,0,4,8,1280,900,1969,0,98155,47.7675,-122.279,2190,10987,8267,8797,40.10720781085479,0.04511475409836065,Very Cheap
20140717T000000,322500.0,4,2.25,2140,9377,2.0,0,0,4,8,2140,0,1986,0,98092,47.2649,-122.218,2030,7846,7237,5816,34.392662898581634,0.032459016393442626,Very Cheap
20150106T000000,563000.0,6,1.0,1730,2760,1.5,0,0,3,7,1250,480,1918,0,98109,47.6342,-122.353,1630,3200,1030,1570,203.9855072463768,0.064,Very Cheap
20150324T000000,464000.0,4,2.5,3140,12591,2.0,0,0,3,9,3140,0,1993,0,98042,47.3826,-122.146,2650,11720,9451,9070,36.851719482169806,0.05101639344262295,Very Cheap
20140617T000000,870000.0,4,4.25,3010,4887,2.0,0,3,4,10,1940,1070,1951,1996,98115,47.6933,-122.272,2540,9375,1877,6835,178.02332719459793,0.10426229508196722,Cheap
20150203T000000,280000.0,2,1.5,800,1196,2.0,0,0,3,8,800,0,2003,0,98103,47.6972,-122.341,1020,1087,396,67,234.11371237458195,0.026885245901639345,Very Cheap
20140912T000000,850000.0,3,2.5,3300,11570,2.0,0,0,3,9,3300,0,1994,0,98006,47.5599,-122.121,3280,11446,8270,8166,73.46585998271391,0.10163934426229508,Cheap
20141022T000000,458950.0,2,1.0,1530,4370,1.0,0,0,3,7,1130,400,1946,0,98115,47.6888,-122.308,1580,4275,2840,2695,105.0228832951945,0.050354098360655734,Very Cheap
20150422T000000,122000.0,2,1.0,760,5280,1.0,0,0,3,6,760,0,1946,0,98168,47.483,-122.33,1710,6594,4520,4884,23.106060606060606,0.0061639344262295085,Very Cheap
20140513T000000,525000.0,5,3.0,2450,4591,2.0,0,0,3,7,2450,0,1994,0,98117,47.6828,-122.388,1060,5500,2141,4440,114.3541712045306,0.05901639344262295,Very Cheap
20140716T000000,286300.0,2,1.0,1000,31838,1.0,0,0,3,7,1000,0,1962,0,98045,47.4789,-121.779,1490,39747,30838,38257,8.992399020038947,0.027711475409836067,Very Cheap
20140718T000000,218450.0,2,1.0,840,7425,1.0,0,0,4,6,840,0,1952,0,98166,47.4749,-122.339,1300,11674,6585,10374,29.420875420875422,0.01881311475409836,Very Cheap
20140905T000000,525000.0,3,1.5,1380,4290,1.0,0,0,3,7,1080,300,1955,0,98107,47.674,-122.379,1510,3900,2910,2390,122.37762237762237,0.05901639344262295,Very Cheap
20141222T000000,650000.0,3,1.5,1380,4290,1.0,0,0,3,7,1080,300,1955,0,98107,47.674,-122.379,1510,3900,2910,2390,151.5151515151515,0.07540983606557378,Very Cheap
20140625T000000,356000.0,4,2.0,2020,48693,1.5,0,0,3,7,2020,0,1949,0,98045,47.4646,-121.759,1610,34900,46673,33290,7.311112480233298,0.03685245901639344,Very Cheap
20140529T000000,436500.0,2,1.0,1260,5000,1.0,0,0,3,7,1040,220,1951,0,98117,47.6782,-122.397,1510,5000,3740,3490,87.3,0.04740983606557377,Very Cheap
20140807T000000,410000.0,3,1.75,1440,7112,1.0,0,0,3,7,1180,260,1979,0,98034,47.7304,-122.227,1570,9152,5672,7582,57.64904386951631,0.043934426229508196,Very Cheap
20140911T000000,512500.0,4,1.75,1540,8311,1.0,0,0,4,7,1540,0,1950,0,98125,47.7046,-122.293,1890,7996,6771,6106,61.66526290458429,0.05737704918032787,Very Cheap
20140818T000000,510000.0,4,1.0,1060,7200,1.0,0,1,3,6,880,180,1925,0,98118,47.5591,-122.268,1910,7200,6140,5290,70.83333333333333,0.057049180327868855,Very Cheap
20140918T000000,566000.0,4,1.75,1900,10297,1.0,0,0,4,8,1900,0,1966,0,98005,47.5944,-122.155,2220,9612,8397,7392,54.967466252306494,0.06439344262295082,Very Cheap
20140910T000000,525000.0,3,1.75,2870,26500,1.5,0,1,3,8,2870,0,1948,1981,98166,47.4485,-122.355,2420,20500,23630,18080,19.81132075471698,0.05901639344262295,Very Cheap
20140807T000000,435000.0,3,1.0,1050,5500,1.0,0,0,3,6,930,120,1920,0,98126,47.5402,-122.38,1410,5834,4450,4424,79.0909090909091,0.04721311475409836,Very Cheap
20141231T000000,406500.0,3,2.75,1840,68479,1.0,0,2,3,8,1340,500,1989,0,98014,47.6802,-121.908,2060,61903,66639,59843,5.936126403715008,0.04347540983606557,Very Cheap
20141007T000000,550000.0,5,2.75,3000,9473,1.0,0,0,3,8,1500,1500,1966,0,98052,47.6567,-122.13,2050,8820,6473,6770,58.05974875963264,0.06229508196721312,Very Cheap
20150226T000000,251000.0,3,2.0,1200,10212,1.5,0,0,5,6,1200,0,1949,0,98022,47.206,-121.998,1280,10212,9012,8932,24.578926752839795,0.023081967213114753,Very Cheap
20141211T000000,830000.0,3,1.5,1840,10125,1.0,0,0,4,8,1220,620,1959,0,98040,47.5607,-122.217,2320,10160,8285,7840,81.9753086419753,0.09901639344262295,Very Cheap
20150414T000000,803000.0,4,2.5,2790,7673,2.0,0,0,3,9,2790,0,1989,0,98052,47.6692,-122.136,2740,7837,4883,5097,104.65267822233807,0.09547540983606558,Very Cheap
20150407T000000,206000.0,3,1.0,970,9360,1.0,0,0,4,5,970,0,1942,0,98002,47.2808,-122.225,1050,11348,8390,10298,22.00854700854701,0.017180327868852457,Very Cheap
20140730T000000,200000.0,4,1.0,1070,7467,1.5,0,0,3,7,1070,0,1944,0,98178,47.4942,-122.235,1160,7467,6397,6307,26.784518548279095,0.01639344262295082,Very Cheap
20140506T000000,219000.0,2,1.0,900,5160,1.0,0,0,3,6,900,0,1952,0,98106,47.525,-122.356,900,5160,4260,4260,42.44186046511628,0.018885245901639345,Very Cheap
20140905T000000,777000.0,4,4.0,2680,6000,1.0,0,0,3,7,1380,1300,1962,2014,98199,47.6557,-122.388,1930,6000,3320,4070,129.5,0.09206557377049181,Very Cheap
20150218T000000,593700.0,3,2.5,2000,22000,2.0,0,0,3,8,2000,0,1979,0,98075,47.59,-122.081,2180,19800,20000,17620,26.986363636363638,0.06802622950819671,Very Cheap
20140603T000000,712500.0,3,1.5,1660,8797,1.0,0,0,4,7,1660,0,1956,0,98004,47.5892,-122.202,2350,10053,7137,7703,80.99352051835854,0.08360655737704918,Very Cheap
20140714T000000,600000.0,4,1.5,1770,6014,1.5,0,0,4,7,1240,530,1946,0,98116,47.5773,-122.393,1740,6014,4244,4274,99.76720984369804,0.06885245901639345,Very Cheap
20150330T000000,554663.0,3,2.0,1230,6802,1.5,0,0,3,7,1230,0,1940,0,98105,47.6712,-122.279,1850,6398,5572,4548,81.54410467509555,0.06290662295081967,Very Cheap
20140703T000000,267000.0,3,1.0,1740,10875,1.0,0,0,4,7,1020,720,1962,0,98188,47.4682,-122.283,1470,8532,9135,7062,24.551724137931036,0.025180327868852458,Very Cheap
20140924T000000,390000.0,3,2.0,1710,8910,1.0,0,0,5,7,1710,0,1953,0,98133,47.7719,-122.338,1430,8493,7200,7063,43.77104377104377,0.04131147540983607,Very Cheap
20150401T000000,335000.0,6,2.0,2020,7071,1.0,0,0,3,7,1010,1010,1979,0,98108,47.5329,-122.294,2020,5000,5051,2980,47.37660868335455,0.03409836065573771,Very Cheap
20150423T000000,938000.0,4,2.5,2410,9886,1.0,0,0,5,8,1990,420,1975,0,98040,47.5351,-122.223,2530,10658,7476,8128,94.88165081934048,0.11318032786885246,Cheap
20150407T000000,370000.0,4,2.75,2310,14745,1.0,0,0,3,7,1410,900,1993,0,98198,47.377,-122.31,2060,9678,12435,7618,25.093251949813496,0.038688524590163934,Very Cheap
20150402T000000,335000.0,5,2.5,2400,4548,2.0,0,0,3,7,2400,0,2003,0,98042,47.371,-122.127,2200,4465,2148,2265,73.65875109938435,0.03409836065573771,Very Cheap
20150421T000000,695000.0,5,2.0,3160,3990,1.5,0,0,3,7,1870,1290,1923,0,98103,47.654,-122.337,1780,4240,830,2460,174.18546365914787,0.08131147540983606,Very Cheap
20140606T000000,387500.0,3,1.0,1560,14333,1.0,0,0,4,7,1560,0,1953,0,98166,47.432,-122.348,1640,14333,12773,12693,27.035512453777994,0.040983606557377046,Very Cheap
20150318T000000,245000.0,3,2.5,1770,6187,2.0,0,0,3,7,1770,0,1992,0,98031,47.4034,-122.189,1650,7200,4417,5550,39.59915952804267,0.022295081967213116,Very Cheap
20140729T000000,308550.0,3,2.0,1600,13200,1.0,0,0,3,7,1600,0,1990,0,98045,47.4656,-121.756,1360,11520,11600,10160,23.375,0.030629508196721313,Very Cheap
20140624T000000,225000.0,3,1.75,1330,13102,1.0,0,0,3,7,1330,0,1968,0,98003,47.3172,-122.322,1270,11475,11772,10205,17.17295069455045,0.019672131147540985,Very Cheap
20140903T000000,715000.0,4,2.5,2970,29163,2.0,0,0,3,9,2970,0,1993,0,98053,47.6717,-122.025,3100,31105,26193,28005,24.517367897678565,0.0839344262295082,Very Cheap
20150506T000000,335000.0,3,1.0,1020,10200,1.0,0,0,4,7,1020,0,1954,0,98133,47.7503,-122.348,1170,8188,9180,7018,32.84313725490196,0.03409836065573771,Very Cheap
20140821T000000,634000.0,3,2.5,2490,4904,2.0,0,0,3,9,2490,0,2003,0,98029,47.5451,-122.014,2370,4050,2414,1680,129.28221859706363,0.07331147540983607,Very Cheap
20140514T000000,337500.0,5,2.0,1700,7314,1.0,0,0,3,7,1000,700,1956,0,98108,47.549,-122.305,2000,7176,5614,5176,46.14438063986874,0.03442622950819672,Very Cheap
20140904T000000,440000.0,1,1.0,850,6567,1.0,0,0,4,6,850,0,1940,0,98010,47.327,-122.039,2160,9794,5717,7634,67.00167504187604,0.04786885245901639,Very Cheap
20140717T000000,350000.0,3,1.75,1250,13775,1.0,0,2,3,7,1250,0,1990,0,98045,47.4981,-121.772,1260,13707,12525,12447,25.40834845735027,0.036065573770491806,Very Cheap
20150114T000000,400000.0,2,1.0,610,4560,1.0,0,0,3,5,610,0,1918,0,98136,47.5498,-122.383,930,1392,3950,462,87.71929824561404,0.04262295081967213,Very Cheap
20140815T000000,1288000.0,4,3.5,3700,13175,2.0,0,0,4,11,3700,0,1989,0,98006,47.5471,-122.133,3880,15508,9475,11628,97.76091081593928,0.15908196721311477,Cheap
20150406T000000,435000.0,3,1.0,950,10080,1.0,0,0,4,7,950,0,1954,0,98006,47.572,-122.139,1060,10000,9130,8940,43.154761904761905,0.04721311475409836,Very Cheap
20140929T000000,681000.0,4,2.5,3860,5130,2.0,0,0,3,8,2930,930,2004,0,98065,47.5387,-121.879,3130,6163,1270,3033,132.7485380116959,0.07947540983606557,Very Cheap
20140629T000000,397000.0,3,3.5,1360,1275,2.0,0,0,3,8,1240,120,2007,0,98144,47.5904,-122.315,1360,1275,-85,-85,311.37254901960785,0.04222950819672131,Very Cheap
20140926T000000,775000.0,4,2.5,3890,34513,2.0,0,0,3,10,3890,0,1996,0,98077,47.7749,-122.048,3600,28435,30623,24835,22.455306696027584,0.09180327868852459,Very Cheap
20140707T000000,480000.0,3,2.25,1680,9090,1.0,0,0,4,7,1130,550,1959,0,98008,47.6068,-122.13,1960,9090,7410,7130,52.805280528052805,0.05311475409836065,Very Cheap
20140909T000000,158000.0,3,2.5,1520,7200,2.0,0,0,4,7,1520,0,1985,0,98030,47.3679,-122.182,1780,7210,5680,5430,21.944444444444443,0.010885245901639345,Very Cheap
20140723T000000,590000.0,3,2.0,2420,208652,1.5,0,0,3,8,2420,0,2005,0,98010,47.3666,-121.978,3180,212137,206232,208957,2.827674788643291,0.06754098360655737,Very Cheap
20140902T000000,772500.0,5,2.75,3890,9130,2.0,0,0,3,9,3890,0,2004,0,98065,47.5407,-121.86,3450,8361,5240,4911,84.61117196056955,0.09147540983606557,Very Cheap
20150217T000000,464500.0,5,1.5,2940,13425,1.0,0,0,3,8,1470,1470,1955,0,98155,47.7632,-122.29,1580,8200,10485,6620,34.59962756052141,0.051081967213114754,Very Cheap
20150424T000000,281000.0,3,1.75,1350,8737,1.0,0,0,3,7,1350,0,1966,0,98188,47.4378,-122.279,1600,8928,7387,7328,32.162069360192284,0.027016393442622952,Very Cheap
20140722T000000,620000.0,3,2.25,2190,45738,1.0,0,0,3,8,2190,0,1990,0,98052,47.7108,-122.12,2970,4496,43548,1526,13.555468100922646,0.07147540983606557,Very Cheap
20140617T000000,475000.0,3,2.25,2280,5750,1.0,0,1,4,7,1150,1130,1985,0,98116,47.5641,-122.393,1500,5060,3470,3560,82.6086956521739,0.05245901639344262,Very Cheap
20141017T000000,245000.0,2,2.0,1070,4500,1.0,0,0,4,6,910,160,1932,0,98055,47.4896,-122.204,1280,4500,3430,3220,54.44444444444444,0.022295081967213116,Very Cheap
20140729T000000,660000.0,5,2.25,2540,3750,1.5,0,0,4,7,1510,1030,1925,0,98115,47.6729,-122.299,1780,3750,1210,1970,176.0,0.07672131147540984,Very Cheap
20141204T000000,527500.0,4,2.25,2270,8480,1.0,0,0,5,8,1310,960,1973,0,98006,47.5448,-122.174,1910,9050,6210,7140,62.20518867924528,0.05934426229508197,Very Cheap
20141027T000000,135000.0,2,1.0,1220,7250,1.0,0,0,4,6,1220,0,1914,0,98010,47.3585,-121.975,1350,20250,6030,18900,18.620689655172413,0.007868852459016393,Very Cheap
20150506T000000,275000.0,3,1.75,1890,5000,1.0,0,0,3,7,1890,0,2003,0,98092,47.3357,-122.175,2960,5421,3110,2461,55.0,0.02622950819672131,Very Cheap
20150210T000000,430000.0,4,2.0,1990,4740,1.0,0,0,3,7,1080,910,1926,0,98122,47.6112,-122.303,1560,2370,2750,810,90.71729957805907,0.04655737704918033,Very Cheap
20140825T000000,213500.0,3,1.0,1220,6000,1.0,0,0,4,7,1220,0,1968,0,98002,47.3245,-122.209,1420,6000,4780,4580,35.583333333333336,0.01816393442622951,Very Cheap
20140912T000000,535000.0,3,3.0,2640,5978,2.0,0,0,3,9,2640,0,2012,0,98045,47.4759,-121.735,2680,6060,3338,3380,89.49481431917029,0.06032786885245902,Very Cheap
20150213T000000,641000.0,3,1.75,1480,9603,1.0,0,0,3,7,1480,0,1952,0,98004,47.5915,-122.202,2660,10766,8123,8106,66.74997396646881,0.0742295081967213,Very Cheap
20141028T000000,436300.0,3,2.0,2320,9420,1.0,0,0,5,7,2320,0,1952,0,98056,47.5133,-122.196,2030,9420,7100,7390,46.316348195329084,0.04738360655737705,Very Cheap
20141014T000000,1440000.0,4,1.75,2410,6000,1.5,0,0,3,8,2410,0,1911,0,98109,47.6369,-122.355,1280,4000,3590,2720,240.0,0.17901639344262296,Cheap
20150327T000000,830000.0,4,2.75,2090,13500,1.0,0,0,4,8,2090,0,1949,0,98040,47.573,-122.225,2130,13500,11410,11370,61.48148148148148,0.09901639344262295,Very Cheap
20140722T000000,380000.0,3,1.0,920,3532,1.0,0,0,3,6,920,0,1910,0,98118,47.5539,-122.268,1250,4000,2612,2750,107.58776896942243,0.04,Very Cheap
20150220T000000,132500.0,3,0.75,850,8573,1.0,0,0,3,6,600,250,1945,0,98146,47.503,-122.356,850,8382,7723,7532,15.455499825032078,0.0075409836065573775,Very Cheap
20141201T000000,179950.0,3,1.0,1130,9907,1.0,0,0,3,7,1130,0,1954,0,98188,47.4362,-122.286,1320,9907,8777,8587,18.163924497829818,0.013763934426229509,Very Cheap
20150420T000000,188200.0,3,1.0,1260,7265,1.0,0,0,4,7,1260,0,1954,0,98002,47.2979,-122.224,940,7200,6005,6260,25.9050240880936,0.014845901639344261,Very Cheap
20140702T000000,659000.0,4,2.0,2090,10800,1.0,0,0,4,7,2090,0,1951,0,98040,47.5759,-122.223,2090,10800,8710,8710,61.01851851851852,0.07659016393442623,Very Cheap
20141022T000000,317000.0,3,2.0,2020,7260,1.5,0,0,3,7,1180,840,1926,0,98108,47.5496,-122.311,1400,5950,5240,4550,43.66391184573003,0.03173770491803279,Very Cheap
20141124T000000,625000.0,3,2.25,1970,4564,1.0,0,0,3,8,1470,500,1959,0,98199,47.6703,-122.41,1980,5000,2594,3020,136.9412795793164,0.07213114754098361,Very Cheap
20140613T000000,350000.0,3,1.75,1820,9545,1.0,0,0,3,7,1230,590,1976,0,98155,47.7772,-122.296,1790,9530,7725,7740,36.668412781561024,0.036065573770491806,Very Cheap
20140625T000000,750000.0,3,1.5,1840,5000,1.5,0,0,5,7,1340,500,1915,0,98107,47.6652,-122.362,1840,5000,3160,3160,150.0,0.08852459016393442,Very Cheap
20140827T000000,457000.0,4,1.75,2100,10358,1.0,0,0,5,8,1280,820,1959,0,98133,47.7478,-122.338,2080,9000,8258,6920,44.12048658042093,0.0500983606557377,Very Cheap
20150304T000000,632500.0,4,2.0,1770,5000,2.0,0,0,4,7,1770,0,1906,0,98107,47.6748,-122.386,1550,5000,3230,3450,126.5,0.07311475409836066,Very Cheap
20140702T000000,223000.0,3,2.0,1110,7231,1.0,0,0,4,7,1110,0,1991,0,98031,47.4036,-122.191,1550,7245,6121,5695,30.839441294426774,0.019409836065573772,Very Cheap
20140902T000000,610000.0,4,2.75,2090,8400,1.0,0,0,4,8,1240,850,1976,0,98052,47.6872,-122.123,2340,9000,6310,6660,72.61904761904762,0.07016393442622951,Very Cheap
20141024T000000,385000.0,4,1.75,2080,8215,2.0,0,0,4,7,2080,0,1948,0,98155,47.737,-122.305,1550,8215,6135,6665,46.865489957395006,0.04065573770491803,Very Cheap
20150324T000000,367500.0,3,3.25,1400,1343,2.0,0,0,3,7,1160,240,2005,0,98118,47.5483,-122.277,1400,1326,-57,-74,273.64110201042445,0.03836065573770492,Very Cheap
20140804T000000,385100.0,3,1.0,1060,8040,1.0,0,0,4,6,1060,0,1949,0,98125,47.7121,-122.287,1300,7620,6980,6320,47.898009950248756,0.04066885245901639,Very Cheap
20141229T000000,230000.0,2,1.0,720,5913,1.0,0,0,3,6,720,0,1920,0,98118,47.5447,-122.27,1560,6600,5193,5040,38.89734483341789,0.020327868852459016,Very Cheap
20140623T000000,286000.0,3,2.75,1100,750,2.0,0,0,3,7,780,320,2008,0,98106,47.5601,-122.363,1170,4800,-350,3630,381.3333333333333,0.027672131147540982,Very Cheap
20150326T000000,201700.0,3,1.0,1010,9576,1.0,0,0,4,7,1010,0,1967,0,98001,47.2956,-122.272,1540,9576,8566,8036,21.063074352548036,0.016616393442622952,Very Cheap
20150423T000000,1350000.0,4,4.75,5230,89298,2.5,0,0,3,11,5230,0,2002,0,98038,47.4097,-122.063,4110,107153,84068,103043,15.117919774239065,0.16721311475409836,Cheap
20140519T000000,525000.0,4,1.75,2420,7672,1.0,0,0,3,8,1480,940,1979,0,98027,47.5637,-122.085,2370,7699,5252,5329,68.43065693430657,0.05901639344262295,Very Cheap
20150202T000000,361000.0,3,1.5,1200,7236,1.0,0,0,3,7,1200,0,1975,0,98011,47.739,-122.194,1680,7800,6036,6120,49.889441680486456,0.037508196721311476,Very Cheap
20140923T000000,530000.0,3,1.5,1950,1963,3.0,0,0,3,8,1950,0,2002,0,98117,47.6904,-122.397,1590,2028,13,438,269.99490575649514,0.05967213114754098,Very Cheap
20141008T000000,455000.0,3,2.25,1870,7403,1.0,0,0,3,7,1870,0,1950,0,98125,47.7171,-122.32,1630,7440,5533,5810,61.46156963393219,0.049836065573770495,Very Cheap
20141120T000000,421000.0,4,2.25,1310,8400,1.0,0,0,4,7,1310,0,1966,0,98034,47.7317,-122.181,1600,8400,7090,6800,50.11904761904762,0.045377049180327866,Very Cheap
20140502T000000,640000.0,4,2.0,1520,6200,1.5,0,0,3,7,1520,0,1945,0,98115,47.678,-122.269,1910,6200,4680,4290,103.2258064516129,0.0740983606557377,Very Cheap
20150331T000000,240000.0,3,1.0,1270,12733,1.0,0,0,3,7,1270,0,1955,0,98188,47.445,-122.276,1660,11536,11463,9876,18.848660959710987,0.021639344262295083,Very Cheap
20141024T000000,360000.0,2,1.0,840,7414,1.0,0,0,4,6,840,0,1928,0,98033,47.6771,-122.172,1740,9784,6574,8044,48.556784461828975,0.037377049180327866,Very Cheap
20150324T000000,157340.0,2,1.0,900,23000,1.0,0,0,2,7,900,0,1953,0,98042,47.3576,-122.156,1460,8265,22100,6805,6.840869565217392,0.010798688524590164,Very Cheap
20150415T000000,1240000.0,4,3.0,3010,6139,2.0,0,4,5,8,2560,450,1950,1972,98115,47.6799,-122.268,2100,6798,3129,4698,201.9872943476136,0.15278688524590164,Cheap
20140506T000000,250000.0,3,1.0,1050,6874,1.0,0,0,3,6,1050,0,1954,0,98133,47.762,-122.355,1500,8954,5824,7454,36.36892638929299,0.022950819672131147,Very Cheap
20150225T000000,735000.0,6,2.75,3360,84506,1.0,0,0,5,7,2040,1320,1962,0,98052,47.715,-122.121,2190,43124,81146,40934,8.69760727048967,0.08655737704918033,Very Cheap
20150115T000000,884900.0,7,4.75,5370,10800,1.5,0,0,3,8,5370,0,1967,0,98040,47.538,-122.223,2310,10910,5430,8600,81.93518518518519,0.10621639344262294,Cheap
20141023T000000,775000.0,3,3.5,2690,104544,2.0,0,0,3,8,2690,0,1948,1990,98072,47.7717,-122.112,2300,81698,101854,79398,7.413146617692072,0.09180327868852459,Very Cheap
20140502T000000,463000.0,3,1.75,1710,7320,1.0,0,0,3,7,1710,0,1948,0,98155,47.7512,-122.281,2260,8839,5610,6579,63.25136612021858,0.05088524590163934,Very Cheap
20140623T000000,579000.0,3,2.5,1640,1269,3.0,0,0,3,8,1640,0,2009,0,98112,47.6197,-122.3,1590,1231,-371,-359,456.26477541371156,0.06609836065573771,Very Cheap
20140709T000000,570000.0,6,3.75,4000,6015,2.0,0,2,3,10,3080,920,2004,0,98058,47.453,-122.118,3180,5700,2015,2520,94.76309226932668,0.06491803278688525,Very Cheap
20150331T000000,1060000.0,5,4.5,4140,7924,2.0,0,0,3,10,4140,0,2005,0,98074,47.6102,-121.993,3960,8410,3784,4450,133.77082281675922,0.12918032786885245,Cheap
20140909T000000,375000.0,4,2.75,3140,24800,1.0,0,0,4,8,2080,1060,1971,0,98042,47.3782,-122.161,2850,12900,21660,10050,15.120967741935484,0.03934426229508197,Very Cheap
20141209T000000,422000.0,2,1.75,1320,2609,1.0,0,0,4,7,920,400,1938,0,98117,47.6878,-122.366,1200,4220,1289,3020,161.74779609045612,0.04550819672131148,Very Cheap
20150209T000000,866500.0,4,3.5,3080,4945,2.0,0,0,3,9,2010,1070,2014,0,98126,47.5662,-122.379,1220,4945,1865,3725,175.22750252780585,0.10380327868852458,Cheap
20150413T000000,705000.0,3,2.5,2500,10359,2.0,0,0,3,10,2500,0,1986,0,98074,47.6286,-122.051,2580,10142,7859,7562,68.05676223573704,0.08262295081967214,Very Cheap
20141029T000000,470000.0,4,2.5,2520,9684,2.0,0,0,3,8,2520,0,1994,0,98045,47.4848,-121.801,2090,10133,7164,8043,48.533663775299466,0.05180327868852459,Very Cheap
20141218T000000,360000.0,3,1.25,2350,6200,1.0,0,0,4,7,1320,1030,1966,0,98007,47.5979,-122.135,2140,9543,3850,7403,58.064516129032256,0.037377049180327866,Very Cheap
20150429T000000,795000.0,4,2.5,2570,13450,1.0,0,4,3,8,1510,1060,1948,0,98155,47.7429,-122.285,3470,12615,10880,9145,59.10780669144982,0.09442622950819672,Very Cheap
20150330T000000,800000.0,4,2.5,3100,7807,2.0,0,0,3,9,3100,0,2003,0,98034,47.7151,-122.227,3100,7807,4707,4707,102.47214038683234,0.09508196721311475,Very Cheap
20140529T000000,2453500.0,4,3.5,4730,13586,1.5,0,0,5,10,4270,460,1935,0,98112,47.6319,-122.288,3710,8828,8856,5118,180.59031355807448,0.3119344262295082,Medium
20150408T000000,277284.0,3,1.75,1030,4800,1.0,0,0,3,6,930,100,1927,0,98126,47.566,-122.373,1540,4800,3770,3260,57.7675,0.02652904918032787,Very Cheap
20150413T000000,460000.0,2,1.0,1020,4002,1.0,0,0,5,7,1020,0,1953,0,98116,47.5828,-122.395,1780,5000,2982,3220,114.94252873563218,0.050491803278688525,Very Cheap
20150504T000000,898888.0,3,2.5,2080,3729,2.0,0,0,3,9,2080,0,1996,0,98033,47.6731,-122.199,2080,4000,1649,1920,241.0533655135425,0.10805088524590165,Cheap
20140806T000000,211000.0,3,1.0,1410,47916,1.0,0,0,3,7,1410,0,1981,0,98019,47.7149,-121.96,1810,215622,46506,213812,4.40353952750647,0.01783606557377049,Very Cheap
20140828T000000,222000.0,2,2.0,1360,3300,2.0,0,0,3,6,1360,0,2004,0,98038,47.3489,-122.022,1310,3300,1940,1990,67.27272727272727,0.019278688524590165,Very Cheap
20140529T000000,672000.0,3,2.5,2620,21587,2.0,0,0,3,7,2620,0,1992,0,98053,47.6384,-121.959,2570,23650,18967,21080,31.129846666975496,0.07829508196721312,Very Cheap
20141020T000000,778000.0,3,2.25,2260,33080,1.0,0,0,5,9,1690,570,1974,0,98005,47.6386,-122.183,3020,35291,30820,32271,23.518742442563482,0.09219672131147541,Very Cheap
20150121T000000,312500.0,3,1.75,1490,9493,1.0,0,0,4,8,1490,0,1976,0,98058,47.4514,-122.134,2440,9600,8003,7160,32.91899294216791,0.03114754098360656,Very Cheap
20140714T000000,650000.0,4,2.5,2530,6500,1.5,0,0,3,8,1720,810,1975,0,98115,47.6737,-122.284,2150,5280,3970,3130,100.0,0.07540983606557378,Very Cheap
20140826T000000,740000.0,6,2.25,3140,10250,1.0,0,0,4,8,1570,1570,1959,0,98005,47.6116,-122.169,2320,10250,7110,7930,72.1951219512195,0.08721311475409836,Very Cheap
20140826T000000,320000.0,3,2.0,1820,17600,1.0,0,0,5,7,1820,0,1972,0,98059,47.4703,-122.112,2190,17440,15780,15250,18.181818181818183,0.032131147540983604,Very Cheap
20150508T000000,455000.0,4,2.5,1770,13168,2.0,0,0,3,7,1770,0,1990,0,98019,47.7306,-121.966,2050,14859,11398,12809,34.55346294046173,0.049836065573770495,Very Cheap
20140513T000000,2450000.0,5,4.0,4430,9000,2.0,0,0,3,10,4430,0,2013,0,98004,47.6168,-122.216,2470,9490,4570,7020,272.22222222222223,0.3114754098360656,Medium
20141203T000000,500000.0,3,3.25,1490,902,3.0,0,0,3,8,1220,270,2001,0,98102,47.6357,-122.324,1550,1092,-588,-458,554.3237250554324,0.05573770491803279,Very Cheap
20140611T000000,325000.0,3,1.75,1790,27427,1.0,0,0,3,7,1130,660,1978,0,98065,47.532,-121.761,1610,16684,25637,15074,11.849637218798994,0.03278688524590164,Very Cheap
20140912T000000,416000.0,3,2.5,1710,1296,3.0,0,0,3,8,1510,200,2004,0,98103,47.6963,-122.342,1610,1282,-414,-328,320.98765432098764,0.044721311475409836,Very Cheap
20150318T000000,495000.0,4,2.25,2070,20280,2.0,0,0,4,7,2070,0,1968,0,98072,47.774,-122.134,2190,21560,18210,19370,24.40828402366864,0.05508196721311476,Very Cheap
20140505T000000,549000.0,2,1.0,1140,5400,1.0,0,0,5,7,1140,0,1908,0,98112,47.6205,-122.294,1520,4800,4260,3280,101.66666666666667,0.06216393442622951,Very Cheap
20140825T000000,589000.0,5,2.0,3930,10150,1.5,0,0,4,8,3070,860,1968,0,98008,47.6317,-122.114,2200,8190,6220,5990,58.029556650246306,0.06740983606557377,Very Cheap
20141121T000000,194820.0,3,1.5,1100,32700,1.0,0,0,3,7,1100,0,1967,0,98001,47.3186,-122.289,1616,32700,31600,31084,5.957798165137615,0.015714098360655737,Very Cheap
20141216T000000,405000.0,3,2.5,2260,5500,1.5,0,0,3,7,1280,980,1910,0,98117,47.681,-122.388,1790,5355,3240,3565,73.63636363636364,0.043278688524590166,Very Cheap
20150408T000000,625000.0,3,2.5,2260,5500,1.5,0,0,3,7,1280,980,1910,0,98117,47.681,-122.388,1790,5355,3240,3565,113.63636363636364,0.07213114754098361,Very Cheap
20141113T000000,205000.0,3,1.0,1130,7014,1.0,0,0,3,7,1130,0,1954,0,98168,47.4743,-122.274,1440,9350,5884,7910,29.227259766181923,0.017049180327868854,Very Cheap
20140623T000000,345100.0,3,3.75,1950,8625,1.0,0,0,3,8,1360,590,1959,0,98178,47.505,-122.258,1950,6670,6675,4720,40.01159420289855,0.03542295081967213,Very Cheap
20141020T000000,200000.0,3,1.0,960,7500,1.0,0,0,3,6,960,0,1953,0,98178,47.4966,-122.255,1250,6000,6540,4750,26.666666666666668,0.01639344262295082,Very Cheap
20150212T000000,1905000.0,4,3.5,4210,18564,2.0,0,0,3,11,4210,0,2001,0,98039,47.6206,-122.225,3520,18564,14354,15044,102.61797026502909,0.24,Cheap
20141029T000000,524500.0,3,1.5,3430,264844,1.0,0,2,3,7,2230,1200,1988,0,98045,47.4476,-121.723,1660,145926,261414,144266,1.9804111099364154,0.05895081967213115,Very Cheap
20140826T000000,598600.0,4,2.75,3470,212639,2.0,0,0,3,7,2070,1400,1993,0,98019,47.7066,-121.968,2370,233917,209169,231547,2.8150997700327784,0.0686688524590164,Very Cheap
20141209T000000,367777.0,5,3.0,2140,5937,1.0,0,0,3,7,1280,860,1978,0,98118,47.5459,-122.27,1820,6710,3797,4890,61.946606029981474,0.038396983606557376,Very Cheap
20140507T000000,750000.0,3,2.75,2520,5401,1.0,0,0,4,7,1360,1160,1946,0,98119,47.6452,-122.373,1800,5036,2881,3236,138.86317348639142,0.08852459016393442,Very Cheap
20141105T000000,575000.0,5,2.25,3550,7992,2.0,0,0,3,8,3550,0,1968,0,98034,47.7285,-122.179,2110,7992,4442,5882,71.94694694694695,0.06557377049180328,Very Cheap
20150430T000000,84000.0,2,1.0,700,20130,1.0,0,0,3,6,700,0,1949,0,98168,47.4752,-122.271,1490,18630,19430,17140,4.172876304023845,0.001180327868852459,Very Cheap
20141218T000000,255000.0,2,1.0,740,5000,1.0,0,0,4,6,740,0,1926,0,98118,47.5298,-122.273,1170,4968,4260,3798,51.0,0.02360655737704918,Very Cheap
20140520T000000,1740000.0,4,3.75,3300,4545,1.5,0,4,3,10,2600,700,1926,1999,98105,47.6561,-122.274,3300,5000,1245,1700,382.8382838283828,0.2183606557377049,Cheap
20150513T000000,415000.0,3,2.25,1640,5880,1.0,0,0,3,7,1240,400,1977,0,98106,47.5323,-122.351,1200,4760,4240,3560,70.578231292517,0.04459016393442623,Very Cheap
20150507T000000,449900.0,3,2.5,2780,8225,2.0,0,1,3,9,2780,0,1990,0,98198,47.3509,-122.323,720,9736,5445,9016,54.69908814589666,0.049167213114754096,Very Cheap
20140919T000000,220000.0,5,1.5,1830,94960,1.5,0,0,3,7,1830,0,1929,0,98031,47.4218,-122.218,1440,16365,93130,14925,2.316764953664701,0.01901639344262295,Very Cheap
20150410T000000,899000.0,4,2.5,3540,9349,2.0,0,0,3,10,3540,0,2003,0,98052,47.7046,-122.107,3280,7546,5809,4266,96.16001711412986,0.10806557377049181,Cheap
20140714T000000,430000.0,3,2.5,1440,7320,1.0,0,0,5,7,1440,0,1954,0,98125,47.7179,-122.316,1160,6941,5880,5781,58.743169398907106,0.04655737704918033,Very Cheap
20150130T000000,472500.0,4,2.5,2960,223462,2.0,0,0,3,10,2960,0,2001,0,98030,47.3646,-122.211,2770,16482,220502,13712,2.1144534641236543,0.05213114754098361,Very Cheap
20141229T000000,680000.0,6,2.5,3180,9375,1.0,0,0,4,8,1590,1590,1967,0,98006,47.5707,-122.129,2670,9625,6195,6955,72.53333333333333,0.07934426229508197,Very Cheap
20150305T000000,1650000.0,5,4.0,3310,8400,2.0,0,0,3,10,3310,0,2000,0,98033,47.6914,-122.214,3430,8400,5090,4970,196.42857142857142,0.20655737704918034,Cheap
20141118T000000,810000.0,3,2.0,2390,8025,2.0,0,0,5,7,2390,0,1921,0,98105,47.6707,-122.288,1920,5350,5635,3430,100.93457943925233,0.09639344262295083,Very Cheap
20150305T000000,605000.0,3,2.5,2460,138085,2.0,0,0,4,9,2460,0,1977,0,98027,47.4572,-122.007,2090,219542,135625,217452,4.381359307672811,0.06950819672131148,Very Cheap
20140725T000000,522000.0,3,1.75,1630,15600,1.0,0,0,3,7,1630,0,1958,0,98033,47.68,-122.165,1830,10850,13970,9020,33.46153846153846,0.05862295081967213,Very Cheap
20150203T000000,759000.0,5,2.75,3490,8230,2.0,0,0,3,10,3490,0,2005,0,98075,47.5825,-121.97,3480,7331,4740,3851,92.2235722964763,0.08970491803278688,Very Cheap
20140519T000000,411000.0,4,2.75,2500,5257,2.0,0,0,3,8,2500,0,1966,0,98118,47.5293,-122.287,1660,5970,2757,4310,78.18147232261747,0.044065573770491806,Very Cheap
20150306T000000,286950.0,4,2.5,2080,9846,1.0,0,0,3,7,1240,840,1984,0,98001,47.3338,-122.268,1890,7977,7766,6087,29.143814747105424,0.02779672131147541,Very Cheap
20140610T000000,440000.0,3,1.5,1290,1286,3.0,0,0,3,7,1290,0,2000,0,98103,47.6617,-122.349,1720,1286,-4,-434,342.1461897356143,0.04786885245901639,Very Cheap
20140523T000000,149000.0,3,1.0,1700,8645,1.0,0,0,3,6,1700,0,1955,0,98146,47.4899,-122.337,1500,7980,6945,6480,17.235396182764603,0.009704918032786886,Very Cheap
20141112T000000,284700.0,3,1.0,1700,8645,1.0,0,0,3,6,1700,0,1955,0,98146,47.4899,-122.337,1500,7980,6945,6480,32.932330827067666,0.027501639344262294,Very Cheap
20140909T000000,374950.0,3,2.5,2540,11562,1.0,0,1,3,8,1290,1250,1964,0,98028,47.7614,-122.229,2230,10310,9022,8080,32.42951046531742,0.03933770491803279,Very Cheap
20140916T000000,816000.0,3,1.5,1180,8545,1.0,0,0,3,8,1180,0,1952,0,98004,47.624,-122.2,1660,9000,7365,7340,95.49444119368052,0.09718032786885246,Very Cheap
20141121T000000,533250.0,4,1.75,1520,15398,1.0,0,0,4,7,1370,150,1960,0,98027,47.5265,-122.05,1840,12500,13878,10660,34.631120924795425,0.060098360655737704,Very Cheap
20140603T000000,689800.0,3,2.75,2390,9313,1.0,0,0,5,8,1390,1000,1942,0,98133,47.7209,-122.331,2390,12712,6923,10322,74.06850638891872,0.08062950819672131,Very Cheap
20140813T000000,775000.0,4,2.75,2740,6200,1.5,0,3,4,8,1820,920,1947,0,98125,47.7084,-122.277,2430,6000,3460,3570,125.0,0.09180327868852459,Very Cheap
20150506T000000,702000.0,3,2.5,2190,8528,1.0,0,0,3,8,1760,430,1991,0,98033,47.6943,-122.209,2060,9811,6338,7751,82.3170731707317,0.08222950819672131,Very Cheap
20140708T000000,160000.0,3,1.0,1350,8700,1.5,0,0,3,6,1350,0,1942,0,98188,47.4497,-122.289,1300,8700,7350,7400,18.39080459770115,0.011147540983606558,Very Cheap
20150309T000000,255500.0,3,1.0,1350,8700,1.5,0,0,3,6,1350,0,1942,0,98188,47.4497,-122.289,1300,8700,7350,7400,29.367816091954023,0.023672131147540982,Very Cheap
20141202T000000,949000.0,4,2.75,2980,42253,1.0,0,0,4,9,1860,1120,1973,0,98005,47.6392,-122.163,2980,42253,39273,39273,22.45994367263863,0.11462295081967214,Cheap
20140731T000000,169500.0,2,1.0,790,7450,1.0,0,0,4,6,790,0,1944,0,98058,47.4743,-122.17,800,7450,6660,6650,22.751677852348994,0.01239344262295082,Very Cheap
20140915T000000,586000.0,4,2.25,2130,9000,2.0,0,0,4,8,2130,0,1965,0,98006,47.5716,-122.159,2110,10431,6870,8321,65.11111111111111,0.06701639344262295,Very Cheap
20150203T000000,680000.0,4,2.5,2700,37431,1.0,0,0,4,8,1600,1100,1978,0,98072,47.7258,-122.117,2290,37431,34731,35141,18.166760172049905,0.07934426229508197,Very Cheap
20141208T000000,851500.0,3,2.0,3200,18184,1.0,0,0,5,8,2000,1200,1977,0,98005,47.6034,-122.172,1670,7416,14984,5746,46.826880774307085,0.10183606557377049,Cheap
20140514T000000,582500.0,2,1.5,1159,4800,1.0,0,0,3,7,1159,0,1948,0,98199,47.6592,-122.399,1640,4800,3641,3160,121.35416666666667,0.06655737704918033,Very Cheap
20140826T000000,637000.0,4,3.5,3080,118918,2.0,0,0,3,9,3080,0,2008,0,98019,47.7721,-121.924,1830,434728,115838,432898,5.356632301249601,0.07370491803278688,Very Cheap
20150128T000000,225000.0,3,1.0,1000,9295,1.0,0,0,3,7,1000,0,1955,0,98146,47.484,-122.346,1320,13500,8295,12180,24.206562668101128,0.019672131147540985,Very Cheap
20141231T000000,795000.0,3,3.25,2260,3727,2.0,0,0,3,8,1880,380,2003,0,98119,47.6422,-122.361,1600,4800,1467,3200,213.30829085055004,0.09442622950819672,Very Cheap
20140818T000000,304999.0,4,2.25,2270,9600,1.0,0,0,3,7,1290,980,1976,0,98023,47.3261,-122.355,1930,15000,7330,13070,31.770729166666666,0.030163803278688523,Very Cheap
20150505T000000,95000.0,1,0.75,760,5746,1.0,0,0,4,5,760,0,1915,0,98002,47.3046,-122.215,970,6696,4986,5726,16.533240515140967,0.002622950819672131,Very Cheap
20141016T000000,240000.0,4,1.75,1420,5382,1.0,0,0,5,5,1040,380,1942,0,98056,47.4946,-122.187,1150,5382,3962,4232,44.593088071348944,0.021639344262295083,Very Cheap
20140813T000000,772000.0,4,2.5,2500,8680,1.0,0,0,4,7,1250,1250,1958,0,98004,47.6073,-122.192,2140,8680,6180,6540,88.94009216589862,0.09140983606557378,Very Cheap
20141113T000000,245000.0,2,1.5,1450,6258,1.0,0,0,4,8,1450,0,1983,0,98198,47.3785,-122.322,1460,5375,4808,3915,39.14988814317673,0.022295081967213116,Very Cheap
20141205T000000,430000.0,5,3.0,2500,5750,1.0,0,0,3,8,1430,1070,1999,0,98126,47.551,-122.369,1980,7130,3250,5150,74.78260869565217,0.04655737704918033,Very Cheap
20140611T000000,799000.0,3,1.5,2210,6300,1.5,0,0,5,8,2210,0,1916,0,98144,47.5892,-122.29,2700,6300,4090,3600,126.82539682539682,0.09495081967213115,Very Cheap
20150417T000000,880000.0,5,2.75,3020,9187,2.0,0,0,3,9,3020,0,2007,0,98033,47.6806,-122.167,2250,9675,6167,7425,95.78752585174703,0.10557377049180328,Cheap
20141208T000000,750000.0,4,2.5,3290,7538,2.0,0,0,3,9,3290,0,2004,0,98075,47.598,-121.972,3450,7538,4248,4088,99.49588750331652,0.08852459016393442,Very Cheap
20141219T000000,2890000.0,4,4.0,5780,7173,2.0,0,0,3,11,4130,1650,2008,0,98112,47.6374,-122.288,3930,7994,1393,4064,402.8997630001394,0.36918032786885246,Medium
20140604T000000,532000.0,3,2.5,1820,4910,2.0,0,0,3,8,1820,0,1993,0,98029,47.5703,-121.996,2090,6668,3090,4578,108.35030549898167,0.059934426229508196,Very Cheap
20140805T000000,525000.0,4,2.75,2500,10330,1.0,0,0,4,8,1380,1120,1978,0,98155,47.7743,-122.286,2270,10430,7830,8160,50.82284607938045,0.05901639344262295,Very Cheap
20141117T000000,239000.0,2,1.0,1210,9375,1.0,0,1,4,7,1210,0,1952,0,98198,47.3865,-122.322,1680,8400,8165,6720,25.493333333333332,0.021508196721311476,Very Cheap
20140616T000000,460000.0,2,1.5,1090,4000,1.0,0,0,3,8,970,120,1951,0,98116,47.5798,-122.393,1700,4000,2910,2300,115.0,0.050491803278688525,Very Cheap
20140605T000000,540000.0,4,2.25,1330,8400,1.5,0,0,3,8,1330,0,1962,0,98005,47.6078,-122.169,2270,10146,7070,7876,64.28571428571429,0.06098360655737705,Very Cheap
20140606T000000,475000.0,2,1.0,890,4590,1.0,0,0,3,7,890,0,1923,0,98117,47.6901,-122.362,1310,4590,3700,3280,103.48583877995642,0.05245901639344262,Very Cheap
20150421T000000,445000.0,3,1.75,1360,4998,1.0,0,0,3,8,1360,0,1968,2014,98108,47.547,-122.302,1350,4998,3638,3648,89.03561424569828,0.04852459016393443,Very Cheap
20140905T000000,1575000.0,5,3.75,4220,9240,2.0,0,2,5,11,3420,800,1991,0,98040,47.5895,-122.229,3380,9240,5020,5860,170.45454545454547,0.19672131147540983,Cheap
20150409T000000,549950.0,4,2.5,3780,6800,2.0,0,0,3,8,3780,0,2004,0,98038,47.3526,-122.012,3640,7326,3020,3686,80.875,0.062288524590163936,Very Cheap
20141017T000000,294950.0,4,2.0,2610,14321,1.5,0,0,4,6,1690,920,1940,0,98188,47.4672,-122.296,1630,8599,11711,6969,20.595628796871726,0.028845901639344262,Very Cheap
20141021T000000,736000.0,3,2.5,1980,2975,3.0,0,2,3,8,1980,0,1993,0,98109,47.6294,-122.344,1980,3144,995,1164,247.39495798319328,0.08668852459016393,Very Cheap
20150430T000000,214946.0,3,1.75,1290,8688,1.0,0,0,4,7,1290,0,1980,0,98042,47.3655,-122.08,1750,9090,7398,7340,24.740561694290975,0.018353573770491804,Very Cheap
20141030T000000,856000.0,5,3.25,3620,5500,2.0,0,2,3,9,3620,0,2003,0,98029,47.5442,-121.996,3260,5500,1880,2240,155.63636363636363,0.10242622950819671,Cheap
20140504T000000,775000.0,2,2.5,2680,7392,1.0,0,0,3,9,2680,0,2004,0,98053,47.717,-122.026,2315,7045,4712,4730,104.8430735930736,0.09180327868852459,Very Cheap
20150203T000000,205000.0,3,1.75,1200,8631,1.0,0,0,3,7,1200,0,1959,0,98198,47.3864,-122.308,1564,8115,7431,6551,23.751593094658787,0.017049180327868854,Very Cheap
20141001T000000,429592.0,2,2.75,1992,10946,1.5,1,4,5,6,1288,704,1903,0,98070,47.3551,-122.475,1110,8328,8954,7218,39.2464827334186,0.04650386885245902,Very Cheap
20150206T000000,414250.0,4,1.75,1640,13566,1.0,0,0,4,7,1120,520,1977,0,98072,47.7423,-122.099,1470,13530,11926,12060,30.5358985699543,0.04449180327868853,Very Cheap
20150202T000000,399950.0,4,2.75,1920,4400,1.0,0,0,4,6,960,960,1906,0,98106,47.5532,-122.365,1040,4400,2480,3360,90.89772727272727,0.04261639344262295,Very Cheap
20141014T000000,319990.0,3,2.25,1840,7326,1.0,0,0,5,7,1370,470,1979,0,98031,47.3958,-122.168,2050,7475,5486,5425,43.67867867867868,0.03212983606557377,Very Cheap
20150109T000000,524000.0,3,1.5,1310,9471,1.0,0,0,4,8,1310,0,1970,0,98052,47.6644,-122.148,2100,9449,8161,7349,55.32678703410411,0.05888524590163934,Very Cheap
20150108T000000,349950.0,2,1.0,1050,6317,1.5,0,0,4,7,1050,0,1913,0,98019,47.7364,-121.981,1600,9616,5267,8016,55.398132024695265,0.036059016393442625,Very Cheap
20141031T000000,889000.0,4,2.5,2570,4480,1.5,0,0,4,8,1580,990,1927,0,98105,47.6701,-122.291,2070,4480,1910,2410,198.4375,0.10675409836065573,Cheap
20140707T000000,300000.0,3,1.0,930,5160,1.5,0,0,5,6,930,0,1919,0,98106,47.5256,-122.357,1060,5160,4230,4100,58.13953488372093,0.029508196721311476,Very Cheap
20140602T000000,395000.0,1,1.0,730,3000,1.0,0,0,3,7,730,0,1911,0,98107,47.6741,-122.396,1520,5000,2270,3480,131.66666666666666,0.0419672131147541,Very Cheap
20150203T000000,348000.0,2,2.5,1270,1242,3.0,0,0,3,7,1270,0,2008,0,98117,47.701,-122.362,1280,1199,-28,-81,280.19323671497585,0.03580327868852459,Very Cheap
20150226T000000,830000.0,2,1.0,1150,6000,1.0,0,1,4,7,710,440,1921,0,98033,47.6841,-122.213,2450,7200,4850,4750,138.33333333333334,0.09901639344262295,Very Cheap
20140612T000000,173000.0,2,1.0,820,10450,1.0,0,0,4,7,820,0,1965,0,98055,47.4261,-122.199,1240,11200,9630,9960,16.555023923444978,0.012852459016393442,Very Cheap
20140522T000000,585000.0,4,1.75,3000,42200,1.0,0,3,3,7,1500,1500,1950,0,98056,47.5265,-122.202,2500,9821,39200,7321,13.862559241706162,0.06688524590163934,Very Cheap
20150213T000000,576750.0,3,2.0,2220,5000,1.0,0,0,4,7,1110,1110,1966,0,98116,47.5807,-122.394,1450,5000,2780,3550,115.35,0.06580327868852459,Very Cheap
20150504T000000,495000.0,5,3.25,2500,7620,1.0,0,3,3,7,1250,1250,1962,0,98106,47.5298,-122.344,2020,7620,5120,5600,64.96062992125984,0.05508196721311476,Very Cheap
20141015T000000,216650.0,3,3.5,1540,1427,2.0,0,0,3,7,1360,180,2007,0,98109,47.542,-122.322,1220,4000,-113,2780,151.82200420462507,0.01857704918032787,Very Cheap
20150413T000000,615000.0,4,2.75,2750,15450,1.0,0,0,3,8,1800,950,1978,0,98155,47.7749,-122.283,2750,10620,12700,7870,39.80582524271845,0.07081967213114754,Very Cheap
20141024T000000,675000.0,4,2.5,3130,12463,1.0,0,0,4,8,1620,1510,1978,0,98006,47.569,-122.127,2740,11779,9333,9039,54.16031453101179,0.07868852459016394,Very Cheap
20150401T000000,510000.0,3,2.0,1430,9250,1.0,0,0,4,8,990,440,1983,0,98052,47.6952,-122.096,1830,8003,7820,6173,55.13513513513514,0.057049180327868855,Very Cheap
20140507T000000,630000.0,3,2.5,2680,327135,2.0,0,0,3,8,2680,0,1995,0,98010,47.3783,-122.003,2020,60080,324455,58060,1.9258104452290339,0.07278688524590164,Very Cheap
20140801T000000,359950.0,4,2.5,3010,5701,2.0,0,0,3,8,3010,0,2003,0,98042,47.3492,-122.152,3010,5772,2691,2762,63.13804595684967,0.037370491803278685,Very Cheap
20141003T000000,265000.0,3,1.5,1530,7500,1.5,0,0,3,7,1530,0,1986,0,98038,47.3639,-122.055,2080,11250,5970,9170,35.333333333333336,0.024918032786885248,Very Cheap
20140521T000000,210000.0,3,1.0,1240,4842,1.0,0,0,4,6,1240,0,1916,0,98118,47.5166,-122.269,1540,5110,3602,3570,43.37050805452292,0.017704918032786884,Very Cheap
20150325T000000,367000.0,3,2.5,2260,93218,1.0,0,2,4,6,2260,0,1998,0,98022,47.2582,-121.935,2180,111078,90958,108898,3.937007874015748,0.03829508196721312,Very Cheap
20150413T000000,1075000.0,4,2.25,2820,5000,1.5,0,2,4,9,1800,1020,1926,0,98122,47.6097,-122.287,2880,6000,2180,3120,215.0,0.13114754098360656,Cheap
20150211T000000,756000.0,3,2.5,3560,8297,1.0,0,2,4,8,1650,1910,1948,0,98199,47.6473,-122.407,2760,8297,4737,5537,91.11727130288055,0.08931147540983607,Very Cheap
20140724T000000,203000.0,3,2.25,1630,9145,1.0,0,0,3,7,1630,0,1960,0,98146,47.5,-122.347,1630,9206,7515,7576,22.197922361946418,0.01678688524590164,Very Cheap
20150121T000000,535000.0,4,2.5,2880,23994,2.0,0,3,3,9,2880,0,2002,0,98022,47.2124,-122.005,2470,17009,21114,14539,22.297240976910896,0.06032786885245902,Very Cheap
20150323T000000,525000.0,3,3.25,2200,7440,2.0,0,0,4,7,1710,490,1947,0,98118,47.5409,-122.268,1260,6765,5240,5505,70.56451612903226,0.05901639344262295,Very Cheap
20150309T000000,347500.0,3,1.75,1620,7500,1.0,0,0,3,7,1220,400,1981,0,98059,47.4815,-122.162,1470,7938,5880,6468,46.333333333333336,0.035737704918032784,Very Cheap
20140505T000000,620000.0,3,1.75,1480,2185,2.5,0,0,3,9,1480,0,2005,0,98034,47.6945,-122.17,1480,2441,705,961,283.7528604118993,0.07147540983606557,Very Cheap
20150422T000000,645000.0,4,2.5,2250,10696,2.0,0,0,3,8,2250,0,1996,0,98006,47.5715,-122.128,2340,13286,8446,10946,60.302916978309646,0.07475409836065573,Very Cheap
20141203T000000,2200000.0,4,3.0,3540,11098,2.0,0,0,3,10,3000,540,1940,0,98112,47.634,-122.288,3430,8214,7558,4784,198.23391602090467,0.2786885245901639,Cheap
20140619T000000,280000.0,3,2.0,1790,42399,1.0,0,0,4,7,1790,0,1990,0,98092,47.3143,-122.134,1330,40015,40609,38685,6.6039293379560835,0.026885245901639345,Very Cheap
20150501T000000,432000.0,3,2.0,1400,6380,1.0,0,0,4,7,700,700,1924,0,98125,47.7015,-122.316,1690,5800,4980,4110,67.7115987460815,0.046819672131147544,Very Cheap
20141222T000000,790000.0,3,1.5,2390,4452,2.0,0,1,3,9,1790,600,1929,0,98126,47.5826,-122.378,2610,5000,2062,2390,177.4483378256963,0.09377049180327869,Very Cheap
20150113T000000,635000.0,4,1.75,2400,10050,1.0,0,0,5,8,2400,0,1957,0,98008,47.6339,-122.124,1680,10050,7650,8370,63.18407960199005,0.07344262295081967,Very Cheap
20140819T000000,442000.0,3,1.5,2050,6384,1.0,0,0,3,7,1350,700,1958,0,98126,47.5325,-122.378,1590,7214,4334,5624,69.23558897243107,0.048131147540983604,Very Cheap
20150422T000000,490000.0,4,3.0,2640,5267,2.0,0,0,3,7,2640,0,2001,0,98065,47.5298,-121.88,2640,5670,2627,3030,93.03208657679893,0.05442622950819672,Very Cheap
20140925T000000,250000.0,5,1.75,2320,7700,1.0,0,0,5,7,1290,1030,1962,0,98001,47.3426,-122.285,1740,7210,5380,5470,32.467532467532465,0.022950819672131147,Very Cheap
20140619T000000,1325000.0,4,2.5,2440,3600,2.5,0,0,4,8,2440,0,1902,0,98119,47.6298,-122.362,2440,5440,1160,3000,368.05555555555554,0.16393442622950818,Cheap
20141027T000000,120000.0,3,1.0,1260,7500,1.0,0,0,3,6,1260,0,1954,0,98198,47.4191,-122.33,1260,7500,6240,6240,16.0,0.005901639344262295,Very Cheap
20140918T000000,2950000.0,5,4.75,6240,47480,1.0,0,3,3,11,4610,1630,2003,0,98040,47.5317,-122.233,4170,17668,41240,13498,62.13142375737152,0.3770491803278688,Medium
20140923T000000,325000.0,4,2.5,1930,8458,2.0,0,0,3,7,1930,0,1993,0,98038,47.3645,-122.039,1670,9485,6528,7815,38.42515961220147,0.03278688524590164,Very Cheap
20140612T000000,210000.0,4,1.75,1200,7680,1.0,0,0,3,7,1200,0,1968,0,98092,47.3138,-122.192,1490,7800,6480,6310,27.34375,0.017704918032786884,Very Cheap
20150504T000000,215000.0,1,1.0,970,7639,1.0,0,0,4,5,570,400,1920,0,98166,47.4655,-122.346,1360,7380,6669,6020,28.145045162979446,0.018360655737704918,Very Cheap
20141029T000000,387000.0,3,1.75,1810,10800,1.0,0,0,5,8,1210,600,1968,0,98056,47.5236,-122.184,1800,10800,8990,9000,35.833333333333336,0.040918032786885244,Very Cheap
20140918T000000,408000.0,3,1.0,1380,7015,1.5,0,0,4,7,1380,0,1925,0,98117,47.6987,-122.36,1160,6700,5635,5540,58.161083392729864,0.04367213114754098,Very Cheap
20140710T000000,410000.0,3,1.0,1470,6500,1.0,0,0,4,7,1470,0,1953,0,98166,47.473,-122.362,1470,9300,5030,7830,63.07692307692308,0.043934426229508196,Very Cheap
20141216T000000,216000.0,3,1.0,1010,7920,1.0,0,0,3,6,1010,0,1925,0,98126,47.5249,-122.37,1520,7560,6910,6040,27.272727272727273,0.018491803278688525,Very Cheap
20150330T000000,390000.0,3,1.0,1010,7920,1.0,0,0,3,6,1010,0,1925,0,98126,47.5249,-122.37,1520,7560,6910,6040,49.24242424242424,0.04131147540983607,Very Cheap
20141211T000000,357000.0,3,1.5,1340,11744,1.0,0,0,2,7,1340,0,1950,0,98146,47.4947,-122.36,2020,13673,10404,11653,30.39850136239782,0.03698360655737705,Very Cheap
20140519T000000,215000.0,3,1.0,970,7275,1.0,0,0,4,7,970,0,1970,0,98031,47.4006,-122.188,1750,7200,6305,5450,29.553264604810998,0.018360655737704918,Very Cheap
20150213T000000,265000.0,3,1.0,1122,6554,1.5,0,0,3,5,1122,0,1900,0,98118,47.5135,-122.257,1610,5650,5432,4040,40.433323161428135,0.024918032786885248,Very Cheap
20141209T000000,589950.0,3,2.75,1670,1350,3.0,0,0,3,9,1350,320,2014,0,98116,47.5763,-122.408,1520,4800,-320,3280,437.0,0.0675344262295082,Very Cheap
20150206T000000,440000.0,3,1.75,2840,16851,1.0,0,3,3,8,1600,1240,1950,0,98155,47.7458,-122.287,2650,11063,14011,8413,26.11121001720966,0.04786885245901639,Very Cheap
20150429T000000,248000.0,2,1.0,770,8600,1.0,0,0,4,4,770,0,1914,0,98027,47.5325,-122.031,1420,6960,7830,5540,28.837209302325583,0.022688524590163933,Very Cheap
20140911T000000,730000.0,3,2.25,2040,130680,2.0,0,0,3,9,2040,0,1977,0,98072,47.7584,-122.136,3080,39630,128640,36550,5.586164677073768,0.0859016393442623,Very Cheap
20150119T000000,425000.0,4,2.5,3052,12145,2.0,0,0,3,8,3052,0,2004,0,98003,47.2598,-122.304,2767,8604,9093,5837,34.99382461918485,0.04590163934426229,Very Cheap
20140912T000000,680000.0,3,2.5,2620,14248,2.0,0,0,4,8,1830,790,1977,0,98004,47.6281,-122.194,2620,12343,11628,9723,47.72599663110612,0.07934426229508197,Very Cheap
20150218T000000,341500.0,5,2.25,3120,10400,2.0,0,0,3,8,3120,0,1980,0,98023,47.3097,-122.34,2160,8267,7280,6107,32.83653846153846,0.03495081967213115,Very Cheap
20150508T000000,395000.0,2,1.0,1100,3975,1.0,0,0,3,7,900,200,1950,0,98105,47.6701,-122.286,1110,4280,2875,3170,99.37106918238993,0.0419672131147541,Very Cheap
20140731T000000,1225000.0,4,2.75,3410,95396,1.5,0,0,4,10,3410,0,1962,0,98005,47.6547,-122.158,3721,35352,91986,31631,12.841209275022013,0.15081967213114755,Cheap
20140708T000000,695500.0,5,2.75,2510,9180,1.0,0,1,4,8,1600,910,1975,0,98052,47.6389,-122.098,2650,9780,6670,7130,75.76252723311546,0.08137704918032787,Very Cheap
20141002T000000,308000.0,3,1.75,1680,8629,1.0,0,0,3,8,1200,480,1977,0,98198,47.3662,-122.319,1990,8400,6949,6410,35.693591377911694,0.030557377049180327,Very Cheap
20150218T000000,422500.0,3,2.0,1960,6450,1.0,0,0,4,7,1000,960,1977,0,98038,47.3972,-122.029,1660,20720,4490,19060,65.50387596899225,0.04557377049180328,Very Cheap
20150421T000000,418000.0,2,1.0,1040,6900,1.0,0,0,4,7,1040,0,1915,0,98136,47.5411,-122.391,1620,6280,5860,4660,60.57971014492754,0.04498360655737705,Very Cheap
20141007T000000,385000.0,5,1.5,1750,9780,1.5,0,0,4,7,1750,0,1961,0,98028,47.7755,-122.235,1750,10295,8030,8545,39.36605316973415,0.04065573770491803,Very Cheap
20140512T000000,876650.0,3,3.25,2170,12508,1.5,0,0,5,9,1650,520,1928,1970,98040,47.5665,-122.229,2720,21070,10338,18350,70.08714422769428,0.1051344262295082,Cheap
20140821T000000,450000.0,3,2.5,1639,2710,2.0,0,0,3,8,1479,160,2003,0,98144,47.5924,-122.294,1580,1733,1071,153,166.05166051660515,0.04918032786885246,Very Cheap
20140625T000000,418800.0,4,2.25,2100,9984,1.0,0,0,4,7,1290,810,1973,0,98028,47.7365,-122.242,1930,10511,7884,8581,41.94711538461539,0.045088524590163936,Very Cheap
20141008T000000,330000.0,2,1.0,880,1753,2.0,0,0,4,7,880,0,1945,0,98199,47.6475,-122.397,1010,1748,873,738,188.24871648602397,0.03344262295081967,Very Cheap
20150416T000000,550000.0,3,1.75,1940,8376,1.0,0,0,4,8,1290,650,1963,0,98006,47.5586,-122.173,2400,8674,6436,6274,65.66380133715377,0.06229508196721312,Very Cheap
20141030T000000,270000.0,4,2.5,2490,11650,1.0,0,0,3,7,1390,1100,1990,0,98148,47.4416,-122.332,2010,10495,9160,8485,23.175965665236053,0.025573770491803278,Very Cheap
20150429T000000,978500.0,3,2.25,2060,7080,2.0,0,0,3,9,1800,260,1940,0,98199,47.6455,-122.409,3070,7500,5020,4430,138.20621468926555,0.11849180327868852,Cheap
20140930T000000,975000.0,4,2.5,2720,10455,2.0,0,2,3,10,2500,220,1981,0,98006,47.5564,-122.158,3240,12348,7735,9108,93.25681492109038,0.1180327868852459,Cheap
20140725T000000,455000.0,3,2.25,2180,6850,1.0,0,0,3,7,1750,430,1973,0,98034,47.7246,-122.217,1740,7016,4670,5276,66.42335766423358,0.049836065573770495,Very Cheap
20141009T000000,1415000.0,4,3.25,3600,38016,2.0,0,2,3,11,3310,290,1991,0,98034,47.7124,-122.253,2440,22693,34416,20253,37.221170033670035,0.17573770491803278,Cheap
20150406T000000,220000.0,2,1.0,840,9000,1.0,0,0,5,6,840,0,1951,0,98168,47.5033,-122.329,1350,10400,8160,9050,24.444444444444443,0.01901639344262295,Very Cheap
20140813T000000,490000.0,3,2.0,2370,12196,2.0,0,0,4,7,2370,0,1970,0,98033,47.6734,-122.176,1380,12196,9826,10816,40.177107248278126,0.05442622950819672,Very Cheap
20150421T000000,420000.0,4,2.25,2270,9100,2.0,0,0,3,7,2270,0,1978,0,98034,47.7242,-122.17,1710,7910,6830,6200,46.15384615384615,0.04524590163934426,Very Cheap
20141208T000000,408500.0,4,2.5,2720,7043,2.0,0,0,3,9,2720,0,2003,0,98092,47.3315,-122.169,2640,6958,4323,4318,58.00085190969757,0.043737704918032784,Very Cheap
20150327T000000,716000.0,3,1.5,1140,4800,1.5,0,0,3,7,1140,0,1915,0,98109,47.6368,-122.354,1260,4800,3660,3540,149.16666666666666,0.0840655737704918,Very Cheap
20140602T000000,965000.0,4,2.5,2460,5000,2.0,0,0,5,8,1620,840,1938,0,98112,47.6282,-122.293,2320,5000,2540,2680,193.0,0.11672131147540983,Cheap
20150113T000000,357823.0,3,1.5,1240,9196,1.0,0,0,3,8,1240,0,1968,0,98072,47.7562,-122.094,1690,10800,7956,9110,38.91072205306655,0.03709154098360656,Very Cheap
20140611T000000,7062500.0,5,4.5,10040,37325,2.0,1,2,3,11,7680,2360,1940,2001,98004,47.65,-122.214,3930,25449,27285,21519,189.21634293369056,0.9163934426229509,Very High
20140805T000000,425000.0,3,2.25,1670,9500,1.0,0,0,3,7,1170,500,1977,0,98125,47.7253,-122.309,1470,9500,7830,8030,44.73684210526316,0.04590163934426229,Very Cheap
20150416T000000,711777.0,4,1.75,2220,6731,1.0,0,0,4,7,1110,1110,1953,0,98116,47.5691,-122.391,1600,6350,4511,4750,105.7461001337097,0.08351173770491803,Very Cheap
20141201T000000,335000.0,3,1.0,980,9903,1.0,0,0,4,7,980,0,1966,0,98028,47.7746,-122.239,1830,9903,8923,8073,33.82813288902353,0.03409836065573771,Very Cheap
20140616T000000,825000.0,4,1.5,1890,6938,1.5,0,0,3,8,1890,0,1919,0,98116,47.5896,-122.389,1700,6250,5048,4550,118.91034880368983,0.09836065573770492,Very Cheap
20150501T000000,210000.0,2,1.0,1100,6000,1.5,0,0,4,6,1100,0,1900,0,98108,47.5275,-122.323,1280,6000,4900,4720,35.0,0.017704918032786884,Very Cheap
20140811T000000,575000.0,2,1.75,2770,19700,2.0,0,0,3,8,1780,990,1983,0,98177,47.7581,-122.365,2360,9700,16930,7340,29.18781725888325,0.06557377049180328,Very Cheap
20150404T000000,1208000.0,4,2.75,4250,10925,2.0,0,0,3,10,4250,0,2003,0,98059,47.5297,-122.14,4650,11544,6675,6894,110.5720823798627,0.14859016393442623,Cheap
20140801T000000,431500.0,2,2.0,1370,4866,1.0,0,0,3,8,1370,0,2005,0,98053,47.704,-122.012,1365,4784,3496,3419,88.67653103164817,0.046754098360655735,Very Cheap
20140903T000000,475000.0,3,1.5,1480,13457,1.0,0,0,3,7,1480,0,1959,0,98007,47.5914,-122.136,2100,10517,11977,8417,35.29761462435907,0.05245901639344262,Very Cheap
20141126T000000,1495000.0,4,3.75,3770,4000,2.5,0,0,5,9,2890,880,1916,0,98122,47.6157,-122.287,2800,5000,230,2200,373.75,0.18622950819672132,Cheap
20141223T000000,540000.0,6,3.0,2870,206474,2.0,0,0,3,7,2330,540,1960,1985,98042,47.401,-122.095,2380,59677,203604,57297,2.615341398917055,0.06098360655737705,Very Cheap
20141210T000000,775000.0,3,2.5,3820,35016,2.0,0,0,4,9,3820,0,1987,0,98053,47.6496,-122.041,3010,35190,31196,32180,22.13273931916838,0.09180327868852459,Very Cheap
20140716T000000,635000.0,3,2.5,1530,2978,1.0,0,0,3,7,1210,320,1997,0,98117,47.6796,-122.39,1640,5100,1448,3460,213.2303559435863,0.07344262295081967,Very Cheap
20150407T000000,1300000.0,3,2.75,4120,16365,1.0,0,2,3,12,4120,0,1999,0,98059,47.5265,-122.148,4020,14110,12245,10090,79.43782462572564,0.16065573770491803,Cheap
20140801T000000,405000.0,3,2.25,1590,7267,1.0,0,0,4,7,1100,490,1976,0,98133,47.7457,-122.332,2060,8336,5677,6276,55.73138846841888,0.043278688524590166,Very Cheap
20140721T000000,210000.0,3,1.0,1520,8600,1.0,0,0,3,6,1040,480,1951,0,98168,47.5134,-122.335,1320,8600,7080,7280,24.41860465116279,0.017704918032786884,Very Cheap
20150504T000000,880000.0,4,2.5,2350,4675,2.0,0,0,3,9,2150,200,1923,0,98112,47.6344,-122.305,2240,3848,2325,1608,188.23529411764707,0.10557377049180328,Cheap
20141024T000000,239000.0,4,2.0,1370,8837,1.5,0,0,3,7,1370,0,1955,0,98188,47.4386,-122.285,1360,9000,7467,7640,27.045377390517142,0.021508196721311476,Very Cheap
20140714T000000,515000.0,3,2.5,1540,6100,1.0,0,0,3,6,770,770,1944,2014,98126,47.5696,-122.378,1710,5950,4560,4240,84.42622950819673,0.057704918032786885,Very Cheap
20140723T000000,1379900.0,3,3.25,3786,38038,1.0,1,4,3,9,1934,1852,1978,2006,98070,47.3907,-122.448,2850,33361,34252,30511,36.27688101372312,0.1711344262295082,Cheap
20140722T000000,215000.0,4,2.25,1500,5393,2.0,0,0,3,7,1500,0,1999,0,98001,47.3378,-122.262,1500,5952,3893,4452,39.866493602818466,0.018360655737704918,Very Cheap
20150409T000000,315000.0,6,2.0,1750,17685,1.0,0,0,4,5,1750,0,1943,0,98056,47.5096,-122.178,1750,9209,15935,7459,17.8117048346056,0.031475409836065574,Very Cheap
20140730T000000,442500.0,3,1.5,1800,8303,1.0,0,0,3,7,1200,600,1957,0,98133,47.7693,-122.357,1800,8171,6503,6371,53.29399012405155,0.04819672131147541,Very Cheap
20140818T000000,311000.0,2,1.75,1180,55321,1.0,0,0,3,8,1180,0,1941,2004,98042,47.3329,-122.091,1480,56192,54141,54712,5.621734965022324,0.030950819672131147,Very Cheap
20141217T000000,425000.0,2,1.0,830,6030,1.0,0,0,4,6,830,0,1925,0,98103,47.6994,-122.347,1280,6030,5200,4750,70.48092868988391,0.04590163934426229,Very Cheap
20140904T000000,433500.0,3,1.75,1540,9450,1.0,0,0,4,6,1040,500,1919,0,98103,47.6985,-122.348,1200,5400,7910,4200,45.87301587301587,0.04701639344262295,Very Cheap
20140804T000000,450000.0,3,2.25,1610,8296,2.0,0,0,3,8,1610,0,1978,0,98115,47.7,-122.297,1610,8288,6686,6678,54.24300867888139,0.04918032786885246,Very Cheap
20140520T000000,675000.0,3,2.25,1990,10260,2.0,0,0,4,8,1990,0,1987,0,98052,47.6801,-122.115,1990,10260,8270,8270,65.78947368421052,0.07868852459016394,Very Cheap
20140624T000000,535000.0,3,2.5,2070,4132,2.0,0,0,3,8,2070,0,1999,0,98074,47.6036,-122.015,1530,5606,2062,4076,129.47725072604067,0.06032786885245902,Very Cheap
20140613T000000,577000.0,3,1.75,1760,12874,1.0,0,0,4,7,1230,530,1967,0,98005,47.5906,-122.167,1950,10240,11114,8290,44.81901506913158,0.06583606557377049,Very Cheap
20141217T000000,480000.0,3,1.75,1740,8528,1.0,0,0,4,7,1290,450,1939,0,98125,47.7097,-122.303,1610,8528,6788,6918,56.28517823639775,0.05311475409836065,Very Cheap
20150112T000000,400000.0,3,1.5,1950,4473,1.0,0,0,4,6,1530,420,1914,0,98034,47.7094,-122.228,2670,14256,2523,11586,89.4254415381176,0.04262295081967213,Very Cheap
20140613T000000,304000.0,3,1.0,1280,8184,1.5,0,0,4,6,1280,0,1947,0,98155,47.7467,-122.319,1120,8184,6904,7064,37.14565004887586,0.030032786885245903,Very Cheap
20150325T000000,355000.0,3,1.75,1460,7203,1.0,0,0,3,7,1460,0,1990,0,98056,47.5049,-122.189,1570,7203,5743,5633,49.28502013050118,0.036721311475409836,Very Cheap
20140905T000000,998000.0,4,3.25,3770,982998,2.0,0,0,3,10,3770,0,1992,0,98058,47.414,-122.087,2290,37141,979228,34851,1.0152614756082923,0.12104918032786885,Cheap
20140814T000000,550000.0,4,1.75,2410,8447,2.0,0,3,4,8,2060,350,1936,1980,98074,47.6499,-122.088,2520,14789,6037,12269,65.11187403812005,0.06229508196721312,Very Cheap
20141016T000000,550000.0,4,1.75,2410,8447,2.0,0,3,4,8,2060,350,1936,1980,98074,47.6499,-122.088,2520,14789,6037,12269,65.11187403812005,0.06229508196721312,Very Cheap
20140821T000000,210000.0,3,1.75,1400,7300,2.0,0,0,3,6,1400,0,1948,0,98178,47.4999,-122.268,1440,10825,5900,9385,28.767123287671232,0.017704918032786884,Very Cheap
20150226T000000,317000.0,3,2.5,2100,7587,2.0,0,0,3,9,2100,0,1990,0,98023,47.3072,-122.391,2330,8119,5487,5789,41.78199551865033,0.03173770491803279,Very Cheap
20150504T000000,700000.0,4,3.5,5360,25800,1.0,0,0,3,9,3270,2090,1971,0,98074,47.6099,-122.054,2650,21781,20440,19131,27.131782945736433,0.08196721311475409,Very Cheap
20140616T000000,265000.0,3,1.0,1000,9150,1.0,0,0,3,7,1000,0,1969,0,98059,47.4829,-122.124,1490,10647,8150,9157,28.961748633879782,0.024918032786885248,Very Cheap
20140902T000000,700000.0,4,3.5,3150,6175,2.0,0,0,3,9,3150,0,2001,0,98075,47.5966,-122.017,3150,6986,3025,3836,113.36032388663968,0.08196721311475409,Very Cheap
20140908T000000,1020000.0,5,3.5,4180,17841,2.0,0,2,3,10,3160,1020,1990,0,98075,47.5618,-122.037,3260,12608,13661,9348,57.17168320161426,0.12393442622950819,Cheap
20141209T000000,1145000.0,4,2.25,2840,20242,1.0,0,0,3,8,2240,600,1972,0,98004,47.639,-122.216,2840,20372,17402,17532,56.565556763165695,0.14032786885245901,Cheap
20140627T000000,460000.0,4,2.5,2110,35091,1.0,0,0,4,8,1290,820,1985,0,98027,47.467,-122.014,2740,36427,32981,33687,13.108774329600182,0.050491803278688525,Very Cheap
20140924T000000,410000.0,2,1.5,1660,4000,1.0,0,0,3,7,1000,660,1950,0,98115,47.6832,-122.304,1570,5500,2340,3930,102.5,0.043934426229508196,Very Cheap
20140905T000000,665000.0,4,3.0,2160,4400,1.0,0,0,5,7,1320,840,1921,0,98122,47.6163,-122.293,1430,4400,2240,2970,151.13636363636363,0.07737704918032787,Very Cheap
20150414T000000,600000.0,4,2.5,2420,7744,2.0,0,0,3,9,2420,0,1994,0,98056,47.534,-122.18,2820,11129,5324,8309,77.47933884297521,0.06885245901639345,Very Cheap
20150504T000000,502000.0,4,1.75,1920,3844,1.0,0,0,3,7,1170,750,1967,0,98133,47.7041,-122.353,1480,3844,1924,2364,130.59313215400624,0.056,Very Cheap
20140604T000000,364950.0,4,2.5,2310,8030,2.0,0,0,3,7,2310,0,1978,0,98019,47.7433,-121.982,1780,8041,5720,6261,45.448318804483186,0.03802622950819672,Very Cheap
20140529T000000,680000.0,3,2.25,2330,4000,1.5,0,2,5,7,1520,810,1927,0,98115,47.6732,-122.29,1870,4000,1670,2130,170.0,0.07934426229508197,Very Cheap
20140708T000000,235500.0,5,2.5,2340,13713,1.0,0,0,2,8,1670,670,1967,0,98003,47.3307,-122.324,2080,11000,11373,8920,17.173485014220084,0.02104918032786885,Very Cheap
20140721T000000,576000.0,4,2.5,2590,5756,2.0,0,0,3,8,2590,0,2001,0,98065,47.5356,-121.875,2620,6109,3166,3489,100.06949270326616,0.06570491803278689,Very Cheap
20140505T000000,405000.0,2,3.0,1410,1240,2.0,0,0,3,8,1140,270,2006,0,98136,47.5221,-122.39,1410,1273,-170,-137,326.61290322580646,0.043278688524590166,Very Cheap
20140716T000000,335000.0,3,2.75,2850,8039,1.0,0,0,4,8,1540,1310,1989,0,98031,47.4141,-122.204,2240,7727,5189,5487,41.6718497325538,0.03409836065573771,Very Cheap
20150420T000000,122000.0,2,1.0,730,6728,1.0,0,0,3,6,730,0,1953,0,98148,47.4275,-122.324,1170,7034,5998,5864,18.13317479191439,0.0061639344262295085,Very Cheap
20140606T000000,432000.0,3,1.75,1470,6250,1.0,0,3,4,7,1070,400,1939,0,98155,47.7394,-122.288,2630,7050,4780,4420,69.12,0.046819672131147544,Very Cheap
20140827T000000,375000.0,4,2.25,2330,11400,1.0,0,0,4,8,2330,0,1974,0,98058,47.4495,-122.148,2640,10200,9070,7560,32.89473684210526,0.03934426229508197,Very Cheap
20140625T000000,276000.0,4,2.25,2460,11250,1.0,0,0,4,8,2460,0,1959,0,98002,47.3182,-122.212,1630,10216,8790,8586,24.533333333333335,0.026360655737704918,Very Cheap
20140721T000000,450000.0,3,2.25,2080,111513,1.5,0,0,3,8,1680,400,1977,0,98072,47.7403,-122.112,2440,107157,109433,104717,4.035403943934788,0.04918032786885246,Very Cheap
20150511T000000,210000.0,2,1.0,990,8140,1.0,0,0,1,6,990,0,1910,0,98116,47.5828,-122.382,2150,5000,7150,2850,25.798525798525798,0.017704918032786884,Very Cheap
20141121T000000,279000.0,3,2.5,1450,4106,2.0,0,0,3,7,1450,0,2011,0,98038,47.3655,-122.019,2000,4000,2656,2000,67.94934242571846,0.02675409836065574,Very Cheap
20150223T000000,635000.0,3,1.75,1340,3900,2.0,0,0,5,7,1340,0,1900,0,98107,47.6711,-122.379,1470,1611,2560,141,162.82051282051282,0.07344262295081967,Very Cheap
20150220T000000,350000.0,3,2.5,2730,7372,2.0,0,0,3,9,2730,0,1998,0,98023,47.2831,-122.346,2710,8343,4642,5633,47.47693977211069,0.036065573770491806,Very Cheap
20140924T000000,218000.0,3,1.0,1140,7560,1.0,0,0,4,6,1140,0,1958,0,98058,47.4624,-122.185,1300,7560,6420,6260,28.835978835978835,0.018754098360655738,Very Cheap
20150324T000000,750000.0,4,1.5,1950,6300,1.5,0,1,3,7,1650,300,1944,0,98115,47.6819,-122.271,1760,6300,4350,4540,119.04761904761905,0.08852459016393442,Very Cheap
20150213T000000,310597.0,4,1.75,2000,25700,1.0,0,0,4,7,1150,850,1958,0,98023,47.32,-122.362,2420,27500,23700,25080,12.085486381322957,0.030897967213114753,Very Cheap
20150401T000000,355000.0,3,1.0,900,37800,1.0,0,0,4,5,700,200,1923,0,98034,47.7146,-122.234,1750,11998,36900,10248,9.39153439153439,0.036721311475409836,Very Cheap
20140527T000000,735000.0,5,2.75,3390,5211,2.0,0,0,3,9,3390,0,2004,0,98075,47.5977,-121.981,3210,5211,1821,2001,141.04778353483016,0.08655737704918033,Very Cheap
20140602T000000,155000.0,1,1.0,720,6000,1.0,0,0,3,6,720,0,1940,0,98108,47.5266,-122.316,1040,6000,5280,4960,25.833333333333332,0.010491803278688525,Very Cheap
20140611T000000,354000.0,3,1.0,940,10368,1.0,0,0,3,7,940,0,1965,0,98052,47.6608,-122.133,2090,9620,9428,7530,34.14351851851852,0.03659016393442623,Very Cheap
20150507T000000,415000.0,3,1.75,1770,10513,1.0,0,0,4,7,1400,370,1982,0,98028,47.7726,-122.266,2070,9968,8743,7898,39.47493579377913,0.04459016393442623,Very Cheap
20140701T000000,202000.0,1,1.0,590,833,1.0,0,0,4,7,590,0,1926,0,98122,47.6082,-122.299,780,1617,243,837,242.49699879951982,0.016655737704918034,Very Cheap
20150506T000000,580000.0,3,2.5,1980,1873,2.0,0,0,3,7,1470,510,1996,0,98107,47.6659,-122.369,1500,1873,-107,373,309.66364121729845,0.06622950819672131,Very Cheap
20141022T000000,1495000.0,4,3.25,3070,10375,2.0,0,0,3,10,2180,890,1962,2005,98004,47.5862,-122.198,2500,11194,7305,8694,144.09638554216866,0.18622950819672132,Cheap
20141008T000000,790000.0,4,2.5,3500,7519,2.0,0,0,3,9,3500,0,2004,0,98053,47.6799,-122.024,3920,7982,4019,4062,105.06716318659396,0.09377049180327869,Very Cheap
20150305T000000,499900.0,3,2.5,2100,5112,2.0,0,0,3,8,2100,0,1999,0,98065,47.5338,-121.867,2100,4370,3012,2270,97.78951486697966,0.055724590163934426,Very Cheap
20150423T000000,525000.0,4,2.25,2620,98881,1.0,0,0,3,7,1820,800,1952,0,98070,47.4662,-122.453,1728,95832,96261,94104,5.309412323904492,0.05901639344262295,Very Cheap
20140622T000000,810000.0,4,2.5,2810,10613,2.0,0,0,3,9,2810,0,1989,0,98006,47.5424,-122.141,2800,9933,7803,7133,76.32149250918684,0.09639344262295083,Very Cheap
20150220T000000,425000.0,4,1.5,2290,8773,1.0,0,0,4,7,1330,960,1947,0,98133,47.7173,-122.33,1740,7058,6483,5318,48.444089821041835,0.04590163934426229,Very Cheap
20141226T000000,241250.0,3,1.75,1350,7588,1.0,0,0,3,7,1350,0,1993,0,98010,47.3123,-122.023,1470,7341,6238,5871,31.793621507643646,0.02180327868852459,Very Cheap
20141112T000000,318700.0,4,2.5,2770,19116,1.0,0,0,4,8,1600,1170,1961,0,98003,47.3386,-122.319,2730,18429,16346,15699,16.671897886587153,0.031960655737704916,Very Cheap
20140827T000000,720000.0,4,1.75,2530,5000,1.5,0,2,5,8,2070,460,1917,0,98103,47.6624,-122.348,1950,3600,2470,1650,144.0,0.08459016393442623,Very Cheap
20140715T000000,291000.0,3,1.0,1280,10500,1.5,0,0,4,5,1280,0,1941,0,98024,47.566,-121.894,1410,10500,9220,9090,27.714285714285715,0.028327868852459016,Very Cheap
20140718T000000,420000.0,3,1.75,1060,38644,1.0,0,0,3,7,1060,0,1983,0,98077,47.7442,-122.072,1310,11416,37584,10106,10.868440120070385,0.04524590163934426,Very Cheap
20140726T000000,210000.0,2,1.75,1000,3554,1.0,0,0,4,8,1000,0,1975,0,98198,47.3811,-122.32,1150,4000,2554,2850,59.088351153629716,0.017704918032786884,Very Cheap
20150427T000000,645000.0,3,3.25,3870,11000,2.0,0,2,3,9,2970,900,1991,0,98106,47.5545,-122.354,2970,11000,7130,8030,58.63636363636363,0.07475409836065573,Very Cheap
20140519T000000,762000.0,5,2.0,3370,5000,1.5,0,0,4,7,2140,1230,1907,0,98109,47.6373,-122.35,1920,3200,1630,1280,152.4,0.0900983606557377,Very Cheap
20140724T000000,247500.0,4,1.75,2290,7765,1.0,0,0,3,6,2290,0,1936,1953,98146,47.4997,-122.353,1240,8215,5475,6975,31.873792659368963,0.02262295081967213,Very Cheap
20140723T000000,282500.0,3,2.25,1670,7150,2.0,0,0,4,7,1670,0,1990,0,98042,47.3603,-122.088,1570,7040,5480,5470,39.51048951048951,0.02721311475409836,Very Cheap
20140605T000000,395000.0,3,1.75,1460,22651,1.0,0,0,4,7,1460,0,1961,0,98027,47.4861,-122.03,2030,49222,21191,47192,17.438523685488498,0.0419672131147541,Very Cheap
20140616T000000,295000.0,3,1.75,1770,8235,1.0,0,0,3,7,1030,740,1960,0,98148,47.4323,-122.328,1560,8918,6465,7358,35.82270795385549,0.028852459016393443,Very Cheap
20140826T000000,235000.0,2,1.0,820,5100,1.0,0,0,4,6,820,0,1954,0,98056,47.5175,-122.205,2270,5100,4280,2830,46.07843137254902,0.02098360655737705,Very Cheap
20141001T000000,770000.0,3,1.75,1900,6334,1.0,0,2,3,8,1450,450,1948,0,98105,47.6675,-122.276,1530,6334,4434,4804,121.56615093148089,0.09114754098360656,Very Cheap
20140508T000000,559950.0,2,2.0,1870,4950,1.0,0,0,3,8,1870,0,2006,0,98053,47.7195,-122.022,1670,4800,3080,3130,113.12121212121212,0.0636,Very Cheap
20140710T000000,639000.0,4,2.0,1840,5419,1.0,0,0,4,7,920,920,1942,0,98199,47.6483,-122.404,1800,5419,3579,3619,117.91843513563389,0.0739672131147541,Very Cheap
20150428T000000,314950.0,3,1.0,1590,8470,1.0,0,0,4,7,1140,450,1967,0,98058,47.4473,-122.159,1570,9375,6880,7805,37.184179456906726,0.03146885245901639,Very Cheap
20150324T000000,525000.0,3,1.0,1640,6180,1.0,0,0,4,7,1640,0,1946,0,98118,47.5682,-122.284,1540,6180,4540,4640,84.95145631067962,0.05901639344262295,Very Cheap
20140509T000000,2400000.0,3,2.25,3000,11665,1.5,1,4,3,11,3000,0,2001,0,98075,47.5884,-122.086,3000,15959,8665,12959,205.74367766823832,0.30491803278688523,Medium
20140602T000000,820000.0,3,1.75,2160,6272,1.0,0,0,4,8,1390,770,1960,0,98115,47.6777,-122.306,1290,5376,4112,4086,130.73979591836735,0.09770491803278689,Very Cheap
20140911T000000,1385000.0,3,3.0,2490,3600,2.0,0,3,4,8,1790,700,1911,0,98119,47.6313,-122.369,2490,3600,1110,1110,384.72222222222223,0.1718032786885246,Cheap
20141017T000000,521450.0,3,2.0,1290,5700,1.0,0,0,5,7,1290,0,1950,0,98116,47.5713,-122.397,1160,5700,4410,4540,91.48245614035088,0.058550819672131146,Very Cheap
20141006T000000,760750.0,3,2.5,3190,49137,2.0,0,0,3,9,3190,0,1988,0,98074,47.6027,-122.043,3240,53143,45947,49903,15.482223171947819,0.0899344262295082,Very Cheap
20140604T000000,759600.0,4,1.0,1540,115434,1.5,0,0,4,7,1540,0,1923,0,98031,47.4163,-122.22,2027,23522,113894,21495,6.580383595820988,0.08978360655737705,Very Cheap
20140619T000000,346150.0,3,2.0,2140,7200,1.0,0,0,4,8,1480,660,1966,0,98056,47.5084,-122.185,2070,7220,5060,5150,48.076388888888886,0.03556065573770492,Very Cheap
20150422T000000,390000.0,2,1.0,980,3800,1.0,0,0,3,7,980,0,1926,0,98103,47.6903,-122.34,1520,5010,2820,3490,102.63157894736842,0.04131147540983607,Very Cheap
20140924T000000,359950.0,5,2.25,2450,9432,2.0,0,0,3,8,2450,0,1973,0,98058,47.4519,-122.13,2310,9100,6982,6790,38.162637828668366,0.037370491803278685,Very Cheap
20140603T000000,430000.0,3,2.0,1360,5120,1.5,0,0,4,6,910,450,1924,0,98116,47.5587,-122.393,1440,5120,3760,3680,83.984375,0.04655737704918033,Very Cheap
20150424T000000,960000.0,4,3.5,4610,11676,2.0,0,0,3,10,4610,0,2000,0,98075,47.6011,-121.983,3900,11164,7066,7264,82.21993833504625,0.1160655737704918,Cheap
20141007T000000,800000.0,7,6.75,7480,41664,2.0,0,2,3,11,5080,2400,1953,0,98166,47.4643,-122.368,2810,33190,34184,30380,19.201228878648234,0.09508196721311475,Very Cheap
20150108T000000,1010000.0,3,2.5,2860,5805,2.0,0,0,3,9,2860,0,1999,0,98005,47.6218,-122.16,2360,5832,2945,3472,173.9879414298019,0.12262295081967213,Cheap
20150120T000000,290000.0,3,2.0,1810,11456,1.0,0,0,3,7,1810,0,1970,0,98045,47.4648,-121.756,1360,12931,9646,11571,25.314245810055866,0.02819672131147541,Very Cheap
20150317T000000,1350000.0,4,2.0,2240,10296,1.0,0,0,5,8,2240,0,1948,0,98004,47.6177,-122.217,2500,10918,8056,8418,131.11888111888112,0.16721311475409836,Cheap
20140513T000000,777000.0,3,3.25,3610,59677,2.0,0,0,3,10,2440,1170,2003,0,98027,47.5464,-122.088,3130,65775,56067,62645,13.020091492534812,0.09206557377049181,Very Cheap
20141007T000000,526000.0,2,1.0,1450,4500,1.5,0,0,4,7,1450,0,1921,0,98107,47.6739,-122.396,1470,5000,3050,3530,116.88888888888889,0.059147540983606556,Very Cheap
20150418T000000,550000.0,3,3.5,1450,1091,2.0,0,0,3,8,1200,250,2007,0,98119,47.6475,-122.359,1490,3017,-359,1527,504.12465627864344,0.06229508196721312,Very Cheap
20141223T000000,276000.0,3,1.5,1820,8750,1.0,0,0,4,7,1200,620,1958,0,98198,47.4213,-122.322,1500,8000,6930,6500,31.542857142857144,0.026360655737704918,Very Cheap
20141229T000000,2500000.0,5,3.25,5620,12672,2.0,0,0,4,11,4140,1480,1916,0,98144,47.5786,-122.287,4470,8050,7052,3580,197.28535353535352,0.3180327868852459,Medium
20150122T000000,325000.0,3,1.75,2080,6554,1.0,0,0,3,7,1040,1040,1950,0,98118,47.5135,-122.257,1230,5650,4474,4420,49.588037839487335,0.03278688524590164,Very Cheap
20140926T000000,365000.0,3,2.5,1780,1754,3.0,0,0,3,8,1780,0,2007,0,98126,47.548,-122.373,1780,1607,-26,-173,208.0957810718358,0.0380327868852459,Very Cheap
20141007T000000,2150000.0,8,6.0,4340,9415,2.0,0,0,3,8,4340,0,1967,0,98004,47.6316,-122.202,2050,9100,5075,7050,228.35900159320235,0.2721311475409836,Cheap
20150305T000000,825050.0,4,3.25,2860,3680,2.0,0,0,3,9,1980,880,1925,1993,98115,47.6752,-122.3,2010,3680,820,1670,224.1983695652174,0.0983672131147541,Very Cheap
20140721T000000,690000.0,3,1.5,2540,9520,1.0,0,0,3,8,1500,1040,1959,0,98115,47.6834,-122.306,1870,6800,6980,4930,72.47899159663865,0.08065573770491803,Very Cheap
20150415T000000,390000.0,4,1.0,1140,6250,1.5,0,0,3,6,1140,0,1958,0,98126,47.5433,-122.375,1140,1370,5110,230,62.4,0.04131147540983607,Very Cheap
20150304T000000,385000.0,3,2.0,1320,1297,3.0,0,0,3,7,1320,0,1995,0,98117,47.6959,-122.376,1380,1503,-23,123,296.83885890516575,0.04065573770491803,Very Cheap
20150331T000000,619000.0,3,2.5,2040,7503,2.0,0,0,3,8,2040,0,1987,0,98029,47.5718,-122.021,2170,7503,5463,5333,82.5003332000533,0.07134426229508196,Very Cheap
20150325T000000,494000.0,4,2.25,1790,42000,1.0,0,0,3,7,1170,620,1983,0,98045,47.4819,-121.744,2060,50094,40210,48034,11.761904761904763,0.05495081967213115,Very Cheap
20150427T000000,412450.0,3,2.0,1910,13505,1.0,0,0,3,8,1910,0,1955,0,98034,47.7114,-122.23,2010,8000,11595,5990,30.54054054054054,0.04425573770491803,Very Cheap
20150123T000000,580000.0,3,1.75,1460,2800,2.0,0,0,3,7,1460,0,1928,0,98117,47.6779,-122.371,1220,4062,1340,2842,207.14285714285714,0.06622950819672131,Very Cheap
20141105T000000,269900.0,3,1.5,1420,22100,1.0,0,0,5,7,1420,0,1957,0,98042,47.4193,-122.149,1540,21780,20680,20240,12.212669683257918,0.02556065573770492,Very Cheap
20150406T000000,704300.0,4,1.5,1790,4080,1.5,0,0,5,7,1790,0,1928,0,98144,47.5749,-122.291,1710,4080,2290,2370,172.62254901960785,0.0825311475409836,Very Cheap
20141107T000000,267000.0,3,2.0,1390,6005,2.0,0,0,3,8,1390,0,2005,0,98022,47.2117,-121.99,1264,5550,4615,4286,44.462947543713575,0.025180327868852458,Very Cheap
20140813T000000,310000.0,4,1.75,1880,12150,1.0,0,0,3,7,1280,600,1976,0,98023,47.3272,-122.363,1980,9680,10270,7700,25.51440329218107,0.03081967213114754,Very Cheap
20150123T000000,227064.0,3,1.5,1570,10824,2.0,0,0,3,7,1570,0,1908,0,98118,47.54,-122.275,1530,8125,9254,6595,20.97782705099778,0.019942819672131146,Very Cheap
20140528T000000,925000.0,3,2.5,2690,7000,2.0,0,0,5,7,1840,850,1943,0,98115,47.6784,-122.277,1800,6435,4310,4635,132.14285714285714,0.11147540983606558,Cheap
20150508T000000,245000.0,3,1.75,1670,11452,1.0,0,2,3,8,1670,0,1992,0,98022,47.1913,-122.015,1820,11152,9782,9332,21.39364303178484,0.022295081967213116,Very Cheap
20141214T000000,339888.0,3,1.0,1040,7490,1.0,0,0,3,7,1040,0,1969,0,98034,47.7137,-122.213,1520,7410,6450,5890,45.37890520694259,0.03473940983606558,Very Cheap
20140710T000000,439000.0,4,2.0,1560,7500,1.0,0,0,4,7,1560,0,1968,0,98034,47.7281,-122.181,1730,7500,5940,5770,58.53333333333333,0.04773770491803279,Very Cheap
20140527T000000,400000.0,2,1.0,1470,6120,1.0,0,0,2,7,1470,0,1940,0,98115,47.6914,-122.287,1840,6120,4650,4280,65.359477124183,0.04262295081967213,Very Cheap
20140630T000000,560000.0,3,2.25,2070,15002,1.5,0,0,3,8,2070,0,1955,2013,98155,47.7635,-122.274,2070,15002,12932,12932,37.32835621917078,0.06360655737704918,Very Cheap
20141001T000000,703011.0,2,1.0,1370,5922,1.0,0,2,3,8,1130,240,1941,0,98199,47.6473,-122.406,2460,6759,4552,4299,118.71175278622087,0.08236209836065574,Very Cheap
20141209T000000,363000.0,2,1.0,1120,4800,1.0,0,0,3,7,770,350,1926,0,98126,47.5669,-122.372,1510,4800,3680,3290,75.625,0.03777049180327869,Very Cheap
20140919T000000,650000.0,4,2.75,2640,6240,2.0,0,0,3,9,2640,0,2001,0,98075,47.5788,-122.059,2640,5898,3600,3258,104.16666666666667,0.07540983606557378,Very Cheap
20150106T000000,299950.0,3,1.0,1030,9916,1.0,0,0,4,7,1030,0,1972,0,98034,47.7218,-122.176,1470,9044,8886,7574,30.249092375958046,0.029501639344262295,Very Cheap
20150422T000000,228950.0,3,1.0,1120,6625,1.0,0,0,3,6,1120,0,1942,0,98168,47.4879,-122.332,1120,6794,5505,5674,34.55849056603773,0.020190163934426228,Very Cheap
20141001T000000,465000.0,4,1.75,1730,11700,1.0,0,0,3,7,880,850,1956,0,98008,47.6031,-122.13,1570,7820,9970,6250,39.743589743589745,0.051147540983606556,Very Cheap
20150213T000000,725000.0,3,2.5,2090,9847,2.0,0,2,3,9,2090,0,1983,0,98006,47.5651,-122.114,2860,11483,7757,8623,73.62648522392607,0.08524590163934426,Very Cheap
20140604T000000,212500.0,3,1.0,920,14400,1.0,0,0,4,7,920,0,1977,0,98001,47.2816,-122.269,1170,9600,13480,8430,14.756944444444445,0.018032786885245903,Very Cheap
20140910T000000,526000.0,4,2.25,2970,54450,2.0,0,0,3,8,2970,0,1983,1998,98058,47.4338,-122.146,2260,6465,51480,4205,9.660238751147842,0.059147540983606556,Very Cheap
20141223T000000,383000.0,3,2.5,1720,10031,2.0,0,0,3,8,1720,0,1993,0,98028,47.7688,-122.238,2280,5845,8311,3565,38.18163692553085,0.04039344262295082,Very Cheap
20150421T000000,244000.0,3,1.75,1460,4692,1.0,0,0,3,7,1460,0,1988,0,98055,47.472,-122.192,1600,4557,3232,2957,52.00341005967604,0.02216393442622951,Very Cheap
20140805T000000,565000.0,3,1.5,1540,3570,1.5,0,0,5,7,1490,50,1930,0,98105,47.6692,-122.325,1620,4080,2030,2460,158.26330532212884,0.06426229508196721,Very Cheap
20150219T000000,373000.0,8,3.0,2850,12714,1.0,0,0,3,7,2850,0,1959,0,98055,47.4859,-122.205,1480,4942,9864,3462,29.33773792669498,0.03908196721311476,Very Cheap
20140902T000000,300000.0,3,2.0,1310,9855,1.0,0,0,3,7,1310,0,1962,0,98034,47.7296,-122.241,1310,8370,8545,7060,30.441400304414003,0.029508196721311476,Very Cheap
20140520T000000,405000.0,5,2.5,2430,4781,2.0,0,0,3,9,2430,0,2001,0,98058,47.4487,-122.117,2420,4770,2351,2350,84.71031165028236,0.043278688524590166,Very Cheap
20140620T000000,979000.0,3,1.5,1700,14133,1.0,0,1,4,8,1700,0,1954,0,98004,47.6166,-122.22,2630,17376,12433,14746,69.27050166277506,0.11855737704918033,Cheap
20141116T000000,324888.0,4,1.75,2160,28750,2.0,0,0,4,8,2160,0,1978,0,98092,47.3212,-122.118,1790,53578,26590,51788,11.300452173913044,0.03277219672131147,Very Cheap
20150429T000000,445000.0,3,1.5,860,3200,1.0,0,0,3,6,860,0,1929,0,98117,47.6791,-122.362,1220,4300,2340,3080,139.0625,0.04852459016393443,Very Cheap
20150221T000000,761000.0,3,3.5,2050,2020,2.0,0,0,3,8,1520,530,2006,0,98112,47.6235,-122.306,1230,3640,-30,2410,376.73267326732673,0.0899672131147541,Very Cheap
20150427T000000,435000.0,4,2.0,1650,4745,1.0,0,0,3,7,1130,520,1972,0,98034,47.7359,-122.18,1650,5184,3095,3534,91.6754478398314,0.04721311475409836,Very Cheap
20140822T000000,252000.0,3,2.25,1570,8410,1.0,0,0,3,7,1180,390,1991,0,98022,47.1942,-121.99,1540,8410,6840,6870,29.96432818073722,0.02321311475409836,Very Cheap
20140623T000000,350000.0,3,1.75,1660,10150,1.5,0,0,3,7,1660,0,1957,0,98133,47.7512,-122.342,1640,8906,8490,7266,34.48275862068966,0.036065573770491806,Very Cheap
20141107T000000,875000.0,3,1.0,1220,8119,1.0,0,0,4,7,1220,0,1955,0,98039,47.6328,-122.236,1910,8119,6899,6209,107.77189309028205,0.10491803278688525,Cheap
20150210T000000,940000.0,3,1.0,1220,8119,1.0,0,0,4,7,1220,0,1955,0,98039,47.6328,-122.236,1910,8119,6899,6209,115.77780514841729,0.11344262295081967,Cheap
20140819T000000,280000.0,3,2.0,1780,11342,1.0,0,0,3,7,1780,0,1964,0,98148,47.4617,-122.327,2140,8449,9562,6309,24.687004055722095,0.026885245901639345,Very Cheap
20140919T000000,450000.0,3,2.5,2180,4226,2.0,0,0,3,8,2180,0,2004,0,98011,47.7733,-122.226,2540,4607,2046,2067,106.48367250354946,0.04918032786885246,Very Cheap
20141231T000000,905000.0,3,2.5,3520,237402,2.5,0,0,3,9,3520,0,2004,0,98092,47.2687,-122.056,2310,165963,233882,163653,3.812099308346181,0.10885245901639344,Cheap
20140716T000000,382450.0,3,2.5,2220,20531,2.0,0,0,3,8,2220,0,1998,0,98001,47.2864,-122.264,2420,19249,18311,16829,18.62792849836832,0.040321311475409835,Very Cheap
20141224T000000,246700.0,3,2.0,1610,13309,1.0,0,0,4,7,1610,0,1967,0,98042,47.3398,-122.133,1610,15725,11699,14115,18.536328800060108,0.022518032786885245,Very Cheap
20140814T000000,220000.0,3,1.5,1070,9331,1.0,0,0,3,6,1070,0,1956,0,98155,47.7633,-122.313,1480,8400,8261,6920,23.57732290215411,0.01901639344262295,Very Cheap
20150216T000000,555750.0,3,1.0,1060,4880,1.0,0,0,2,6,910,150,1913,0,98118,47.5545,-122.288,1200,4880,3820,3680,113.88319672131148,0.06304918032786885,Very Cheap
20140611T000000,262500.0,3,1.5,1160,8906,1.0,0,0,3,7,1160,0,1962,0,98118,47.5362,-122.29,1160,8906,7746,7746,29.47451156523692,0.02459016393442623,Very Cheap
20141201T000000,515000.0,2,1.0,910,4725,1.0,0,0,3,7,910,0,1949,0,98115,47.676,-122.281,1600,5200,3815,3600,108.994708994709,0.057704918032786885,Very Cheap
20140617T000000,499500.0,3,2.5,2970,21907,2.0,0,0,3,9,2970,0,1998,2006,98059,47.4741,-122.099,2040,27917,18937,25877,22.80093120920254,0.055672131147540986,Very Cheap
20140604T000000,135000.0,1,1.0,790,13062,1.0,0,0,3,6,790,0,1942,0,98168,47.4919,-122.311,1240,7137,12272,5897,10.335323840146991,0.007868852459016393,Very Cheap
20141118T000000,462500.0,2,2.0,1540,7290,2.0,0,0,3,7,1540,0,1948,1983,98136,47.551,-122.395,1540,7072,5750,5532,63.44307270233196,0.05081967213114754,Very Cheap
20150415T000000,937500.0,4,2.5,3130,21100,1.0,0,4,3,9,2530,600,1956,0,98177,47.7598,-122.372,3680,23000,17970,19320,44.43127962085308,0.11311475409836065,Cheap
20150422T000000,458000.0,3,1.5,1470,9570,1.0,0,0,3,7,1280,190,1941,0,98125,47.7032,-122.306,1390,9570,8100,8180,47.85788923719958,0.05022950819672131,Very Cheap
20141022T000000,845000.0,4,2.75,3160,7143,1.5,0,0,3,8,2100,1060,1933,0,98199,47.6513,-122.406,2200,6122,3983,3922,118.29763404731905,0.10098360655737705,Cheap
20140531T000000,660000.0,3,2.25,2675,40910,2.0,0,0,3,8,2675,0,1984,0,98075,47.5916,-122.055,2300,39438,38235,37138,16.132974822781716,0.07672131147540984,Very Cheap
20150417T000000,265000.0,3,2.0,1340,6783,1.0,0,0,4,7,1340,0,1987,0,98030,47.3504,-122.177,1630,6458,5443,4828,39.068258882500366,0.024918032786885248,Very Cheap
20140507T000000,599999.0,9,4.5,3830,6988,2.5,0,0,3,7,2450,1380,1938,0,98103,47.6927,-122.338,1460,6291,3158,4831,85.8613337149399,0.06885232786885245,Very Cheap
20141202T000000,280000.0,3,2.5,1800,8697,2.0,0,0,3,8,1800,0,1987,0,98023,47.3115,-122.4,1770,8390,6897,6620,32.19500977348511,0.026885245901639345,Very Cheap
20141029T000000,1055000.0,3,3.25,2990,189852,2.0,0,0,4,10,2990,0,1974,0,98072,47.746,-122.138,3500,48760,186862,45260,5.556960158439205,0.12852459016393442,Cheap
20141107T000000,875000.0,4,3.0,3720,14125,1.0,0,0,4,9,1930,1790,1960,0,98005,47.5911,-122.177,3160,15300,10405,12140,61.94690265486726,0.10491803278688525,Cheap
20141014T000000,125000.0,3,1.0,920,7276,1.0,0,0,4,6,920,0,1961,0,98002,47.285,-122.211,1120,7276,6356,6156,17.179769103903244,0.006557377049180328,Very Cheap
20141209T000000,634800.0,4,3.0,3280,4904,2.0,0,0,3,7,3280,0,2005,0,98053,47.6802,-122.033,2600,5004,1624,2404,129.4453507340946,0.07341639344262295,Very Cheap
20150203T000000,269950.0,4,1.0,1440,9600,1.0,0,0,2,7,1440,0,1964,0,98001,47.3168,-122.264,1740,43560,8160,41820,28.119791666666668,0.025567213114754097,Very Cheap
20140620T000000,359950.0,3,2.25,1940,11612,1.0,0,0,4,8,1100,840,1981,0,98178,47.5018,-122.23,2180,8954,9672,6774,30.998105408198416,0.037370491803278685,Very Cheap
20141215T000000,417000.0,3,1.75,1590,11454,1.0,0,0,4,8,1590,0,1979,0,98056,47.5049,-122.186,1970,9960,9864,7990,36.40649554740702,0.04485245901639344,Very Cheap
20140722T000000,389000.0,2,2.0,1340,4122,1.0,0,0,3,8,1340,0,2007,0,98053,47.7182,-122.022,1350,4273,2782,2923,94.37166424065987,0.04118032786885246,Very Cheap
20140815T000000,1038000.0,4,2.5,3770,10893,2.0,0,2,3,11,3770,0,1997,0,98006,47.5646,-122.129,3710,9685,7123,5975,95.29055356651061,0.12629508196721312,Cheap
20140929T000000,698000.0,6,2.5,2680,11250,1.0,0,0,5,7,1340,1340,1967,0,98033,47.6553,-122.19,2200,9875,8570,7675,62.044444444444444,0.08170491803278689,Very Cheap
20150318T000000,685000.0,4,2.5,2820,10125,2.0,0,0,3,8,2820,0,2008,0,98155,47.7494,-122.304,1560,10125,7305,8565,67.65432098765432,0.08,Very Cheap
20141105T000000,198500.0,3,1.75,1520,7137,1.0,0,0,3,5,1520,0,1932,0,98168,47.4924,-122.311,1240,8602,5617,7362,27.812806501331092,0.01619672131147541,Very Cheap
20150326T000000,350000.0,4,2.5,2560,5428,2.0,0,0,3,8,2560,0,2012,0,98042,47.3835,-122.095,2620,5428,2868,2808,64.48047162859248,0.036065573770491806,Very Cheap
20150408T000000,649950.0,3,2.5,3310,387684,1.0,0,0,3,8,2160,1150,1919,1996,98038,47.4167,-121.936,2340,189050,384374,186710,1.676494258210295,0.07540327868852459,Very Cheap
20150429T000000,441000.0,3,1.5,1540,7200,1.0,0,0,3,7,1540,0,1968,0,98011,47.7357,-122.195,1560,7500,5660,5940,61.25,0.048,Very Cheap
20141111T000000,462600.0,3,1.75,1430,11761,1.0,0,0,4,8,1430,0,1964,0,98052,47.6686,-122.157,2040,10035,10331,7995,39.33339001785563,0.0508327868852459,Very Cheap
20150306T000000,365070.0,4,2.5,2506,6232,2.0,0,0,3,7,2506,0,2006,0,98030,47.3734,-122.182,2070,8260,3726,6190,58.579910141206675,0.03804196721311475,Very Cheap
20140513T000000,550000.0,4,2.0,2250,7500,1.0,0,0,5,7,1200,1050,1956,0,98005,47.5877,-122.157,1440,7500,5250,6060,73.33333333333333,0.06229508196721312,Very Cheap
20150428T000000,470000.0,5,1.75,2740,9600,1.0,0,0,4,7,1370,1370,1945,0,98144,47.5738,-122.315,1990,4800,6860,2810,48.958333333333336,0.05180327868852459,Very Cheap
20140827T000000,340000.0,3,1.75,1540,10400,1.0,0,0,3,6,1540,0,1977,0,98024,47.5651,-121.89,1090,7500,8860,6410,32.69230769230769,0.03475409836065574,Very Cheap
20140805T000000,910000.0,4,2.75,4190,38912,1.0,0,0,4,9,2040,2150,1965,0,98005,47.6472,-122.157,3050,36884,34722,33834,23.38610197368421,0.10950819672131147,Cheap
20150407T000000,405000.0,4,1.75,1690,8392,1.0,0,0,3,7,1190,500,1979,0,98028,47.773,-122.256,1880,9861,6702,7981,48.2602478551001,0.043278688524590166,Very Cheap
20140602T000000,661000.0,4,2.25,1990,4600,1.5,0,2,4,8,1420,570,1932,0,98126,47.5638,-122.38,1810,5750,2610,3940,143.69565217391303,0.07685245901639344,Very Cheap
20141106T000000,635000.0,4,2.5,2410,7069,2.0,0,0,3,9,2410,0,1993,0,98034,47.7094,-122.234,2240,7184,4659,4944,89.82883010326779,0.07344262295081967,Very Cheap
20150505T000000,282000.0,2,1.0,1150,6098,1.0,0,0,3,7,950,200,1948,0,98125,47.7259,-122.328,1790,8455,4948,6665,46.24467038373237,0.02714754098360656,Very Cheap
20150211T000000,235000.0,4,1.75,1720,10137,2.0,0,0,3,7,1720,0,1956,0,98188,47.4424,-122.276,1350,10205,8417,8855,23.182401104863374,0.02098360655737705,Very Cheap
20140819T000000,277500.0,3,2.0,1260,22100,2.0,0,0,4,7,1260,0,1981,0,98023,47.2772,-122.354,1430,13000,20840,11570,12.55656108597285,0.026557377049180327,Very Cheap
20150420T000000,346500.0,5,2.5,2020,8250,1.0,0,0,4,8,1430,590,1978,0,98058,47.4432,-122.135,1680,8959,6230,7279,42.0,0.03560655737704918,Very Cheap
20150410T000000,480000.0,5,2.25,2240,5500,1.0,0,0,3,7,1490,750,1959,0,98136,47.5305,-122.391,2010,6050,3260,4040,87.27272727272727,0.05311475409836065,Very Cheap
20140916T000000,360000.0,4,2.25,1930,6508,2.0,0,0,3,8,1930,0,1996,0,98019,47.7458,-121.977,2170,6548,4578,4378,55.316533497234175,0.037377049180327866,Very Cheap
20141106T000000,245000.0,3,2.5,1820,6785,1.0,0,0,3,7,1420,400,1994,0,98092,47.3201,-122.177,1710,6055,4965,4345,36.109064112011794,0.022295081967213116,Very Cheap
20140919T000000,625000.0,3,3.5,1560,1490,2.0,0,0,3,8,1240,320,1995,0,98102,47.6248,-122.319,1560,1662,-70,102,419.46308724832215,0.07213114754098361,Very Cheap
20140529T000000,750500.0,5,3.0,2170,2440,1.5,0,0,4,8,1450,720,1911,0,98115,47.6724,-122.317,2070,4000,270,1930,307.58196721311475,0.08859016393442623,Very Cheap
20150418T000000,525000.0,3,1.75,1600,9579,1.0,0,0,3,8,1180,420,1977,0,98072,47.7662,-122.159,1750,9829,7979,8079,54.807391168180395,0.05901639344262295,Very Cheap
20140729T000000,740000.0,4,3.5,3760,57063,2.0,0,0,3,9,2950,810,1998,0,98053,47.6328,-121.964,2870,28945,53303,26075,12.968122951825176,0.08721311475409836,Very Cheap
20140513T000000,523000.0,3,1.5,1240,7735,1.0,0,0,4,7,1240,0,1957,0,98008,47.601,-122.122,1260,7500,6495,6240,67.6147382029735,0.05875409836065574,Very Cheap
20150304T000000,292000.0,3,1.75,1090,4500,1.5,0,0,5,8,1090,0,1929,0,98118,47.5157,-122.256,1640,5225,3410,3585,64.88888888888889,0.028459016393442622,Very Cheap
20150121T000000,625000.0,4,2.5,2740,9599,1.0,0,2,3,8,1820,920,1961,0,98177,47.7728,-122.385,2660,8280,6859,5620,65.11094905719345,0.07213114754098361,Very Cheap
20150116T000000,700000.0,3,2.5,3110,11727,2.0,0,2,3,9,3110,0,2002,0,98065,47.5445,-121.871,4240,13353,8617,9113,59.69131065063529,0.08196721311475409,Very Cheap
20150312T000000,399950.0,3,2.5,1610,1320,2.0,0,0,3,7,1280,330,2007,0,98144,47.6,-122.298,1480,1602,-290,122,302.99242424242425,0.04261639344262295,Very Cheap
20150225T000000,545000.0,4,3.5,1880,1341,3.0,0,0,3,8,1650,230,2007,0,98122,47.6053,-122.306,1740,1883,-539,143,406.41312453392993,0.06163934426229508,Very Cheap
20140807T000000,339999.0,4,2.0,1740,6369,1.0,0,0,5,6,870,870,1954,0,98133,47.7461,-122.332,1560,7200,4629,5640,53.38341968911917,0.03475396721311475,Very Cheap
20141201T000000,1210000.0,4,2.25,3270,6000,2.0,0,0,5,8,2180,1090,1909,0,98122,47.6101,-122.286,2880,6000,2730,3120,201.66666666666666,0.14885245901639343,Cheap
20141113T000000,545000.0,3,2.5,1990,5149,2.0,0,0,3,8,1990,0,2003,0,98075,47.5895,-122.019,2280,4506,3159,2226,105.84579530005827,0.06163934426229508,Very Cheap
20150309T000000,260000.0,4,1.75,1960,8400,1.0,0,0,4,8,1960,0,1967,0,98023,47.3111,-122.379,2080,8400,6440,6320,30.952380952380953,0.024262295081967214,Very Cheap
20140523T000000,526000.0,3,1.75,1680,3420,1.0,0,0,3,7,960,720,1992,0,98115,47.6854,-122.291,1680,4080,1740,2400,153.80116959064327,0.059147540983606556,Very Cheap
20141112T000000,701000.0,4,3.0,2910,8540,2.0,0,0,3,9,2910,0,2003,0,98059,47.5223,-122.156,3040,6091,5630,3051,82.08430913348946,0.08209836065573771,Very Cheap
20141003T000000,290000.0,3,2.25,1500,7482,1.0,0,0,4,7,1210,290,1968,0,98055,47.4619,-122.187,1480,7308,5982,5828,38.75968992248062,0.02819672131147541,Very Cheap
20141004T000000,330600.0,1,1.0,580,1799,1.0,0,0,3,7,580,0,1908,2005,98117,47.6829,-122.375,1260,4000,1219,2740,183.76876042245692,0.033521311475409835,Very Cheap
20150427T000000,550500.0,3,1.75,2540,8280,1.0,0,0,3,7,1270,1270,1949,0,98177,47.7219,-122.358,1950,8280,5740,6330,66.48550724637681,0.06236065573770492,Very Cheap
20150313T000000,430000.0,2,1.0,950,6426,1.0,0,0,3,7,950,0,1949,0,98126,47.5653,-122.37,1360,2550,5476,1190,66.91565515094926,0.04655737704918033,Very Cheap
20141014T000000,4000000.0,4,5.5,7080,16573,2.0,0,0,3,12,5760,1320,2008,0,98039,47.6151,-122.224,3140,15996,9493,12856,241.35642309780968,0.5147540983606558,Very High
20140804T000000,260600.0,2,1.0,810,4560,1.0,0,0,3,7,810,0,1928,0,98126,47.5425,-122.376,1490,4560,3750,3070,57.14912280701754,0.024340983606557377,Very Cheap
20141218T000000,825000.0,5,3.0,4080,7500,2.0,0,2,4,8,2720,1360,1961,0,98103,47.6722,-122.349,2000,4545,3420,2545,110.0,0.09836065573770492,Very Cheap
20141023T000000,378950.0,4,2.0,1820,8400,1.0,0,0,5,7,1300,520,1956,0,98155,47.7615,-122.329,1700,9450,6580,7750,45.11309523809524,0.03986229508196721,Very Cheap
20150116T000000,435000.0,4,2.5,2650,9065,2.0,0,0,3,7,2650,0,2000,0,98019,47.7258,-121.959,2590,13218,6415,10628,47.98676227247656,0.04721311475409836,Very Cheap
20150422T000000,631000.0,3,2.25,1670,1396,2.0,0,0,3,9,1250,420,2015,0,98115,47.6814,-122.288,1610,5191,-274,3581,452.0057306590258,0.07291803278688525,Very Cheap
20140518T000000,415000.0,3,2.5,2480,8342,2.0,0,0,3,8,2480,0,1986,0,98058,47.4381,-122.134,2300,8303,5862,6003,49.74826180771997,0.04459016393442623,Very Cheap
20141021T000000,222000.0,3,1.75,1240,7560,1.0,0,0,3,8,1070,170,1967,0,98003,47.333,-122.3,1650,7560,6320,5910,29.365079365079364,0.019278688524590165,Very Cheap
20140820T000000,245000.0,3,2.0,1390,8250,1.0,0,0,3,7,1390,0,1987,0,98042,47.3707,-122.094,1390,7875,6860,6485,29.696969696969695,0.022295081967213116,Very Cheap
20150325T000000,720000.0,3,2.5,2880,10126,2.0,0,0,4,10,2880,0,1985,0,98074,47.6319,-122.037,2960,10514,7246,7554,71.1040884850879,0.08459016393442623,Very Cheap
20141223T000000,215000.0,3,1.0,1060,9954,1.0,0,0,4,7,1060,0,1960,0,98032,47.3801,-122.289,1620,8760,8894,7140,21.599357042395017,0.018360655737704918,Very Cheap
20141030T000000,579100.0,2,1.0,1070,2754,1.0,0,0,3,7,830,240,1924,0,98103,47.6755,-122.331,1760,4080,1684,2320,210.27596223674655,0.06611147540983607,Very Cheap
20140728T000000,522500.0,4,1.75,1640,9299,1.5,0,0,4,7,870,770,1943,0,98056,47.5334,-122.168,2460,14326,7659,11866,56.188837509409616,0.05868852459016394,Very Cheap
20140919T000000,489000.0,3,2.0,1510,3000,1.0,0,0,4,7,910,600,1972,0,98115,47.6804,-122.319,1620,4000,1490,2380,163.0,0.05429508196721312,Very Cheap
20150506T000000,240000.0,3,1.0,1230,2353,1.5,0,0,4,6,1230,0,1925,0,98106,47.5177,-122.354,1280,1572,1123,292,101.9974500637484,0.021639344262295083,Very Cheap
20150421T000000,420250.0,3,2.0,1510,3657,1.0,0,0,3,8,1510,0,2007,0,98053,47.7225,-122.029,1510,3657,2147,2147,114.91659830462127,0.04527868852459016,Very Cheap
20141114T000000,523000.0,4,2.5,3180,20870,2.0,0,0,3,8,2120,1060,1967,0,98034,47.7176,-122.241,2700,14190,17690,11490,25.059894585529467,0.05875409836065574,Very Cheap
20140513T000000,628000.0,4,2.0,2260,6000,1.0,0,0,3,8,1430,830,1958,0,98115,47.6876,-122.298,2030,5874,3740,3844,104.66666666666667,0.07252459016393442,Very Cheap
20150506T000000,320000.0,4,2.5,1920,7277,2.0,0,0,4,8,1920,0,1990,0,98031,47.4058,-122.192,2300,7645,5357,5345,43.97416517795795,0.032131147540983604,Very Cheap
20141118T000000,359950.0,3,2.5,1980,7800,2.0,0,0,3,8,1980,0,1999,0,98055,47.4492,-122.199,1700,20580,5820,18880,46.1474358974359,0.037370491803278685,Very Cheap
20140505T000000,232000.0,2,1.0,1200,8063,1.0,0,0,4,6,1200,0,1958,0,98198,47.4204,-122.324,1200,7500,6863,6300,28.77340940096738,0.02059016393442623,Very Cheap
20141114T000000,810000.0,4,2.25,2020,5600,1.0,0,2,4,8,1210,810,1961,0,98115,47.6821,-122.267,2660,6050,3580,3390,144.64285714285714,0.09639344262295083,Very Cheap
20141211T000000,245000.0,4,1.5,2010,7561,1.5,0,0,4,7,1890,120,1921,0,98002,47.311,-122.227,1420,6564,5551,5144,32.403121280253934,0.022295081967213116,Very Cheap
20150507T000000,273000.0,3,2.25,1930,8192,1.0,0,0,3,7,1470,460,1984,0,98003,47.2624,-122.299,1510,8192,6262,6682,33.3251953125,0.025967213114754098,Very Cheap
20150211T000000,1191000.0,5,2.5,2710,14989,1.0,0,0,3,8,1720,990,1959,0,98004,47.6411,-122.207,3180,16624,12279,13444,79.45826939755821,0.14636065573770493,Cheap
20150421T000000,438000.0,5,1.0,1950,6250,1.5,0,0,4,7,1450,500,1917,0,98136,47.5511,-122.386,1950,6250,4300,4300,70.08,0.04760655737704918,Very Cheap
20140717T000000,400000.0,3,1.75,2110,19600,1.0,0,0,4,8,2110,0,1959,0,98055,47.4742,-122.198,880,10077,17490,9197,20.408163265306122,0.04262295081967213,Very Cheap
20140516T000000,340000.0,3,1.0,1250,4800,1.0,0,0,4,7,1250,0,1951,0,98126,47.5517,-122.381,1404,4800,3550,3396,70.83333333333333,0.03475409836065574,Very Cheap
20140609T000000,552000.0,2,2.5,1380,951,3.0,0,0,3,9,1380,0,2006,0,98103,47.6654,-122.355,1430,3400,-429,1970,580.4416403785489,0.06255737704918032,Very Cheap
20141125T000000,790000.0,3,1.75,2050,4080,2.0,0,0,3,8,2050,0,1991,0,98105,47.6698,-122.325,1890,4080,2030,2190,193.62745098039215,0.09377049180327869,Very Cheap
20140707T000000,360000.0,3,1.5,1800,22000,2.0,0,0,3,8,1800,0,1931,0,98168,47.4889,-122.286,1440,16640,20200,15200,16.363636363636363,0.037377049180327866,Very Cheap
20150302T000000,235000.0,3,1.0,1310,15022,1.0,0,0,3,7,1310,0,1934,1984,98168,47.5008,-122.332,1530,13154,13712,11624,15.643722540274265,0.02098360655737705,Very Cheap
20141010T000000,775000.0,2,1.0,1010,3600,1.0,0,0,3,7,1010,0,1913,0,98107,47.6641,-122.357,1540,3600,2590,2060,215.27777777777777,0.09180327868852459,Very Cheap
20140514T000000,489200.0,3,2.75,1850,9600,1.5,0,0,5,7,1850,0,1965,0,98034,47.7259,-122.226,1250,10500,7750,9250,50.958333333333336,0.054321311475409834,Very Cheap
20140729T000000,341000.0,3,2.25,1750,8900,2.0,0,0,4,8,1750,0,1977,0,98058,47.4451,-122.136,1680,7910,7150,6230,38.31460674157304,0.03488524590163934,Very Cheap
20141001T000000,335000.0,4,2.5,2154,6050,2.0,0,0,3,8,2154,0,2012,0,98030,47.3513,-122.174,2305,5769,3896,3464,55.37190082644628,0.03409836065573771,Very Cheap
20150121T000000,393500.0,3,1.75,1230,1441,2.0,0,0,3,8,1010,220,2004,0,98116,47.5626,-122.382,1170,1942,211,772,273.07425399028455,0.041770491803278686,Very Cheap
20140918T000000,360000.0,3,2.0,1960,8846,1.0,0,3,4,6,980,980,1940,0,98178,47.5101,-122.246,2190,6363,6886,4173,40.69635993669455,0.037377049180327866,Very Cheap
20150304T000000,400800.0,4,1.0,1070,5750,1.0,0,0,3,6,870,200,1923,0,98126,47.564,-122.379,1270,5750,4680,4480,69.70434782608696,0.042727868852459015,Very Cheap
20141103T000000,585000.0,3,1.0,1450,5378,1.0,0,0,3,7,1190,260,1939,0,98199,47.6436,-122.405,1810,5559,3928,3749,108.7764968389736,0.06688524590163934,Very Cheap
20141001T000000,1600000.0,4,2.75,3680,5000,2.0,0,3,3,9,2480,1200,1936,0,98105,47.6599,-122.269,3200,5000,1320,1800,320.0,0.2,Cheap
20140729T000000,2880500.0,4,2.5,5760,32033,2.0,0,4,4,12,4390,1370,1994,0,98177,47.7288,-122.37,3420,28475,26273,25055,89.92289201760684,0.36793442622950817,Medium
20140515T000000,300000.0,3,1.0,1220,13000,1.0,0,0,4,7,1220,0,1955,0,98133,47.7608,-122.353,1510,12600,11780,11090,23.076923076923077,0.029508196721311476,Very Cheap
20141114T000000,1045000.0,4,2.75,2950,4560,2.0,0,0,5,7,1810,1140,1912,0,98103,47.6525,-122.333,2000,4560,1610,2560,229.16666666666666,0.12721311475409836,Cheap
20140922T000000,360000.0,3,1.5,1340,1110,2.0,0,0,3,7,1040,300,1999,0,98117,47.698,-122.366,1220,1110,-230,-110,324.3243243243243,0.037377049180327866,Very Cheap
20140620T000000,665900.0,4,2.25,2870,5453,2.0,0,1,4,8,2220,650,1926,0,98146,47.5129,-122.388,1660,4800,2583,3140,122.11626627544472,0.07749508196721311,Very Cheap
20140822T000000,470000.0,4,1.0,2590,18224,1.5,0,0,4,7,2000,590,1911,0,98118,47.5318,-122.286,1800,7080,15634,5280,25.790166812993853,0.05180327868852459,Very Cheap
20140513T000000,581000.0,4,1.75,2090,8164,1.0,0,0,4,8,1070,1020,1963,0,98052,47.6715,-122.155,1310,7975,6074,6665,71.16609505144537,0.06636065573770492,Very Cheap
20140707T000000,527000.0,6,3.5,3000,8401,1.0,0,0,3,8,1500,1500,1979,0,98125,47.7226,-122.299,1400,8403,5401,7003,62.730627306273064,0.059278688524590166,Very Cheap
20150506T000000,423000.0,4,1.75,1730,7245,1.0,0,0,4,7,880,850,1955,0,98007,47.5995,-122.144,1550,7245,5515,5695,58.38509316770186,0.04563934426229508,Very Cheap
20140927T000000,875000.0,4,3.5,2850,4416,1.5,0,0,3,7,2040,810,1926,0,98103,47.6835,-122.342,1860,4416,1566,2556,198.143115942029,0.10491803278688525,Cheap
20140729T000000,410000.0,3,1.0,1020,6903,1.0,0,0,3,7,1020,0,1951,0,98116,47.571,-122.392,1440,6678,5883,5238,59.39446617412719,0.043934426229508196,Very Cheap
20150316T000000,606000.0,3,2.5,2200,6005,2.0,0,0,3,9,2200,0,1997,0,98072,47.7408,-122.169,2320,6098,3805,3778,100.91590341382181,0.06963934426229508,Very Cheap
20150501T000000,654000.0,3,2.5,3240,60840,2.0,0,0,3,7,3240,0,1997,0,98045,47.5192,-121.764,2570,204732,57600,202162,10.749506903353057,0.0759344262295082,Very Cheap
20140709T000000,150000.0,3,0.75,490,38500,1.5,0,0,4,5,490,0,1959,0,98014,47.7112,-121.315,800,18297,38010,17497,3.896103896103896,0.009836065573770493,Very Cheap
20141109T000000,373000.0,3,2.5,2990,6771,1.0,0,0,3,7,1550,1440,2003,0,98106,47.5237,-122.353,1800,6771,3781,4971,55.08787476000591,0.03908196721311476,Very Cheap
20140529T000000,550000.0,5,2.0,2450,9488,1.0,0,0,4,7,1240,1210,1900,1955,98133,47.7056,-122.34,1310,5693,7038,4383,57.96795952782462,0.06229508196721312,Very Cheap
20140521T000000,512500.0,3,2.5,1900,7604,2.0,0,0,3,8,1900,0,1990,0,98033,47.7002,-122.188,1980,9583,5704,7603,67.39873750657549,0.05737704918032787,Very Cheap
20150428T000000,360000.0,4,2.5,2640,7388,2.0,0,0,3,7,2640,0,2003,0,98038,47.3505,-122.027,2640,6383,4748,3743,48.727666486193826,0.037377049180327866,Very Cheap
20140926T000000,369000.0,3,2.0,1340,1480,3.0,0,0,3,8,1340,0,1997,0,98117,47.6904,-122.393,1340,1321,140,-19,249.32432432432432,0.03855737704918033,Very Cheap
20141230T000000,825000.0,4,2.5,3220,5262,2.0,0,0,3,9,3220,0,2003,0,98033,47.6878,-122.162,3220,4921,2042,1701,156.78449258836943,0.09836065573770492,Very Cheap
20141201T000000,255000.0,3,2.0,930,11475,1.0,0,0,3,7,930,0,1978,0,98045,47.4644,-121.745,1280,11250,10545,9970,22.22222222222222,0.02360655737704918,Very Cheap
20140528T000000,1285000.0,4,2.5,3240,10800,1.0,0,0,3,10,2260,980,1946,0,98105,47.6709,-122.262,3490,10800,7560,7310,118.98148148148148,0.15868852459016394,Cheap
20140808T000000,270000.0,5,2.5,2630,8470,1.5,0,0,4,8,2630,0,1968,0,98002,47.2863,-122.196,1780,8575,5840,6795,31.877213695395515,0.025573770491803278,Very Cheap
20140924T000000,480680.0,3,2.5,1730,4924,2.0,0,0,3,8,1730,0,1996,0,98029,47.5672,-122.005,1610,4313,3194,2703,97.61982128350934,0.05320393442622951,Very Cheap
20150303T000000,525000.0,4,1.75,2120,7725,1.0,0,0,3,8,1220,900,1965,0,98007,47.6003,-122.144,2160,7725,5605,5565,67.96116504854369,0.05901639344262295,Very Cheap
20140623T000000,291500.0,3,1.0,880,9238,1.5,0,0,5,6,880,0,1946,0,98155,47.7494,-122.319,1170,9238,8358,8068,31.5544490149383,0.02839344262295082,Very Cheap
20141230T000000,305000.0,4,2.0,1800,13551,1.0,0,0,4,7,1800,0,1974,0,98059,47.4721,-122.128,1730,13551,11751,11821,22.50756401741569,0.03016393442622951,Very Cheap
20150507T000000,285000.0,3,1.75,1600,7500,1.0,0,0,3,7,1600,0,1998,0,98002,47.2831,-122.199,1620,7461,5900,5841,38.0,0.02754098360655738,Very Cheap
20140916T000000,1875000.0,3,2.5,3280,29111,2.0,1,3,3,11,3280,0,1925,0,98199,47.6699,-122.416,3530,21074,25831,17544,64.40864278107932,0.2360655737704918,Cheap
20150108T000000,329500.0,5,1.75,3290,8000,1.0,0,0,3,7,1790,1500,1968,0,98030,47.3733,-122.214,2380,7000,4710,4620,41.1875,0.03337704918032787,Very Cheap
20140708T000000,1570000.0,4,2.25,2890,18226,3.0,1,4,3,10,2890,0,1984,0,98056,47.5169,-122.209,2870,11151,15336,8281,86.14067815209042,0.1960655737704918,Cheap
20140811T000000,379260.0,3,2.5,1730,7202,1.0,0,0,3,7,1330,400,1991,0,98198,47.4099,-122.329,2100,8125,5472,6025,52.660372118855875,0.03990295081967213,Very Cheap
20140709T000000,356000.0,3,2.5,1590,3411,2.0,0,0,3,7,1590,0,2000,0,98065,47.5303,-121.878,1590,3411,1821,1821,104.36822046320727,0.03685245901639344,Very Cheap
20141201T000000,571900.0,4,1.75,1710,8947,1.0,0,0,4,7,1710,0,1956,0,98007,47.5947,-122.135,1360,10133,7237,8773,63.920867329831225,0.0651672131147541,Very Cheap
20140821T000000,271500.0,3,1.75,1995,18360,2.0,0,0,3,7,1995,0,1957,0,98198,47.4129,-122.322,1980,13640,16365,11660,14.787581699346406,0.02577049180327869,Very Cheap
20150316T000000,390000.0,3,1.75,1300,10030,1.0,0,0,4,7,1300,0,1967,0,98034,47.7359,-122.192,1520,7713,8730,6193,38.88334995014955,0.04131147540983607,Very Cheap
20150512T000000,550000.0,3,2.5,2720,62310,1.0,0,0,3,8,2040,680,1985,0,98038,47.4168,-122.074,2770,204296,59590,201526,8.826833574065159,0.06229508196721312,Very Cheap
20150105T000000,755000.0,2,2.5,1360,2070,2.0,0,0,3,8,1360,0,1999,0,98102,47.6423,-122.329,1920,2092,710,172,364.7342995169082,0.08918032786885247,Very Cheap
20141118T000000,509500.0,2,2.5,1590,1485,2.0,0,0,3,8,1300,290,1994,0,98199,47.6375,-122.387,1880,3675,-105,1795,343.0976430976431,0.056983606557377046,Very Cheap
20150325T000000,486700.0,2,1.0,1200,6278,1.0,0,0,3,7,1080,120,1942,0,98103,47.7001,-122.351,1200,6211,5078,5011,77.52468939152597,0.05399344262295082,Very Cheap
20140728T000000,527500.0,2,1.0,1170,3000,1.5,0,0,3,7,1170,0,1910,0,98103,47.6697,-122.338,1530,4000,1830,2470,175.83333333333334,0.05934426229508197,Very Cheap
20140815T000000,475000.0,5,2.5,2010,3600,1.5,0,0,3,6,1510,500,1912,0,98119,47.6522,-122.366,1780,3600,1590,1820,131.94444444444446,0.05245901639344262,Very Cheap
20140827T000000,268000.0,3,2.75,1880,1793,2.0,0,0,3,7,1810,70,2001,0,98108,47.5405,-122.293,1800,2537,-87,737,149.4701617401004,0.025311475409836064,Very Cheap
20150416T000000,562000.0,3,2.0,3250,50529,2.0,0,0,4,8,3250,0,1978,0,98075,47.5849,-122.016,2370,47480,47279,45110,11.122325793108908,0.0638688524590164,Very Cheap
20140722T000000,780000.0,4,2.5,2270,13449,1.0,0,0,4,9,1310,960,1975,0,98040,47.5416,-122.232,2810,13475,11179,10665,57.99687709123355,0.09245901639344262,Very Cheap
20150106T000000,700000.0,9,3.0,3680,4400,2.0,0,0,3,7,2830,850,1908,0,98102,47.6374,-122.324,1960,2450,720,490,159.0909090909091,0.08196721311475409,Very Cheap
20140902T000000,710000.0,3,2.0,1880,3000,1.0,0,0,4,8,1040,840,1931,0,98109,47.6418,-122.351,1790,3000,1120,1210,236.66666666666666,0.08327868852459017,Very Cheap
20140612T000000,445000.0,3,1.0,1050,5664,1.0,0,0,4,7,910,140,1947,0,98115,47.6897,-122.285,1500,5664,4614,4164,78.56638418079096,0.04852459016393443,Very Cheap
20140915T000000,729000.0,3,3.25,2250,60548,1.0,0,0,3,9,2250,0,2005,0,98038,47.4246,-122.014,2760,84070,58298,81310,12.040034352910087,0.08577049180327868,Very Cheap
20140618T000000,384400.0,3,3.25,1689,1388,3.0,0,0,3,8,1689,0,2008,0,98125,47.7174,-122.317,1459,1384,-301,-75,276.94524495677234,0.04057704918032787,Very Cheap
20150327T000000,815000.0,6,3.0,2860,17853,1.0,0,0,3,8,1430,1430,1962,2015,98006,47.546,-122.175,1920,13452,14993,11532,45.650590937097405,0.09704918032786886,Very Cheap
20141029T000000,865000.0,4,2.5,2710,4069,3.0,0,0,4,10,2710,0,1990,0,98122,47.604,-122.288,1810,3586,1359,1776,212.5829442123372,0.10360655737704919,Cheap
20140828T000000,514000.0,3,2.0,1770,7200,1.0,0,0,4,7,1770,0,1967,0,98033,47.6642,-122.173,2250,11250,5430,9000,71.38888888888889,0.05757377049180328,Very Cheap
20140520T000000,615000.0,4,2.75,2820,13193,1.0,0,0,3,8,1860,960,1965,0,98006,47.5579,-122.174,2580,13193,10373,10613,46.61562950049269,0.07081967213114754,Very Cheap
20141016T000000,865000.0,4,3.25,3400,99170,1.0,0,0,4,8,2000,1400,1980,0,98072,47.7293,-122.099,3460,47920,95770,44460,8.722395885852576,0.10360655737704919,Cheap
20141013T000000,755000.0,4,2.5,3110,6930,2.0,0,0,3,9,3110,0,2004,0,98052,47.7011,-122.112,3090,7000,3820,3910,108.94660894660895,0.08918032786885247,Very Cheap
20150427T000000,425000.0,4,1.0,1480,8321,1.0,0,0,3,7,1080,400,1953,0,98155,47.7629,-122.318,1580,8502,6841,6922,51.07559187597644,0.04590163934426229,Very Cheap
20140618T000000,375000.0,2,1.0,940,9839,1.0,0,0,3,6,940,0,1910,0,98136,47.5379,-122.386,1330,8740,8899,7410,38.113629433885556,0.03934426229508197,Very Cheap
20150424T000000,750000.0,4,2.5,2680,4548,2.0,0,0,3,8,2680,0,2009,0,98052,47.7073,-122.114,2750,4548,1868,1798,164.90765171503958,0.08852459016393442,Very Cheap
20140926T000000,722000.0,4,2.75,3190,5408,2.0,0,0,3,9,3190,0,2005,0,98075,47.5903,-121.988,3160,5773,2218,2613,133.5059171597633,0.08485245901639345,Very Cheap
20150331T000000,1011000.0,3,2.5,1920,4480,2.0,0,1,3,9,1920,0,1949,1997,98119,47.6472,-122.373,1790,4500,2560,2710,225.66964285714286,0.12275409836065573,Cheap
20140625T000000,725000.0,3,2.5,2610,7510,2.0,0,0,3,9,2610,0,1996,0,98052,47.6648,-122.137,2610,8458,4900,5848,96.53794940079894,0.08524590163934426,Very Cheap
20140930T000000,170000.0,3,0.75,1040,42180,1.0,0,0,2,6,1040,0,1947,0,98055,47.4518,-122.199,1270,24090,41140,22820,4.030346135609293,0.012459016393442624,Very Cheap
20150501T000000,845000.0,4,3.25,2880,35315,1.0,0,0,3,11,2270,610,1982,0,98005,47.6587,-122.163,1910,167378,32435,165468,23.927509556845532,0.10098360655737705,Cheap
20150115T000000,271900.0,3,2.0,1450,8771,2.0,0,0,4,7,1450,0,1991,0,98022,47.1947,-121.989,1450,8653,7321,7203,30.99988598791472,0.02582295081967213,Very Cheap
20140605T000000,1300000.0,6,4.5,3902,3880,3.0,0,4,4,9,2782,1120,1977,0,98116,47.5837,-122.399,1100,3870,-22,2770,335.0515463917526,0.16065573770491803,Cheap
20141222T000000,261500.0,4,2.5,2460,7800,1.0,0,0,3,8,1500,960,1977,0,98023,47.3081,-122.384,2210,7800,5340,5590,33.52564102564103,0.024459016393442622,Very Cheap
20140516T000000,619500.0,3,2.5,2170,5000,2.0,0,0,3,9,2170,0,2003,0,98029,47.5458,-121.996,2170,5000,2830,2830,123.9,0.07140983606557377,Very Cheap
20140610T000000,435000.0,5,2.25,1970,15247,1.0,0,0,3,7,1450,520,1986,0,98024,47.5669,-121.905,1300,10800,13277,9500,28.530202662818915,0.04721311475409836,Very Cheap
20141003T000000,210000.0,3,1.0,1000,5454,1.0,0,0,3,7,1000,0,1954,0,98133,47.7339,-122.337,1320,5250,4454,3930,38.503850385038504,0.017704918032786884,Very Cheap
20141126T000000,489950.0,3,2.0,1580,4010,1.0,0,0,4,7,790,790,1909,0,98117,47.6769,-122.371,1350,5350,2430,4000,122.18204488778055,0.05441967213114754,Very Cheap
20140508T000000,260000.0,4,1.5,2130,8800,1.0,0,0,3,7,1100,1030,1962,0,98032,47.383,-122.288,1480,8120,6670,6640,29.545454545454547,0.024262295081967214,Very Cheap
20140628T000000,300000.0,4,1.0,1370,8499,1.0,0,0,3,7,1370,0,1949,0,98155,47.736,-122.301,1370,8187,7129,6817,35.29827038475115,0.029508196721311476,Very Cheap
20150422T000000,530000.0,4,2.0,2150,14161,1.0,0,2,3,8,1330,820,1966,0,98003,47.3376,-122.323,2310,14034,12011,11724,37.42673540004237,0.05967213114754098,Very Cheap
20141216T000000,235000.0,3,1.75,1370,14030,1.0,0,0,4,8,1370,0,1977,0,98092,47.2969,-122.163,2100,15260,12660,13160,16.74982181040627,0.02098360655737705,Very Cheap
20150105T000000,593500.0,3,1.0,1370,4000,2.0,0,0,4,8,1370,0,1918,0,98105,47.6711,-122.324,1370,4000,2630,2630,148.375,0.068,Very Cheap
20140723T000000,562000.0,3,3.0,3290,80471,2.0,0,2,4,8,2330,960,1975,0,98070,47.504,-122.464,1830,30494,77181,28664,6.9838823924146585,0.0638688524590164,Very Cheap
20150427T000000,585000.0,3,2.0,3190,207346,2.0,0,0,3,9,3190,0,1994,0,98022,47.2737,-122.015,2930,206474,204156,203544,2.8213710416405426,0.06688524590163934,Very Cheap
20140530T000000,2400000.0,4,3.25,4140,20734,1.0,0,1,3,10,3300,840,1977,2005,98004,47.6344,-122.215,4020,20008,16594,15988,115.75190508343783,0.30491803278688523,Medium
20150224T000000,199500.0,3,1.75,1690,8901,1.0,0,0,3,7,1690,0,1986,0,98030,47.3546,-122.176,1690,7532,7211,5842,22.413211998651835,0.016327868852459015,Very Cheap
20140902T000000,544500.0,5,1.0,1690,3240,1.5,0,0,3,7,1690,0,1914,0,98115,47.6746,-122.325,1230,4500,1550,3270,168.05555555555554,0.06157377049180328,Very Cheap
20150218T000000,394900.0,3,1.0,1430,13370,1.0,0,0,3,7,1430,0,1962,0,98034,47.7317,-122.241,1670,10075,11940,8405,29.536275243081526,0.04195409836065574,Very Cheap
20140731T000000,912000.0,4,3.75,1980,4095,2.0,0,0,3,9,1980,0,2009,0,98103,47.6901,-122.356,1480,3840,2115,2360,222.71062271062272,0.10977049180327869,Cheap
20140710T000000,260000.0,3,2.5,1490,8102,2.0,0,0,4,7,1490,0,1990,0,98042,47.3712,-122.092,1640,7943,6612,6303,32.09084176746482,0.024262295081967214,Very Cheap
20150219T000000,858000.0,5,3.0,3620,12778,1.0,0,2,5,8,1900,1720,1964,0,98006,47.5512,-122.191,2930,10669,9158,7739,67.14665831898576,0.10268852459016393,Cheap
20141209T000000,1275000.0,4,2.5,2720,16454,1.0,0,1,5,9,1870,850,1963,0,98040,47.5489,-122.216,3560,15993,13734,12433,77.48875653336574,0.15737704918032788,Cheap
20150513T000000,242150.0,4,1.75,1490,8544,1.0,0,0,4,7,1490,0,1970,0,98031,47.3894,-122.166,1180,8372,7054,7192,28.341526217228463,0.021921311475409835,Very Cheap
20141030T000000,220000.0,3,1.75,1230,7200,1.0,0,0,3,7,1230,0,1986,0,98023,47.2881,-122.363,1540,7210,5970,5670,30.555555555555557,0.01901639344262295,Very Cheap
20150430T000000,235000.0,3,2.0,1900,7980,1.0,0,0,4,7,1340,560,1977,0,98023,47.305,-122.373,1690,7840,6080,6150,29.448621553884713,0.02098360655737705,Very Cheap
20141021T000000,370000.0,3,1.75,1530,10300,1.0,0,0,4,7,1530,0,1978,0,98133,47.7767,-122.356,1940,9883,8770,7943,35.922330097087375,0.038688524590163934,Very Cheap
20141003T000000,450000.0,3,1.75,2290,44866,1.0,0,0,3,8,1390,900,1981,0,98077,47.7398,-122.041,2410,44866,42576,42456,10.029866714215665,0.04918032786885246,Very Cheap
20140711T000000,534950.0,5,1.5,2240,6337,1.0,0,0,3,8,1280,960,1956,0,98125,47.7046,-122.316,1870,6380,4097,4510,84.41691652201357,0.06032131147540984,Very Cheap
20150315T000000,730000.0,4,2.5,3470,14271,2.0,0,0,3,9,3470,0,2005,0,98065,47.5423,-121.877,3450,9380,10801,5930,51.15268726788592,0.0859016393442623,Very Cheap
20140925T000000,465000.0,4,2.5,3050,32450,1.0,0,0,4,8,1550,1500,1983,0,98030,47.3626,-122.209,2350,15390,29400,13040,14.329738058551618,0.051147540983606556,Very Cheap
20140801T000000,178000.0,3,1.0,1100,5734,1.0,0,0,4,7,1100,0,1955,0,98030,47.3632,-122.174,1770,6050,4634,4280,31.042901988140915,0.013508196721311476,Very Cheap
20150209T000000,215000.0,3,1.0,1610,7140,1.0,0,0,3,7,1080,530,1976,0,98031,47.3943,-122.189,1800,7600,5530,5800,30.11204481792717,0.018360655737704918,Very Cheap
20150312T000000,300000.0,3,2.75,1910,15508,1.0,0,0,3,8,1210,700,1984,0,98023,47.3128,-122.345,2450,7989,13598,5539,19.344854268764507,0.029508196721311476,Very Cheap
20140515T000000,430000.0,3,2.0,1510,7066,1.0,0,2,3,7,1230,280,1973,0,98125,47.7053,-122.303,1950,8089,5556,6139,60.85479762241721,0.04655737704918033,Very Cheap
20140731T000000,183000.0,3,1.5,1280,4366,2.0,0,0,4,6,1280,0,1985,0,98002,47.335,-122.215,1280,4366,3086,3086,41.914796152084286,0.014163934426229508,Very Cheap
20140612T000000,585000.0,3,2.5,1910,1501,2.5,0,0,3,8,1530,380,2007,0,98199,47.6441,-122.385,1760,1750,-409,-10,389.74017321785476,0.06688524590163934,Very Cheap
20140716T000000,192950.0,3,1.0,1170,3330,2.0,0,0,4,6,1170,0,1969,0,98092,47.3155,-122.182,1090,3330,2160,2240,57.94294294294294,0.015468852459016394,Very Cheap
20140926T000000,599000.0,2,1.0,1550,7713,1.0,0,0,3,7,1550,0,1930,1979,98117,47.7005,-122.358,1340,6350,6163,5010,77.66109166342538,0.06872131147540983,Very Cheap
20140708T000000,326500.0,3,1.0,1060,7920,1.0,0,0,4,7,1060,0,1968,0,98106,47.5649,-122.358,1060,7457,6860,6397,41.224747474747474,0.032983606557377046,Very Cheap
20140718T000000,358803.0,2,1.0,1040,5765,1.0,0,0,3,7,1040,0,1944,0,98133,47.7024,-122.346,1040,3844,4725,2804,62.23816131830009,0.03722006557377049,Very Cheap
20140528T000000,537000.0,3,2.5,1550,12920,2.0,0,0,5,7,1550,0,1999,0,98033,47.6973,-122.194,2610,10800,11370,8190,41.56346749226006,0.060590163934426226,Very Cheap
20141023T000000,1155000.0,3,2.5,2490,24691,1.0,1,4,4,9,1580,910,1961,0,98146,47.488,-122.364,2800,24121,22201,21321,46.77817828358511,0.14163934426229507,Cheap
20150129T000000,156000.0,2,1.0,920,5889,1.0,0,0,4,6,920,0,1950,0,98002,47.3012,-122.218,1210,6180,4969,4970,26.490066225165563,0.010622950819672131,Very Cheap
20150325T000000,219000.0,3,1.0,1250,8276,1.5,0,0,5,6,1250,0,1939,0,98022,47.2092,-121.997,1250,8792,7026,7542,26.462058965683905,0.018885245901639345,Very Cheap
20150501T000000,1190000.0,3,1.5,2540,2700,2.0,0,0,4,8,1630,910,1922,0,98119,47.637,-122.361,2520,5400,160,2880,440.74074074074076,0.14622950819672131,Cheap
20150427T000000,248000.0,5,1.75,2190,16788,1.0,0,2,3,8,1380,810,1978,0,98030,47.3764,-122.176,1920,8366,14598,6446,14.772456516559448,0.022688524590163933,Very Cheap
20150209T000000,340000.0,3,1.75,1340,196020,1.0,0,0,4,7,1340,0,1987,0,98010,47.2931,-121.992,2250,232230,194680,229980,1.7345168860320375,0.03475409836065574,Very Cheap
20150422T000000,899100.0,5,2.5,2410,15300,1.0,0,0,4,8,1400,1010,1975,0,98040,47.5416,-122.231,2440,15300,12890,12860,58.76470588235294,0.10807868852459017,Cheap
20140728T000000,346950.0,3,1.75,1830,10954,1.0,0,0,3,7,1830,0,1963,0,98155,47.7554,-122.306,1850,8624,9124,6774,31.673361329194815,0.0356655737704918,Very Cheap
20140917T000000,330000.0,3,1.0,1850,5775,2.0,0,0,3,6,1740,110,1928,0,98108,47.5446,-122.296,1520,3578,3925,2058,57.142857142857146,0.03344262295081967,Very Cheap
20140731T000000,325000.0,3,1.0,1410,8250,1.0,0,0,3,7,1410,0,1954,0,98177,47.7621,-122.36,1580,8250,6840,6670,39.39393939393939,0.03278688524590164,Very Cheap
20141027T000000,315000.0,3,1.75,1460,7884,1.0,0,0,3,8,1460,0,1975,0,98058,47.4457,-122.128,2050,7210,6424,5160,39.954337899543376,0.031475409836065574,Very Cheap
20140623T000000,649950.0,3,2.5,1500,1375,2.0,0,0,3,9,1200,300,2014,0,98119,47.6451,-122.375,1680,1627,-125,-53,472.6909090909091,0.07540327868852459,Very Cheap
20140825T000000,316000.0,3,1.0,1130,7200,1.5,0,0,4,6,1130,0,1942,0,98133,47.7298,-122.355,1350,1358,6070,8,43.888888888888886,0.03160655737704918,Very Cheap
20140617T000000,386000.0,2,2.5,1620,3196,2.0,0,0,3,8,1620,0,2008,0,98065,47.5167,-121.878,1750,2828,1576,1078,120.77596996245306,0.04078688524590164,Very Cheap
20150408T000000,535000.0,2,1.75,2330,7280,1.0,0,0,3,7,1450,880,1982,0,98188,47.4282,-122.28,1830,12178,4950,10348,73.48901098901099,0.06032786885245902,Very Cheap
20150325T000000,600000.0,3,3.0,1520,1800,3.0,0,0,3,7,1520,0,2003,0,98115,47.6822,-122.326,1520,1500,280,-20,333.3333333333333,0.06885245901639345,Very Cheap
20141118T000000,339000.0,4,2.5,2840,8746,2.0,0,0,3,8,2840,0,2001,0,98022,47.19,-122.013,2630,9900,5906,7270,38.760576263434714,0.03462295081967213,Very Cheap
20140926T000000,167000.0,3,2.0,1520,7456,1.0,0,0,3,7,1520,0,1949,0,98166,47.4745,-122.343,1740,8464,5936,6724,22.3980686695279,0.012065573770491804,Very Cheap
20141215T000000,430000.0,3,1.0,1740,4800,1.0,0,0,3,8,1740,0,1952,0,98118,47.5596,-122.27,1600,4800,3060,3200,89.58333333333333,0.04655737704918033,Very Cheap
20140821T000000,688000.0,4,4.0,4000,9309,2.0,0,0,3,9,4000,0,2007,0,98065,47.5421,-121.888,3920,8048,5309,4128,73.90697174777097,0.08039344262295083,Very Cheap
20140908T000000,834500.0,3,2.25,2780,6000,1.0,0,3,4,9,1670,1110,1948,0,98199,47.6442,-122.406,2780,6000,3220,3220,139.08333333333334,0.09960655737704918,Very Cheap
20140628T000000,1075000.0,4,4.25,3500,8750,1.0,0,4,5,9,2140,1360,1951,0,98177,47.7222,-122.367,3110,8750,5250,5640,122.85714285714286,0.13114754098360656,Cheap
20141201T000000,250000.0,3,1.0,1060,52272,1.0,0,0,3,7,1060,0,1960,0,98030,47.36,-122.178,1900,5971,51212,4071,4.782675237220691,0.022950819672131147,Very Cheap
20150410T000000,402500.0,3,1.0,1290,4000,1.5,0,0,3,7,1290,0,1926,0,98118,47.5462,-122.277,1160,5040,2710,3880,100.625,0.04295081967213115,Very Cheap
20141216T000000,432500.0,3,2.5,2390,6435,1.0,0,0,3,8,1600,790,1978,0,98034,47.726,-122.194,2020,7300,4045,5280,67.2105672105672,0.046885245901639346,Very Cheap
20140814T000000,485000.0,5,1.75,2460,14100,1.0,0,0,3,7,1380,1080,1972,0,98028,47.7452,-122.224,2028,11078,11640,9050,34.39716312056738,0.05377049180327869,Very Cheap
20140820T000000,560000.0,4,2.75,2930,22000,1.0,0,3,4,9,1580,1350,1978,0,98023,47.3227,-122.384,2930,9758,19070,6828,25.454545454545453,0.06360655737704918,Very Cheap
20141021T000000,410000.0,4,2.25,2200,8292,2.0,0,0,3,7,2200,0,1990,0,98155,47.7456,-122.315,1090,8290,6092,7200,49.44524843222383,0.043934426229508196,Very Cheap
20140515T000000,455000.0,3,2.5,1870,7344,1.0,0,0,3,8,1470,400,1980,0,98034,47.7265,-122.206,1930,7344,5474,5414,61.95533769063181,0.049836065573770495,Very Cheap
20141229T000000,459500.0,4,2.5,2060,8968,1.0,0,0,4,7,1190,870,1975,0,98155,47.7686,-122.317,1350,8972,6908,7622,51.237734165923285,0.050426229508196724,Very Cheap
20141212T000000,371000.0,4,1.75,1610,11305,1.0,0,0,3,7,1610,0,1968,0,98034,47.727,-122.176,1870,11850,9695,9980,32.81733746130031,0.038819672131147544,Very Cheap
20150220T000000,289500.0,3,2.25,2120,3400,2.0,0,0,3,7,2120,0,2002,0,98092,47.3364,-122.17,2420,3400,1280,980,85.1470588235294,0.028131147540983607,Very Cheap
20141021T000000,395000.0,3,3.5,1450,1263,2.0,0,0,3,8,1160,290,2007,0,98199,47.6508,-122.383,1390,1282,-187,-108,312.7474267616785,0.0419672131147541,Very Cheap
20140614T000000,496752.0,2,1.0,1980,5000,1.0,0,0,4,7,1090,890,1923,0,98144,47.586,-122.295,1720,5000,3020,3280,99.3504,0.05531173770491803,Very Cheap
20141001T000000,227000.0,2,1.0,860,6800,1.0,0,0,3,6,860,0,1943,0,98133,47.7274,-122.337,1220,6800,5940,5580,33.38235294117647,0.019934426229508195,Very Cheap
20140804T000000,330000.0,3,1.75,1460,9261,1.0,0,0,3,7,1460,0,1985,0,98056,47.5155,-122.189,1550,8800,7801,7250,35.633300939423386,0.03344262295081967,Very Cheap
20150123T000000,480000.0,5,2.0,2590,8610,1.0,0,0,4,7,1340,1250,1958,0,98008,47.6112,-122.126,1750,8610,6020,6860,55.749128919860624,0.05311475409836065,Very Cheap
20140806T000000,290000.0,2,1.0,1120,217800,1.0,0,0,3,6,1120,0,1976,0,98019,47.7378,-121.912,1480,217800,216680,216320,1.3314967860422406,0.02819672131147541,Very Cheap
20141112T000000,281000.0,3,1.0,1340,21336,1.5,0,0,4,5,1340,0,1945,0,98032,47.4023,-122.273,1340,37703,19996,36363,13.170228721409824,0.027016393442622952,Very Cheap
20150407T000000,705000.0,4,1.5,1780,3120,1.5,0,3,3,8,1780,0,1926,0,98118,47.5589,-122.264,1710,3600,1340,1890,225.96153846153845,0.08262295081967214,Very Cheap
20140502T000000,1400000.0,4,2.5,2920,4000,1.5,0,0,5,8,1910,1010,1909,0,98105,47.6578,-122.28,2470,4000,1080,1530,350.0,0.1737704918032787,Cheap
20141212T000000,485000.0,4,3.25,2820,6611,1.0,0,0,3,7,1410,1410,1958,0,98155,47.7473,-122.285,2320,6611,3791,4291,73.3625775223113,0.05377049180327869,Very Cheap
20150309T000000,622000.0,3,2.25,1550,1919,3.0,0,0,3,8,1550,0,2003,0,98107,47.6729,-122.379,1550,2918,369,1368,324.127149557061,0.07173770491803279,Very Cheap
20140902T000000,380000.0,3,2.25,1600,39848,1.0,0,3,4,8,1600,0,1958,0,98022,47.1991,-122.013,1600,39848,38248,38248,9.536237703272436,0.04,Very Cheap
20141126T000000,2125000.0,4,2.75,3190,19513,2.0,0,4,4,10,3190,0,1982,0,98034,47.6991,-122.235,2750,13496,16323,10746,108.90175780249065,0.26885245901639343,Cheap
20140627T000000,561500.0,3,1.75,1960,6380,1.0,0,0,4,7,980,980,1939,0,98115,47.6975,-122.316,1480,6380,4420,4900,88.00940438871473,0.06380327868852459,Very Cheap
20140916T000000,242000.0,3,1.0,970,9600,1.0,0,0,3,7,970,0,1972,0,98045,47.4451,-121.768,1110,9600,8630,8490,25.208333333333332,0.021901639344262296,Very Cheap
20140624T000000,348500.0,3,1.5,1360,10726,1.0,0,0,4,7,1360,0,1966,0,98059,47.4948,-122.134,1650,10726,9366,9076,32.49114301696812,0.035868852459016394,Very Cheap
20150326T000000,370000.0,3,1.5,1360,10726,1.0,0,0,4,7,1360,0,1966,0,98059,47.4948,-122.134,1650,10726,9366,9076,34.495618124184226,0.038688524590163934,Very Cheap
20150414T000000,752000.0,6,3.75,3810,6663,2.0,0,0,4,8,3810,0,1977,0,98103,47.6938,-122.34,1610,4561,2853,2951,112.86207414077742,0.08878688524590164,Very Cheap
20141031T000000,230000.0,3,1.75,1340,8250,1.0,0,0,3,7,1100,240,1985,0,98042,47.3668,-122.09,1540,7860,6910,6320,27.87878787878788,0.020327868852459016,Very Cheap
20150318T000000,715000.0,3,2.25,1990,4977,3.0,0,0,3,9,1990,0,2012,0,98118,47.5404,-122.268,1280,5000,2987,3720,143.6608398633715,0.0839344262295082,Very Cheap
20150417T000000,240415.0,3,1.75,1120,10187,1.0,0,0,3,7,1120,0,1968,0,98198,47.3694,-122.311,1900,8736,9067,6836,23.60017669578875,0.02169377049180328,Very Cheap
20141125T000000,562000.0,4,1.75,2060,4080,1.5,0,0,3,7,1460,600,1922,1996,98105,47.6698,-122.325,1620,4080,2020,2460,137.7450980392157,0.0638688524590164,Very Cheap
20140805T000000,360000.0,3,1.5,1170,4080,1.0,0,0,5,6,1170,0,1917,0,98126,47.5338,-122.381,920,4242,2910,3322,88.23529411764706,0.037377049180327866,Very Cheap
20141029T000000,659950.0,3,2.5,1610,1246,2.0,0,1,3,9,1080,530,2014,0,98119,47.6423,-122.375,1610,1249,-364,-361,529.6548956661317,0.07671475409836065,Very Cheap
20140623T000000,458500.0,3,2.0,1890,1599,2.0,0,0,3,9,1430,460,2012,0,98136,47.5438,-122.385,1780,1562,-291,-218,286.74171357098186,0.050295081967213114,Very Cheap
20150305T000000,259950.0,2,2.0,1070,649,2.0,0,0,3,9,720,350,2008,0,98106,47.5213,-122.357,1070,928,-421,-142,400.5392912172573,0.024255737704918033,Very Cheap
20140918T000000,366000.0,3,1.75,1680,6108,1.0,0,0,3,8,1680,0,1989,0,98055,47.4501,-122.208,2220,5664,4428,3444,59.921414538310415,0.03816393442622951,Very Cheap
20150428T000000,978000.0,4,2.75,2890,7821,2.0,0,0,3,9,2890,0,2014,0,98006,47.554,-122.189,2890,10108,4931,7218,125.04794783275796,0.11842622950819671,Cheap
20150421T000000,525000.0,2,1.0,1360,6120,1.0,0,0,3,7,1060,300,1947,0,98115,47.6841,-122.291,1800,5100,4760,3300,85.7843137254902,0.05901639344262295,Very Cheap
20140522T000000,926300.0,3,1.5,1660,4800,2.0,0,0,3,8,1660,0,1907,0,98119,47.6352,-122.358,1690,4000,3140,2310,192.97916666666666,0.11164590163934426,Cheap
20150423T000000,750000.0,2,1.0,1620,6120,1.0,0,0,3,7,1620,0,1951,0,98115,47.6731,-122.326,1650,4590,4500,2940,122.54901960784314,0.08852459016393442,Very Cheap
20141204T000000,660000.0,2,1.0,960,6263,1.0,0,1,4,6,960,0,1942,0,98033,47.6646,-122.202,1460,6054,5303,4594,105.38080791952738,0.07672131147540984,Very Cheap
20140813T000000,305000.0,4,1.75,1000,7200,1.5,0,0,4,6,1000,0,1947,0,98155,47.742,-122.324,1280,7200,6200,5920,42.361111111111114,0.03016393442622951,Very Cheap
20150426T000000,800000.0,2,2.5,2395,6143,1.0,0,0,3,8,2395,0,2003,0,98053,47.7114,-122.029,2170,6162,3748,3992,130.2295295458245,0.09508196721311475,Very Cheap
20150427T000000,600000.0,4,1.75,3050,9440,1.0,0,0,3,8,1800,1250,1966,0,98034,47.7228,-122.183,2020,8660,6390,6640,63.559322033898304,0.06885245901639345,Very Cheap
20140827T000000,435000.0,2,1.0,1120,88327,1.5,0,0,4,6,1120,0,1972,0,98010,47.3205,-121.867,1640,136662,87207,135022,4.924881406591416,0.04721311475409836,Very Cheap
20150310T000000,1135000.0,4,3.25,2960,4296,2.0,0,0,3,9,2190,770,2007,0,98119,47.6526,-122.372,2150,6000,1336,3850,264.1992551210428,0.13901639344262295,Cheap
20141010T000000,318000.0,3,2.25,1250,1017,3.0,0,0,3,8,1250,0,2008,0,98133,47.7099,-122.333,1250,1017,-233,-233,312.68436578171094,0.03186885245901639,Very Cheap
20141006T000000,639000.0,4,2.0,1940,5000,1.0,0,0,4,7,980,960,1910,0,98107,47.6719,-122.369,1940,5000,3060,3060,127.8,0.0739672131147541,Very Cheap
20150316T000000,453000.0,3,2.5,1750,3900,2.0,0,0,3,8,1750,0,1977,0,98052,47.6638,-122.129,1750,5700,2150,3950,116.15384615384616,0.04957377049180328,Very Cheap
20141117T000000,800000.0,4,1.75,2150,9148,1.0,0,0,4,7,2150,0,1955,0,98004,47.5828,-122.197,2370,9148,6998,6778,87.4508089199825,0.09508196721311475,Very Cheap
20140604T000000,437000.0,2,1.75,1500,6800,1.0,0,0,4,7,910,590,1942,0,98117,47.7004,-122.371,1450,6800,5300,5350,64.26470588235294,0.047475409836065574,Very Cheap
20141121T000000,1150000.0,3,2.75,3230,75889,2.0,1,4,3,7,3230,0,1925,1993,98023,47.3344,-122.37,2560,72229,72659,69669,15.153711341564653,0.14098360655737704,Cheap
20140926T000000,490000.0,4,2.5,3000,8645,2.0,0,0,3,8,3000,0,1985,0,98034,47.7315,-122.224,1930,8866,5645,6936,56.68016194331984,0.05442622950819672,Very Cheap
20140710T000000,499950.0,4,1.75,1520,7700,1.0,0,0,4,7,1520,0,1967,0,98034,47.7356,-122.191,1520,7500,6180,5980,64.92857142857143,0.05573114754098361,Very Cheap
20141226T000000,160134.0,3,1.5,1190,10116,1.0,0,0,3,7,1190,0,1968,0,98042,47.385,-122.085,1190,9905,8926,8715,15.829774614472123,0.01116511475409836,Very Cheap
20141215T000000,191000.0,3,1.0,990,8255,1.0,0,0,3,7,990,0,1953,0,98148,47.425,-122.331,1180,9750,7265,8570,23.13749242883101,0.01521311475409836,Very Cheap
20150115T000000,221000.0,3,1.0,1250,7280,1.0,0,0,3,7,1250,0,1965,0,98001,47.3414,-122.286,1450,7350,6030,5900,30.357142857142858,0.01914754098360656,Very Cheap
20141028T000000,352800.0,4,2.0,2080,6360,1.0,0,0,3,7,1330,750,1960,0,98118,47.5392,-122.278,2080,6741,4280,4661,55.471698113207545,0.0364327868852459,Very Cheap
20150511T000000,350000.0,3,2.5,1640,10424,2.0,0,0,3,7,1640,0,1988,0,98019,47.7345,-121.977,1560,10101,8784,8541,33.57636224098235,0.036065573770491806,Very Cheap
20140617T000000,458000.0,4,1.5,1550,3000,1.5,0,0,3,7,1350,200,1918,0,98105,47.6604,-122.324,1710,5535,1450,3825,152.66666666666666,0.05022950819672131,Very Cheap
20140519T000000,359950.0,3,1.0,1290,189486,1.0,0,0,4,7,1290,0,1960,0,98092,47.3356,-122.157,2370,98881,188196,96511,1.8996126362897523,0.037370491803278685,Very Cheap
20150407T000000,1050000.0,3,3.0,3250,5093,2.0,0,3,3,10,3250,0,2004,0,98146,47.5123,-122.39,2820,7752,1843,4932,206.16532495582172,0.12786885245901639,Cheap
20140724T000000,353000.0,3,1.75,1260,11775,1.0,0,0,5,6,1260,0,1942,0,98108,47.5501,-122.296,1270,5480,10515,4210,29.97876857749469,0.03645901639344262,Very Cheap
20140801T000000,717550.0,3,3.5,2840,4468,3.0,0,0,3,10,2840,0,2006,0,98052,47.7069,-122.117,3040,5400,1628,2360,160.59758281110118,0.0842688524590164,Very Cheap
20140807T000000,450000.0,3,2.25,1960,6500,2.0,0,0,4,8,1960,0,1977,0,98052,47.6642,-122.129,1860,6160,4540,4300,69.23076923076923,0.04918032786885246,Very Cheap
20140924T000000,167500.0,3,1.0,760,3090,1.0,0,0,2,5,760,0,1903,0,98118,47.5513,-122.275,1020,5356,2330,4336,54.20711974110032,0.012131147540983607,Very Cheap
20140617T000000,550000.0,3,1.75,2240,78225,2.0,0,0,5,8,2240,0,1976,0,98070,47.4638,-122.484,2030,202554,75985,200524,7.031000319590923,0.06229508196721312,Very Cheap
20150421T000000,939000.0,4,2.25,2240,9684,2.0,0,0,4,9,2240,0,1970,0,98040,47.5489,-122.225,2440,9618,7444,7178,96.96406443618339,0.11331147540983606,Cheap
20150429T000000,700000.0,3,1.75,1820,15570,1.0,0,2,3,8,1820,0,1948,0,98146,47.5068,-122.386,2490,9480,13750,6990,44.9582530507386,0.08196721311475409,Very Cheap
20140519T000000,480000.0,4,3.5,3370,435600,2.0,0,3,3,9,3370,0,2005,0,98045,47.4398,-121.738,2790,114868,432230,112078,1.1019283746556474,0.05311475409836065,Very Cheap
20140829T000000,501000.0,3,1.0,1160,4360,1.0,0,0,4,8,1160,0,1929,0,98105,47.6718,-122.291,1810,4360,3200,2550,114.90825688073394,0.05586885245901639,Very Cheap
20150204T000000,580000.0,3,2.25,1640,8625,1.0,0,0,3,8,1320,320,1987,0,98052,47.6772,-122.153,1770,9476,6985,7706,67.2463768115942,0.06622950819672131,Very Cheap
20140523T000000,527550.0,1,0.75,820,59677,1.0,0,0,3,5,820,0,1999,0,98065,47.5316,-121.764,1590,14163,58857,12573,8.840089146572382,0.05935081967213115,Very Cheap
20141124T000000,399000.0,4,2.5,2800,4687,2.0,0,0,3,9,2800,0,2005,0,98038,47.3594,-122.04,2750,4750,1887,2000,85.12908043524642,0.042491803278688525,Very Cheap
20150415T000000,240000.0,3,1.75,1780,5000,1.5,0,0,3,6,1080,700,1957,0,98146,47.5105,-122.36,1500,5000,3220,3500,48.0,0.021639344262295083,Very Cheap
20150311T000000,353000.0,4,2.75,2200,268329,1.0,0,0,3,7,1410,790,1989,0,98092,47.3224,-122.122,2240,58806,266129,56566,1.3155491952043945,0.03645901639344262,Very Cheap
20140528T000000,335000.0,4,2.0,1480,3132,1.0,0,0,5,6,740,740,1910,0,98108,47.55,-122.312,1480,6420,1652,4940,106.96040868454662,0.03409836065573771,Very Cheap
20150317T000000,475000.0,3,3.0,2010,2554,2.0,0,0,3,7,1860,150,2001,0,98118,47.5525,-122.269,1370,5100,544,3730,185.98277212216132,0.05245901639344262,Very Cheap
20140826T000000,660000.0,3,2.0,2880,5100,1.5,0,0,4,7,2080,800,1926,0,98117,47.6805,-122.385,1820,5100,2220,3280,129.41176470588235,0.07672131147540984,Very Cheap
20140724T000000,551000.0,3,1.0,940,1948,1.0,0,0,5,6,940,0,1900,0,98107,47.6733,-122.383,1700,5000,1008,3300,282.85420944558524,0.06242622950819672,Very Cheap
20150320T000000,249950.0,4,1.75,1620,10530,1.0,0,0,3,7,1620,0,1968,0,98030,47.3808,-122.211,1890,9975,8910,8085,23.736942070275404,0.022944262295081966,Very Cheap
20141120T000000,1150000.0,4,3.25,4400,262666,2.0,0,0,3,11,4400,0,1988,0,98075,47.5927,-122.064,3240,9791,258266,6551,4.37818370097386,0.14098360655737704,Cheap
20140703T000000,575000.0,3,1.75,1530,6743,1.0,0,0,3,7,1410,120,1955,0,98116,47.5745,-122.396,2040,6000,5213,3960,85.2736170843838,0.06557377049180328,Very Cheap
20140718T000000,1088890.0,4,2.75,3460,11350,1.0,0,4,4,9,1780,1680,1974,0,98006,47.568,-122.153,3200,13874,7890,10674,95.9374449339207,0.13296918032786886,Cheap
20141118T000000,515000.0,4,2.5,2890,7306,2.0,0,0,3,7,2890,0,2006,0,98065,47.5447,-121.883,2850,6687,4416,3837,70.49000821242814,0.057704918032786885,Very Cheap
20141210T000000,235000.0,3,1.5,1980,11214,1.0,0,0,3,7,1980,0,1959,0,98168,47.4696,-122.298,1510,9072,9234,7562,20.955947922240057,0.02098360655737705,Very Cheap
20140915T000000,796000.0,3,1.0,1980,3243,1.5,0,0,3,8,1980,0,1912,0,98102,47.6429,-122.327,1380,1249,1263,-131,245.45174221399938,0.09455737704918032,Very Cheap
20150423T000000,450000.0,2,1.5,1450,2550,1.0,0,0,3,7,820,630,1984,0,98103,47.6911,-122.348,1450,5100,1100,3650,176.47058823529412,0.04918032786885246,Very Cheap
20141106T000000,2050000.0,4,3.0,4280,18834,1.0,0,4,5,11,2180,2100,1971,0,98116,47.5811,-122.4,2490,8858,14554,6368,108.84570457682914,0.25901639344262295,Cheap
20140508T000000,270000.0,4,2.5,1810,6509,2.0,0,0,3,7,1810,0,1994,0,98042,47.3531,-122.143,1760,7417,4699,5657,41.48102627131664,0.025573770491803278,Very Cheap
20150414T000000,1705000.0,3,3.0,2490,27702,2.0,1,4,3,10,2490,0,2000,0,98116,47.5596,-122.403,2580,12119,25212,9539,61.547902678506965,0.2137704918032787,Cheap
20150309T000000,565000.0,3,1.0,1610,4108,1.5,0,0,5,7,1610,0,1928,0,98126,47.5704,-122.376,1680,4467,2498,2787,137.5365141187926,0.06426229508196721,Very Cheap
20140804T000000,680000.0,1,2.5,1820,3008,2.0,0,0,3,7,1090,730,1910,2004,98103,47.6529,-122.339,1860,3420,1188,1560,226.06382978723406,0.07934426229508197,Very Cheap
20140804T000000,5570000.0,5,5.75,9200,35069,2.0,0,0,3,13,6200,3000,2001,0,98039,47.6289,-122.233,3560,24345,25869,20785,158.82973566397672,0.7206557377049181,Very High
20141114T000000,864500.0,4,2.5,3520,35991,2.0,0,0,4,10,3520,0,1992,0,98077,47.7437,-122.035,3210,35991,32471,32781,24.01989386235448,0.10354098360655738,Cheap
20140915T000000,1150000.0,4,2.25,3740,18000,1.0,0,0,4,9,1870,1870,1951,0,98177,47.7027,-122.378,2610,10902,14260,8292,63.888888888888886,0.14098360655737704,Cheap
20140515T000000,335000.0,3,2.25,2150,30476,2.0,0,0,3,7,2150,0,1991,0,98188,47.4605,-122.277,2010,10800,28326,8790,10.99225620160126,0.03409836065573771,Very Cheap
20150504T000000,911000.0,4,3.25,3526,15958,2.0,0,0,3,10,3526,0,1997,0,98075,47.567,-122.033,3639,15090,12432,11451,57.08735430505076,0.10963934426229509,Cheap
20141112T000000,425000.0,2,1.0,1070,6625,1.0,0,0,3,7,830,240,1950,0,98116,47.5736,-122.393,1310,6625,5555,5315,64.15094339622641,0.04590163934426229,Very Cheap
20141029T000000,299950.0,3,1.0,1410,81021,1.0,0,0,3,7,1410,0,1949,1981,98058,47.4303,-122.067,2000,81021,79611,79021,3.702126609150714,0.029501639344262295,Very Cheap
20141208T000000,864000.0,4,2.5,3190,49658,2.0,0,0,3,10,3190,0,1999,0,98074,47.6216,-122.015,3040,49658,46468,46618,17.39900922308591,0.10347540983606557,Cheap
20150305T000000,425000.0,2,1.0,1270,6000,1.0,0,0,3,7,1270,0,1939,0,98199,47.6482,-122.393,1770,6000,4730,4230,70.83333333333333,0.04590163934426229,Very Cheap
20140814T000000,374950.0,4,1.5,1970,14490,1.5,0,0,4,7,1970,0,1963,0,98059,47.4612,-122.069,1880,14880,12520,13000,25.876466528640442,0.03933770491803279,Very Cheap
20141203T000000,247000.0,3,2.25,1640,7630,1.0,0,0,4,8,1180,460,1968,0,98032,47.3739,-122.29,1930,7630,5990,5700,32.37221494102228,0.022557377049180326,Very Cheap
20141212T000000,475000.0,3,1.0,1600,7161,1.0,0,0,3,8,1600,0,1953,0,98118,47.5507,-122.261,1760,8280,5561,6520,66.33151794442117,0.05245901639344262,Very Cheap
20140801T000000,275000.0,3,2.5,3020,5868,2.0,0,0,3,7,3020,0,2003,0,98092,47.3361,-122.175,2710,5470,2848,2760,46.864349011588274,0.02622950819672131,Very Cheap
20141029T000000,355000.0,2,1.0,1350,368517,1.0,0,0,3,6,1350,0,1947,0,98077,47.7617,-122.061,2330,104108,367167,101778,0.9633205523761454,0.036721311475409836,Very Cheap
20150318T000000,285000.0,4,1.75,1870,22072,1.0,0,0,3,7,1070,800,1959,0,98042,47.3775,-122.165,2100,10185,20202,8085,12.912287060529177,0.02754098360655738,Very Cheap
20140905T000000,1338750.0,3,2.75,2730,38869,1.5,1,4,3,9,1940,790,1963,2001,98146,47.4857,-122.361,2630,28188,36139,25558,34.442614937353675,0.16573770491803277,Cheap
20140811T000000,325000.0,2,1.0,1100,17817,1.0,0,0,3,7,620,480,1980,0,98019,47.7728,-121.9,1790,20009,16717,18219,18.24100578099568,0.03278688524590164,Very Cheap
20150420T000000,1670000.0,5,3.5,4320,40816,2.0,0,0,4,11,4320,0,1997,0,98004,47.644,-122.185,4320,44584,36496,40264,40.91532732261858,0.20918032786885246,Cheap
20140606T000000,402000.0,3,2.5,2700,9994,1.0,0,3,4,7,1350,1350,1959,0,98198,47.397,-122.321,2470,10664,7294,8194,40.22413448068841,0.04288524590163934,Very Cheap
20140814T000000,1100000.0,3,3.0,3700,16857,1.0,0,0,3,10,2170,1530,2000,0,98117,47.6956,-122.392,2320,12000,13157,9680,65.254790294833,0.13442622950819672,Cheap
20140730T000000,375000.0,4,1.75,2190,9225,1.0,0,0,4,7,1250,940,1959,0,98028,47.7396,-122.256,2190,9225,7035,7035,40.65040650406504,0.03934426229508197,Very Cheap
20140911T000000,396000.0,5,2.75,2840,12253,1.0,0,0,3,7,1420,1420,1960,0,98028,47.7618,-122.253,2210,11620,9413,9410,32.31861584917979,0.0420983606557377,Very Cheap
20140716T000000,320000.0,4,2.75,2610,9077,1.0,0,0,4,8,1310,1300,1987,0,98058,47.4612,-122.147,1900,10500,6467,8600,35.2539385259447,0.032131147540983604,Very Cheap
20140709T000000,610000.0,3,2.5,2630,5827,2.0,0,0,3,8,2630,0,2001,0,98053,47.688,-122.038,2330,4715,3197,2385,104.68508666552256,0.07016393442622951,Very Cheap
20141117T000000,249950.0,3,1.5,1090,7698,1.0,0,0,5,7,1090,0,1966,0,98058,47.4553,-122.174,1540,7624,6608,6084,32.46947259028319,0.022944262295081966,Very Cheap
20150423T000000,675000.0,4,3.5,3090,100835,2.0,0,0,3,9,3090,0,1999,0,98092,47.3087,-122.088,2400,50543,97745,48143,6.694104229682154,0.07868852459016394,Very Cheap
20150326T000000,448000.0,2,2.0,1670,7772,1.0,0,0,4,6,860,810,1919,0,98126,47.5461,-122.377,1300,7770,6102,6470,57.642820380854346,0.048918032786885245,Very Cheap
20150428T000000,819000.0,3,1.0,1300,3600,2.0,0,0,3,7,1300,0,1900,0,98119,47.6345,-122.366,2510,4800,2300,2290,227.5,0.09757377049180328,Very Cheap
20141110T000000,1250000.0,3,2.5,3670,18505,1.0,0,4,3,10,2530,1140,1983,0,98177,47.7588,-122.376,2920,20000,14835,17080,67.54931099702783,0.1540983606557377,Cheap
20141201T000000,225000.0,4,2.5,1700,6031,2.0,0,0,3,8,1700,0,1994,0,98030,47.3582,-122.191,1930,6035,4331,4105,37.30724589620295,0.019672131147540985,Very Cheap
20140730T000000,790000.0,2,3.0,2560,982278,1.0,0,0,3,8,2560,0,2004,0,98014,47.6955,-121.861,1620,40946,979718,39326,0.8042529711548054,0.09377049180327869,Very Cheap
20150414T000000,685000.0,4,2.5,2770,6000,2.0,0,0,3,8,2400,370,1993,0,98136,47.5536,-122.383,2120,6000,3230,3880,114.16666666666667,0.08,Very Cheap
20140620T000000,812000.0,3,3.25,3240,8338,2.0,0,0,3,9,3240,0,2001,0,98074,47.6321,-122.064,3420,8405,5098,4985,97.38546414008155,0.09665573770491803,Very Cheap
20141202T000000,705000.0,2,2.5,2300,6400,1.0,0,0,3,8,2300,0,2007,0,98053,47.7196,-122.02,2300,6400,4100,4100,110.15625,0.08262295081967214,Very Cheap
20150429T000000,360000.0,4,3.0,2483,6870,2.0,0,0,3,8,2483,0,2005,0,98030,47.3627,-122.199,1943,6434,4387,4491,52.40174672489083,0.037377049180327866,Very Cheap
20150112T000000,344000.0,1,1.5,760,779,3.0,0,0,3,8,760,0,2006,0,98107,47.6715,-122.382,1290,1189,19,-101,441.59178433889605,0.035278688524590165,Very Cheap
20141022T000000,825000.0,4,1.5,2040,6900,2.0,0,0,3,9,2040,0,1903,0,98112,47.6188,-122.285,3150,8220,4860,5070,119.56521739130434,0.09836065573770492,Very Cheap
20150427T000000,476500.0,3,1.0,1200,6120,1.0,0,0,4,7,950,250,1945,0,98115,47.6929,-122.287,1550,6120,4920,4570,77.859477124183,0.052655737704918035,Very Cheap
20141124T000000,379500.0,2,1.0,960,5096,1.0,0,0,5,7,960,0,1949,0,98126,47.5314,-122.378,1760,4488,4136,2728,74.4701726844584,0.0399344262295082,Very Cheap
20141003T000000,620000.0,3,1.75,2410,35236,1.0,0,0,3,8,2410,0,1980,2001,98072,47.7651,-122.166,2110,16980,32826,14870,17.595640821886708,0.07147540983606557,Very Cheap
20140731T000000,477590.0,3,3.25,2260,7701,2.0,0,0,3,8,1760,500,2000,0,98146,47.5053,-122.377,1880,7529,5441,5649,62.01662121802363,0.052798688524590166,Very Cheap
20140520T000000,490000.0,3,1.0,1910,8190,1.0,0,0,4,7,1010,900,1946,0,98117,47.697,-122.365,1600,5042,6280,3442,59.82905982905983,0.05442622950819672,Very Cheap
20140628T000000,470000.0,3,1.5,1500,5000,1.5,0,0,4,7,1140,360,1927,0,98117,47.679,-122.373,1500,5000,3500,3500,94.0,0.05180327868852459,Very Cheap
20140724T000000,500000.0,3,2.25,1360,1236,2.0,0,0,3,8,1140,220,2006,0,98112,47.6198,-122.299,1620,1231,-124,-389,404.53074433656957,0.05573770491803279,Very Cheap
20140630T000000,370000.0,3,1.0,1320,7341,1.0,0,0,3,7,1320,0,1982,0,98155,47.7367,-122.295,1160,7573,6021,6413,50.401852608636425,0.038688524590163934,Very Cheap
20150311T000000,790000.0,2,1.5,1940,4400,1.0,0,0,3,7,970,970,1923,0,98112,47.6371,-122.279,1480,3080,2460,1600,179.54545454545453,0.09377049180327869,Very Cheap
20140624T000000,725000.0,4,2.5,2650,18295,2.0,0,0,3,8,2650,0,1986,0,98005,47.6075,-122.154,2230,19856,15645,17626,39.62831374692539,0.08524590163934426,Very Cheap
20140528T000000,840000.0,4,2.75,3040,2800,2.0,0,0,3,9,2100,940,1906,2014,98102,47.6245,-122.327,1260,2178,-240,918,300.0,0.10032786885245902,Cheap
20140604T000000,390000.0,3,1.0,1240,11108,1.0,0,0,4,7,1240,0,1952,0,98166,47.4465,-122.354,2220,16533,9868,14313,35.10983075261073,0.04131147540983607,Very Cheap
20140828T000000,507000.0,3,2.25,2210,11585,1.0,0,0,4,7,1510,700,1958,0,98155,47.7574,-122.279,1870,14092,9375,12222,43.76348726801899,0.05665573770491803,Very Cheap
20141122T000000,263500.0,3,1.75,1540,6273,1.0,0,0,4,6,770,770,1951,0,98118,47.5305,-122.277,1140,5512,4733,4372,42.00542005420054,0.024721311475409836,Very Cheap
20140712T000000,369000.0,3,2.5,1320,1683,2.0,0,0,3,8,1270,50,2004,0,98106,47.5357,-122.365,1320,2206,363,886,219.25133689839572,0.03855737704918033,Very Cheap
20140814T000000,500000.0,3,2.5,3040,5326,2.0,0,0,3,9,3040,0,2008,0,98055,47.4472,-122.207,3040,5442,2286,2402,93.87908374014269,0.05573770491803279,Very Cheap
20150406T000000,570000.0,2,1.0,910,4301,1.0,0,0,4,7,910,0,1923,0,98117,47.6814,-122.399,1810,4301,3391,2491,132.5273192280865,0.06491803278688525,Very Cheap
20150306T000000,284000.0,4,3.0,2040,7145,1.0,0,0,3,8,1490,550,1994,0,98092,47.3275,-122.171,1940,7145,5105,5205,39.7480755773268,0.027409836065573772,Very Cheap
20141110T000000,415000.0,2,1.0,980,4108,1.0,0,0,3,7,980,0,1947,0,98117,47.687,-122.381,1500,4046,3128,2546,101.0223953261928,0.04459016393442623,Very Cheap
20140515T000000,197500.0,3,1.0,980,3090,1.5,0,0,3,6,980,0,1903,0,98118,47.5525,-122.277,980,3090,2110,2110,63.91585760517799,0.016065573770491802,Very Cheap
20141027T000000,925000.0,4,3.75,4420,9492,2.0,0,1,3,9,3420,1000,1962,2005,98125,47.7211,-122.283,2880,9900,5072,7020,97.4504846186262,0.11147540983606558,Cheap
20141112T000000,468000.0,3,2.0,1570,6300,1.0,0,0,3,7,820,750,1953,2005,98118,47.5565,-122.275,1510,4281,4730,2771,74.28571428571429,0.05154098360655738,Very Cheap
20140715T000000,355000.0,3,1.0,1600,5001,1.5,0,0,5,6,1080,520,1930,0,98125,47.7232,-122.289,1340,5001,3401,3661,70.98580283943211,0.036721311475409836,Very Cheap
20140812T000000,639000.0,4,1.75,1830,6000,1.0,0,0,4,7,930,900,1939,0,98199,47.6536,-122.41,1540,6000,4170,4460,106.5,0.0739672131147541,Very Cheap
20150412T000000,720000.0,3,2.5,2820,14250,2.0,0,0,3,11,2820,0,1991,0,98074,47.6396,-122.054,2820,12600,11430,9780,50.526315789473685,0.08459016393442623,Very Cheap
20140612T000000,381000.0,3,1.75,1800,6000,1.0,0,0,5,6,900,900,1950,0,98155,47.7505,-122.317,1060,6628,4200,5568,63.5,0.040131147540983604,Very Cheap
20140523T000000,1050000.0,3,4.0,4380,42769,2.0,0,0,5,11,4380,0,1983,0,98052,47.7167,-122.109,3630,35425,38389,31795,24.550492178914634,0.12786885245901639,Cheap
20141111T000000,670000.0,3,3.0,2980,3730,2.0,0,0,3,9,2980,0,2005,0,98029,47.5533,-121.995,2710,3640,750,930,179.62466487935657,0.0780327868852459,Very Cheap
20141028T000000,400000.0,3,1.0,1690,6658,1.0,0,0,3,7,1690,0,1942,1982,98133,47.7099,-122.35,1080,5925,4968,4845,60.07810153199159,0.04262295081967213,Very Cheap
20140626T000000,910000.0,4,3.5,4040,50479,2.0,0,0,3,11,4040,0,1987,0,98077,47.7196,-122.048,3770,40899,46439,37129,18.027298480556272,0.10950819672131147,Cheap
20150402T000000,294000.0,3,1.0,1250,9427,1.0,0,0,3,6,1250,0,1931,0,98034,47.7254,-122.175,1590,8250,8177,6660,31.18701601782115,0.028721311475409836,Very Cheap
20150310T000000,315001.0,3,1.75,1500,10230,1.0,0,0,2,7,1500,0,1968,0,98058,47.4349,-122.168,1770,8374,8730,6604,30.79188660801564,0.03147554098360656,Very Cheap
20140731T000000,360000.0,3,2.0,1630,10723,1.0,0,0,5,7,1630,0,1959,0,98059,47.4898,-122.133,1450,10723,9093,9273,33.572694208710246,0.037377049180327866,Very Cheap
20140805T000000,520000.0,3,2.0,1410,2700,2.0,0,0,4,7,1410,0,1902,0,98122,47.6029,-122.302,1750,4000,1290,2250,192.59259259259258,0.058360655737704915,Very Cheap
20141010T000000,474000.0,3,1.0,1140,4560,1.0,0,0,4,6,770,370,1944,0,98117,47.6889,-122.362,1340,3980,3420,2640,103.94736842105263,0.05232786885245902,Very Cheap
20150313T000000,702000.0,4,2.5,3280,5876,2.0,0,0,3,7,3280,0,2004,0,98053,47.6802,-122.034,2600,5000,2596,2400,119.46902654867256,0.08222950819672131,Very Cheap
20140826T000000,728000.0,4,3.5,3490,87497,2.0,0,0,3,9,3490,0,2001,0,98038,47.4028,-122.002,2400,55657,84007,53257,8.320285266923438,0.08563934426229508,Very Cheap
20150305T000000,308000.0,4,2.5,2020,7277,2.0,0,0,3,8,2020,0,1993,0,98055,47.4318,-122.19,2820,7284,5257,4464,42.325133983784525,0.030557377049180327,Very Cheap
20140524T000000,2000000.0,5,4.0,4580,4443,3.0,1,4,3,10,4580,0,2004,0,98075,47.5682,-122.059,2710,4443,-137,1733,450.14629754670267,0.25245901639344265,Cheap
20140725T000000,340000.0,3,2.5,2270,7917,2.0,0,0,3,8,2270,0,1986,0,98092,47.2643,-122.22,2160,7917,5647,5757,42.945560186939495,0.03475409836065574,Very Cheap
20150401T000000,306500.0,2,1.75,1310,10200,1.0,0,0,4,6,1310,0,1947,0,98065,47.5231,-121.82,1500,7200,8890,5700,30.04901960784314,0.03036065573770492,Very Cheap
20150126T000000,716000.0,3,2.0,1420,3600,1.5,0,0,4,7,1420,0,1904,0,98119,47.6367,-122.364,1250,3600,2180,2350,198.88888888888889,0.0840655737704918,Very Cheap
20140909T000000,950000.0,4,3.0,2980,44431,2.0,0,0,2,10,2640,340,1981,0,98034,47.7154,-122.161,2010,7332,41451,5322,21.381467894037947,0.11475409836065574,Cheap
20140829T000000,673200.0,5,3.0,4180,8561,2.0,0,0,3,7,4180,0,2003,0,98053,47.6833,-122.04,3425,6591,4381,3166,78.63567340263988,0.07845245901639344,Very Cheap
20150323T000000,564500.0,4,2.25,1950,6000,1.0,0,0,3,7,1350,600,1961,0,98115,47.6909,-122.301,1980,6000,4050,4020,94.08333333333333,0.06419672131147541,Very Cheap
20150206T000000,393000.0,4,1.75,1790,11801,1.0,0,0,4,8,1790,0,1974,0,98056,47.5172,-122.17,2000,12988,10011,10988,33.30226252012541,0.041704918032786885,Very Cheap
20150312T000000,425000.0,5,1.75,1400,5071,1.0,0,0,3,5,1400,0,1916,0,98014,47.6499,-121.908,1200,7500,3671,6300,83.80989942812069,0.04590163934426229,Very Cheap
20140730T000000,150000.0,3,1.0,1320,24684,1.0,0,0,3,7,1320,0,1979,0,98168,47.4771,-122.322,1120,21214,23364,20094,6.076810889645114,0.009836065573770493,Very Cheap
20150220T000000,327000.0,4,2.25,1620,106722,1.0,0,0,3,8,1200,420,1980,0,98042,47.3394,-122.091,1620,38400,105102,36780,3.064035531567999,0.033049180327868855,Very Cheap
20150318T000000,444900.0,4,2.5,3120,7448,2.0,0,0,3,9,3120,0,1998,0,98042,47.3645,-122.126,2980,8102,4328,5122,59.734156820622985,0.048511475409836066,Very Cheap
20140722T000000,305000.0,4,2.5,2100,14773,2.0,0,0,3,8,2100,0,1998,0,98023,47.3045,-122.391,2370,15440,12673,13070,20.645772693427197,0.03016393442622951,Very Cheap
20140818T000000,469000.0,3,3.25,1370,1194,3.0,0,0,3,8,1370,0,2004,0,98107,47.6718,-122.388,1800,2678,-176,878,392.79731993299833,0.05167213114754098,Very Cheap
20140926T000000,525000.0,3,1.75,1520,7875,1.0,0,0,5,8,1520,0,1969,0,98006,47.5569,-122.176,2150,9428,6355,7278,66.66666666666667,0.05901639344262295,Very Cheap
20150404T000000,330000.0,3,2.5,2410,17424,1.0,0,0,3,7,1630,780,1978,0,98030,47.3741,-122.218,1530,11761,15014,10231,18.939393939393938,0.03344262295081967,Very Cheap
20141002T000000,618000.0,4,1.0,1260,4080,1.0,0,0,4,7,1260,0,1911,0,98105,47.6644,-122.324,1340,4080,2820,2740,151.47058823529412,0.07121311475409836,Very Cheap
20141117T000000,295500.0,4,2.5,2830,7350,1.0,0,0,3,8,1690,1140,1982,0,98023,47.3088,-122.341,2350,7768,4520,5418,40.204081632653065,0.028918032786885244,Very Cheap
20140718T000000,567035.0,3,2.0,2064,46173,2.0,0,0,5,7,2064,0,1903,0,98070,47.4469,-122.455,1640,21780,44109,20140,12.280661858661988,0.06452918032786885,Very Cheap
20140725T000000,518000.0,4,2.25,2640,34870,1.0,0,0,3,8,1770,870,1977,0,98027,47.4688,-122.009,2500,35580,32230,33080,14.855176369371954,0.0580983606557377,Very Cheap
20150504T000000,303000.0,2,1.0,1020,9200,1.0,0,0,3,7,1020,0,1978,0,98045,47.4461,-121.769,1520,9600,8180,8080,32.93478260869565,0.029901639344262296,Very Cheap
20140708T000000,300000.0,4,2.5,2200,8065,2.0,0,0,3,7,2200,0,1998,0,98031,47.4042,-122.213,2641,8535,5865,5894,37.197768133911964,0.029508196721311476,Very Cheap
20141015T000000,413107.0,3,1.5,1420,7520,1.0,0,0,4,7,1420,0,1956,0,98007,47.601,-122.134,2000,7520,6100,5520,54.9344414893617,0.04434190163934426,Very Cheap
20140820T000000,400000.0,3,1.0,1350,3090,1.5,0,0,5,6,1350,0,1914,0,98103,47.682,-122.348,1350,3090,1740,1740,129.44983818770226,0.04262295081967213,Very Cheap
20150408T000000,535000.0,3,1.0,1290,6859,1.0,0,0,4,7,1290,0,1941,0,98136,47.5317,-122.387,1560,6369,5569,4809,77.999708412305,0.06032786885245902,Very Cheap
20140919T000000,555000.0,4,2.0,1680,2600,1.0,0,0,5,7,840,840,1915,0,98107,47.6648,-122.363,1680,3340,920,1660,213.46153846153845,0.06295081967213115,Very Cheap
20141119T000000,312000.0,3,2.5,2280,6386,2.0,0,0,3,8,2280,0,2008,0,98042,47.3861,-122.096,2550,4835,4106,2285,48.856874412777955,0.031081967213114754,Very Cheap
20140603T000000,785200.0,3,2.25,1840,3500,1.5,0,0,5,8,1540,300,1910,0,98122,47.6063,-122.292,1800,3300,1660,1500,224.34285714285716,0.09314098360655737,Very Cheap
20141016T000000,749000.0,4,2.0,2040,11850,1.0,0,2,3,7,1020,1020,1959,0,98033,47.6891,-122.208,2040,8504,9810,6464,63.20675105485232,0.08839344262295082,Very Cheap
20150405T000000,285000.0,3,1.5,1490,10367,1.0,0,0,3,7,1010,480,1957,0,98146,47.4973,-122.347,1000,8254,8877,7254,27.491077457316486,0.02754098360655738,Very Cheap
20140910T000000,425000.0,4,2.5,2440,5088,2.0,0,0,3,7,2440,0,2007,0,98065,47.5406,-121.889,2440,5762,2648,3322,83.52987421383648,0.04590163934426229,Very Cheap
20140717T000000,360000.0,3,2.0,1930,15540,1.0,0,0,3,8,1260,670,1958,0,98155,47.7675,-122.307,1900,12123,13610,10223,23.166023166023166,0.037377049180327866,Very Cheap
20150505T000000,260000.0,3,1.0,1200,6615,1.0,0,0,4,7,1200,0,1954,0,98106,47.5168,-122.351,1230,6615,5415,5385,39.30461073318216,0.024262295081967214,Very Cheap
20140530T000000,369000.0,3,2.0,1550,8509,1.0,0,0,3,7,1150,400,1959,0,98106,47.5299,-122.344,1840,7620,6959,5780,43.3658479257257,0.03855737704918033,Very Cheap
20140815T000000,275000.0,4,2.5,2180,11132,1.0,0,0,4,8,1620,560,1978,0,98023,47.3187,-122.367,1950,13801,8952,11851,24.703557312252965,0.02622950819672131,Very Cheap
20140903T000000,407000.0,3,2.25,1430,1448,3.0,0,0,3,8,1430,0,2005,0,98103,47.6916,-122.341,1430,1383,18,-47,281.0773480662983,0.04354098360655738,Very Cheap
20150412T000000,575000.0,2,1.75,1230,5418,1.0,0,0,3,8,990,240,1949,0,98117,47.6839,-122.376,1330,5074,4188,3744,106.12772240679217,0.06557377049180328,Very Cheap
20150427T000000,1236000.0,3,1.5,1670,3852,2.0,0,3,4,8,1670,0,1928,0,98119,47.6411,-122.371,2320,4572,2182,2252,320.8722741433022,0.1522622950819672,Cheap
20150108T000000,875000.0,2,2.5,2720,4913,1.0,0,1,4,8,1700,1020,1936,0,98199,47.6384,-122.404,2520,5303,2193,2783,178.0989212293914,0.10491803278688525,Cheap
20140712T000000,320000.0,4,1.5,2220,6811,1.0,0,0,4,7,1270,950,1961,0,98056,47.5059,-122.193,1800,7350,4591,5550,46.982821905740714,0.032131147540983604,Very Cheap
20140703T000000,810000.0,3,1.5,1520,9041,1.0,0,0,4,7,1520,0,1954,0,98004,47.6158,-122.213,3260,10020,7521,6760,89.59185930759871,0.09639344262295083,Very Cheap
20150414T000000,274000.0,3,1.75,1590,7620,1.0,0,0,4,7,1090,500,1984,0,98038,47.3655,-122.048,1590,7620,6030,6030,35.958005249343834,0.026098360655737705,Very Cheap
20141219T000000,239900.0,4,1.75,1480,9523,1.0,0,0,3,7,1120,360,1959,0,98030,47.3732,-122.217,1590,8300,8043,6710,25.191641289509608,0.02162622950819672,Very Cheap
20141214T000000,450000.0,4,1.5,1860,7808,1.0,0,0,3,7,1080,780,1953,0,98125,47.7314,-122.3,1530,7884,5948,6354,57.63319672131148,0.04918032786885246,Very Cheap
20140630T000000,263400.0,4,2.0,1360,60548,1.0,0,0,3,6,960,400,1960,0,98001,47.2718,-122.265,1930,28800,59188,26870,4.350267556318953,0.024708196721311474,Very Cheap
20150415T000000,265000.0,3,1.0,1360,5967,1.0,0,0,3,6,1360,0,1954,0,98178,47.4973,-122.256,1360,6052,4607,4692,44.41092676386794,0.024918032786885248,Very Cheap
20140616T000000,418000.0,4,3.0,2360,6250,1.0,0,2,3,7,1460,900,1960,0,98118,47.512,-122.249,2500,6250,3890,3750,66.88,0.04498360655737705,Very Cheap
20140813T000000,390000.0,3,2.0,2360,5737,2.0,0,0,3,8,2360,0,2003,0,98028,47.7633,-122.262,1600,9163,3377,7563,67.97978037301726,0.04131147540983607,Very Cheap
20150422T000000,430000.0,3,2.0,1860,7500,1.0,0,0,3,7,930,930,1909,1950,98106,47.5662,-122.364,1000,5000,5640,4000,57.333333333333336,0.04655737704918033,Very Cheap
20150423T000000,1442500.0,3,2.25,2630,9705,2.5,0,2,4,8,2630,0,1987,0,98052,47.6485,-122.121,2640,14284,7075,11644,148.63472436888202,0.17934426229508196,Cheap
20141120T000000,297000.0,2,1.75,1280,37373,1.0,0,0,4,7,1280,0,1996,0,98022,47.2631,-122.019,2180,48351,36093,46171,7.946913547213229,0.029114754098360656,Very Cheap
20150401T000000,650000.0,4,2.25,2330,7220,2.0,0,1,3,8,1600,730,1988,0,98177,47.7764,-122.386,2220,9100,4890,6880,90.02770083102493,0.07540983606557378,Very Cheap
20140509T000000,195000.0,2,1.0,720,18000,1.0,0,0,3,6,720,0,1950,0,98178,47.5054,-122.261,1250,7925,17280,6675,10.833333333333334,0.015737704918032787,Very Cheap
20140616T000000,554000.0,3,3.5,3380,108900,2.0,0,0,3,9,2700,680,1999,0,98058,47.4316,-122.075,2250,130680,105520,128430,5.087235996326905,0.06281967213114754,Very Cheap
20140929T000000,550000.0,3,2.0,3650,843309,2.0,0,0,4,7,3650,0,1991,0,98070,47.3627,-122.496,1870,273992,839659,272122,0.6521927312527199,0.06229508196721312,Very Cheap
20150219T000000,700000.0,3,1.75,1640,4590,1.5,0,0,5,7,1640,0,1951,0,98115,47.6846,-122.294,1760,5100,2950,3340,152.5054466230937,0.08196721311475409,Very Cheap
20141002T000000,300000.0,4,1.0,1730,177657,1.5,0,0,3,5,1730,0,1948,0,98065,47.5163,-121.829,1400,45175,175927,43775,1.6886472247082862,0.029508196721311476,Very Cheap
20141007T000000,315000.0,2,1.0,1030,8576,1.5,0,0,5,6,1030,0,1952,0,98155,47.7352,-122.295,1310,8504,7546,7194,36.730410447761194,0.031475409836065574,Very Cheap
20141008T000000,603000.0,3,1.0,1790,5250,1.0,0,0,3,7,1400,390,1943,0,98105,47.6627,-122.276,1790,5250,3460,3460,114.85714285714286,0.06924590163934426,Very Cheap
20140629T000000,530000.0,2,1.0,840,3400,1.0,0,2,4,7,840,0,1924,0,98119,47.6403,-122.372,2000,4000,2560,2000,155.88235294117646,0.05967213114754098,Very Cheap
20140909T000000,397500.0,3,1.75,1300,8480,1.0,0,0,3,7,1300,0,1969,0,98052,47.6991,-122.13,1740,7280,7180,5540,46.875,0.04229508196721311,Very Cheap
20150325T000000,221000.0,3,1.0,1240,5250,1.5,0,0,4,6,1240,0,1904,0,98055,47.4917,-122.206,1240,5250,4010,4010,42.095238095238095,0.01914754098360656,Very Cheap
20141202T000000,466000.0,4,2.25,2170,8050,1.0,0,0,3,7,1220,950,1976,0,98072,47.7354,-122.174,1820,7700,5880,5880,57.88819875776397,0.051278688524590166,Very Cheap
20140619T000000,197500.0,3,1.0,1330,5412,2.0,0,0,5,7,1330,0,1905,0,98022,47.2053,-121.993,1710,10825,4082,9115,36.4929785661493,0.016065573770491802,Very Cheap
20150507T000000,280000.0,3,3.0,1390,1080,2.0,0,0,3,7,1140,250,2006,0,98118,47.5325,-122.282,1450,1461,-310,11,259.25925925925924,0.026885245901639345,Very Cheap
20141003T000000,412000.0,2,1.5,1240,3873,1.0,0,0,4,6,860,380,1909,0,98116,47.5752,-122.388,1240,4336,2633,3096,106.37748515362767,0.04419672131147541,Very Cheap
20140818T000000,454000.0,2,1.0,880,6731,1.0,0,0,4,7,880,0,1950,0,98116,47.5694,-122.395,1240,6731,5851,5491,67.44911603030754,0.049704918032786885,Very Cheap
20140512T000000,540000.0,4,2.25,2540,228254,1.0,0,0,3,8,1450,1090,1990,0,98019,47.719,-121.912,1780,59241,225714,57461,2.3657854845917266,0.06098360655737705,Very Cheap
20140609T000000,250000.0,5,1.5,2520,5753,1.5,0,0,4,7,1510,1010,1928,0,98022,47.2058,-121.997,1620,6875,3233,5255,43.45558838866678,0.022950819672131147,Very Cheap
20150511T000000,900000.0,5,2.25,2510,35691,1.0,0,0,3,9,2510,0,1967,0,98005,47.6435,-122.154,3160,35037,33181,31877,25.216441119609986,0.10819672131147541,Cheap
20140513T000000,245000.0,5,1.75,2020,7902,1.0,0,0,3,7,1220,800,1962,0,98168,47.51,-122.327,2220,8819,5882,6599,31.004808909136926,0.022295081967213116,Very Cheap
20141007T000000,290000.0,3,1.75,2060,7251,1.0,0,0,3,7,1350,710,1987,0,98030,47.3569,-122.175,1520,7582,5191,6062,39.99448351951455,0.02819672131147541,Very Cheap
20150205T000000,160000.0,2,1.0,930,7742,1.0,0,0,3,6,930,0,1933,0,98168,47.507,-122.302,2240,8723,6812,6483,20.666494445879618,0.011147540983606558,Very Cheap
20150330T000000,1260000.0,2,1.5,2700,7225,1.5,0,4,3,8,1660,1040,1910,2008,98116,47.5892,-122.383,2970,5150,4525,2180,174.39446366782008,0.15540983606557376,Cheap
20150327T000000,325000.0,2,1.0,1060,6050,1.0,0,0,3,7,940,120,1939,0,98125,47.7028,-122.321,1540,5279,4990,3739,53.71900826446281,0.03278688524590164,Very Cheap
20150108T000000,185000.0,2,1.0,670,6750,1.0,0,0,4,5,670,0,1947,0,98188,47.4521,-122.283,1700,11520,6080,9820,27.40740740740741,0.014426229508196721,Very Cheap
20140925T000000,477000.0,3,2.0,1750,4990,1.0,0,0,3,7,950,800,1916,0,98107,47.6667,-122.361,1700,5000,3240,3300,95.59118236472946,0.052721311475409836,Very Cheap
20140630T000000,100000.0,2,1.0,930,7623,1.0,0,0,2,6,930,0,1942,0,98166,47.467,-122.349,1300,7641,6693,6341,13.118194936376755,0.003278688524590164,Very Cheap
20150504T000000,345000.0,4,2.5,2420,11481,1.0,0,0,3,8,1370,1050,1985,0,98003,47.341,-122.318,2290,8985,9061,6695,30.04964724327149,0.03540983606557377,Very Cheap
20150331T000000,530000.0,4,2.25,2410,14985,1.0,0,1,4,7,1950,460,1965,0,98166,47.4278,-122.343,2510,15256,12575,12746,35.3687020353687,0.05967213114754098,Very Cheap
20140620T000000,203000.0,3,1.0,1150,7156,1.0,0,0,4,6,1150,0,1953,0,98168,47.4864,-122.317,1210,7156,6006,5946,28.367803242034658,0.01678688524590164,Very Cheap
20141028T000000,599000.0,4,2.5,2480,5000,2.0,0,0,3,7,2480,0,2004,0,98053,47.6811,-122.035,2410,5000,2520,2590,119.8,0.06872131147540983,Very Cheap
20140720T000000,370000.0,4,1.0,1310,6000,1.5,0,0,3,7,1310,0,1940,0,98144,47.5822,-122.295,1630,6000,4690,4370,61.666666666666664,0.038688524590163934,Very Cheap
20150227T000000,140000.0,3,1.0,1240,8000,1.0,0,0,4,6,1040,200,1954,0,98198,47.4204,-122.316,1240,8000,6760,6760,17.5,0.008524590163934427,Very Cheap
20140623T000000,500000.0,3,1.0,1150,5100,2.0,0,0,3,8,1150,0,1911,2005,98136,47.5349,-122.384,1440,5100,3950,3660,98.03921568627452,0.05573770491803279,Very Cheap
20150203T000000,527200.0,3,1.75,1460,4000,1.0,0,2,4,7,730,730,1929,0,98144,47.5768,-122.307,1360,4000,2540,2640,131.8,0.05930491803278688,Very Cheap
20140510T000000,549900.0,5,2.75,3060,7015,1.0,0,0,5,8,1600,1460,1979,0,98146,47.5052,-122.372,2190,7600,3955,5410,78.38916607270136,0.062281967213114756,Very Cheap
20150502T000000,760000.0,4,2.5,3520,8095,2.0,0,0,3,9,3520,0,2006,0,98052,47.7065,-122.109,2460,4676,4575,2216,93.8851142680667,0.0898360655737705,Very Cheap
20140728T000000,319000.0,2,1.0,960,4400,1.0,0,0,4,7,960,0,1951,0,98118,47.5269,-122.264,1520,5000,3440,3480,72.5,0.032,Very Cheap
20140623T000000,362300.0,3,2.5,2430,15264,2.0,0,0,3,8,2430,0,1997,0,98030,47.3805,-122.208,2260,10416,12834,8156,23.735587002096437,0.037678688524590165,Very Cheap
20150427T000000,421000.0,3,2.5,1930,4505,1.0,0,3,4,7,1440,490,1973,0,98198,47.3459,-122.326,1550,4505,2575,2955,93.45172031076582,0.045377049180327866,Very Cheap
20150304T000000,690000.0,3,1.0,1090,4000,1.5,0,0,4,7,1090,0,1945,0,98117,47.6846,-122.386,1520,4000,2910,2480,172.5,0.08065573770491803,Very Cheap
20140828T000000,640000.0,3,2.5,2790,31798,1.0,0,0,5,8,1650,1140,1953,0,98027,47.5241,-122.039,1400,14849,29008,13449,20.127052015850055,0.0740983606557377,Very Cheap
20141208T000000,238000.0,4,1.75,1650,6900,1.0,0,0,3,7,910,740,1978,1993,98002,47.2802,-122.211,1540,7645,5250,6105,34.492753623188406,0.02137704918032787,Very Cheap
20140602T000000,789000.0,3,3.0,3740,39640,2.0,0,2,3,10,3740,0,1991,0,98070,47.4036,-122.462,2930,26136,35900,23206,19.904137235116046,0.09363934426229509,Very Cheap
20150423T000000,1050000.0,6,4.0,5310,12741,2.0,0,2,3,10,3600,1710,1967,0,98040,47.5696,-122.213,4190,12632,7431,8442,82.41111372733694,0.12786885245901639,Cheap
20150408T000000,302500.0,3,2.5,1690,4476,2.0,0,0,3,7,1690,0,2008,0,98042,47.3663,-122.114,2250,4488,2786,2238,67.58266309204647,0.02983606557377049,Very Cheap
20150311T000000,259950.0,4,1.75,1400,7920,1.0,0,0,3,7,1400,0,1963,0,98058,47.4658,-122.184,1910,7700,6520,5790,32.821969696969695,0.024255737704918033,Very Cheap
20140620T000000,456000.0,3,1.5,1440,28516,1.0,0,0,4,7,1440,0,1975,0,98075,47.5829,-122.005,2080,27049,27076,24969,15.991022583812596,0.0499672131147541,Very Cheap
20140925T000000,369950.0,3,2.5,1360,3718,2.0,0,0,3,7,1360,0,1987,0,98052,47.6827,-122.097,1090,3718,2358,2628,99.5024206562668,0.03868196721311475,Very Cheap
20140516T000000,363750.0,3,1.75,1726,197326,2.0,0,0,4,7,1726,0,1982,0,98070,47.3484,-122.505,2114,99316,195600,97202,1.8433962072914871,0.037868852459016396,Very Cheap
20140811T000000,585000.0,3,1.75,2220,216493,1.0,0,2,3,8,2220,0,1989,0,98014,47.6624,-121.951,2900,169884,214273,166984,2.702165889890204,0.06688524590163934,Very Cheap
20141008T000000,268000.0,3,2.5,1850,6676,2.0,0,0,3,7,1850,0,1986,0,98023,47.3103,-122.36,1700,6663,4826,4963,40.14379868184542,0.025311475409836064,Very Cheap
20140923T000000,1200000.0,5,2.5,2860,4000,2.0,0,0,4,8,2160,700,1910,0,98102,47.6225,-122.318,1340,1224,1140,-116,300.0,0.14754098360655737,Cheap
20140716T000000,345000.0,3,1.0,1120,10176,1.0,0,0,3,6,920,200,1905,0,98118,47.5235,-122.277,1350,7500,9056,6150,33.903301886792455,0.03540983606557377,Very Cheap
20150225T000000,539000.0,4,2.5,2340,19850,2.0,0,0,3,9,2340,0,1993,0,98155,47.7672,-122.306,1930,15439,17510,13509,27.1536523929471,0.06085245901639344,Very Cheap
20140702T000000,851000.0,5,3.25,3760,9792,2.0,0,0,3,9,2550,1210,1984,0,98006,47.5654,-122.115,2960,16500,6032,13540,86.9076797385621,0.10177049180327868,Cheap
20150408T000000,900000.0,3,2.5,1920,7200,2.0,0,2,3,10,1780,140,1997,0,98116,47.5709,-122.408,2080,5000,5280,2920,125.0,0.10819672131147541,Cheap
20140703T000000,850000.0,3,2.5,3230,5000,2.0,0,2,5,8,2430,800,1945,0,98117,47.7011,-122.389,1820,5000,1770,3180,170.0,0.10163934426229508,Cheap
20140506T000000,390000.0,3,1.75,1260,6500,1.0,0,0,4,7,1260,0,1966,0,98008,47.6224,-122.116,1500,7700,5240,6200,60.0,0.04131147540983607,Very Cheap
20140610T000000,345000.0,3,1.75,1540,6909,1.0,0,0,4,7,920,620,1955,0,98155,47.7451,-122.313,1130,6908,5369,5778,49.9348675640469,0.03540983606557377,Very Cheap
20140616T000000,534500.0,3,2.5,1700,3150,2.0,0,0,3,8,1700,0,2005,0,98029,47.5505,-121.998,1700,3600,1450,1900,169.68253968253967,0.06026229508196721,Very Cheap
20141118T000000,643500.0,6,5.25,3600,3960,2.0,0,0,3,7,2400,1200,1971,0,98126,47.5656,-122.372,1450,4600,360,3150,162.5,0.07455737704918033,Very Cheap
20150402T000000,1206500.0,3,2.75,3150,5520,1.5,0,0,4,8,2130,1020,1925,0,98112,47.6345,-122.302,3160,6200,2370,3040,218.56884057971016,0.14839344262295082,Cheap
20150115T000000,495000.0,2,1.75,1280,4000,1.0,0,0,4,7,730,550,1929,0,98116,47.5798,-122.383,2250,5382,2720,3132,123.75,0.05508196721311476,Very Cheap
20140730T000000,535000.0,2,1.0,980,4120,1.0,0,0,3,7,830,150,1950,2014,98115,47.6815,-122.291,1760,4120,3140,2360,129.85436893203882,0.06032786885245902,Very Cheap
20141029T000000,435000.0,4,2.5,2190,6578,2.0,0,0,3,7,2190,0,2004,0,98065,47.5305,-121.847,2190,5416,4388,3226,66.12952265126178,0.04721311475409836,Very Cheap
20141113T000000,305000.0,4,2.0,2470,1831,2.0,0,0,3,7,1970,500,2009,0,98166,47.4645,-122.337,1310,7500,-639,6190,166.57564172583287,0.03016393442622951,Very Cheap
20140619T000000,799000.0,4,2.5,2590,7910,2.0,0,0,3,9,2590,0,2001,0,98115,47.6978,-122.284,1700,7488,5320,5788,101.01137800252845,0.09495081967213115,Very Cheap
20141113T000000,700000.0,4,2.5,2580,15031,2.0,0,0,3,9,2580,0,1999,0,98052,47.6895,-122.094,3030,10361,12451,7331,46.570421129665355,0.08196721311475409,Very Cheap
20140520T000000,467000.0,3,2.25,1270,1213,2.0,0,0,3,8,1040,230,2005,0,98107,47.6736,-122.375,1410,1265,-57,-145,384.99587798845835,0.05140983606557377,Very Cheap
20150407T000000,263000.0,3,1.0,1250,7560,1.0,0,0,3,6,1250,0,1959,0,98058,47.4493,-122.173,1270,7615,6310,6345,34.78835978835979,0.024655737704918034,Very Cheap
20140820T000000,760000.0,4,2.5,4660,7157,2.0,0,0,3,9,3020,1640,2003,0,98059,47.5352,-122.156,3300,7047,2497,3747,106.18974430627358,0.0898360655737705,Very Cheap
20150207T000000,293000.0,4,2.5,2019,4435,2.0,0,3,3,8,2019,0,2008,0,98022,47.1958,-121.974,1950,4800,2416,2850,66.06538895152198,0.02859016393442623,Very Cheap
20140821T000000,245000.0,3,2.0,1490,7929,1.0,0,0,3,7,1490,0,1989,0,98002,47.2875,-122.218,1650,7929,6439,6279,30.899230672215918,0.022295081967213116,Very Cheap
20140731T000000,181000.0,2,1.5,1560,10807,1.0,0,0,2,7,1560,0,1949,0,98070,47.4444,-122.509,1660,196591,9247,194931,16.748403812343852,0.013901639344262294,Very Cheap
20150423T000000,240000.0,3,1.0,1030,15264,1.0,0,0,4,7,1030,0,1962,0,98056,47.5016,-122.168,1430,14840,14234,13410,15.723270440251572,0.021639344262295083,Very Cheap
20141117T000000,880000.0,4,2.75,2560,7961,1.0,0,2,4,8,1450,1110,1975,0,98033,47.6499,-122.199,2500,9009,5401,6509,110.5388770254993,0.10557377049180328,Cheap
20140625T000000,285000.0,3,2.0,1460,6377,1.0,0,0,3,7,1460,0,1995,0,98038,47.3679,-122.02,1600,6250,4917,4650,44.691861376822956,0.02754098360655738,Very Cheap
20150416T000000,407500.0,2,1.0,770,6017,1.0,0,0,3,7,770,0,1950,0,98125,47.7223,-122.321,1670,7500,5247,5830,67.72477979059332,0.04360655737704918,Very Cheap
20140812T000000,325000.0,4,2.5,1960,3543,2.0,0,0,3,7,1960,0,2004,0,98056,47.4849,-122.184,2420,3646,1583,1226,91.73017217047699,0.03278688524590164,Very Cheap
20141017T000000,405000.0,3,1.75,1900,10454,1.0,0,0,3,7,1390,510,1978,0,98155,47.7748,-122.291,2000,12000,8554,10000,38.741151712263246,0.043278688524590166,Very Cheap
20150407T000000,291700.0,3,2.5,1970,4120,1.5,0,0,3,6,1230,740,1927,0,98106,47.5328,-122.346,1470,4080,2150,2610,70.80097087378641,0.02841967213114754,Very Cheap
20141016T000000,370000.0,3,2.5,2490,18525,2.0,0,3,3,8,2490,0,1995,0,98022,47.2119,-122.001,1850,9516,16035,7666,19.973009446693656,0.038688524590163934,Very Cheap
20140528T000000,270000.0,3,1.5,1430,8960,1.0,0,0,4,6,1430,0,1953,0,98166,47.4759,-122.349,1560,10125,7530,8565,30.133928571428573,0.025573770491803278,Very Cheap
20140527T000000,800000.0,4,2.5,2680,7200,1.0,0,0,3,8,1380,1300,1952,2013,98033,47.6835,-122.187,1950,8520,4520,6570,111.11111111111111,0.09508196721311475,Very Cheap
20140923T000000,626500.0,3,1.75,1610,3210,1.0,0,0,5,7,910,700,1928,0,98103,47.6656,-122.335,1420,3210,1600,1790,195.17133956386292,0.07232786885245901,Very Cheap
20141021T000000,1130000.0,4,3.5,4300,8406,2.0,0,1,3,11,3580,720,1987,0,98040,47.5396,-122.214,2770,10006,4106,7236,134.42778967404234,0.13836065573770492,Cheap
20140822T000000,399950.0,4,2.5,3200,7545,2.0,0,0,3,7,3200,0,2003,0,98038,47.3666,-122.03,2840,7137,4345,4297,53.00861497680583,0.04261639344262295,Very Cheap
20140724T000000,419000.0,3,1.75,2140,15030,1.0,0,0,4,7,1570,570,1958,0,98166,47.4181,-122.338,2170,15030,12890,12860,27.877578176979373,0.04511475409836065,Very Cheap
20140715T000000,1160000.0,4,2.5,4240,43995,2.0,0,0,3,10,4240,0,1989,0,98075,47.6008,-122.044,3720,59522,39755,55802,26.36663257188317,0.1422950819672131,Cheap
20140519T000000,1405000.0,4,3.5,3410,10769,2.0,0,0,3,10,3410,0,2008,0,98004,47.6081,-122.198,2650,10058,7359,7408,130.46708143745937,0.17442622950819672,Cheap
20140731T000000,710000.0,4,2.75,2090,8064,2.0,0,0,5,7,2090,0,1967,0,98033,47.6829,-122.195,1460,8400,5974,6940,88.04563492063492,0.08327868852459017,Very Cheap
20150330T000000,650000.0,3,1.0,1410,4840,1.0,0,2,4,6,1230,180,1942,0,98033,47.6646,-122.204,1410,5400,3430,3990,134.29752066115702,0.07540983606557378,Very Cheap
20150220T000000,369900.0,4,2.5,2820,33750,2.0,0,0,4,9,2820,0,1984,0,98072,47.7387,-122.096,2510,36180,30930,33670,10.96,0.03867540983606557,Very Cheap
20140627T000000,641000.0,4,2.5,2770,63118,2.0,0,0,3,9,2770,0,1997,0,98014,47.6622,-121.961,2770,44224,60348,41454,10.155581609049717,0.0742295081967213,Very Cheap
20150318T000000,403000.0,3,1.0,1400,6879,1.0,0,0,3,7,1400,0,1951,0,98155,47.7508,-122.286,1950,7400,5479,5450,58.5840965256578,0.04301639344262295,Very Cheap
20140703T000000,1015000.0,3,3.25,3620,4000,2.0,0,0,3,10,2730,890,2005,0,98199,47.6393,-122.403,1910,5000,380,3090,253.75,0.12327868852459016,Cheap
20140922T000000,865000.0,4,2.5,2260,13600,1.0,0,0,4,8,1770,490,1974,0,98040,47.5436,-122.233,2630,13995,11340,11365,63.60294117647059,0.10360655737704919,Cheap
20141111T000000,2485000.0,4,2.5,3440,23954,1.5,1,3,5,10,2260,1180,1931,0,98040,47.5636,-122.231,4230,18723,20514,14493,103.74050263004091,0.3160655737704918,Medium
20141016T000000,810000.0,4,1.0,2150,3588,2.0,0,3,4,8,1850,300,1926,0,98126,47.5767,-122.378,1950,3588,1438,1638,225.752508361204,0.09639344262295083,Very Cheap
20140715T000000,316750.0,3,2.5,1256,1154,3.0,0,0,3,7,1256,0,2005,0,98125,47.7146,-122.311,1309,1232,-102,-77,274.4800693240901,0.03170491803278688,Very Cheap
20140820T000000,652500.0,4,2.25,2220,130244,2.0,0,0,3,8,2220,0,1989,0,98027,47.4989,-121.9,2680,130680,128024,128000,5.009827707994226,0.07573770491803279,Very Cheap
20150204T000000,360000.0,6,2.75,2850,15240,1.0,0,0,3,7,1850,1000,1962,0,98106,47.5288,-122.345,2090,7620,12390,5530,23.62204724409449,0.037377049180327866,Very Cheap
20150416T000000,208000.0,2,1.0,700,5100,1.0,0,0,4,5,700,0,1953,0,98056,47.4957,-122.168,970,5811,4400,4841,40.78431372549019,0.01744262295081967,Very Cheap
20150210T000000,898000.0,4,2.5,3700,63991,2.0,0,0,3,10,3700,0,1992,0,98077,47.7319,-122.051,3210,47215,60291,44005,14.033223422043726,0.10793442622950819,Cheap
20150227T000000,295000.0,4,1.75,1400,11934,1.0,0,0,3,7,1050,350,1961,0,98028,47.7346,-122.244,2080,10400,10534,8320,24.719289425171777,0.028852459016393443,Very Cheap
20150506T000000,652500.0,4,1.75,3130,18253,2.0,0,0,3,7,3130,0,1978,0,98133,47.7402,-122.348,1850,12220,15123,10370,35.74754834821673,0.07573770491803279,Very Cheap
20140725T000000,560000.0,4,3.0,2170,5764,2.0,0,0,3,8,2170,0,1992,0,98029,47.5673,-121.999,2010,5681,3594,3671,97.15475364330327,0.06360655737704918,Very Cheap
20150504T000000,280000.0,3,1.0,1020,8400,1.0,0,0,4,7,1020,0,1957,0,98056,47.4905,-122.18,1690,8030,7380,6340,33.333333333333336,0.026885245901639345,Very Cheap
20140630T000000,289950.0,3,2.5,1760,8584,1.5,0,0,5,7,1760,0,1937,0,98148,47.4612,-122.325,2160,8584,6824,6424,33.77795899347623,0.028190163934426228,Very Cheap
20150410T000000,397500.0,3,2.5,1860,44093,1.0,0,0,3,7,1860,0,1978,0,98055,47.4381,-122.188,1900,6130,42233,4230,9.015036400335655,0.04229508196721311,Very Cheap
20150324T000000,380000.0,2,1.0,1140,75132,1.0,0,0,3,7,1140,0,1956,0,98077,47.7349,-122.074,2570,35200,73992,32630,5.0577650002661985,0.04,Very Cheap
20141031T000000,415900.0,3,2.5,1670,22703,1.0,0,0,3,7,1310,360,1988,0,98045,47.4708,-121.756,1510,16817,21033,15307,18.31916486807911,0.044708196721311474,Very Cheap
20140716T000000,475000.0,2,1.75,1710,8645,1.0,0,0,4,7,1510,200,1923,0,98115,47.7005,-122.313,1280,5366,6935,4086,54.94505494505494,0.05245901639344262,Very Cheap
20141002T000000,125000.0,1,1.0,500,7440,1.0,0,0,1,5,500,0,1928,0,98106,47.5252,-122.362,1350,7440,6940,6090,16.801075268817204,0.006557377049180328,Very Cheap
20140821T000000,238000.0,3,1.0,1470,32670,1.0,0,0,3,7,1020,450,1958,0,98042,47.3811,-122.144,2640,24100,31200,21460,7.2849709213345575,0.02137704918032787,Very Cheap
20140820T000000,296000.0,4,1.5,1370,9750,1.0,0,0,3,7,1070,300,1953,0,98168,47.4718,-122.323,1540,9789,8380,8249,30.358974358974358,0.02898360655737705,Very Cheap
20140506T000000,475000.0,6,3.0,3470,117612,1.5,0,0,3,7,3470,0,1924,0,98028,47.7663,-122.234,2120,17100,114142,14980,4.038703533653028,0.05245901639344262,Very Cheap
20150223T000000,390000.0,3,2.25,1650,6250,1.5,0,0,3,7,1650,0,1910,0,98116,47.5639,-122.4,2060,6250,4600,4190,62.4,0.04131147540983607,Very Cheap
20141119T000000,425000.0,3,1.0,1180,3750,1.0,0,0,3,6,1030,150,1940,0,98116,47.5726,-122.382,1280,3750,2570,2470,113.33333333333333,0.04590163934426229,Very Cheap
20140626T000000,725000.0,6,3.0,3110,5000,1.5,0,0,5,7,1810,1300,1921,0,98103,47.6631,-122.348,1600,4000,1890,2400,145.0,0.08524590163934426,Very Cheap
20140702T000000,605000.0,3,2.25,2080,12134,1.0,0,0,4,8,1530,550,1973,0,98052,47.6315,-122.102,2320,12400,10054,10080,49.85989780781276,0.06950819672131148,Very Cheap
20141105T000000,302000.0,3,1.0,1600,1950,2.0,0,0,2,7,1600,0,1906,0,98122,47.6028,-122.312,1310,1138,350,-172,154.87179487179486,0.02977049180327869,Very Cheap
20150318T000000,886000.0,3,2.25,2380,6000,2.0,0,0,5,9,1650,730,1931,0,98199,47.6472,-122.393,2000,6000,3620,4000,147.66666666666666,0.10636065573770492,Cheap
20140814T000000,540000.0,4,1.75,1630,6120,1.0,0,0,5,7,980,650,1918,0,98115,47.6821,-122.31,1630,4080,4490,2450,88.23529411764706,0.06098360655737705,Very Cheap
20150414T000000,435000.0,4,2.25,1910,8400,2.0,0,0,3,7,1910,0,1975,0,98072,47.7352,-122.175,1910,8400,6490,6490,51.785714285714285,0.04721311475409836,Very Cheap
20141010T000000,409000.0,4,3.25,3140,10752,2.0,0,0,3,7,2300,840,1992,0,98146,47.5022,-122.363,1300,9920,7612,8620,38.039434523809526,0.04380327868852459,Very Cheap
20150106T000000,405000.0,3,1.0,1250,7280,1.0,0,0,3,7,1250,0,1975,0,98052,47.6986,-122.129,1690,7280,6030,5590,55.63186813186813,0.043278688524590166,Very Cheap
20140611T000000,560200.0,3,2.5,1990,3984,2.0,0,0,3,8,1990,0,2004,0,98075,47.5914,-122.017,2320,3984,1994,1664,140.61244979919678,0.0636327868852459,Very Cheap
20140623T000000,324000.0,4,1.75,2110,7208,1.0,0,0,3,8,1170,940,1975,0,98058,47.4464,-122.129,1820,7208,5098,5388,44.95005549389567,0.03265573770491803,Very Cheap
20140519T000000,390000.0,4,2.5,2490,8290,2.0,0,0,3,9,2490,0,1999,0,98092,47.3305,-122.171,2690,7008,5800,4318,47.04463208685163,0.04131147540983607,Very Cheap
20150407T000000,414000.0,2,1.0,800,5000,1.0,0,0,3,6,800,0,1938,0,98055,47.4914,-122.204,1220,5000,4200,3780,82.8,0.04445901639344262,Very Cheap
20140903T000000,441500.0,3,2.5,2360,4670,2.0,0,0,3,7,2360,0,1998,0,98065,47.537,-121.871,2420,5620,2310,3200,94.53961456102783,0.0480655737704918,Very Cheap
20150309T000000,375000.0,3,2.5,1770,5146,2.0,0,0,3,7,1770,0,1992,0,98106,47.5263,-122.356,1230,5160,3376,3930,72.87213369607463,0.03934426229508197,Very Cheap
20140602T000000,668500.0,4,2.5,2710,5500,2.0,0,0,3,9,2710,0,1999,0,98074,47.6027,-122.023,2710,6242,2790,3532,121.54545454545455,0.07783606557377049,Very Cheap
20141007T000000,540000.0,5,1.5,1940,10202,1.5,0,0,4,7,1940,0,1940,0,98125,47.7213,-122.31,1900,8000,8262,6100,52.93079788276808,0.06098360655737705,Very Cheap
20140606T000000,1035000.0,4,3.25,3450,11240,2.0,0,3,4,10,2430,1020,1960,2001,98166,47.4556,-122.372,2412,19499,7790,17087,92.08185053380782,0.1259016393442623,Cheap
20150325T000000,1345000.0,4,3.25,3440,4920,2.0,0,4,3,10,2520,920,2014,0,98116,47.5727,-122.409,2350,5166,1480,2816,273.3739837398374,0.16655737704918033,Cheap
20140507T000000,758000.0,4,2.75,2410,9549,1.0,0,0,4,7,1780,630,1956,0,98033,47.6503,-122.197,2090,9549,7139,7459,79.3800397947429,0.08957377049180328,Very Cheap
20140527T000000,949880.0,4,2.25,2290,10687,2.0,0,0,3,9,2290,0,1978,0,98004,47.5878,-122.202,2290,10300,8397,8010,88.88181903246935,0.11473836065573771,Cheap
20150507T000000,570000.0,3,1.0,1030,4089,1.5,0,0,3,7,1030,0,1927,0,98116,47.574,-122.385,1440,4917,3059,3477,139.39838591342627,0.06491803278688525,Very Cheap
20140506T000000,736000.0,4,2.5,2290,12047,2.0,0,0,4,9,2290,0,1988,0,98006,47.5599,-122.105,3130,15666,9757,12536,61.09404831078277,0.08668852459016393,Very Cheap
20140626T000000,670000.0,3,1.5,1490,4400,1.5,0,0,4,7,1490,0,1906,0,98122,47.6113,-122.292,1560,4400,2910,2840,152.27272727272728,0.0780327868852459,Very Cheap
20150406T000000,1130000.0,4,1.75,2370,8400,1.0,0,0,5,9,1270,1100,1949,0,98105,47.6716,-122.264,2370,8400,6030,6030,134.52380952380952,0.13836065573770492,Cheap
20141022T000000,650000.0,4,2.0,1930,3976,1.5,0,0,4,8,1930,0,1914,0,98122,47.6117,-122.297,1470,4080,2046,2610,163.48088531187122,0.07540983606557378,Very Cheap
20140616T000000,690000.0,2,1.75,1600,4000,1.0,0,0,5,7,850,750,1918,0,98112,47.6408,-122.3,1860,4000,2400,2140,172.5,0.08065573770491803,Very Cheap
20150313T000000,610000.0,4,2.25,2240,45738,2.0,0,0,3,7,2240,0,1988,0,98053,47.687,-122.047,3180,45738,43498,42558,13.336831518649701,0.07016393442622951,Very Cheap
20140519T000000,413500.0,2,1.0,770,4000,1.0,0,0,5,5,770,0,1924,0,98117,47.6959,-122.364,1420,5040,3230,3620,103.375,0.04439344262295082,Very Cheap
20150414T000000,765000.0,3,2.5,2300,9752,2.0,0,2,3,8,2300,0,1968,2003,98075,47.5825,-122.076,2640,10764,7452,8124,78.44544708777687,0.09049180327868853,Very Cheap
20141210T000000,828200.0,4,2.75,3400,7081,2.0,0,0,3,9,3400,0,2001,0,98006,47.5661,-122.123,3060,7081,3681,4021,116.96088123146448,0.09878032786885246,Very Cheap
20140726T000000,205000.0,2,1.0,900,4397,1.0,0,0,3,6,900,0,1918,0,98055,47.4851,-122.205,1430,4500,3497,3070,46.62269729360928,0.017049180327868854,Very Cheap
20141202T000000,465000.0,3,2.5,1450,5175,1.0,0,0,3,8,1030,420,1995,0,98133,47.7082,-122.338,1740,9250,3725,7510,89.85507246376811,0.051147540983606556,Very Cheap
20150311T000000,556000.0,4,2.5,2240,5402,2.0,0,0,3,8,2240,0,2005,0,98133,47.772,-122.35,2240,7560,3162,5320,102.92484265087005,0.06308196721311475,Very Cheap
20140608T000000,540000.0,4,2.5,1780,4169,2.0,0,0,3,8,1780,0,1994,0,98029,47.5695,-122.006,1830,4164,2389,2334,129.52746461981292,0.06098360655737705,Very Cheap
20140729T000000,423000.0,4,2.5,2320,4254,2.0,0,0,3,8,2320,0,2004,0,98059,47.48,-122.137,2330,4602,1934,2272,99.4358251057828,0.04563934426229508,Very Cheap
20150410T000000,375000.0,3,1.75,1590,14766,1.0,0,0,3,8,1590,0,1963,0,98007,47.5902,-122.147,2040,10190,13176,8150,25.396180414465665,0.03934426229508197,Very Cheap
20141209T000000,173250.0,3,1.0,990,12696,1.5,0,0,3,7,990,0,1936,0,98168,47.4776,-122.279,1260,8937,11706,7677,13.646030245746692,0.012885245901639345,Very Cheap
20150205T000000,599900.0,3,1.5,2605,12030,1.0,0,0,3,8,1355,1250,2003,0,98019,47.7725,-121.899,1590,15242,9425,13652,49.866999168744805,0.06883934426229509,Very Cheap
20140618T000000,646000.0,5,2.75,2870,4461,1.0,0,0,3,7,1650,1220,1976,0,98107,47.675,-122.39,1890,4196,1591,2306,144.81058058731227,0.07488524590163935,Very Cheap
20140605T000000,1075000.0,5,4.75,5180,17811,2.0,0,2,3,11,4070,1110,2001,0,98065,47.5405,-121.868,3960,15103,12631,11143,60.35595980012352,0.13114754098360656,Cheap
20140610T000000,558000.0,4,2.0,2180,3870,1.0,0,0,3,7,1020,1160,1900,0,98122,47.6089,-122.303,1520,2580,1690,1060,144.1860465116279,0.06334426229508197,Very Cheap
20141110T000000,354000.0,2,1.0,850,5225,1.0,0,0,3,7,850,0,1949,0,98126,47.5311,-122.38,1230,5225,4375,3995,67.7511961722488,0.03659016393442623,Very Cheap
20150108T000000,1195000.0,4,4.0,4050,9517,2.0,0,0,3,11,3360,690,1990,0,98040,47.5769,-122.215,3330,9436,5467,6106,125.56477881685404,0.14688524590163934,Cheap
20150331T000000,670000.0,4,2.0,2250,4200,1.5,0,0,3,7,1650,600,1909,0,98122,47.6136,-122.297,1200,3360,1950,2160,159.52380952380952,0.0780327868852459,Very Cheap
20141006T000000,1125000.0,6,4.25,3100,9378,3.0,0,2,3,11,3100,0,1978,0,98112,47.6381,-122.314,3270,6334,6278,3064,119.9616122840691,0.1377049180327869,Cheap
20140807T000000,267500.0,2,1.0,1747,12250,2.5,0,0,4,6,1747,0,1948,0,98001,47.3282,-122.285,1620,10300,10503,8680,21.836734693877553,0.025245901639344263,Very Cheap
20150225T000000,299800.0,4,2.5,2410,4708,2.0,0,0,3,8,2410,0,2002,0,98092,47.3229,-122.182,2517,5290,2298,2773,63.67884451996601,0.029481967213114753,Very Cheap
20150414T000000,430000.0,4,1.75,2070,9120,1.0,0,0,4,7,1250,820,1958,0,98008,47.6045,-122.123,1650,8400,7050,6750,47.14912280701754,0.04655737704918033,Very Cheap
20150313T000000,775000.0,5,1.0,1860,3040,1.5,0,0,3,7,1530,330,1921,0,98103,47.6559,-122.339,1910,3600,1180,1690,254.93421052631578,0.09180327868852459,Very Cheap
20150122T000000,333000.0,3,1.0,950,5214,1.0,0,0,3,7,830,120,1944,0,98126,47.5362,-122.379,1490,7636,4264,6146,63.86651323360184,0.033836065573770495,Very Cheap
20150407T000000,336000.0,3,2.0,1060,11765,1.0,0,0,4,6,1060,0,1951,0,98125,47.7333,-122.302,1500,9151,10705,7651,28.559286017849555,0.03422950819672131,Very Cheap
20150109T000000,323000.0,2,1.0,880,1712,2.0,0,0,4,7,880,0,1945,0,98199,47.6475,-122.397,1360,1748,832,388,188.66822429906543,0.03252459016393443,Very Cheap
20140715T000000,575000.0,4,2.5,2550,56628,2.0,0,0,3,9,2550,0,2001,0,98027,47.4913,-122.081,1870,56628,54078,54758,10.1539874267147,0.06557377049180328,Very Cheap
20141205T000000,328000.0,2,2.25,1550,2079,2.0,0,0,3,8,1550,0,2008,0,98106,47.54,-122.368,1420,1977,529,557,157.76815776815778,0.03318032786885246,Very Cheap
20141210T000000,572500.0,3,1.0,1590,4600,1.5,0,0,4,7,1290,300,1926,0,98117,47.6807,-122.399,1770,4350,3010,2580,124.45652173913044,0.06524590163934427,Very Cheap
20140522T000000,600000.0,3,1.75,1650,5100,1.0,0,0,5,7,1040,610,1908,0,98115,47.6873,-122.321,1540,5100,3450,3560,117.6470588235294,0.06885245901639345,Very Cheap
20150420T000000,412000.0,4,3.0,2430,7242,2.0,0,0,3,8,2430,0,2003,0,98038,47.3533,-122.015,2430,7242,4812,4812,56.890361778514226,0.04419672131147541,Very Cheap
20141203T000000,827500.0,3,2.5,1810,7200,1.0,0,0,5,7,1310,500,1960,0,98033,47.6885,-122.211,2050,7200,5390,5150,114.93055555555556,0.09868852459016393,Very Cheap
20150325T000000,300000.0,4,2.5,2890,17349,2.0,0,0,3,8,2890,0,1994,0,98023,47.2822,-122.34,2330,22356,14459,20026,17.292062943109112,0.029508196721311476,Very Cheap
20141113T000000,415000.0,3,2.5,1280,5040,2.0,0,0,4,7,1280,0,1985,0,98118,47.5611,-122.276,1500,5040,3760,3540,82.34126984126983,0.04459016393442623,Very Cheap
20141112T000000,750000.0,7,2.75,3410,4056,1.5,0,0,4,8,2130,1280,1906,0,98102,47.6454,-122.316,2510,4056,646,1546,184.9112426035503,0.08852459016393442,Very Cheap
20140710T000000,800000.0,3,2.75,2220,4000,2.0,0,0,3,8,1700,520,1914,2000,98122,47.617,-122.291,1800,4000,1780,2200,200.0,0.09508196721311475,Very Cheap
20150317T000000,420000.0,3,1.0,1060,6000,1.0,0,0,3,8,1060,0,1954,0,98118,47.5427,-122.275,1240,7874,4940,6634,70.0,0.04524590163934426,Very Cheap
20141015T000000,266000.0,3,1.5,1120,8250,1.0,0,0,4,7,1120,0,1957,0,98056,47.4905,-122.179,1320,8400,7130,7080,32.24242424242424,0.02504918032786885,Very Cheap
20141021T000000,499000.0,4,2.5,2680,10590,2.0,0,0,3,8,2680,0,2004,0,98019,47.7377,-121.97,2330,5566,7910,3236,47.11992445703494,0.05560655737704918,Very Cheap
20140626T000000,440000.0,4,1.5,1770,5750,2.0,0,0,3,7,1770,0,1947,0,98116,47.5621,-122.394,970,5750,3980,4780,76.52173913043478,0.04786885245901639,Very Cheap
20140623T000000,495000.0,3,2.0,2950,12196,2.0,0,0,4,7,2310,640,1918,0,98166,47.4702,-122.365,2320,19844,9246,17524,40.58707773040341,0.05508196721311476,Very Cheap
20150330T000000,630000.0,2,1.75,1260,5300,1.0,0,0,4,7,840,420,1951,0,98103,47.6809,-122.348,1280,3000,4040,1720,118.86792452830188,0.07278688524590164,Very Cheap
20140804T000000,424000.0,3,1.75,1430,6818,1.0,0,0,5,7,1430,0,1972,0,98034,47.7271,-122.196,1480,7210,5388,5730,62.18832502200058,0.04577049180327869,Very Cheap
20140604T000000,760000.0,4,2.5,2730,36183,2.0,0,0,3,9,2730,0,1986,0,98052,47.7036,-122.127,2710,5964,33453,3254,21.004339054251997,0.0898360655737705,Very Cheap
20140819T000000,650000.0,4,3.5,3270,15704,2.0,0,0,3,9,2110,1160,1990,0,98074,47.6256,-122.042,3020,8582,12434,5562,41.390728476821195,0.07540983606557378,Very Cheap
20140507T000000,248500.0,4,1.75,1720,10018,1.0,0,0,5,7,1720,0,1960,0,98042,47.3614,-122.119,1220,10018,8298,8798,24.805350369335198,0.02275409836065574,Very Cheap
20150421T000000,379600.0,3,1.75,1270,12420,1.0,0,0,4,7,1270,0,1962,0,98056,47.5387,-122.179,1560,9910,11150,8350,30.563607085346217,0.039947540983606554,Very Cheap
20140721T000000,538000.0,4,2.5,3260,10032,1.0,0,0,3,8,1960,1300,1978,0,98125,47.7203,-122.323,1802,7249,6772,5447,53.62838915470494,0.06072131147540984,Very Cheap
20140616T000000,530000.0,4,2.5,2050,6360,2.0,0,0,3,8,2050,0,1988,0,98029,47.5641,-122.011,2070,7541,4310,5471,83.33333333333333,0.05967213114754098,Very Cheap
20150120T000000,545000.0,4,2.25,2050,9720,2.0,0,0,3,8,2050,0,1967,0,98008,47.5911,-122.119,2310,9680,7670,7370,56.06995884773662,0.06163934426229508,Very Cheap
20140624T000000,925000.0,4,3.0,3580,35261,1.5,0,0,3,10,3580,0,1985,0,98072,47.7577,-122.134,3540,36750,31681,33210,26.232948583420775,0.11147540983606558,Cheap
20141209T000000,565000.0,4,2.75,1960,48787,1.5,0,0,4,9,1960,0,1983,0,98072,47.7484,-122.111,1970,36425,46827,34455,11.580953942648657,0.06426229508196721,Very Cheap
20140514T000000,405100.0,2,1.0,840,3522,1.0,0,0,3,6,840,0,1947,0,98199,47.6575,-122.395,1390,4800,2682,3410,115.0198750709824,0.04329180327868853,Very Cheap
20140609T000000,502000.0,3,1.75,1300,8800,1.0,0,0,4,8,1300,0,1963,0,98008,47.6199,-122.116,1350,8800,7500,7450,57.04545454545455,0.056,Very Cheap
20141103T000000,425000.0,3,2.25,1260,3000,2.0,0,0,3,7,1260,0,2003,0,98029,47.5454,-121.997,1630,3042,1740,1412,141.66666666666666,0.04590163934426229,Very Cheap
20140623T000000,233500.0,3,2.25,1650,2958,2.0,0,0,3,7,1650,0,1985,0,98031,47.3916,-122.167,1510,3788,1308,2278,78.93847194050034,0.02078688524590164,Very Cheap
20150323T000000,287000.0,3,2.5,1710,10341,2.0,0,2,3,7,1710,0,1986,0,98030,47.3494,-122.171,1830,9358,8631,7528,27.753602166134804,0.02780327868852459,Very Cheap
20150213T000000,190000.0,3,1.0,1180,8775,1.0,0,0,3,7,1180,0,1966,0,98002,47.2848,-122.223,1300,8100,7595,6800,21.65242165242165,0.015081967213114755,Very Cheap
20141103T000000,666000.0,3,2.25,2780,31510,2.0,0,0,3,8,2780,0,1979,0,98053,47.67,-122.024,2890,36400,28730,33510,21.136147254839734,0.07750819672131147,Very Cheap
20141201T000000,330000.0,2,1.0,950,3090,1.0,0,0,4,6,950,0,1909,0,98118,47.551,-122.276,1230,4120,2140,2890,106.79611650485437,0.03344262295081967,Very Cheap
20140911T000000,1490000.0,5,3.5,3620,7821,2.0,0,2,3,10,2790,830,1958,2010,98040,47.5738,-122.215,2690,9757,4201,7067,190.51272215829178,0.1855737704918033,Cheap
20140909T000000,393000.0,3,2.25,2140,10256,2.0,0,0,3,8,2140,0,1987,0,98038,47.3751,-122.044,2040,11717,8116,9677,38.31903276131045,0.041704918032786885,Very Cheap
20140924T000000,353000.0,4,2.75,1920,4627,1.0,0,0,3,8,1010,910,1998,0,98178,47.5003,-122.23,1910,7210,2707,5300,76.29133347741517,0.03645901639344262,Very Cheap
20141020T000000,260000.0,2,1.0,750,6720,1.0,0,0,3,6,750,0,1916,0,98108,47.552,-122.31,920,6720,5970,5800,38.69047619047619,0.024262295081967214,Very Cheap
20141215T000000,680000.0,3,2.5,2060,2551,2.0,0,0,3,8,1900,160,2001,0,98005,47.5881,-122.165,2060,2936,491,876,266.56213249705996,0.07934426229508197,Very Cheap
20140715T000000,921000.0,3,2.25,2380,11200,1.0,0,0,4,8,2380,0,1963,0,98004,47.5873,-122.193,2010,11200,8820,9190,82.23214285714286,0.11095081967213115,Cheap
20141218T000000,319000.0,2,1.0,750,6380,1.0,0,0,3,7,750,0,1949,0,98125,47.7033,-122.308,1690,6495,5630,4805,50.0,0.032,Very Cheap
20150422T000000,280000.0,3,1.0,1160,10881,1.0,0,0,2,7,920,240,1983,0,98074,47.6339,-122.033,1280,10843,9721,9563,25.73292895873541,0.026885245901639345,Very Cheap
20140611T000000,220000.0,3,1.0,1050,6300,1.0,0,0,3,6,1050,0,1942,0,98146,47.5128,-122.374,740,6300,5250,5560,34.92063492063492,0.01901639344262295,Very Cheap
20150121T000000,219000.0,3,1.5,1740,5200,1.0,0,0,4,7,1060,680,1977,0,98042,47.3657,-122.094,1540,5200,3460,3660,42.11538461538461,0.018885245901639345,Very Cheap
20140808T000000,528000.0,4,2.75,2050,7171,1.0,0,0,3,8,1540,510,1988,0,98074,47.6194,-122.042,1960,7110,5121,5150,73.62989820108771,0.05940983606557377,Very Cheap
20140527T000000,405000.0,3,1.75,1980,8100,1.0,0,0,4,7,1310,670,1949,0,98133,47.7353,-122.331,1450,8212,6120,6762,50.0,0.043278688524590166,Very Cheap
20140514T000000,372977.0,3,2.5,1690,1618,2.0,0,0,3,8,1150,540,2014,0,98029,47.5518,-121.998,1690,1618,-72,-72,230.51730531520394,0.03907895081967213,Very Cheap
20150507T000000,934550.0,4,3.25,2320,5900,1.5,0,2,4,9,2320,0,1910,0,98144,47.597,-122.292,2320,6240,3580,3920,158.39830508474577,0.11272786885245902,Cheap
20150206T000000,1465000.0,3,1.5,2480,9900,2.0,0,3,3,10,2130,350,1940,0,98177,47.7018,-122.381,2860,9288,7420,6428,147.97979797979798,0.1822950819672131,Cheap
20140603T000000,975000.0,4,2.25,2290,5350,2.0,0,0,4,9,2120,170,1958,0,98199,47.6428,-122.411,2910,5350,3060,2440,182.2429906542056,0.1180327868852459,Cheap
20140505T000000,800866.0,5,2.5,3180,13806,2.0,0,0,4,10,3180,0,1990,0,98033,47.652,-122.182,3180,13798,10626,10618,58.00854700854701,0.09519554098360655,Very Cheap
20150413T000000,950000.0,7,3.5,3470,16264,2.0,0,0,4,9,3470,0,1980,0,98007,47.6203,-122.149,3040,13500,12794,10460,58.41121495327103,0.11475409836065574,Cheap
20140904T000000,624000.0,4,3.0,1540,4140,1.5,0,0,5,7,1540,0,1902,0,98107,47.6728,-122.396,1460,5000,2600,3540,150.7246376811594,0.072,Very Cheap
20140814T000000,1850000.0,5,2.25,2800,8442,2.0,1,4,3,9,2800,0,1963,2001,98075,47.5784,-122.076,3220,9156,5642,5936,219.1423833214878,0.23278688524590163,Cheap
20140514T000000,310000.0,3,1.0,1050,9876,1.0,0,0,3,7,1050,0,1953,0,98028,47.7635,-122.262,1760,9403,8826,7643,31.38922640745241,0.03081967213114754,Very Cheap
20141204T000000,315000.0,3,1.75,1480,6800,1.0,0,0,4,7,1480,0,1968,0,98055,47.4633,-122.188,1500,7900,5320,6400,46.3235294117647,0.031475409836065574,Very Cheap
20140820T000000,675000.0,3,2.0,1010,5973,1.0,0,0,5,6,1010,0,1942,0,98033,47.6652,-122.202,1920,6015,4963,4095,113.00853842290306,0.07868852459016394,Very Cheap
20141113T000000,490000.0,3,1.75,1660,8208,1.0,0,0,4,8,1660,0,1965,0,98005,47.5919,-122.154,2210,11000,6548,8790,59.69785575048733,0.05442622950819672,Very Cheap
20150211T000000,600000.0,5,2.25,2760,6350,1.0,0,0,3,7,1380,1380,1958,0,98126,47.5561,-122.379,2060,6342,3590,4282,94.48818897637796,0.06885245901639345,Very Cheap
20140909T000000,154000.0,2,1.0,1040,20524,1.0,0,3,3,6,1040,0,1949,1989,98014,47.6981,-121.875,1880,38996,19484,37116,7.503410641200546,0.010360655737704918,Very Cheap
20140609T000000,480000.0,4,1.75,2220,6500,2.0,0,3,4,8,2220,0,1964,0,98166,47.4519,-122.375,2430,11600,4280,9170,73.84615384615384,0.05311475409836065,Very Cheap
20150213T000000,196900.0,3,1.0,1270,7500,1.0,0,0,3,6,1270,0,1954,0,98198,47.4214,-122.316,1250,8000,6230,6750,26.253333333333334,0.01598688524590164,Very Cheap
20140826T000000,735000.0,3,3.25,2960,39370,2.0,0,0,3,10,2960,0,1989,0,98011,47.7452,-122.202,2960,56628,36410,53668,18.669037338074677,0.08655737704918033,Very Cheap
20150227T000000,205500.0,3,2.0,1330,8748,1.0,0,0,3,7,1330,0,1986,0,98003,47.2619,-122.298,1510,8584,7418,7074,23.49108367626886,0.017114754098360656,Very Cheap
20140616T000000,357186.0,2,1.75,1210,1040,2.0,0,0,3,8,1210,0,2014,0,98029,47.5519,-121.999,1210,1090,-170,-120,343.44807692307694,0.037008,Very Cheap
20150128T000000,275000.0,4,2.5,2120,6754,2.0,0,0,3,7,2120,0,1998,0,98030,47.3629,-122.184,2120,6937,4634,4817,40.71661237785016,0.02622950819672131,Very Cheap
20140906T000000,248500.0,3,1.75,2090,12026,1.0,0,0,4,7,2090,0,1948,0,98002,47.3095,-122.217,1700,9496,9936,7796,20.663562281722935,0.02275409836065574,Very Cheap
20140602T000000,350000.0,3,2.5,2680,7836,2.0,0,0,3,8,2680,0,1990,2009,98092,47.3203,-122.185,2340,8040,5156,5700,44.66564573762123,0.036065573770491806,Very Cheap
20140812T000000,390000.0,4,2.75,1790,47250,1.0,0,0,3,7,1220,570,1987,0,98045,47.5302,-121.746,1250,43791,45460,42541,8.253968253968255,0.04131147540983607,Very Cheap
20140715T000000,390000.0,3,2.75,1950,12240,1.0,0,0,3,7,1250,700,1956,0,98028,47.7401,-122.258,1880,12000,10290,10120,31.862745098039216,0.04131147540983607,Very Cheap
20150413T000000,660000.0,5,2.25,3740,14913,1.5,0,0,4,9,3740,0,1979,0,98074,47.6234,-122.059,2180,7600,11173,5420,44.256688795011065,0.07672131147540984,Very Cheap
20141117T000000,310000.0,3,1.75,1140,8263,1.0,0,0,5,7,1140,0,1950,0,98155,47.7407,-122.327,1140,6770,7123,5630,37.51664044535883,0.03081967213114754,Very Cheap
20140612T000000,717000.0,3,2.5,2480,5137,2.0,0,0,3,9,2480,0,2000,0,98052,47.684,-122.164,2480,6023,2657,3543,139.57562779832588,0.0841967213114754,Very Cheap
20141230T000000,260000.0,5,2.5,2580,11250,1.0,0,0,3,7,1410,1170,1964,0,98198,47.397,-122.313,2240,11780,8670,9540,23.11111111111111,0.024262295081967214,Very Cheap
20150430T000000,745000.0,3,2.0,2290,5001,1.0,0,0,4,7,1490,800,1960,0,98103,47.6909,-122.339,1230,5001,2711,3771,148.97020595880824,0.08786885245901639,Very Cheap
20150218T000000,470000.0,4,2.5,2320,12042,1.0,0,0,4,7,1320,1000,1975,0,98072,47.763,-122.16,2160,7054,9722,4894,39.030061451586114,0.05180327868852459,Very Cheap
20150505T000000,429000.0,3,2.5,2530,8820,2.0,0,0,3,8,2530,0,1997,0,98031,47.42,-122.205,2340,9472,6290,7132,48.63945578231292,0.04642622950819672,Very Cheap
20150408T000000,220000.0,4,2.0,1400,7140,1.0,0,0,3,7,1400,0,1969,0,98155,47.7719,-122.309,1610,10500,5740,8890,30.81232492997199,0.01901639344262295,Very Cheap
20140903T000000,497000.0,3,3.0,2060,1850,2.0,0,0,3,8,1400,660,2007,0,98119,47.6543,-122.373,1910,2951,-210,1041,268.64864864864865,0.055344262295081964,Very Cheap
20140714T000000,716100.0,3,1.0,1640,4000,1.5,0,0,5,7,1640,0,1909,0,98103,47.6563,-122.351,2140,4000,2360,1860,179.025,0.08407868852459016,Very Cheap
20140911T000000,371000.0,4,1.0,1960,94525,1.5,0,0,3,6,1960,0,1979,0,98027,47.5418,-121.962,2430,188564,92565,186134,3.9248875958741074,0.038819672131147544,Very Cheap
20140724T000000,379000.0,5,2.75,3000,25175,1.0,0,0,4,7,1500,1500,1961,0,98027,47.497,-122.088,2170,40523,22175,38353,15.054617676266137,0.03986885245901639,Very Cheap
20150324T000000,937500.0,3,1.0,1320,8500,1.0,0,0,4,7,1320,0,1954,0,98039,47.6187,-122.226,2790,10800,7180,8010,110.29411764705883,0.11311475409836065,Cheap
20141027T000000,720000.0,4,2.0,1760,4500,1.5,0,0,5,7,1760,0,1906,0,98103,47.6711,-122.331,1740,4220,2740,2480,160.0,0.08459016393442623,Very Cheap
20150427T000000,616000.0,3,3.25,2130,2306,2.0,0,1,5,7,1420,710,1924,0,98136,47.5424,-122.391,1560,4500,176,2940,267.1292281006071,0.07095081967213114,Very Cheap
20150414T000000,259000.0,3,2.0,1390,7120,1.0,0,0,3,7,1390,0,1988,0,98030,47.3786,-122.179,1530,7688,5730,6158,36.37640449438202,0.024131147540983607,Very Cheap
20140514T000000,538000.0,3,1.75,1400,3825,1.5,0,0,4,6,1100,300,1904,0,98117,47.6793,-122.393,1720,5100,2425,3380,140.65359477124184,0.06072131147540984,Very Cheap
20150507T000000,605000.0,3,2.75,3230,9576,1.5,0,0,4,8,3230,0,1966,0,98034,47.7307,-122.183,2820,9576,6346,6756,63.17878028404344,0.06950819672131148,Very Cheap
20141103T000000,369950.0,3,1.0,1110,7603,1.0,0,0,3,7,1110,0,1967,0,98034,47.7262,-122.224,1260,8094,6493,6834,48.658424306194924,0.03868196721311475,Very Cheap
20150414T000000,310000.0,3,2.5,1670,4220,2.0,0,0,3,7,1670,0,2002,0,98038,47.3834,-122.028,1670,4238,2550,2568,73.45971563981043,0.03081967213114754,Very Cheap
20150428T000000,227500.0,3,1.0,1540,9450,1.0,0,0,4,7,1540,0,1960,0,98198,47.3612,-122.315,1210,9450,7910,8240,24.074074074074073,0.02,Very Cheap
20141121T000000,274000.0,4,2.25,2090,7400,1.0,0,0,3,9,1670,420,1973,0,98023,47.3178,-122.38,2260,8000,5310,5740,37.027027027027025,0.026098360655737705,Very Cheap
20141120T000000,410000.0,3,2.0,1410,8088,1.0,0,0,3,7,1410,0,1987,0,98034,47.7303,-122.227,1770,7401,6678,5631,50.69238377843719,0.043934426229508196,Very Cheap
20140523T000000,354800.0,3,2.0,1370,78408,1.0,0,0,5,7,1370,0,1964,0,98042,47.3867,-122.081,1620,9690,77038,8070,4.525048464442404,0.03669508196721311,Very Cheap
20140911T000000,650000.0,4,2.25,1910,5120,1.0,0,0,3,8,1300,610,1954,0,98199,47.6534,-122.409,1810,5153,3210,3343,126.953125,0.07540983606557378,Very Cheap
20150505T000000,353000.0,3,2.0,1678,13862,1.0,0,0,3,7,1678,0,1994,0,98030,47.3744,-122.19,1550,11753,12184,10203,25.46530082239215,0.03645901639344262,Very Cheap
20150304T000000,224975.0,3,1.0,960,12745,1.0,0,0,4,6,960,0,1977,0,98038,47.3617,-122.03,1160,10488,11785,9328,17.652020400156925,0.019668852459016395,Very Cheap
20150512T000000,600000.0,2,1.75,2080,13054,1.0,0,1,3,7,2080,0,1951,0,98155,47.7435,-122.292,2440,13054,10974,10614,45.96292324191818,0.06885245901639345,Very Cheap
20150218T000000,437500.0,3,2.25,1790,7700,1.0,0,0,4,7,1340,450,1976,0,98034,47.7205,-122.168,1610,7350,5910,5740,56.81818181818182,0.047540983606557376,Very Cheap
20140521T000000,567000.0,3,2.5,2540,6093,2.0,0,0,3,9,2540,0,1999,0,98034,47.7042,-122.236,2540,5924,3553,3384,93.0576070901034,0.06452459016393443,Very Cheap
20150506T000000,225000.0,5,1.5,1790,11656,2.0,0,0,3,7,1790,0,1963,0,98198,47.3961,-122.308,2040,9790,9866,7750,19.303363074811255,0.019672131147540985,Very Cheap
20140906T000000,255000.0,2,1.0,940,9330,1.0,0,0,3,6,940,0,1941,0,98118,47.5445,-122.273,1900,6145,8390,4245,27.331189710610932,0.02360655737704918,Very Cheap
20150304T000000,2479000.0,5,3.75,6810,7500,2.5,0,0,3,13,6110,700,1922,0,98102,47.6285,-122.322,2660,7500,690,4840,330.53333333333336,0.3152786885245902,Medium
20140613T000000,370000.0,2,1.0,900,4600,1.0,0,0,3,6,900,0,1951,0,98117,47.6918,-122.361,1060,4600,3700,3540,80.43478260869566,0.038688524590163934,Very Cheap
20150421T000000,675000.0,4,1.75,1900,8800,1.0,0,0,3,8,1140,760,1975,0,98033,47.6579,-122.197,2280,8800,6900,6520,76.70454545454545,0.07868852459016394,Very Cheap
20140904T000000,285000.0,3,1.0,1440,4268,1.0,0,0,3,7,1040,400,1953,0,98108,47.5468,-122.293,1370,4268,2828,2898,66.77600749765698,0.02754098360655738,Very Cheap
20140507T000000,310000.0,3,1.75,2070,37904,1.0,0,0,4,7,1420,650,1973,0,98058,47.425,-122.186,2011,19110,35834,17099,8.178556352891516,0.03081967213114754,Very Cheap
20141202T000000,475000.0,4,2.5,2240,7245,1.0,0,0,4,7,1140,1100,1972,0,98034,47.7161,-122.17,1740,7350,5005,5610,65.5624568668047,0.05245901639344262,Very Cheap
20150508T000000,410000.0,4,2.5,3320,5034,2.0,0,0,4,7,3320,0,2006,0,98042,47.4011,-122.164,2580,4950,1714,2370,81.44616607071912,0.043934426229508196,Very Cheap
20140702T000000,895000.0,4,2.25,1950,5950,1.0,0,0,3,8,1330,620,1947,0,98109,47.639,-122.347,2600,5593,4000,2993,150.42016806722688,0.10754098360655738,Cheap
20140822T000000,375000.0,3,1.5,1240,7733,1.0,0,0,3,6,790,450,1941,0,98125,47.714,-122.283,1130,7733,6493,6603,48.493469546101124,0.03934426229508197,Very Cheap
20150427T000000,349000.0,4,2.5,1830,4694,2.0,0,0,3,7,1830,0,2003,0,98038,47.3573,-122.016,1830,5175,2864,3345,74.35023434171282,0.035934426229508196,Very Cheap
20150406T000000,650500.0,3,1.75,1740,4400,1.5,0,0,3,8,1740,0,1903,0,98122,47.6115,-122.292,1740,4400,2660,2660,147.8409090909091,0.07547540983606557,Very Cheap
20150428T000000,760000.0,3,1.75,1410,15120,1.0,0,0,4,7,1410,0,1950,0,98004,47.5974,-122.195,1880,15120,13710,13240,50.264550264550266,0.0898360655737705,Very Cheap
20140520T000000,480000.0,4,2.75,2050,3960,1.0,0,0,4,7,1180,870,1986,0,98116,47.5808,-122.394,1440,5040,1910,3600,121.21212121212122,0.05311475409836065,Very Cheap
20140926T000000,689000.0,4,2.75,3220,16145,2.0,0,0,3,10,3220,0,1993,0,98075,47.5786,-121.995,3200,12921,12925,9721,42.67575100650356,0.08052459016393443,Very Cheap
20140513T000000,415000.0,3,1.75,1960,5000,1.0,0,0,5,6,980,980,1911,0,98108,47.5576,-122.317,1790,5000,3040,3210,83.0,0.04459016393442623,Very Cheap
20150427T000000,195000.0,3,1.75,1070,6110,1.0,0,0,4,7,1070,0,1968,0,98002,47.3249,-122.207,1350,6148,5040,4798,31.914893617021278,0.015737704918032787,Very Cheap
20140731T000000,318000.0,5,2.5,2820,9956,1.0,0,0,4,7,1410,1410,1967,0,98168,47.4715,-122.33,2700,9956,7136,7256,31.94053836882282,0.03186885245901639,Very Cheap
20140523T000000,404000.0,4,3.0,4060,35621,1.0,0,0,3,9,2030,2030,1989,0,98092,47.3059,-122.108,2950,35259,31561,32309,11.341624322730974,0.043147540983606555,Very Cheap
20141030T000000,339950.0,2,1.0,800,3090,1.0,0,0,4,6,800,0,1925,0,98118,47.5518,-122.277,1400,3090,2290,1690,110.01618122977347,0.03474754098360656,Very Cheap
20141124T000000,215000.0,3,1.0,1260,7897,1.0,0,0,3,7,1260,0,1979,0,98022,47.1946,-122.003,1560,8285,6637,6725,27.22552868177789,0.018360655737704918,Very Cheap
20140818T000000,339900.0,3,2.5,2420,7423,2.0,0,0,3,8,2420,0,1990,0,98092,47.3199,-122.186,2260,7629,5003,5369,45.7901118146302,0.03474098360655738,Very Cheap
20140519T000000,285000.0,1,1.5,810,3211,2.0,0,0,4,7,810,0,1982,0,98033,47.6939,-122.184,1320,3298,2401,1978,88.75739644970415,0.02754098360655738,Very Cheap
20140716T000000,550000.0,3,1.0,1600,5000,1.5,0,0,3,7,1110,490,1947,0,98107,47.655,-122.358,1380,5000,3400,3620,110.0,0.06229508196721312,Very Cheap
20140725T000000,430000.0,4,1.0,1350,9000,1.5,0,0,4,7,1350,0,1964,0,98103,47.6953,-122.332,1940,8000,7650,6060,47.77777777777778,0.04655737704918033,Very Cheap
20141202T000000,219000.0,3,1.0,970,7790,1.0,0,0,3,6,970,0,1967,0,98003,47.3165,-122.325,1150,8160,6820,7010,28.112965340179716,0.018885245901639345,Very Cheap
20140815T000000,555000.0,2,1.5,1780,4750,1.0,0,0,4,7,1080,700,1947,0,98117,47.6859,-122.395,1690,5962,2970,4272,116.84210526315789,0.06295081967213115,Very Cheap
20140721T000000,233000.0,3,2.0,1350,7686,1.0,0,0,3,7,1350,0,1989,0,98038,47.3609,-122.053,1470,7686,6336,6216,30.314858183710644,0.020721311475409836,Very Cheap
20150402T000000,248000.0,3,1.75,1840,19501,1.0,0,0,4,8,1270,570,1972,0,98003,47.3364,-122.318,1910,12000,17661,10090,12.717296548894929,0.022688524590163933,Very Cheap
20150422T000000,454000.0,5,2.25,2550,9200,1.0,0,0,4,8,1580,970,1975,0,98166,47.4673,-122.363,2090,9200,6650,7110,49.34782608695652,0.049704918032786885,Very Cheap
20150331T000000,950000.0,4,2.5,1700,4418,2.0,0,0,3,8,1700,0,1931,2000,98112,47.6434,-122.3,2090,4174,2718,2084,215.02942507922137,0.11475409836065574,Cheap
20140915T000000,359000.0,3,2.5,2430,7857,2.0,0,0,5,8,1730,700,1980,0,98055,47.4546,-122.211,2160,8740,5427,6580,45.69173984981545,0.03724590163934426,Very Cheap
20140903T000000,407500.0,5,2.0,2740,8230,1.5,0,0,3,7,2210,530,1962,0,98155,47.7352,-122.297,2130,8232,5490,6102,49.51397326852977,0.04360655737704918,Very Cheap
20140528T000000,224000.0,3,1.5,1560,7300,1.0,0,0,4,7,1040,520,1964,0,98001,47.3427,-122.281,1460,7910,5740,6450,30.684931506849313,0.01954098360655738,Very Cheap
20140718T000000,210000.0,2,1.0,1040,4590,1.0,0,0,3,7,1040,0,1954,0,98146,47.5078,-122.337,1040,6120,3550,5080,45.751633986928105,0.017704918032786884,Very Cheap
20150123T000000,261000.0,4,1.75,1820,9824,1.0,0,0,5,7,1820,0,1968,0,98042,47.3833,-122.093,1410,11013,8004,9603,26.56758957654723,0.02439344262295082,Very Cheap
20140806T000000,719000.0,3,3.0,1833,1706,3.0,0,0,3,9,1833,0,1998,0,98115,47.6827,-122.325,1466,1455,-127,-11,421.45369284876904,0.08445901639344262,Very Cheap
20150203T000000,440000.0,3,2.5,2160,3738,2.0,0,0,3,8,2160,0,1994,0,98126,47.5661,-122.375,1500,4000,1578,2500,117.7100053504548,0.04786885245901639,Very Cheap
20140521T000000,525000.0,3,2.75,2100,10362,2.0,0,0,3,9,1510,590,1998,0,98045,47.4347,-121.417,2240,11842,8262,9602,50.6658946149392,0.05901639344262295,Very Cheap
20140721T000000,375000.0,3,1.5,1370,9720,2.0,0,0,3,7,1370,0,1968,0,98034,47.7302,-122.197,1510,8775,8350,7265,38.58024691358025,0.03934426229508197,Very Cheap
20150331T000000,428000.0,2,2.5,1414,1960,2.0,0,0,3,8,1414,0,1986,0,98006,47.5423,-122.189,1414,2511,546,1097,218.3673469387755,0.04629508196721312,Very Cheap
20141118T000000,988830.0,5,3.25,4115,7910,2.0,0,0,3,9,4115,0,2014,0,98053,47.6847,-122.016,3950,6765,3795,2815,125.01011378002528,0.11984655737704918,Cheap
20141004T000000,199950.0,3,1.75,1550,6225,1.0,0,0,4,7,1550,0,1949,0,98002,47.3098,-122.218,1760,9496,4675,7736,32.12048192771084,0.01638688524590164,Very Cheap
20141028T000000,840000.0,4,2.25,2100,3671,1.5,0,0,3,8,1750,350,1929,0,98112,47.6359,-122.3,1800,4560,1571,2760,228.8204848815037,0.10032786885245902,Cheap
20140908T000000,285000.0,3,1.75,1160,7006,1.0,0,0,4,7,1160,0,1992,0,98022,47.1937,-121.98,1670,7750,5846,6080,40.67941764202112,0.02754098360655738,Very Cheap
20140915T000000,330000.0,5,2.5,3597,4972,2.0,0,0,3,7,3597,0,2006,0,98001,47.3002,-122.282,3193,6000,1375,2807,66.3716814159292,0.03344262295081967,Very Cheap
20150102T000000,147500.0,3,1.5,1230,10125,1.0,0,0,3,7,1230,0,1960,0,98198,47.397,-122.299,1970,10125,8895,8155,14.567901234567902,0.009508196721311476,Very Cheap
20141107T000000,320000.0,4,2.5,2190,7125,2.0,0,0,5,8,2190,0,1978,0,98032,47.3709,-122.285,2190,8075,4935,5885,44.91228070175438,0.032131147540983604,Very Cheap
20140701T000000,382500.0,3,1.75,1040,9000,1.0,0,0,4,7,1040,0,1967,0,98027,47.5253,-122.043,1750,10878,7960,9128,42.5,0.040327868852459016,Very Cheap
20150324T000000,2048000.0,5,4.0,4690,8208,2.0,0,0,3,9,3040,1650,1926,0,98112,47.6321,-122.304,3300,8001,3518,4701,249.51267056530213,0.2587540983606557,Cheap
20140814T000000,596000.0,4,2.25,2270,10000,1.0,0,0,5,8,1720,550,1974,0,98006,47.5599,-122.142,2270,10148,7730,7878,59.6,0.06832786885245902,Very Cheap
20141111T000000,220000.0,4,2.25,1950,7280,2.0,0,0,4,8,1950,0,1979,0,98023,47.2957,-122.37,1910,7280,5330,5370,30.21978021978022,0.01901639344262295,Very Cheap
20140925T000000,325000.0,3,2.5,1880,6818,2.0,0,0,3,8,1880,0,1993,0,98031,47.4206,-122.183,1970,7000,4938,5030,47.667937811674975,0.03278688524590164,Very Cheap
20150326T000000,679950.0,4,2.5,2850,5664,2.0,0,0,3,9,2850,0,2001,0,98075,47.5835,-121.996,2850,5475,2814,2625,120.04766949152543,0.07933770491803278,Very Cheap
20150218T000000,175000.0,2,1.0,1160,6911,1.0,0,0,3,7,1160,0,1947,0,98125,47.7149,-122.318,1120,6948,5751,5828,25.321950513673855,0.013114754098360656,Very Cheap
20141201T000000,268000.0,3,1.75,1370,10050,1.0,0,1,4,7,1370,0,1966,0,98023,47.3338,-122.341,1720,10050,8680,8330,26.666666666666668,0.025311475409836064,Very Cheap
20140919T000000,715000.0,4,3.5,3260,110579,2.0,0,0,3,10,3260,0,1997,0,98053,47.6436,-121.997,3470,97895,107319,94425,6.465965508821747,0.0839344262295082,Very Cheap
20150408T000000,600000.0,7,2.25,3170,36384,2.0,0,0,3,8,3170,0,1969,0,98027,47.4654,-122.003,2460,38370,33214,35910,16.49076517150396,0.06885245901639345,Very Cheap
20141002T000000,228000.0,0,1.0,390,5900,1.0,0,0,2,4,390,0,1953,0,98118,47.526,-122.261,2170,6000,5510,3830,38.644067796610166,0.020065573770491802,Very Cheap
20150304T000000,950000.0,5,2.5,3450,35880,2.0,0,0,3,11,3450,0,1992,0,98052,47.7173,-122.099,3450,26820,32430,23370,26.477146042363433,0.11475409836065574,Cheap
20140610T000000,475000.0,2,1.75,1490,224334,1.0,0,2,3,8,1490,0,1983,0,98092,47.2645,-122.163,2350,213879,222844,211529,2.117378551623918,0.05245901639344262,Very Cheap
20150402T000000,700000.0,3,1.5,1460,78408,1.0,0,0,4,7,1460,0,1963,0,98075,47.59,-122.058,3320,7787,76948,4467,8.927660442811957,0.08196721311475409,Very Cheap
20140827T000000,275000.0,3,1.75,1300,20700,1.0,0,0,3,7,1300,0,1962,0,98024,47.5587,-121.904,1930,37638,19400,35708,13.285024154589372,0.02622950819672131,Very Cheap
20150318T000000,369500.0,3,1.75,1300,20700,1.0,0,0,3,7,1300,0,1962,0,98024,47.5587,-121.904,1930,37638,19400,35708,17.85024154589372,0.03862295081967213,Very Cheap
20140721T000000,215000.0,4,2.0,1540,7575,1.0,0,0,4,7,1040,500,1978,0,98032,47.3664,-122.279,1720,7575,6035,5855,28.382838283828384,0.018360655737704918,Very Cheap
20150422T000000,593450.0,4,2.25,2130,7172,2.0,0,0,4,8,2130,0,1964,0,98008,47.6271,-122.112,1910,7653,5042,5743,82.74539877300613,0.06799344262295082,Very Cheap
20140709T000000,498800.0,2,1.75,1350,4614,1.0,0,0,3,8,1350,0,2008,0,98053,47.7091,-122.015,1680,4775,3264,3095,108.10576506285219,0.05558032786885246,Very Cheap
20141208T000000,849000.0,5,3.25,2450,6534,2.0,0,0,3,8,1770,680,1951,2014,98115,47.688,-122.281,1620,6534,4084,4914,129.93572084481175,0.10150819672131148,Cheap
20141229T000000,1151250.0,4,2.5,1940,4875,2.0,0,0,4,9,1940,0,1925,0,98112,47.6427,-122.304,1790,4875,2935,3085,236.15384615384616,0.14114754098360655,Cheap
20140715T000000,825000.0,5,2.5,2890,5110,2.0,0,2,3,9,2890,0,2003,0,98029,47.5453,-121.995,3010,5110,2220,2100,161.44814090019568,0.09836065573770492,Very Cheap
20150224T000000,265000.0,3,1.75,1680,9769,1.0,0,0,3,8,1340,340,1989,0,98058,47.4631,-122.126,1730,9686,8089,7956,27.126625038386734,0.024918032786885248,Very Cheap
20141223T000000,285000.0,4,2.25,1960,10400,1.0,0,0,4,8,1220,740,1985,0,98023,47.3199,-122.392,1650,8660,8440,7010,27.403846153846153,0.02754098360655738,Very Cheap
20141231T000000,240000.0,3,1.75,1590,7931,1.0,0,0,3,7,1190,400,1979,0,98038,47.3628,-122.05,1680,7931,6341,6251,30.26100113478754,0.021639344262295083,Very Cheap
20140721T000000,261000.0,4,1.0,1390,17739,1.0,0,0,3,7,1390,0,1958,0,98003,47.3457,-122.302,1230,7840,16349,6610,14.713343480466769,0.02439344262295082,Very Cheap
20140627T000000,330000.0,4,1.75,2440,7350,1.0,0,0,3,8,1610,830,1978,0,98032,47.3743,-122.285,2180,7680,4910,5500,44.89795918367347,0.03344262295081967,Very Cheap
20140602T000000,250000.0,4,2.0,1850,7560,1.0,0,0,4,7,1540,310,1978,0,98032,47.3666,-122.277,1620,7658,5710,6038,33.06878306878307,0.022950819672131147,Very Cheap
20140710T000000,350000.0,4,2.5,2800,9538,2.0,0,0,3,8,2800,0,1993,0,98003,47.2675,-122.307,1970,7750,6738,5780,36.695323967288736,0.036065573770491806,Very Cheap
20140925T000000,930000.0,3,2.5,3780,35273,1.5,0,0,3,10,3780,0,1986,0,98072,47.7499,-122.119,3450,35273,31493,31823,26.36577552235421,0.1121311475409836,Cheap
20141030T000000,275000.0,3,2.0,1910,8050,1.0,0,0,4,7,1000,910,1980,0,98030,47.37,-122.17,1780,7344,6140,5564,34.161490683229815,0.02622950819672131,Very Cheap
20150223T000000,325000.0,4,2.25,2460,7620,1.0,0,0,3,7,1230,1230,1969,0,98106,47.5285,-122.345,2090,7620,5160,5530,42.650918635170605,0.03278688524590164,Very Cheap
20150424T000000,255000.0,1,1.0,810,5000,1.0,0,1,3,7,590,220,1936,0,98106,47.5696,-122.36,1920,5000,4190,3080,51.0,0.02360655737704918,Very Cheap
20150320T000000,562200.0,3,1.5,1900,5250,1.0,0,0,4,7,1500,400,1943,0,98117,47.6991,-122.392,1810,5250,3350,3440,107.08571428571429,0.06389508196721312,Very Cheap
20140820T000000,952000.0,2,1.75,3490,88909,1.0,0,3,3,10,2320,1170,1980,0,98006,47.5462,-122.112,3490,40185,85419,36695,10.707577410610849,0.11501639344262295,Cheap
20140504T000000,365000.0,3,2.5,2200,7350,1.0,0,0,5,8,1570,630,1988,0,98058,47.4395,-122.161,2350,7557,5150,5207,49.65986394557823,0.0380327868852459,Very Cheap
20150316T000000,332900.0,3,1.5,1190,11996,1.0,0,0,4,7,1190,0,1969,0,98077,47.7561,-122.071,1190,9756,10806,8566,27.75091697232411,0.03382295081967213,Very Cheap
20150423T000000,721000.0,3,2.25,2040,18360,2.0,0,0,4,8,2040,0,1983,0,98052,47.6976,-122.137,2590,21315,16320,18725,39.270152505446625,0.08472131147540983,Very Cheap
20150421T000000,487275.0,4,2.5,2400,3986,2.0,0,0,3,8,2400,0,1999,0,98065,47.5344,-121.877,2070,3986,1586,1916,122.24661314601104,0.054068852459016395,Very Cheap
20150429T000000,310000.0,3,2.5,1670,5791,2.0,0,0,3,7,1670,0,1995,0,98055,47.4424,-122.188,1610,6034,4121,4424,53.53134173717838,0.03081967213114754,Very Cheap
20150115T000000,245000.0,2,1.0,990,4800,1.0,0,0,3,6,990,0,1908,0,98118,47.5615,-122.28,1700,5400,3810,3700,51.041666666666664,0.022295081967213116,Very Cheap
20150415T000000,325000.0,3,1.75,2920,10573,1.0,0,0,4,7,2920,0,1964,0,98055,47.4429,-122.195,1560,10572,7653,9012,30.73867398089473,0.03278688524590164,Very Cheap
20141112T000000,550000.0,3,1.75,1840,9401,1.0,0,0,3,8,1840,0,1971,0,98075,47.5847,-122.075,2850,14323,7561,11473,58.504414423997446,0.06229508196721312,Very Cheap
20140512T000000,350000.0,2,1.0,910,4500,1.5,0,0,4,7,910,0,1906,0,98118,47.5633,-122.289,1270,3500,3590,2230,77.77777777777777,0.036065573770491806,Very Cheap
20140714T000000,599000.0,5,2.5,2950,72309,2.0,0,0,3,8,2950,0,2006,0,98058,47.4186,-122.079,1480,56192,69359,54712,8.283892738110055,0.06872131147540983,Very Cheap
20141112T000000,259950.0,3,1.5,1240,9500,1.0,0,0,4,7,1240,0,1955,0,98166,47.4756,-122.35,1845,10125,8260,8280,27.36315789473684,0.024255737704918033,Very Cheap
20141201T000000,240000.0,4,2.5,1980,7264,2.0,0,0,3,7,1980,0,1996,0,98038,47.3678,-122.019,1600,6380,5284,4780,33.03964757709251,0.021639344262295083,Very Cheap
20150211T000000,186000.0,3,1.0,1200,10080,1.0,0,0,4,7,1200,0,1969,0,98042,47.3261,-122.135,1230,9800,8880,8570,18.452380952380953,0.014557377049180328,Very Cheap
20150204T000000,395000.0,3,1.5,1280,15028,1.0,0,0,3,7,1280,0,1982,0,98074,47.6304,-122.035,1470,13698,13748,12228,26.28426936385414,0.0419672131147541,Very Cheap
20140915T000000,475000.0,4,2.5,3150,5757,2.0,0,0,3,9,3150,0,2004,0,98058,47.4568,-122.117,3100,5757,2607,2657,82.50825082508251,0.05245901639344262,Very Cheap
20140804T000000,815000.0,5,3.5,3500,10794,2.0,0,0,3,10,3500,0,1996,0,98075,47.5887,-121.974,3110,10837,7294,7727,75.50491013526033,0.09704918032786886,Very Cheap
20140902T000000,572000.0,3,1.5,1680,13751,1.0,0,0,4,7,1680,0,1951,0,98040,47.5716,-122.227,1760,13500,12071,11740,41.5969747654716,0.06518032786885246,Very Cheap
20141017T000000,419500.0,3,2.5,1360,3188,2.0,0,0,3,7,1360,0,1986,0,98052,47.6831,-122.096,1090,3188,1828,2098,131.58720200752822,0.04518032786885246,Very Cheap
20140903T000000,298700.0,3,2.25,2110,7350,1.0,0,0,3,8,1530,580,1980,0,98023,47.3088,-122.341,2640,7777,5240,5137,40.63945578231292,0.029337704918032788,Very Cheap
20140624T000000,549000.0,2,1.0,2034,13392,1.0,1,4,5,7,1159,875,1947,0,98070,47.3312,-122.503,1156,15961,11358,14805,40.994623655913976,0.06216393442622951,Very Cheap
20150422T000000,278000.0,3,1.5,1900,9994,1.0,0,0,3,7,1120,780,1960,0,98168,47.4729,-122.301,1900,9994,8094,8094,27.816690014008405,0.02662295081967213,Very Cheap
20141230T000000,455000.0,4,2.0,2380,4500,1.5,0,0,3,6,1470,910,1926,2014,98118,47.5652,-122.281,1300,4500,2120,3200,101.11111111111111,0.049836065573770495,Very Cheap
20140819T000000,925000.0,5,3.5,4050,13495,1.0,0,2,4,9,2230,1820,1988,0,98166,47.4384,-122.352,3210,13495,9445,10285,68.54390515005558,0.11147540983606558,Cheap
20150415T000000,465000.0,2,1.5,1120,1201,3.0,0,0,3,8,1120,0,1999,0,98103,47.6524,-122.353,1370,1298,81,-72,387.17735220649456,0.051147540983606556,Very Cheap
20141001T000000,620000.0,4,4.0,2850,2970,2.0,0,0,3,8,2120,730,1999,0,98029,47.547,-122.01,2380,3559,120,1179,208.75420875420875,0.07147540983606557,Very Cheap
20150422T000000,499900.0,4,2.25,2360,7650,1.0,0,0,3,8,1640,720,1963,0,98155,47.75,-122.292,2320,11060,5290,8740,65.34640522875817,0.055724590163934426,Very Cheap
20150206T000000,620000.0,5,3.0,2540,11422,1.0,0,0,3,8,1270,1270,1962,2014,98006,47.5459,-122.176,2090,10741,8882,8651,54.28121169672562,0.07147540983606557,Very Cheap
20141108T000000,450000.0,3,1.75,1160,6120,1.0,0,0,3,7,1040,120,1941,0,98115,47.6926,-122.287,1530,6120,4960,4590,73.52941176470588,0.04918032786885246,Very Cheap
20150220T000000,690000.0,4,3.5,2710,2147,2.0,0,0,3,10,2220,490,2007,0,98029,47.5468,-121.994,2650,2252,-563,-398,321.3786679087098,0.08065573770491803,Very Cheap
20140513T000000,1895000.0,5,2.25,3120,16672,2.0,0,0,4,9,3120,0,1969,0,98004,47.6458,-122.219,3740,17853,13552,14113,113.66362763915546,0.23868852459016393,Cheap
20150313T000000,1940000.0,5,2.25,3120,16672,2.0,0,0,4,9,3120,0,1969,0,98004,47.6458,-122.219,3740,17853,13552,14113,116.36276391554702,0.24459016393442623,Cheap
20140818T000000,832500.0,3,2.0,1870,9527,1.0,0,0,4,7,1870,0,1951,1997,98040,47.5777,-122.224,1970,11904,7657,9934,87.3832266190826,0.09934426229508196,Very Cheap
20141107T000000,245000.0,3,1.0,1010,9678,1.0,0,0,5,7,1010,0,1955,0,98188,47.4396,-122.285,1010,9375,8668,8365,25.3151477578012,0.022295081967213116,Very Cheap
20141017T000000,820000.0,3,2.5,2980,18935,1.5,0,0,3,11,2980,0,1990,0,98077,47.7133,-122.079,3670,18225,15955,14555,43.30604700290468,0.09770491803278689,Very Cheap
20140807T000000,369000.0,4,2.75,2420,6495,2.0,0,0,3,8,2420,0,2005,0,98038,47.3771,-122.029,2420,6200,4075,3780,56.812933025404156,0.03855737704918033,Very Cheap
20141015T000000,1050000.0,4,3.25,3830,8331,2.0,0,0,3,9,3830,0,2014,0,98053,47.6906,-122.019,4080,8425,4501,4345,126.03528988116673,0.12786885245901639,Cheap
20140917T000000,653000.0,3,3.0,3040,5067,3.0,0,2,3,10,3040,0,1993,0,98118,47.5409,-122.267,1820,5998,2027,4178,128.87310045391752,0.07580327868852459,Very Cheap
20150422T000000,220650.0,2,1.75,1460,10500,1.0,0,0,3,7,1460,0,1980,0,98045,47.4461,-121.768,1340,9600,9040,8260,21.014285714285716,0.019101639344262296,Very Cheap
20140616T000000,300000.0,5,3.0,1940,6355,1.0,0,0,3,8,1200,740,2007,0,98168,47.498,-122.322,1940,5033,4415,3093,47.206923682140044,0.029508196721311476,Very Cheap
20140912T000000,970000.0,4,3.5,3780,20023,2.0,0,2,3,10,3780,0,2001,0,98029,47.5491,-122.006,2150,3675,16243,1525,48.44428906757229,0.11737704918032787,Cheap
20141124T000000,360000.0,4,2.5,1950,5451,2.0,0,0,3,7,1950,0,2004,0,98058,47.4341,-122.144,2240,6221,3501,3981,66.04292790313704,0.037377049180327866,Very Cheap
20150330T000000,672500.0,3,2.5,2450,5760,2.0,0,0,3,9,2450,0,2000,0,98074,47.6145,-122.026,2450,5762,3310,3312,116.75347222222223,0.07836065573770491,Very Cheap
20150423T000000,268000.0,4,1.5,1730,7020,1.5,0,0,4,5,1730,0,1953,0,98056,47.4939,-122.167,1110,7020,5290,5910,38.17663817663818,0.025311475409836064,Very Cheap
20141202T000000,440000.0,4,1.5,1690,3245,1.5,0,0,3,8,1690,0,1929,0,98126,47.5445,-122.375,1380,1590,1555,210,135.59322033898306,0.04786885245901639,Very Cheap
20140514T000000,1400000.0,3,2.5,2550,7200,2.0,0,2,3,10,2550,0,1981,2013,98144,47.5996,-122.288,2030,3500,4650,1470,194.44444444444446,0.1737704918032787,Cheap
20140718T000000,590000.0,4,2.5,2290,11072,2.0,0,0,3,9,2290,0,1986,0,98074,47.6283,-122.03,2340,9774,8782,7434,53.28757225433526,0.06754098360655737,Very Cheap
20150127T000000,359000.0,4,2.25,2710,22860,1.0,0,0,4,7,1850,860,1962,0,98001,47.3207,-122.266,1700,22860,20150,21160,15.704286964129484,0.03724590163934426,Very Cheap
20140529T000000,266500.0,4,1.75,1880,7632,1.0,0,0,4,7,1180,700,1978,0,98023,47.3068,-122.372,1840,8528,5752,6688,34.918763102725364,0.025114754098360656,Very Cheap
20141216T000000,635000.0,4,2.5,2930,8679,2.0,0,0,3,8,2930,0,2014,0,98056,47.5164,-122.19,2030,7264,5749,5234,73.16511118792488,0.07344262295081967,Very Cheap
20141013T000000,559000.0,3,2.5,3110,217800,2.0,0,0,3,9,3110,0,2001,0,98092,47.3281,-122.124,2220,217800,214690,215580,2.566574839302112,0.06347540983606557,Very Cheap
20141218T000000,895000.0,4,2.5,3480,38985,2.0,0,0,3,10,3480,0,1989,0,98053,47.6895,-122.052,3630,36290,35505,32660,22.957547774785173,0.10754098360655738,Cheap
20150127T000000,625000.0,2,1.5,1110,118047,1.0,0,0,3,7,1110,0,1961,0,98072,47.7467,-122.128,2970,43500,116937,40530,5.294501342685541,0.07213114754098361,Very Cheap
20150312T000000,650000.0,4,2.25,2440,9320,1.0,0,0,4,7,1880,560,1957,0,98007,47.5933,-122.135,1530,9335,6880,7805,69.74248927038627,0.07540983606557378,Very Cheap
20150224T000000,312500.0,4,1.75,2280,7840,1.0,0,0,3,7,1280,1000,1957,0,98055,47.4809,-122.224,2120,7260,5560,5140,39.859693877551024,0.03114754098360656,Very Cheap
20140925T000000,225000.0,3,1.0,900,6099,1.0,0,0,3,6,790,110,1944,0,98168,47.4807,-122.289,1240,6099,5199,4859,36.89129365469749,0.019672131147540985,Very Cheap
20141119T000000,425000.0,4,1.75,1980,8400,1.0,0,0,3,7,1330,650,1968,0,98052,47.6721,-122.152,1920,8400,6420,6480,50.595238095238095,0.04590163934426229,Very Cheap
20150219T000000,329999.0,3,2.75,3360,41250,1.0,0,0,4,7,1820,1540,1988,0,98022,47.2604,-122.023,2580,98881,37890,96301,7.999975757575758,0.03344249180327869,Very Cheap
20140716T000000,572000.0,5,2.25,2340,9225,2.0,0,0,3,8,2340,0,1973,0,98052,47.6369,-122.098,2140,9348,6885,7208,62.00542005420054,0.06518032786885246,Very Cheap
20150407T000000,386500.0,4,2.5,3110,5048,2.0,0,0,3,8,3110,0,2002,0,98042,47.3782,-122.125,3110,5190,1938,2080,76.56497622820919,0.04085245901639344,Very Cheap
20150121T000000,452000.0,2,1.0,980,5000,1.0,0,0,3,6,980,0,1904,0,98107,47.6744,-122.369,1270,4500,4020,3230,90.4,0.04944262295081967,Very Cheap
20141212T000000,278000.0,4,2.0,1480,6324,1.0,0,0,3,7,1480,0,1943,0,98122,47.6147,-122.302,1480,3600,4844,2120,43.959519291587604,0.02662295081967213,Very Cheap
20140603T000000,474900.0,3,2.25,1800,43647,1.0,0,0,4,8,1800,0,1976,0,98072,47.7757,-122.132,2480,25608,41847,23128,10.880472884734345,0.05244590163934426,Very Cheap
20150414T000000,450000.0,2,1.75,2130,6574,1.0,0,0,3,8,1500,630,1946,0,98199,47.6529,-122.411,2130,6275,4444,4145,68.4514755095832,0.04918032786885246,Very Cheap
20141104T000000,611000.0,2,1.0,1270,5100,1.0,0,0,3,7,1100,170,1900,0,98115,47.6771,-122.328,1670,3900,3830,2230,119.80392156862744,0.07029508196721311,Very Cheap
20140605T000000,214100.0,2,2.5,1150,2064,2.0,0,0,3,7,1150,0,2004,0,98001,47.3516,-122.292,1880,2855,914,975,103.73062015503876,0.018242622950819673,Very Cheap
20140514T000000,317000.0,3,2.5,1840,5011,2.0,0,0,3,8,1840,0,2012,0,98038,47.3555,-122.054,2000,4793,3171,2793,63.26082618239872,0.03173770491803279,Very Cheap
20150305T000000,1000000.0,4,3.5,3180,12528,2.0,0,1,4,9,2060,1120,1979,0,98177,47.7058,-122.379,2850,11410,9348,8560,79.82120051085569,0.12131147540983607,Cheap
20150424T000000,1000000.0,5,2.75,1510,5700,2.0,0,1,4,7,1510,0,1946,0,98105,47.6653,-122.27,2190,5700,4190,3510,175.43859649122808,0.12131147540983607,Cheap
20150505T000000,525000.0,4,2.5,3070,7200,2.0,0,0,3,8,3070,0,2005,0,98059,47.4899,-122.138,2590,7200,4130,4610,72.91666666666667,0.05901639344262295,Very Cheap
20141001T000000,436000.0,3,2.25,1800,6680,2.0,0,0,3,8,1800,0,1983,0,98034,47.7293,-122.223,1630,8621,4880,6991,65.26946107784431,0.047344262295081964,Very Cheap
20140718T000000,450000.0,3,1.75,1540,9154,1.0,0,0,3,8,1540,0,1983,0,98074,47.6207,-122.042,1990,10273,7614,8283,49.15883766659384,0.04918032786885246,Very Cheap
20140502T000000,588500.0,3,1.75,2330,14892,1.0,0,0,3,8,1970,360,1980,0,98074,47.6267,-122.046,2570,14217,12562,11647,39.51786193929627,0.06734426229508196,Very Cheap
20150511T000000,340000.0,4,1.75,1400,8374,1.0,0,0,3,7,1400,0,1953,0,98166,47.4735,-122.344,1420,8360,6974,6940,40.60186290900406,0.03475409836065574,Very Cheap
20140714T000000,482000.0,4,2.5,2846,85377,1.5,0,0,3,8,1976,870,2000,0,98001,47.317,-122.281,1696,57934,82531,56238,5.645548566944259,0.05337704918032787,Very Cheap
20141213T000000,1575000.0,4,3.5,5830,131116,2.0,0,0,3,11,5830,0,2005,0,98024,47.5986,-121.949,5340,207206,125286,201866,12.01226394947985,0.19672131147540983,Cheap
20140811T000000,749000.0,3,2.5,3380,7126,2.0,0,0,3,8,3380,0,1965,2003,98008,47.6276,-122.122,1810,7308,3746,5498,105.10805500982319,0.08839344262295082,Very Cheap
20150511T000000,330000.0,3,1.5,1440,7875,1.0,0,0,4,8,1440,0,1968,0,98058,47.4561,-122.148,1800,8964,6435,7164,41.904761904761905,0.03344262295081967,Very Cheap
20140821T000000,568000.0,3,2.5,1740,1279,3.0,0,0,3,8,1740,0,2008,0,98116,47.5891,-122.387,1740,1280,-461,-460,444.0969507427678,0.06465573770491803,Very Cheap
20140924T000000,239000.0,3,1.75,1470,8925,1.0,0,0,4,7,1470,0,1957,0,98022,47.2026,-122.0,1430,9282,7455,7852,26.77871148459384,0.021508196721311476,Very Cheap
20150107T000000,528000.0,3,2.5,2810,4932,2.0,0,0,3,8,2810,0,2003,0,98011,47.7739,-122.227,2470,4919,2122,2449,107.0559610705596,0.05940983606557377,Very Cheap
20140730T000000,385000.0,4,3.0,2090,5102,1.0,0,0,3,7,1350,740,1994,0,98106,47.5427,-122.356,2090,5102,3012,3012,75.46060368482948,0.04065573770491803,Very Cheap
20140902T000000,825000.0,4,3.25,4110,14219,2.0,0,2,4,10,2570,1540,1979,0,98028,47.7382,-122.264,2760,12283,10109,9523,58.02095787326816,0.09836065573770492,Very Cheap
20141126T000000,815000.0,5,3.25,3230,5000,2.0,0,1,3,9,2350,880,2002,0,98136,47.5202,-122.393,1520,5000,1770,3480,163.0,0.09704918032786886,Very Cheap
20141013T000000,625000.0,4,2.5,2601,34335,2.0,0,0,3,9,2601,0,1995,0,98072,47.742,-122.087,2080,32336,31734,30256,18.202999854376,0.07213114754098361,Very Cheap
20141007T000000,690000.0,3,1.75,2070,6000,1.0,0,3,3,8,1340,730,1955,0,98136,47.5226,-122.382,2200,6000,3930,3800,115.0,0.08065573770491803,Very Cheap
20150325T000000,210000.0,3,1.0,1660,7440,1.0,0,0,3,7,1270,390,1957,0,98106,47.5242,-122.362,1540,7440,5780,5900,28.225806451612904,0.017704918032786884,Very Cheap
20150416T000000,599000.0,4,1.0,1590,4280,1.5,0,0,3,7,1590,0,1924,0,98103,47.667,-122.335,2230,4280,2690,2050,139.9532710280374,0.06872131147540983,Very Cheap
20150212T000000,860000.0,3,1.75,1860,5584,1.0,0,0,3,8,1310,550,1951,0,98199,47.637,-122.4,1630,6022,3724,4392,154.01146131805157,0.10295081967213114,Cheap
20150212T000000,147200.0,3,1.0,1420,9600,1.0,0,0,4,6,1420,0,1954,0,98188,47.4232,-122.292,1400,8415,8180,7015,15.333333333333334,0.009468852459016394,Very Cheap
20150506T000000,476900.0,3,1.0,1240,5758,1.5,0,0,4,6,960,280,1910,0,98116,47.5675,-122.396,1460,5750,4518,4290,82.8238971865231,0.052708196721311475,Very Cheap
20140807T000000,450000.0,4,2.5,2500,36254,1.0,0,0,4,8,1590,910,1978,0,98027,47.4685,-122.004,2360,36254,33754,33894,12.412423456722017,0.04918032786885246,Very Cheap
20150506T000000,570000.0,4,2.5,2640,11816,2.0,0,0,3,8,2640,0,1999,0,98019,47.733,-121.968,2400,11816,9176,9416,48.2396750169262,0.06491803278688525,Very Cheap
20141016T000000,567500.0,3,1.0,1440,3060,1.5,0,0,4,7,1440,0,1910,0,98115,47.6769,-122.307,1440,3570,1620,2130,185.45751633986927,0.06459016393442622,Very Cheap
20141023T000000,790000.0,5,3.25,3030,20446,2.0,0,2,3,9,2130,900,1976,0,98008,47.6133,-122.106,2890,20908,17416,18018,38.638364472268414,0.09377049180327869,Very Cheap
20140707T000000,875000.0,3,1.5,1820,12686,1.0,0,0,4,7,1820,0,1952,0,98004,47.5886,-122.195,3020,11550,10866,8530,68.97367176414946,0.10491803278688525,Cheap
20140610T000000,490000.0,3,2.0,2220,10275,2.0,0,0,3,9,1640,580,1980,0,98027,47.5304,-122.055,2300,9975,8055,7675,47.688564476885645,0.05442622950819672,Very Cheap
20140610T000000,335000.0,3,1.75,2430,9133,1.0,0,0,4,7,1410,1020,1978,0,98059,47.5116,-122.157,1980,9592,6703,7612,36.680170809153616,0.03409836065573771,Very Cheap
20150415T000000,550000.0,3,1.75,1670,10798,1.0,0,0,4,8,1670,0,1962,0,98006,47.549,-122.17,2290,10798,9128,8508,50.93535839970365,0.06229508196721312,Very Cheap
20140516T000000,385000.0,3,1.75,1180,10541,1.0,0,0,4,7,940,240,1981,0,98074,47.6348,-122.032,1230,10879,9361,9649,36.52404895171236,0.04065573770491803,Very Cheap
20140718T000000,395000.0,3,1.75,1620,8085,1.0,0,0,3,7,1210,410,1976,0,98011,47.7349,-122.197,1700,8085,6465,6385,48.85590599876314,0.0419672131147541,Very Cheap
20140611T000000,650000.0,2,1.0,1030,5750,1.0,0,0,5,8,1030,0,1928,0,98116,47.5861,-122.391,1570,5750,4720,4180,113.04347826086956,0.07540983606557378,Very Cheap
20150304T000000,637000.0,4,2.75,2900,5803,2.0,0,0,3,9,2900,0,2007,0,98028,47.7368,-122.232,2900,6212,2903,3312,109.7708082026538,0.07370491803278688,Very Cheap
20141014T000000,692500.0,3,2.25,3420,9900,1.0,0,0,3,9,1710,1710,1963,2004,98028,47.7412,-122.256,2290,10700,6480,8410,69.94949494949495,0.08098360655737705,Very Cheap
20140930T000000,322400.0,3,1.75,1710,15844,1.0,0,0,4,8,1710,0,1964,0,98059,47.4706,-122.1,1990,20359,14134,18369,20.348396869477405,0.032445901639344264,Very Cheap
20140905T000000,233500.0,3,1.5,1580,10517,1.0,0,0,4,6,1580,0,1957,0,98002,47.2903,-122.214,1400,10658,8937,9258,22.202148901778074,0.02078688524590164,Very Cheap
20140624T000000,400000.0,3,2.0,1230,11413,1.0,0,0,3,7,990,240,1984,0,98074,47.6321,-122.034,1570,11517,10183,9947,35.047752562866904,0.04262295081967213,Very Cheap
20140620T000000,547000.0,5,2.5,2200,4080,1.5,0,0,5,7,1420,780,1916,0,98103,47.6872,-122.35,1300,4080,1880,2780,134.0686274509804,0.061901639344262294,Very Cheap
20140702T000000,519000.0,5,2.25,2570,13054,1.0,0,1,3,8,1470,1100,1950,1992,98166,47.4487,-122.352,2570,19807,10484,17237,39.757928604259234,0.05822950819672131,Very Cheap
20140626T000000,1025000.0,4,3.5,3320,19850,1.0,0,2,4,10,2040,1280,1977,0,98040,47.527,-122.228,3240,15470,16530,12230,51.63727959697733,0.12459016393442623,Cheap
20140502T000000,365000.0,3,1.0,1090,6435,1.0,0,0,4,7,1090,0,1955,0,98106,47.5334,-122.365,1340,6435,5345,5095,56.72105672105672,0.0380327868852459,Very Cheap
20150319T000000,699000.0,5,2.75,2970,36817,2.0,0,0,4,8,2970,0,1978,0,98072,47.7731,-122.139,2730,29150,33847,26420,18.985794605752776,0.08183606557377049,Very Cheap
20141009T000000,525000.0,3,1.75,1970,8000,1.0,0,0,4,8,1970,0,1968,0,98052,47.6324,-122.1,1910,8000,6030,6090,65.625,0.05901639344262295,Very Cheap
20140522T000000,430000.0,4,3.0,3220,8936,2.0,0,0,3,9,2450,770,1990,0,98031,47.4208,-122.213,2810,10500,5716,7690,48.11996418979409,0.04655737704918033,Very Cheap
20141215T000000,325000.0,3,1.0,1600,7500,1.0,0,0,3,7,1600,0,1966,0,98034,47.7198,-122.182,2050,7200,5900,5150,43.333333333333336,0.03278688524590164,Very Cheap
20140710T000000,279000.0,2,1.0,670,6300,1.0,0,0,5,6,670,0,1942,0,98126,47.5161,-122.374,760,6300,5630,5540,44.285714285714285,0.02675409836065574,Very Cheap
20150311T000000,805000.0,4,1.75,2360,4750,2.0,0,0,5,7,1660,700,1911,0,98115,47.6729,-122.293,1810,4750,2390,2940,169.47368421052633,0.09573770491803278,Very Cheap
20150204T000000,419950.0,3,3.0,2150,3962,1.5,0,0,3,7,1540,610,1949,0,98125,47.7183,-122.285,1730,4609,1812,2879,105.9944472488642,0.04523934426229508,Very Cheap
20150416T000000,425000.0,2,1.0,620,4455,1.0,0,0,3,6,620,0,1927,0,98117,47.6877,-122.395,1180,5000,3835,3820,95.39842873176207,0.04590163934426229,Very Cheap
20140724T000000,446000.0,4,1.75,1730,5922,2.0,0,0,5,7,1730,0,1949,0,98125,47.7188,-122.321,1700,6127,4192,4427,75.31239446133063,0.04865573770491803,Very Cheap
20150302T000000,455000.0,5,2.0,2500,7860,1.0,0,0,3,7,1040,1460,1963,0,98034,47.7212,-122.226,2060,9684,5360,7624,57.8880407124682,0.049836065573770495,Very Cheap
20140709T000000,226550.0,3,1.0,990,4440,1.0,0,0,3,6,990,0,1943,0,98106,47.522,-122.354,990,6771,3450,5781,51.02477477477478,0.019875409836065575,Very Cheap
20140930T000000,764000.0,3,2.0,1420,4080,1.5,0,0,5,8,1420,0,1904,0,98103,47.6801,-122.348,1220,3060,2660,1840,187.2549019607843,0.09036065573770492,Very Cheap
20150505T000000,439950.0,3,2.25,2170,15000,2.0,0,0,4,8,2170,0,1978,0,98042,47.3863,-122.158,2430,14256,12830,11826,29.33,0.04786229508196721,Very Cheap
20141216T000000,453000.0,4,2.0,1880,5100,1.0,0,0,3,8,1880,0,1952,0,98103,47.6872,-122.349,1610,4590,3220,2980,88.82352941176471,0.04957377049180328,Very Cheap
20150206T000000,219950.0,3,1.0,1300,9620,1.0,0,0,3,7,1300,0,1971,0,98003,47.282,-122.331,1420,9620,8320,8200,22.863825363825363,0.01900983606557377,Very Cheap
20140514T000000,702500.0,3,1.5,2360,6750,2.0,0,0,5,7,1930,430,1926,0,98103,47.6923,-122.332,1320,4500,4390,3180,104.07407407407408,0.08229508196721312,Very Cheap
20141016T000000,285000.0,3,1.5,1780,12231,1.0,0,0,4,8,1780,0,1956,0,98003,47.335,-122.321,2460,12663,10451,10203,23.301447142506746,0.02754098360655738,Very Cheap
20150213T000000,798750.0,2,2.25,2160,2578,3.0,0,0,3,8,2160,0,2005,0,98103,47.6607,-122.354,1800,2142,418,342,309.833204034135,0.09491803278688525,Very Cheap
20140626T000000,320000.0,2,1.0,950,5316,1.0,0,2,3,7,950,0,1948,0,98126,47.57,-122.38,1620,6085,4366,4465,60.19563581640331,0.032131147540983604,Very Cheap
20141216T000000,425000.0,3,1.75,1680,14630,1.5,0,0,3,8,1680,0,1985,0,98027,47.5272,-122.044,1920,14630,12950,12710,29.049897470950103,0.04590163934426229,Very Cheap
20140716T000000,540000.0,4,2.5,2290,4450,2.0,0,0,3,9,2290,0,2004,0,98072,47.7385,-122.169,2570,5096,2160,2526,121.34831460674157,0.06098360655737705,Very Cheap
20141210T000000,1060000.0,4,5.25,4140,14757,2.0,0,2,3,11,4140,0,2005,0,98075,47.5871,-121.969,4440,15523,10617,11083,71.83031781527411,0.12918032786885245,Cheap
20150325T000000,1165000.0,4,3.75,3920,4500,3.0,0,0,3,8,3920,0,2013,0,98103,47.6805,-122.346,2040,3000,580,960,258.8888888888889,0.14295081967213114,Cheap
20150421T000000,576000.0,3,1.75,1500,13891,1.0,0,0,4,7,1500,0,1951,0,98005,47.5866,-122.175,2020,13891,12391,11871,41.46569721402347,0.06570491803278689,Very Cheap
20150417T000000,525000.0,3,1.75,1720,7200,1.0,0,0,3,7,1140,580,1977,0,98052,47.6977,-122.132,1700,8400,5480,6700,72.91666666666667,0.05901639344262295,Very Cheap
20140822T000000,324950.0,4,2.5,2641,8615,2.0,0,0,3,7,2641,0,1998,0,98031,47.4038,-122.213,2641,8091,5974,5450,37.71909460243761,0.03278032786885246,Very Cheap
20140822T000000,600000.0,3,2.5,4930,77536,2.0,0,0,3,9,3930,1000,1981,0,98072,47.7634,-122.139,2760,7351,72606,4591,7.738340899711102,0.06885245901639345,Very Cheap
20140811T000000,464000.0,3,2.5,2460,5400,1.0,0,0,4,8,1520,940,2001,0,98056,47.5231,-122.202,1745,5400,2940,3655,85.92592592592592,0.05101639344262295,Very Cheap
20140707T000000,266000.0,4,2.25,1995,7102,2.0,0,0,4,8,1995,0,1981,0,98023,47.2986,-122.37,1880,7950,5107,6070,37.454238242748524,0.02504918032786885,Very Cheap
20140804T000000,775000.0,3,2.5,3010,74390,2.0,0,0,3,10,3010,0,1998,0,98053,47.6442,-121.999,3240,109771,71380,106531,10.418066944481785,0.09180327868852459,Very Cheap
20140618T000000,415000.0,3,1.75,1270,4800,1.0,0,0,3,7,1270,0,1952,2014,98126,47.5362,-122.376,1220,4800,3530,3580,86.45833333333333,0.04459016393442623,Very Cheap
20140919T000000,550000.0,4,2.75,3080,6731,2.0,0,3,3,9,3080,0,2003,0,98058,47.4522,-122.118,3080,6731,3651,3651,81.71148417768534,0.06229508196721312,Very Cheap
20150114T000000,235000.0,3,2.25,1670,7606,2.0,0,0,3,7,1670,0,1990,0,98022,47.1949,-121.982,1670,7433,5936,5763,30.89666053115961,0.02098360655737705,Very Cheap
20140620T000000,280000.0,3,2.0,1470,8089,1.0,0,0,3,7,1470,0,1987,0,98198,47.3878,-122.316,1530,7721,6619,6191,34.61490913586352,0.026885245901639345,Very Cheap
20141030T000000,459000.0,3,1.75,1730,7807,1.0,0,0,3,7,1260,470,1976,0,98034,47.7211,-122.169,1800,7650,6077,5850,58.79339054694505,0.050360655737704915,Very Cheap
20141014T000000,195000.0,3,1.0,1070,7615,1.0,0,0,4,7,1070,0,1969,0,98023,47.3189,-122.373,1240,6906,6545,5666,25.607353906762967,0.015737704918032787,Very Cheap
20141112T000000,235000.0,3,1.5,1660,8738,1.0,0,0,4,7,1080,580,1959,0,98002,47.3117,-122.208,1500,8466,7078,6966,26.894026092927444,0.02098360655737705,Very Cheap
20141126T000000,711800.0,4,2.25,2410,16650,1.0,0,0,4,8,2410,0,1965,0,98006,47.5706,-122.163,2720,11141,14240,8421,42.750750750750754,0.08351475409836065,Very Cheap
20150116T000000,440000.0,3,2.5,1040,1032,3.0,0,0,3,7,1040,0,2007,0,98107,47.6673,-122.377,1290,1275,-8,-15,426.3565891472868,0.04786885245901639,Very Cheap
20150217T000000,515000.0,2,1.0,970,3300,1.0,0,0,4,7,970,0,1916,0,98103,47.6609,-122.343,1060,3600,2330,2540,156.06060606060606,0.057704918032786885,Very Cheap
20140502T000000,1200000.0,5,2.75,2910,9480,1.5,0,0,3,8,2910,0,1939,0,98105,47.6552,-122.278,2940,6600,6570,3660,126.58227848101266,0.14754098360655737,Cheap
20150406T000000,560000.0,3,1.75,2340,12443,1.5,0,0,4,8,2340,0,1965,0,98006,47.5432,-122.177,1970,9600,10103,7630,45.005223820622035,0.06360655737704918,Very Cheap
20140620T000000,340000.0,3,1.75,1880,11249,1.0,0,0,3,7,1330,550,1985,0,98001,47.3295,-122.257,1870,14547,9369,12677,30.224908880789403,0.03475409836065574,Very Cheap
20141110T000000,600000.0,2,1.0,1110,3500,1.5,0,0,3,6,970,140,1912,0,98102,47.6453,-122.327,1884,1778,2390,-106,171.42857142857142,0.06885245901639345,Very Cheap
20140618T000000,764000.0,4,2.5,2790,7938,2.0,0,0,3,9,2790,0,1997,0,98074,47.6223,-122.026,2780,7779,5148,4999,96.24590576971529,0.09036065573770492,Very Cheap
20140729T000000,337000.0,4,2.0,1590,8779,1.0,0,0,3,8,1590,0,2001,0,98019,47.7408,-121.974,2090,9600,7189,7510,38.38706002961613,0.034360655737704915,Very Cheap
20140530T000000,1385000.0,6,2.75,5700,20000,1.0,0,4,4,10,2850,2850,1977,0,98006,47.5601,-122.16,3690,15700,14300,12010,69.25,0.1718032786885246,Cheap
20141119T000000,249000.0,4,1.0,1200,7552,1.0,0,0,3,6,1060,140,1919,0,98126,47.5317,-122.37,1580,7680,6352,6100,32.97139830508475,0.02281967213114754,Very Cheap
20140715T000000,350000.0,3,3.0,3200,35782,1.0,0,0,3,8,2360,840,1978,0,98042,47.4121,-122.154,3090,37887,32582,34797,9.781454362528645,0.036065573770491806,Very Cheap
20150129T000000,269950.0,3,2.25,1510,6000,1.0,0,0,4,7,1150,360,1993,0,98038,47.3484,-122.036,1510,6000,4490,4490,44.99166666666667,0.025567213114754097,Very Cheap
20150225T000000,735000.0,3,1.75,1880,108900,1.0,0,0,3,7,1880,0,1978,0,98075,47.5913,-122.01,2730,37731,107020,35001,6.74931129476584,0.08655737704918033,Very Cheap
20150331T000000,1295000.0,4,2.5,3070,4000,2.0,0,0,4,8,2070,1000,1940,0,98105,47.659,-122.281,2560,4000,930,1440,323.75,0.16,Cheap
20140911T000000,475000.0,4,2.25,2110,7560,2.0,0,0,4,8,2110,0,1974,0,98034,47.7331,-122.183,2110,7560,5450,5450,62.83068783068783,0.05245901639344262,Very Cheap
20150310T000000,339000.0,3,2.0,2350,8459,1.5,0,0,3,9,2350,0,1989,0,98023,47.3043,-122.349,2430,8459,6109,6029,40.07565906135477,0.03462295081967213,Very Cheap
20150311T000000,600000.0,4,3.5,3270,15160,1.0,0,2,3,8,1660,1610,1997,0,98155,47.7437,-122.287,2790,15160,11890,12370,39.577836411609496,0.06885245901639345,Very Cheap
20140807T000000,397500.0,4,1.75,2220,4760,1.0,0,0,3,7,1320,900,1918,0,98106,47.5215,-122.348,940,4760,2540,3820,83.50840336134453,0.04229508196721311,Very Cheap
20140822T000000,1525000.0,4,3.5,5990,111078,2.0,0,0,3,11,5990,0,2004,0,98053,47.667,-121.994,4690,118918,105088,114228,13.729091269198221,0.1901639344262295,Cheap
20140507T000000,460000.0,3,2.0,1760,9055,2.0,0,0,4,7,1760,0,1985,0,98052,47.6534,-122.128,2010,9383,7295,7373,50.80066261733849,0.050491803278688525,Very Cheap
20141216T000000,370000.0,4,2.75,2200,5207,1.0,0,0,5,7,1120,1080,1951,0,98133,47.74,-122.343,1210,6008,3007,4798,71.0581908968696,0.038688524590163934,Very Cheap
20150325T000000,250000.0,4,1.0,1550,7296,1.5,0,0,3,6,1550,0,1957,0,98106,47.5184,-122.366,1370,7680,5746,6310,34.26535087719298,0.022950819672131147,Very Cheap
20140703T000000,1100000.0,4,3.75,5070,60123,2.0,0,0,3,11,5070,0,2000,0,98053,47.6567,-122.004,4920,101930,55053,97010,18.2958268882125,0.13442622950819672,Cheap
20140930T000000,430000.0,2,2.25,1040,1516,2.0,0,0,3,8,1040,0,2008,0,98122,47.6037,-122.307,1560,1920,476,360,283.6411609498681,0.04655737704918033,Very Cheap
20140807T000000,1085000.0,3,1.5,2560,4000,1.5,0,0,5,8,1660,900,1927,0,98112,47.6384,-122.279,2560,4000,1440,1440,271.25,0.13245901639344262,Cheap
20150419T000000,670000.0,3,1.75,1850,8160,1.0,0,0,3,8,1850,0,1952,0,98177,47.7241,-122.363,1600,8160,6310,6560,82.1078431372549,0.0780327868852459,Very Cheap
20150423T000000,461550.0,3,1.5,2090,11895,1.0,0,0,3,7,1790,300,1954,0,98118,47.5362,-122.267,2180,11072,9805,8892,38.80201765447667,0.05069508196721312,Very Cheap
20140805T000000,479990.0,3,2.5,2010,2386,2.0,0,0,3,8,1390,620,2014,0,98029,47.5525,-121.998,1690,1870,376,180,201.1693210393965,0.05311344262295082,Very Cheap
20150414T000000,643000.0,4,2.5,2518,4663,2.0,0,0,3,8,2518,0,2005,0,98075,47.5894,-122.017,2280,4525,2145,2245,137.8940596182715,0.07449180327868853,Very Cheap
20140930T000000,607000.0,3,2.75,2810,12813,2.0,0,0,3,8,2040,770,1988,0,98052,47.6796,-122.114,1890,10336,10003,8446,47.37376102396004,0.06977049180327868,Very Cheap
20140523T000000,625000.0,3,2.5,2600,10092,1.0,0,0,3,9,2600,0,1984,0,98074,47.6223,-122.032,2440,9298,7492,6858,61.930241775663895,0.07213114754098361,Very Cheap
20140729T000000,731100.0,3,2.5,2060,8778,1.0,0,0,3,8,1160,900,1953,2010,98136,47.5245,-122.384,1990,7560,6718,5570,83.28776486671224,0.08604590163934427,Very Cheap
20150309T000000,859000.0,3,2.5,2920,434728,2.0,0,3,4,8,2920,0,1999,0,98042,47.3809,-122.13,3150,55216,431808,52066,1.9759481790912938,0.10281967213114754,Cheap
20141103T000000,435000.0,4,2.5,2130,10375,2.0,0,0,4,8,2130,0,1986,0,98058,47.4381,-122.16,2220,8508,8245,6288,41.9277108433735,0.04721311475409836,Very Cheap
20141029T000000,465000.0,3,3.0,2290,15600,1.0,0,0,3,8,1420,870,1948,1990,98001,47.3558,-122.29,1890,14143,13310,12253,29.807692307692307,0.051147540983606556,Very Cheap
20150415T000000,740000.0,3,1.0,1230,6380,1.5,0,0,3,7,1230,0,1927,0,98115,47.6947,-122.315,1250,6380,5150,5130,115.98746081504702,0.08721311475409836,Very Cheap
20141210T000000,740000.0,3,1.75,2020,9478,1.0,0,0,4,9,2020,0,1961,0,98040,47.5383,-122.238,3050,15594,7458,12544,78.07554336357882,0.08721311475409836,Very Cheap
20141119T000000,250000.0,3,2.0,1430,7280,1.0,0,0,3,7,990,440,1980,0,98030,47.3742,-122.18,1430,7280,5850,5850,34.34065934065934,0.022950819672131147,Very Cheap
20150311T000000,656000.0,2,2.5,2270,1763,3.0,0,0,3,7,1820,450,2009,0,98052,47.6757,-122.121,2180,1763,-507,-417,372.09302325581393,0.07619672131147541,Very Cheap
20141009T000000,300000.0,4,2.5,1910,8058,2.0,0,0,3,8,1910,0,1992,0,98031,47.3891,-122.172,1910,6500,6148,4590,37.230081906180196,0.029508196721311476,Very Cheap
20150220T000000,643000.0,3,1.5,1780,214315,1.0,0,0,3,7,1780,0,1954,0,98077,47.7631,-122.028,2740,133419,212535,130679,3.000256631593682,0.07449180327868853,Very Cheap
20140807T000000,311000.0,4,2.5,2690,6124,2.0,0,0,3,7,2690,0,2007,0,98042,47.3343,-122.058,2300,6002,3434,3702,50.7838014369693,0.030950819672131147,Very Cheap
20140721T000000,360000.0,3,1.75,1330,7482,1.0,0,0,4,7,1330,0,1975,0,98034,47.7322,-122.207,1480,8096,6152,6616,48.115477145148354,0.037377049180327866,Very Cheap
20140519T000000,475000.0,4,2.5,3060,10043,1.0,0,0,4,8,1700,1360,1968,0,98133,47.7387,-122.337,1630,8296,6983,6666,47.29662451458727,0.05245901639344262,Very Cheap
20140809T000000,469950.0,3,3.25,1760,1778,3.0,0,0,3,8,1760,0,2008,0,98125,47.7201,-122.301,1520,1615,18,95,264.31383577052867,0.05179672131147541,Very Cheap
20140703T000000,240000.0,3,1.75,1570,8750,1.0,0,0,3,7,1570,0,1960,0,98148,47.4425,-122.333,1890,8825,7180,6935,27.428571428571427,0.021639344262295083,Very Cheap
20140929T000000,232000.0,2,1.0,960,8100,1.0,0,0,3,6,810,150,1936,0,98168,47.494,-122.304,960,12150,7140,11190,28.641975308641975,0.02059016393442623,Very Cheap
20140813T000000,350000.0,3,2.0,1680,81893,1.0,0,0,3,7,1680,0,1991,0,98092,47.3248,-122.179,2480,38637,80213,36157,4.273869561500983,0.036065573770491806,Very Cheap
20150109T000000,803000.0,2,1.0,1440,33747,1.5,0,0,3,7,1440,0,1928,0,98034,47.7223,-122.209,1980,8400,32307,6420,23.7947076777195,0.09547540983606558,Very Cheap
20141210T000000,355000.0,3,2.25,1960,7000,1.0,0,0,3,8,1600,360,1980,0,98058,47.4427,-122.126,1980,7140,5040,5160,50.714285714285715,0.036721311475409836,Very Cheap
20140521T000000,475000.0,4,2.0,1790,2250,1.0,0,2,4,7,840,950,1909,0,98103,47.6526,-122.345,1440,1545,460,105,211.11111111111111,0.05245901639344262,Very Cheap
20150324T000000,823000.0,3,2.5,2560,9825,2.0,0,0,4,9,2560,0,1988,0,98006,47.5497,-122.145,2710,12034,7265,9324,83.76590330788804,0.09809836065573771,Very Cheap
20141112T000000,395000.0,2,1.5,1010,3060,1.0,0,0,4,7,1010,0,1918,0,98103,47.6897,-122.354,1160,4080,2050,2920,129.08496732026143,0.0419672131147541,Very Cheap
20150427T000000,499000.0,4,3.75,2560,5250,2.0,0,0,3,7,1900,660,1963,2006,98133,47.7326,-122.342,1400,5250,2690,3850,95.04761904761905,0.05560655737704918,Very Cheap
20150402T000000,420000.0,2,1.75,1200,3136,1.0,0,0,3,7,800,400,1904,2005,98122,47.6132,-122.297,1330,3164,1936,1834,133.92857142857142,0.04524590163934426,Very Cheap
20140812T000000,961500.0,3,2.5,3910,14000,2.0,0,0,3,10,3910,0,1999,0,98008,47.6374,-122.12,2280,14000,10090,11720,68.67857142857143,0.11626229508196721,Cheap
20150331T000000,833000.0,4,1.75,2260,12238,1.0,0,0,3,9,2260,0,1967,0,98005,47.5976,-122.178,2430,10204,9978,7774,68.06667756169308,0.09940983606557377,Very Cheap
20140623T000000,479000.0,3,2.25,2110,11319,2.0,0,0,4,8,2110,0,1978,0,98072,47.742,-122.105,1860,11319,9209,9459,42.31822599169538,0.05298360655737705,Very Cheap
20140701T000000,1150000.0,4,2.5,3340,10422,2.0,0,0,3,10,3340,0,1996,0,98033,47.6515,-122.197,1770,9490,7082,7720,110.34350412588755,0.14098360655737704,Cheap
20140708T000000,267000.0,3,1.0,1400,8100,1.5,0,0,3,6,1400,0,1944,0,98125,47.7124,-122.289,1420,8100,6700,6680,32.96296296296296,0.025180327868852458,Very Cheap
20140911T000000,555000.0,4,1.75,1760,94525,1.5,0,0,3,7,1760,0,1988,0,98075,47.5882,-122.07,3030,34848,92765,31818,5.871462576038085,0.06295081967213115,Very Cheap
20140731T000000,490000.0,3,2.5,2010,9725,2.0,0,0,4,8,2010,0,1987,0,98029,47.568,-122.018,1850,6858,7715,5008,50.38560411311054,0.05442622950819672,Very Cheap
20140529T000000,619000.0,4,2.0,2300,3400,1.5,0,0,5,8,1550,750,1915,0,98117,47.678,-122.361,1670,4200,1100,2530,182.05882352941177,0.07134426229508196,Very Cheap
20141031T000000,569950.0,5,2.75,2510,28185,1.0,0,0,4,7,1600,910,1963,0,98155,47.7719,-122.282,2910,14880,25675,11970,20.2217491573532,0.06491147540983606,Very Cheap
20141125T000000,549000.0,3,2.0,1340,3000,2.0,0,0,5,7,1340,0,1905,0,98103,47.6857,-122.349,1120,3000,1660,1880,183.0,0.06216393442622951,Very Cheap
20141023T000000,422500.0,3,1.75,1560,7245,1.5,0,0,3,7,1560,0,1962,1985,98052,47.6868,-122.119,2220,8502,5685,6282,58.31608005521049,0.04557377049180328,Very Cheap
20140801T000000,400000.0,4,3.5,3350,9681,1.0,0,1,3,7,2140,1210,1980,0,98198,47.3978,-122.322,2580,9681,6331,7101,41.318045656440454,0.04262295081967213,Very Cheap
20140709T000000,692500.0,4,2.75,3710,7984,2.0,0,0,3,9,3710,0,1999,0,98065,47.5352,-121.868,2950,7984,4274,5034,86.73597194388778,0.08098360655737705,Very Cheap
20140626T000000,310000.0,4,2.5,2430,5499,2.0,0,0,3,8,2430,0,2002,0,98042,47.3779,-122.125,2890,5190,3069,2300,56.373886161120204,0.03081967213114754,Very Cheap
20141216T000000,499900.0,3,1.75,2430,8820,1.0,0,2,3,8,1630,800,1977,0,98178,47.4972,-122.233,2390,10050,6390,7660,56.678004535147394,0.055724590163934426,Very Cheap
20140827T000000,492000.0,3,2.25,2100,7335,2.0,0,0,3,8,2100,0,1983,0,98074,47.647,-122.061,2050,8930,5235,6880,67.07566462167689,0.054688524590163934,Very Cheap
20150506T000000,460000.0,2,2.5,1880,40575,1.0,0,0,3,9,1880,0,1987,0,98024,47.5614,-121.899,1930,32935,38695,31005,11.337030191004313,0.050491803278688525,Very Cheap
20140716T000000,800000.0,3,2.5,1630,2640,2.0,0,0,5,8,1630,0,1919,0,98119,47.6452,-122.371,1630,3000,1010,1370,303.030303030303,0.09508196721311475,Very Cheap
20150407T000000,832600.0,4,1.0,1640,4200,1.5,0,0,3,7,1640,0,1925,0,98103,47.6601,-122.332,1730,3990,2560,2260,198.23809523809524,0.09935737704918032,Very Cheap
20150318T000000,470000.0,4,2.75,2310,7350,1.0,0,0,3,8,1670,640,1989,0,98011,47.7505,-122.182,2600,6077,5040,3477,63.945578231292515,0.05180327868852459,Very Cheap
20141021T000000,542000.0,2,2.0,1930,4500,1.0,0,0,3,8,1930,0,2003,0,98053,47.7104,-122.031,1670,5200,2570,3530,120.44444444444444,0.06124590163934426,Very Cheap
20140619T000000,1309500.0,4,4.5,4750,13912,2.0,0,2,3,10,3600,1150,2005,0,98118,47.5332,-122.265,3600,22124,9162,18524,94.12737205290397,0.1619016393442623,Cheap
20141010T000000,308130.0,4,2.5,2300,7500,1.0,0,3,2,7,1650,650,1959,0,98198,47.4125,-122.33,2300,7500,5200,5200,41.084,0.030574426229508195,Very Cheap
20150311T000000,310000.0,2,1.0,1050,2699,1.0,0,0,3,7,1050,0,2005,0,98029,47.5471,-121.996,1240,2671,1649,1431,114.85735457576881,0.03081967213114754,Very Cheap
20141022T000000,235000.0,2,1.0,1500,8015,1.0,0,0,3,6,1500,0,1947,0,98146,47.5027,-122.348,1130,8015,6515,6885,29.320024953212727,0.02098360655737705,Very Cheap
20140919T000000,215000.0,3,1.0,1150,7560,1.0,0,0,4,6,1150,0,1958,0,98058,47.4613,-122.184,1230,7560,6410,6330,28.43915343915344,0.018360655737704918,Very Cheap
20140605T000000,210000.0,4,1.5,1920,10403,1.0,0,0,3,7,1370,550,1959,0,98023,47.2987,-122.366,1550,9619,8483,8069,20.186484667884265,0.017704918032786884,Very Cheap
20141126T000000,730000.0,4,2.75,3660,150282,2.0,0,0,3,10,3660,0,1990,0,98053,47.6813,-122.048,3090,53578,146622,50488,4.8575345018032765,0.0859016393442623,Very Cheap
20141210T000000,245000.0,3,1.75,1720,9342,1.0,0,0,4,7,1140,580,1981,0,98092,47.3177,-122.182,1330,7540,7622,6210,26.22564761293085,0.022295081967213116,Very Cheap
20140915T000000,540000.0,3,2.25,2100,20018,1.0,0,4,3,8,1470,630,1948,0,98166,47.4544,-122.366,2410,17196,17918,14786,26.9757218503347,0.06098360655737705,Very Cheap
20150203T000000,299000.0,4,2.5,2400,6078,2.0,0,0,3,8,2400,0,2001,0,98001,47.2606,-122.285,2406,7642,3678,5236,49.19381375452451,0.02937704918032787,Very Cheap
20141118T000000,510000.0,3,2.5,2540,40106,2.0,0,0,3,10,2540,0,1991,0,98074,47.6037,-122.043,3190,71797,37566,68607,12.716301800229392,0.057049180327868855,Very Cheap
20140703T000000,198000.0,4,1.75,2080,7200,1.0,0,0,4,7,1050,1030,1966,0,98001,47.3385,-122.282,1500,7350,5120,5850,27.5,0.016131147540983607,Very Cheap
20140523T000000,950000.0,5,3.25,3400,7452,2.0,0,0,3,10,3400,0,1999,0,98007,47.6141,-122.136,2650,8749,4052,6099,127.4825550187869,0.11475409836065574,Cheap
20150220T000000,300000.0,4,1.75,2200,7600,2.0,0,0,3,8,2200,0,1978,0,98092,47.3131,-122.191,1910,7600,5400,5690,39.473684210526315,0.029508196721311476,Very Cheap
20140904T000000,528000.0,5,1.75,2140,8580,1.0,0,0,3,7,1200,940,1962,0,98033,47.6625,-122.178,1600,9206,6440,7606,61.53846153846154,0.05940983606557377,Very Cheap
20140618T000000,507000.0,5,3.25,3850,16249,2.0,0,2,3,9,3030,820,2002,0,98092,47.3324,-122.168,2640,7393,12399,4753,31.201920118161116,0.05665573770491803,Very Cheap
20150219T000000,770000.0,4,3.25,4270,6384,2.0,0,0,3,9,3060,1210,2001,0,98065,47.5362,-121.874,2850,6285,2114,3435,120.6140350877193,0.09114754098360656,Very Cheap
20150220T000000,255000.0,3,1.75,1340,7210,1.0,0,0,4,7,1340,0,1975,0,98031,47.4182,-122.167,1370,7210,5870,5840,35.36754507628294,0.02360655737704918,Very Cheap
20150505T000000,220000.0,1,1.5,1100,3451,1.5,0,0,4,8,1100,0,1978,0,98198,47.3829,-122.322,1400,4560,2351,3160,63.749637786148945,0.01901639344262295,Very Cheap
20150223T000000,690700.0,5,2.75,2870,5349,2.0,0,0,3,9,2870,0,2005,0,98059,47.5405,-122.187,2800,5000,2479,2200,129.12693961488128,0.08074754098360656,Very Cheap
20140627T000000,447000.0,2,1.0,1320,8380,1.0,0,0,3,7,1320,0,1953,0,98177,47.705,-122.367,1290,8025,7060,6735,53.34128878281623,0.04878688524590164,Very Cheap
20140520T000000,755000.0,6,2.0,2150,4505,1.0,0,0,3,7,1270,880,1952,0,98119,47.6514,-122.369,1740,4505,2355,2765,167.59156492785795,0.08918032786885247,Very Cheap
20150313T000000,700000.0,4,1.5,2470,6000,1.5,0,0,3,7,1480,990,1940,0,98199,47.6365,-122.391,2140,4000,3530,1860,116.66666666666667,0.08196721311475409,Very Cheap
20140715T000000,250000.0,4,2.75,1910,7700,1.0,0,0,4,7,1000,910,1980,0,98030,47.369,-122.17,1880,7875,5790,5995,32.467532467532465,0.022950819672131147,Very Cheap
20140510T000000,320000.0,3,2.5,2130,6969,2.0,0,0,3,7,2130,0,2003,0,98038,47.3655,-122.027,1670,9545,4839,7875,45.91763524178505,0.032131147540983604,Very Cheap
20140514T000000,565000.0,4,2.5,2240,14667,2.0,0,0,4,9,2240,0,1989,0,98059,47.5276,-122.161,2410,11243,12427,8833,38.521851776096,0.06426229508196721,Very Cheap
20150424T000000,754300.0,5,2.75,1800,4500,2.0,0,0,4,7,1680,120,1939,0,98107,47.6648,-122.358,1730,4500,2700,2770,167.62222222222223,0.08908852459016393,Very Cheap
20140505T000000,650000.0,3,1.5,2160,9000,1.0,0,2,4,8,1400,760,1949,0,98177,47.7241,-122.369,3010,9000,6840,5990,72.22222222222223,0.07540983606557378,Very Cheap
20150218T000000,529888.0,4,2.5,3140,8455,2.0,0,0,3,8,3140,0,2003,0,98059,47.4866,-122.147,3140,7391,5315,4251,62.6715552927262,0.05965744262295082,Very Cheap
20141106T000000,432000.0,3,2.5,1920,9812,2.0,0,0,3,8,1920,0,2000,0,98028,47.7633,-122.243,1830,10534,7892,8704,44.027721157766,0.046819672131147544,Very Cheap
20150318T000000,235000.0,3,1.0,1050,7670,1.5,0,0,5,7,1050,0,1955,0,98022,47.2046,-121.996,1220,7670,6620,6450,30.63885267275098,0.02098360655737705,Very Cheap
20150127T000000,994900.0,4,3.5,3695,6556,2.0,0,0,3,9,3695,0,2014,0,98053,47.683,-122.015,4160,6786,2861,2626,151.75411836485662,0.12064262295081968,Cheap
20150403T000000,489000.0,4,2.5,3910,8442,2.0,0,0,3,9,2710,1200,2000,0,98038,47.3766,-122.027,2650,7576,4532,4926,57.92466240227434,0.05429508196721312,Very Cheap
20150420T000000,800000.0,4,2.75,3010,7427,2.0,0,0,3,8,3010,0,2010,0,98052,47.7068,-122.112,3000,4929,4417,1929,107.71509357748755,0.09508196721311475,Very Cheap
20140516T000000,370000.0,4,1.5,1370,9957,1.0,0,0,3,7,900,470,1972,0,98034,47.7237,-122.181,1510,8088,8587,6578,37.15978708446319,0.038688524590163934,Very Cheap
20141212T000000,436000.0,4,2.75,2080,9600,1.0,0,0,3,8,1240,840,1979,0,98034,47.7149,-122.235,1880,9525,7520,7645,45.416666666666664,0.047344262295081964,Very Cheap
20140528T000000,395000.0,3,2.5,2250,3757,2.0,0,0,3,7,2250,0,2006,0,98059,47.4787,-122.129,2250,4556,1507,2306,105.13707745541656,0.0419672131147541,Very Cheap
20140523T000000,377691.0,5,1.75,2120,8399,1.0,0,0,4,7,1320,800,1942,0,98133,47.7621,-122.335,2120,8398,6279,6278,44.96856768662936,0.039697180327868856,Very Cheap
20150417T000000,370000.0,5,3.0,2220,5185,2.0,0,3,3,7,2220,0,2003,0,98118,47.543,-122.29,2340,6316,2965,3976,71.35969141755062,0.038688524590163934,Very Cheap
20141023T000000,515000.0,3,2.5,1440,4394,1.0,0,0,5,8,1440,0,1987,0,98029,47.5688,-122.019,1900,5893,2954,3993,117.20527992717342,0.057704918032786885,Very Cheap
20140926T000000,169000.0,3,1.0,910,7686,1.0,0,0,3,7,910,0,1969,0,98001,47.3405,-122.288,1020,7686,6776,6666,21.988030184751498,0.012327868852459017,Very Cheap
20150321T000000,475000.0,3,1.0,1270,4268,1.0,0,0,3,7,1270,0,1921,0,98117,47.6848,-122.392,1310,4080,2998,2770,111.2933458294283,0.05245901639344262,Very Cheap
20150425T000000,420000.0,3,2.5,2480,6180,2.0,0,0,3,9,2480,0,1999,0,98031,47.4044,-122.208,2870,6180,3700,3310,67.96116504854369,0.04524590163934426,Very Cheap
20140701T000000,1297000.0,6,2.75,2630,9420,2.0,0,0,5,9,2510,120,1900,0,98103,47.6695,-122.337,1540,4969,6790,3429,137.68577494692144,0.1602622950819672,Cheap
20150225T000000,822000.0,3,2.0,2410,13300,2.0,0,0,3,9,1840,570,1985,0,98006,47.5632,-122.148,2930,10900,10890,7970,61.80451127819549,0.09796721311475409,Very Cheap
20141216T000000,1500000.0,4,2.75,2930,25697,1.0,0,0,4,9,2310,620,1964,0,98004,47.6264,-122.226,3810,20681,22767,16871,58.37257267385298,0.18688524590163935,Cheap
20150330T000000,485000.0,3,2.25,1570,6810,1.0,0,0,3,8,1180,390,1988,0,98074,47.6176,-122.044,1620,6584,5240,4964,71.21879588839941,0.05377049180327869,Very Cheap
20140807T000000,270000.0,4,1.0,1900,8505,1.0,0,0,3,7,1200,700,1956,0,98055,47.4406,-122.196,1440,8505,6605,7065,31.746031746031747,0.025573770491803278,Very Cheap
20150401T000000,300000.0,6,2.5,2590,11250,1.0,0,0,4,8,1390,1200,1978,0,98055,47.4608,-122.196,2270,8360,8660,6090,26.666666666666668,0.029508196721311476,Very Cheap
20150416T000000,878000.0,4,2.5,3810,7728,2.0,0,0,3,9,3810,0,2007,0,98074,47.5925,-122.058,3290,7728,3918,4438,113.6128364389234,0.10531147540983607,Cheap
20150403T000000,590000.0,3,2.5,2290,4203,2.0,0,0,3,9,2290,0,2001,0,98006,47.5441,-122.172,2290,5089,1913,2799,140.3759219605044,0.06754098360655737,Very Cheap
20141119T000000,611900.0,1,2.25,1220,2100,2.0,0,2,4,8,1220,0,1946,1979,98033,47.6703,-122.204,3150,6000,880,2850,291.3809523809524,0.07041311475409837,Very Cheap
20150319T000000,240000.0,3,1.75,1100,7373,1.0,0,0,4,7,1100,0,1968,0,98092,47.3124,-122.183,1430,8415,6273,6985,32.551200325512006,0.021639344262295083,Very Cheap
20150417T000000,395000.0,4,2.5,2810,10951,2.0,0,0,3,8,2810,0,2003,0,98092,47.3249,-122.187,1680,6625,8141,4945,36.069765318235774,0.0419672131147541,Very Cheap
20140716T000000,169000.0,3,1.0,890,7110,1.0,0,0,3,6,890,0,1957,0,98178,47.4971,-122.261,1100,8375,6220,7275,23.769338959212376,0.012327868852459017,Very Cheap
20150324T000000,200500.0,3,2.0,1280,14972,1.0,0,0,3,7,1280,0,1963,0,98031,47.4129,-122.209,1800,9698,13692,7898,13.391664440288539,0.016459016393442622,Very Cheap
20150410T000000,308000.0,3,2.5,2320,7140,2.0,0,0,3,8,2320,0,1990,0,98003,47.275,-122.295,2360,7955,4820,5595,43.13725490196079,0.030557377049180327,Very Cheap
20140710T000000,290256.0,3,2.25,1720,7885,2.0,0,0,3,8,1720,0,1983,0,98023,47.3136,-122.344,2340,7885,6165,5545,36.81116043119848,0.028230295081967213,Very Cheap
20150427T000000,279950.0,3,1.75,1530,8800,1.0,0,0,4,7,1040,490,1967,0,98058,47.4483,-122.158,1530,8690,7270,7160,31.8125,0.026878688524590164,Very Cheap
20140807T000000,195000.0,3,1.75,1580,7875,1.0,0,0,3,7,1580,0,1979,0,98022,47.1958,-122.003,1560,8314,6295,6754,24.761904761904763,0.015737704918032787,Very Cheap
20140826T000000,630000.0,3,1.0,1360,13000,1.0,0,0,5,6,1360,0,1945,0,98010,47.3359,-122.033,1890,19650,11640,17760,48.46153846153846,0.07278688524590164,Very Cheap
20150406T000000,1160000.0,4,3.0,2680,15438,2.0,0,2,3,8,2680,0,1902,1956,98039,47.6109,-122.226,4480,14406,12758,9926,75.13926674439695,0.1422950819672131,Cheap
20140701T000000,478000.0,3,2.25,1640,3896,2.0,0,0,3,8,1640,0,1994,0,98029,47.5689,-122.006,1780,3999,2256,2219,122.68993839835728,0.05285245901639344,Very Cheap
20140814T000000,835000.0,3,2.25,2520,6690,2.0,0,2,5,8,1700,820,1944,1990,98126,47.5705,-122.381,1990,5792,4170,3802,124.81315396113602,0.09967213114754099,Very Cheap
20150417T000000,639000.0,3,2.25,1400,2421,2.0,0,0,3,9,1400,0,2005,0,98034,47.695,-122.169,1500,2743,1021,1243,263.9405204460966,0.0739672131147541,Very Cheap
20141013T000000,623000.0,4,2.75,2300,12633,2.0,0,0,3,9,2300,0,1984,0,98074,47.6218,-122.032,2240,9246,10333,7006,49.31528536372991,0.07186885245901639,Very Cheap
20141217T000000,220000.0,3,1.75,1900,7680,1.0,0,0,3,7,1260,640,1959,0,98178,47.5081,-122.266,2000,7740,5780,5740,28.645833333333332,0.01901639344262295,Very Cheap
20150325T000000,526000.0,3,2.25,2000,18099,1.0,0,0,4,8,1250,750,1978,0,98006,47.5443,-122.18,2060,12000,16099,9940,29.062379136968893,0.059147540983606556,Very Cheap
20150123T000000,243500.0,2,1.0,900,5016,1.0,0,0,3,6,900,0,1948,0,98118,47.542,-122.282,1420,5184,4116,3764,48.54465709728868,0.022098360655737705,Very Cheap
20140512T000000,750000.0,4,2.5,2980,4930,2.0,0,0,3,9,2890,90,2000,0,98006,47.5445,-122.12,2980,6099,1950,3119,152.12981744421907,0.08852459016393442,Very Cheap
20150318T000000,329000.0,4,2.0,1850,9126,1.0,0,0,5,7,1850,0,1963,0,98059,47.5009,-122.164,1730,9110,7276,7380,36.05084374315143,0.03331147540983607,Very Cheap
20140926T000000,525000.0,4,1.0,1570,4000,1.5,0,0,3,7,1570,0,1920,0,98102,47.6275,-122.321,1610,4000,2430,2390,131.25,0.05901639344262295,Very Cheap
20150317T000000,190000.0,2,1.0,670,3101,1.0,0,0,4,6,670,0,1948,0,98118,47.5546,-122.274,1660,4100,2431,2440,61.27055788455337,0.015081967213114755,Very Cheap
20140626T000000,772650.0,4,2.5,2660,10800,1.0,0,0,3,7,2660,0,1955,2014,98005,47.5894,-122.172,2640,10800,8140,8160,71.54166666666667,0.09149508196721312,Very Cheap
20140710T000000,355000.0,3,2.5,2110,4038,2.0,0,0,4,8,2110,0,1989,0,98042,47.3875,-122.153,2110,3727,1928,1617,87.91480931154037,0.036721311475409836,Very Cheap
20150401T000000,650000.0,3,1.75,1970,54450,1.0,0,0,3,8,1570,400,1980,0,98075,47.5936,-122.012,2460,36677,52480,34217,11.937557392102846,0.07540983606557378,Very Cheap
20150311T000000,678500.0,3,2.75,1210,3600,1.5,0,2,5,7,1210,0,1910,0,98103,47.6798,-122.354,1630,3910,2390,2280,188.47222222222223,0.07914754098360656,Very Cheap
20140626T000000,669950.0,4,2.5,2670,11877,2.0,0,0,3,9,2670,0,1996,0,98074,47.6327,-122.036,2430,11333,9207,8903,56.40734192136061,0.07802622950819672,Very Cheap
20150311T000000,850000.0,3,2.25,3000,18450,1.0,0,0,3,10,3000,0,1983,0,98077,47.7274,-122.062,2980,12304,15450,9324,46.070460704607044,0.10163934426229508,Cheap
20140827T000000,572000.0,3,2.75,2200,3885,2.0,0,0,3,8,2200,0,2002,0,98074,47.6171,-122.028,2710,6000,1685,3290,147.23294723294723,0.06518032786885246,Very Cheap
20140801T000000,492450.0,3,1.75,1540,13002,1.0,0,0,2,8,1200,340,1984,0,98074,47.6231,-122.044,1620,10098,11462,8478,37.87494231656668,0.054747540983606555,Very Cheap
20141030T000000,813000.0,3,1.75,2080,11866,1.0,0,0,3,8,2080,0,1960,0,98005,47.5872,-122.173,2240,10696,9786,8456,68.51508511714141,0.09678688524590164,Very Cheap
20140828T000000,710000.0,3,2.0,1780,9732,1.0,0,0,3,8,1780,0,1967,0,98040,47.5796,-122.229,1900,10200,7952,8300,72.95519934237566,0.08327868852459017,Very Cheap
20141202T000000,792500.0,3,1.5,1960,2400,2.0,0,0,3,8,1330,630,1911,0,98119,47.6423,-122.37,2090,4000,440,1910,330.2083333333333,0.0940983606557377,Very Cheap
20150313T000000,285900.0,5,1.5,1690,7725,1.5,0,0,4,7,1690,0,1961,0,98032,47.3859,-122.288,1690,7739,6035,6049,37.00970873786408,0.027659016393442624,Very Cheap
20150511T000000,389000.0,3,2.0,2080,12972,1.0,0,0,4,7,1250,830,1981,0,98070,47.3733,-122.432,1530,10089,10892,8559,29.987665741597286,0.04118032786885246,Very Cheap
20141205T000000,675000.0,3,2.25,2070,2833,2.0,0,2,3,8,1490,580,1966,0,98136,47.5543,-122.398,1940,3794,763,1854,238.26332509707024,0.07868852459016394,Very Cheap
20141022T000000,352000.0,2,0.75,760,33801,1.0,0,0,4,4,760,0,1931,0,98059,47.4703,-122.076,1100,39504,33041,38404,10.413893080086387,0.03632786885245902,Very Cheap
20150507T000000,1050000.0,4,3.25,4020,11588,2.0,0,0,3,11,4020,0,2000,0,98059,47.5217,-122.155,3190,8066,7568,4876,90.61097687262685,0.12786885245901639,Cheap
20150108T000000,768500.0,4,1.75,3620,10400,1.0,0,0,4,8,1820,1800,1965,0,98005,47.6069,-122.167,2410,10400,6780,7990,73.89423076923077,0.09095081967213114,Very Cheap
20141226T000000,500000.0,4,2.0,2330,7778,1.0,0,0,3,7,1230,1100,1961,0,98125,47.7109,-122.323,1250,8160,5448,6910,64.28387760349705,0.05573770491803279,Very Cheap
20141230T000000,685000.0,3,2.5,1460,8800,1.0,0,0,4,7,1460,0,1956,0,98040,47.5895,-122.232,2200,8800,7340,6600,77.8409090909091,0.08,Very Cheap
20140523T000000,648475.0,4,2.75,2250,5700,1.0,0,0,3,8,1200,1050,1951,0,98109,47.6406,-122.344,1720,3850,3450,2130,113.76754385964912,0.07520983606557377,Very Cheap
20150422T000000,655000.0,6,5.0,2850,6600,2.0,0,0,3,7,2850,0,1994,0,98033,47.6813,-122.187,1870,9900,3750,8030,99.24242424242425,0.0760655737704918,Very Cheap
20140912T000000,895000.0,4,2.75,2640,4000,2.0,0,0,5,8,1730,910,1925,0,98115,47.6727,-122.297,1530,3740,1360,2210,223.75,0.10754098360655738,Cheap
20150408T000000,195000.0,3,1.0,1310,9554,1.0,0,0,3,7,960,350,1962,0,98001,47.2949,-122.285,1310,9845,8244,8535,20.410299351057148,0.015737704918032787,Very Cheap
20141208T000000,368000.0,4,2.5,2720,7350,2.0,0,0,3,9,2720,0,1989,0,98023,47.3028,-122.35,2570,8336,4630,5766,50.06802721088435,0.03842622950819672,Very Cheap
20150228T000000,997000.0,4,3.5,3430,13609,2.0,0,0,3,11,3430,0,2001,0,98059,47.5196,-122.151,3880,11614,10179,7734,73.26034242045705,0.12091803278688525,Cheap
20141222T000000,335000.0,3,2.75,1990,19991,1.0,0,0,3,7,1340,650,1977,0,98072,47.7434,-122.106,1750,9775,18001,8025,16.75754089340203,0.03409836065573771,Very Cheap
20140521T000000,250000.0,3,2.0,1170,7258,1.0,0,0,3,7,1170,0,1984,0,98001,47.3333,-122.266,1410,7750,6088,6340,34.444750620005514,0.022950819672131147,Very Cheap
20150312T000000,278500.0,3,1.75,1390,8980,1.0,0,0,4,8,1390,0,1985,0,98022,47.2015,-122.005,1770,9085,7590,7315,31.01336302895323,0.026688524590163933,Very Cheap
20150128T000000,260000.0,4,1.5,1540,7300,2.0,0,0,3,7,1540,0,1973,0,98001,47.3317,-122.276,1580,7650,5760,6070,35.61643835616438,0.024262295081967214,Very Cheap
20141001T000000,162500.0,2,1.0,760,6141,1.0,0,0,2,6,760,0,1920,0,98118,47.5469,-122.277,900,4120,5381,3220,26.46148835694512,0.011475409836065573,Very Cheap
20140714T000000,239000.0,4,1.0,1280,8316,1.0,0,0,3,6,1280,0,1950,0,98168,47.4989,-122.302,1310,7830,7036,6520,28.73977873977874,0.021508196721311476,Very Cheap
20141121T000000,600000.0,4,2.5,2990,5122,2.0,0,0,3,8,2990,0,2004,0,98075,47.5773,-122.055,3140,7875,2132,4735,117.14174150722374,0.06885245901639345,Very Cheap
20150428T000000,350000.0,4,2.25,1770,7778,2.0,0,0,3,7,1770,0,1998,0,98031,47.4192,-122.201,1770,7591,6008,5821,44.99871432244793,0.036065573770491806,Very Cheap
20141215T000000,852500.0,5,3.75,3830,8131,2.0,0,0,3,10,3830,0,2005,0,98075,47.5837,-121.971,3570,7290,4301,3720,104.84565244127414,0.1019672131147541,Cheap
20140721T000000,485000.0,3,2.5,2870,5490,2.0,0,0,3,9,2870,0,2008,0,98055,47.4471,-122.207,3040,5442,2620,2402,88.3424408014572,0.05377049180327869,Very Cheap
20141007T000000,299000.0,3,1.0,1520,8320,1.0,0,0,3,6,1520,0,1953,0,98133,47.7699,-122.335,1500,8320,6800,6820,35.9375,0.02937704918032787,Very Cheap
20150422T000000,227450.0,2,1.0,660,6509,1.0,0,0,4,5,660,0,1952,0,98056,47.4938,-122.171,970,5713,5849,4743,34.94392379781841,0.01999344262295082,Very Cheap
20140523T000000,383000.0,3,1.0,1800,5612,1.0,0,0,4,7,1200,600,1942,0,98126,47.525,-122.378,1450,5250,3812,3800,68.24661439771917,0.04039344262295082,Very Cheap
20150112T000000,835000.0,2,3.25,3570,392475,1.0,0,0,3,9,2370,1200,1998,0,98024,47.5448,-121.93,3190,217800,388905,214610,2.1275240461175873,0.09967213114754099,Very Cheap
20150211T000000,760000.0,5,1.5,3050,2992,1.5,0,0,4,8,1920,1130,1931,0,98112,47.621,-122.302,1200,1209,-58,9,254.01069518716577,0.0898360655737705,Very Cheap
20150217T000000,532500.0,2,1.0,820,3000,1.0,0,0,4,7,820,0,1924,0,98103,47.6842,-122.348,1490,3000,2180,1510,177.5,0.06,Very Cheap
20141125T000000,635000.0,3,2.5,3610,26359,1.0,0,0,3,8,1950,1660,1998,0,98053,47.6306,-121.968,2620,26427,22749,23807,24.090443491786488,0.07344262295081967,Very Cheap
20140825T000000,438500.0,3,2.0,1490,3072,1.0,0,0,5,7,770,720,1912,0,98144,47.5772,-122.307,1320,3072,1582,1752,142.74088541666666,0.047672131147540986,Very Cheap
20140618T000000,545500.0,3,2.5,1560,9361,1.5,0,0,4,7,1360,200,1936,0,98108,47.5591,-122.295,1670,6244,7801,4574,58.27368870847132,0.06170491803278688,Very Cheap
20150414T000000,675000.0,3,1.75,1660,9549,1.0,0,0,3,7,1660,0,1956,0,98033,47.6503,-122.198,2090,9549,7889,7459,70.6880301602262,0.07868852459016394,Very Cheap
20140618T000000,450000.0,3,1.75,1180,4080,1.0,0,0,4,6,760,420,1928,0,98117,47.6825,-122.391,1490,4080,2900,2590,110.29411764705883,0.04918032786885246,Very Cheap
20141223T000000,199999.0,3,1.0,960,10815,1.0,0,0,5,5,960,0,1900,0,98010,47.3091,-122.006,1330,10815,9855,9485,18.492741562644476,0.016393311475409837,Very Cheap
20140910T000000,375000.0,3,1.5,1630,16170,1.0,0,0,3,7,1630,0,1988,0,98034,47.7104,-122.235,1630,9931,14540,8301,23.19109461966605,0.03934426229508197,Very Cheap
20150430T000000,600000.0,4,2.25,2260,43847,2.0,0,0,3,8,2260,0,1982,0,98072,47.7713,-122.129,2470,37304,41587,34834,13.683946450156226,0.06885245901639345,Very Cheap
20140708T000000,292600.0,3,1.5,1520,7123,1.0,0,0,4,7,1520,0,1959,0,98056,47.4991,-122.176,1450,8023,5603,6573,41.0781973887407,0.028537704918032786,Very Cheap
20150319T000000,1038000.0,5,2.75,3050,8904,1.0,0,0,4,8,1650,1400,1956,0,98040,47.5709,-122.214,2920,8904,5854,5984,116.57681940700809,0.12629508196721312,Cheap
20141010T000000,610000.0,3,1.0,1000,4959,1.0,0,0,3,8,1000,0,1945,0,98105,47.6629,-122.277,2240,4959,3959,2719,123.00867110304497,0.07016393442622951,Very Cheap
20140825T000000,397450.0,4,2.5,2650,9451,2.0,0,0,4,8,2650,0,1993,0,98042,47.3693,-122.129,2510,8850,6801,6340,42.053750925827956,0.04228852459016393,Very Cheap
20150414T000000,382000.0,3,2.25,1750,15528,1.0,0,0,3,8,1270,480,1963,0,98155,47.7739,-122.274,2170,12000,13778,9830,24.60072127769191,0.040262295081967214,Very Cheap
20150116T000000,370000.0,3,2.25,1770,7667,1.0,0,0,3,8,1270,500,1966,0,98177,47.7724,-122.362,2180,8103,5897,5923,48.25877135776705,0.038688524590163934,Very Cheap
20150428T000000,520000.0,3,2.25,1770,7667,1.0,0,0,3,8,1270,500,1966,0,98177,47.7724,-122.362,2180,8103,5897,5923,67.82313812442938,0.058360655737704915,Very Cheap
20140701T000000,260000.0,2,1.0,770,7906,1.0,0,0,4,6,770,0,1948,0,98155,47.766,-122.32,990,7906,7136,6916,32.8864153807235,0.024262295081967214,Very Cheap
20141120T000000,890000.0,4,2.5,3370,7200,2.0,0,0,3,8,3370,0,2014,0,98177,47.7698,-122.384,1880,7200,3830,5320,123.61111111111111,0.10688524590163935,Cheap
20140826T000000,344000.0,5,2.0,2130,8412,1.0,0,0,3,7,1440,690,1946,2000,98155,47.7403,-122.318,2310,7474,6282,5164,40.89396100808369,0.035278688524590165,Very Cheap
20140625T000000,205000.0,3,1.0,1050,8498,1.0,0,0,3,7,1050,0,1958,0,98031,47.4038,-122.203,1340,8498,7448,7158,24.12332313485526,0.017049180327868854,Very Cheap
20150507T000000,379000.0,5,2.5,2803,8550,1.0,0,0,3,8,2803,0,1963,2011,98003,47.3032,-122.306,1810,8550,5747,6740,44.32748538011696,0.03986885245901639,Very Cheap
20140822T000000,424240.0,3,2.0,2080,12094,2.0,0,0,4,8,2080,0,1982,0,98052,47.7035,-122.164,2230,12204,10014,9974,35.07855134777576,0.045801967213114754,Very Cheap
20141124T000000,589950.0,3,2.0,2080,12094,2.0,0,0,4,8,2080,0,1982,0,98052,47.7035,-122.164,2230,12204,10014,9974,48.780386968744835,0.0675344262295082,Very Cheap
20140512T000000,582000.0,4,1.75,2120,4650,1.0,0,1,3,7,1190,930,1951,0,98117,47.6964,-122.4,2070,6487,2530,4417,125.16129032258064,0.06649180327868852,Very Cheap
20150312T000000,349000.0,3,2.5,2550,7709,2.0,0,0,3,9,2550,0,1989,0,98023,47.3081,-122.391,2410,9250,5159,6840,45.271760280191984,0.035934426229508196,Very Cheap
20150408T000000,658000.0,3,1.0,1290,12005,1.0,0,0,4,7,1290,0,1966,0,98033,47.6835,-122.199,1930,8000,10715,6070,54.81049562682216,0.07645901639344262,Very Cheap
20141029T000000,294000.0,5,2.75,1790,5000,1.5,0,0,4,7,1060,730,1915,0,98106,47.5655,-122.363,1400,5000,3210,3600,58.8,0.028721311475409836,Very Cheap
20140626T000000,690000.0,5,3.5,2720,7598,2.0,0,0,3,8,1860,860,1993,0,98115,47.6931,-122.283,2430,7728,4878,5298,90.81337193998421,0.08065573770491803,Very Cheap
20150423T000000,600000.0,3,1.0,1040,5000,1.5,0,2,3,7,1040,0,1912,0,98107,47.6754,-122.359,1440,4400,3960,2960,120.0,0.06885245901639345,Very Cheap
20150116T000000,199990.0,3,1.0,840,5200,1.0,0,0,3,6,840,0,1969,2014,98042,47.3685,-122.077,870,5200,4360,4330,38.45961538461538,0.016392131147540984,Very Cheap
20141209T000000,220000.0,3,1.75,1650,8850,1.0,0,0,3,7,1650,0,1959,0,98188,47.4331,-122.291,1400,8800,7200,7400,24.858757062146893,0.01901639344262295,Very Cheap
20150126T000000,440000.0,4,2.25,2080,15750,1.0,0,0,3,8,1460,620,1976,0,98034,47.7225,-122.2,1960,10500,13670,8540,27.936507936507937,0.04786885245901639,Very Cheap
20140904T000000,439990.0,4,2.5,1540,1994,2.0,0,0,3,8,1540,0,2014,0,98029,47.5526,-121.999,1540,1689,454,149,220.65697091273822,0.04786754098360656,Very Cheap
20150311T000000,815000.0,4,2.5,3880,7208,2.0,0,0,3,10,3880,0,2006,0,98075,47.5841,-121.971,3280,7221,3328,3941,113.06881243063263,0.09704918032786886,Very Cheap
20150421T000000,535000.0,4,2.25,1860,3766,2.0,0,0,3,8,1860,0,1995,0,98029,47.5699,-122.006,1860,4169,1906,2309,142.06054168879447,0.06032786885245902,Very Cheap
20141126T000000,215000.0,3,1.75,1280,10016,1.0,0,0,4,7,1280,0,1975,0,98003,47.2823,-122.333,1670,9764,8736,8094,21.465654952076676,0.018360655737704918,Very Cheap
20150223T000000,605000.0,3,2.5,3200,35012,1.5,0,0,3,8,2100,1100,1965,0,98027,47.4651,-121.993,2690,35100,31812,32410,17.27978978635896,0.06950819672131148,Very Cheap
20140530T000000,349900.0,3,2.5,2200,7278,2.0,0,0,3,8,2200,0,1990,0,98058,47.4624,-122.132,2190,8580,5078,6390,48.07639461390492,0.036052459016393444,Very Cheap
20150218T000000,495000.0,3,1.0,1570,5510,1.0,0,0,4,7,1070,500,1940,0,98115,47.6942,-122.319,1770,6380,3940,4610,89.83666061705989,0.05508196721311476,Very Cheap
20141014T000000,515100.0,3,2.5,2074,4900,2.0,0,0,3,8,2074,0,1997,0,98034,47.7327,-122.233,1840,7382,2826,5542,105.12244897959184,0.05771803278688525,Very Cheap
20140624T000000,620000.0,4,2.5,2450,55387,2.0,0,0,3,9,2450,0,1994,0,98053,47.6323,-121.985,2730,38827,52937,36097,11.193962482170907,0.07147540983606557,Very Cheap
20150122T000000,657500.0,4,2.25,2520,10370,2.0,0,0,3,9,2520,0,1980,0,98074,47.6377,-122.049,2848,12682,7850,9834,63.404050144648025,0.07639344262295082,Very Cheap
20150119T000000,250000.0,5,1.75,2190,8250,1.0,0,2,3,7,1190,1000,1963,0,98055,47.4887,-122.223,2570,8250,6060,5680,30.303030303030305,0.022950819672131147,Very Cheap
20150421T000000,385000.0,5,1.75,2190,8250,1.0,0,2,3,7,1190,1000,1963,0,98055,47.4887,-122.223,2570,8250,6060,5680,46.666666666666664,0.04065573770491803,Very Cheap
20140522T000000,307000.0,3,1.5,2320,7500,1.0,0,0,3,7,2320,0,1976,0,98019,47.7413,-121.979,1480,10000,5180,8520,40.93333333333333,0.03042622950819672,Very Cheap
20150513T000000,288000.0,3,2.5,1370,9253,1.0,0,0,3,7,1090,280,1994,0,98042,47.3717,-122.073,1470,9253,7883,7783,31.12504052739652,0.027934426229508195,Very Cheap
20141028T000000,226450.0,3,1.75,1730,7200,1.5,0,0,4,6,1730,0,1944,0,98032,47.3774,-122.236,860,7200,5470,6340,31.45138888888889,0.019862295081967213,Very Cheap
20150310T000000,390000.0,3,2.5,1640,6991,1.0,0,0,3,7,1110,530,1967,0,98125,47.7255,-122.327,1860,7342,5351,5482,55.78601058503791,0.04131147540983607,Very Cheap
20140930T000000,350000.0,3,1.0,1300,10236,1.0,0,0,4,6,1300,0,1971,0,98045,47.5028,-121.77,1380,11325,8936,9945,34.19304415787417,0.036065573770491806,Very Cheap
20141201T000000,368000.0,3,1.5,1560,7884,1.0,0,0,3,7,1060,500,1969,0,98125,47.7312,-122.298,1820,9000,6324,7180,46.67681380010147,0.03842622950819672,Very Cheap
20140818T000000,469000.0,2,1.0,1120,4284,1.0,0,0,3,6,730,390,1921,0,98105,47.6688,-122.324,2050,4160,3164,2110,109.47712418300654,0.05167213114754098,Very Cheap
20150323T000000,865000.0,3,2.25,2670,150270,2.0,0,0,3,9,2670,0,1985,0,98072,47.7601,-122.134,3080,81054,147600,77974,5.756305317095894,0.10360655737704919,Cheap
20150113T000000,515000.0,5,2.5,3810,15916,1.5,0,0,5,8,3810,0,1967,0,98058,47.4521,-122.14,2470,11662,12106,9192,32.35737622518221,0.057704918032786885,Very Cheap
20150123T000000,410000.0,3,1.75,1440,8560,1.0,0,0,4,7,1440,0,1979,0,98034,47.7296,-122.232,1460,7560,7120,6100,47.89719626168224,0.043934426229508196,Very Cheap
20140808T000000,210000.0,4,1.0,1200,43560,1.0,0,0,3,5,1200,0,1968,0,98042,47.3375,-122.123,1400,54450,42360,53050,4.820936639118457,0.017704918032786884,Very Cheap
20150325T000000,460000.0,3,1.75,1520,7700,1.0,0,0,3,7,820,700,1969,0,98034,47.7226,-122.219,1420,7674,6180,6254,59.74025974025974,0.050491803278688525,Very Cheap
20140919T000000,241500.0,4,2.5,2500,9654,1.0,0,0,3,8,1830,670,1979,0,98023,47.3137,-122.343,2500,8839,7154,6339,25.015537600994406,0.02183606557377049,Very Cheap
20140623T000000,322200.0,4,2.25,2010,19000,2.0,0,0,4,8,2010,0,1975,0,98042,47.3734,-122.119,1950,19626,16990,17676,16.957894736842107,0.03241967213114754,Very Cheap
20140818T000000,279000.0,4,1.0,1210,6000,1.5,0,2,3,7,1210,0,1943,0,98178,47.5026,-122.234,1470,6000,4790,4530,46.5,0.02675409836065574,Very Cheap
20140908T000000,303000.0,2,1.0,1100,27007,1.0,0,0,4,6,1100,0,1943,0,98070,47.4471,-122.473,1746,91476,25907,89730,11.219313511311881,0.029901639344262296,Very Cheap
20141020T000000,420000.0,3,1.5,1050,6615,1.0,0,0,4,6,800,250,1950,0,98199,47.6578,-122.39,1530,5250,5565,3720,63.492063492063494,0.04524590163934426,Very Cheap
20140813T000000,249000.0,3,1.75,2120,18335,1.0,0,0,3,7,1380,740,1961,0,98188,47.451,-122.273,2050,18333,16215,16283,13.580583583310608,0.02281967213114754,Very Cheap
20140714T000000,294950.0,3,1.0,1240,8840,1.0,0,0,3,6,1240,0,1952,0,98125,47.7277,-122.308,1250,8840,7600,7590,33.36538461538461,0.028845901639344262,Very Cheap
20140512T000000,1315000.0,4,3.5,3460,3997,2.0,0,0,3,10,2560,900,2004,0,98103,47.6718,-122.329,1860,4000,537,2140,328.9967475606705,0.16262295081967212,Cheap
20140915T000000,335000.0,3,1.75,1270,4800,1.0,0,0,3,7,1270,0,1953,0,98117,47.693,-122.361,1490,4800,3530,3310,69.79166666666667,0.03409836065573771,Very Cheap
20140605T000000,1155000.0,4,2.25,2980,8051,1.5,0,2,4,10,2020,960,1935,0,98199,47.6426,-122.409,2760,5499,5071,2739,143.46043969693207,0.14163934426229507,Cheap
20150311T000000,520000.0,2,1.0,1250,3708,1.5,0,0,3,7,1250,0,1926,0,98117,47.685,-122.363,1430,3708,2458,2278,140.23732470334411,0.058360655737704915,Very Cheap
20140916T000000,560000.0,4,1.75,1740,8800,1.0,0,0,4,8,1740,0,1965,0,98007,47.6232,-122.142,2180,8436,7060,6256,63.63636363636363,0.06360655737704918,Very Cheap
20141012T000000,243400.0,4,1.5,1730,7464,2.0,0,0,4,7,1730,0,1959,0,98032,47.3782,-122.304,1370,7860,5734,6490,32.60986066452304,0.022085245901639343,Very Cheap
20140529T000000,405000.0,3,2.0,1240,14404,1.0,0,0,3,7,1240,0,1988,0,98053,47.6614,-122.06,1350,9990,13164,8640,28.11718966953624,0.043278688524590166,Very Cheap
20141002T000000,495000.0,2,1.0,1670,14695,1.5,0,0,5,7,1670,0,1930,0,98033,47.7001,-122.2,1800,11355,13025,9555,33.68492684586594,0.05508196721311476,Very Cheap
20150402T000000,350000.0,4,2.5,2140,7095,2.0,0,0,3,8,2140,0,1992,0,98038,47.3528,-122.057,1600,7182,4955,5582,49.330514446793515,0.036065573770491806,Very Cheap
20141211T000000,368500.0,5,2.75,2530,7601,1.0,0,0,3,7,1520,1010,1992,0,98188,47.4683,-122.263,2400,7776,5071,5376,48.480463096960925,0.03849180327868852,Very Cheap
20150105T000000,99000.0,2,1.0,960,8236,1.0,0,0,2,6,960,0,1948,0,98058,47.4698,-122.166,1260,8236,7276,6976,12.020398251578436,0.003147540983606557,Very Cheap
20140603T000000,1070000.0,4,3.75,4130,12320,2.0,0,0,3,11,4130,0,2001,0,98059,47.5194,-122.151,3690,11227,8190,7537,86.85064935064935,0.13049180327868853,Cheap
20140826T000000,430000.0,4,1.75,1710,7724,1.0,0,0,3,8,1710,0,1983,0,98155,47.7721,-122.293,1940,7724,6014,5784,55.67063697566028,0.04655737704918033,Very Cheap
20140515T000000,412500.0,3,1.5,1490,8475,1.0,0,0,4,7,1490,0,1963,0,98052,47.6571,-122.133,1490,8540,6985,7050,48.67256637168141,0.04426229508196721,Very Cheap
20141213T000000,1122500.0,4,3.25,4750,62365,2.0,0,0,3,11,4750,0,1988,0,98052,47.7149,-122.099,3300,31866,57615,28566,17.998877575563217,0.13737704918032786,Cheap
20140828T000000,915000.0,4,2.5,3400,35062,2.0,0,0,4,11,3400,0,1988,0,98052,47.7168,-122.113,2880,9705,31662,6825,26.096628828931607,0.11016393442622952,Cheap
20140523T000000,535000.0,3,2.5,2210,7620,2.0,0,0,3,8,2210,0,1994,0,98052,47.6938,-122.13,1920,7440,5410,5520,70.20997375328083,0.06032786885245902,Very Cheap
20141104T000000,390000.0,3,1.5,1650,8676,1.0,0,0,4,8,1130,520,1979,0,98133,47.7471,-122.352,1400,8499,7026,7099,44.95159059474412,0.04131147540983607,Very Cheap
20140908T000000,499000.0,3,1.5,1260,3135,1.0,0,0,4,7,780,480,1944,0,98107,47.6693,-122.371,1540,3025,1875,1485,159.17065390749602,0.05560655737704918,Very Cheap
20140730T000000,375000.0,3,1.0,1960,7955,1.0,0,0,4,7,1260,700,1963,0,98177,47.7641,-122.364,1850,8219,5995,6369,47.14016341923319,0.03934426229508197,Very Cheap
20141028T000000,349000.0,4,2.5,1800,7620,2.0,0,0,3,8,1800,0,1995,0,98055,47.4346,-122.201,1800,6879,5820,5079,45.800524934383205,0.035934426229508196,Very Cheap
20141031T000000,635000.0,3,2.25,1940,7482,1.0,0,0,4,7,1240,700,1964,0,98004,47.6004,-122.195,2340,9310,5542,6970,84.87035551991445,0.07344262295081967,Very Cheap
20141215T000000,682000.0,4,2.75,2820,8009,2.0,0,0,3,9,2820,0,2001,0,98075,47.6,-121.977,2820,7398,5189,4578,85.1542015232863,0.07960655737704918,Very Cheap
20150203T000000,321027.0,4,2.25,2820,16770,1.0,0,0,4,8,1920,900,1966,0,98023,47.3186,-122.364,2320,13850,13950,11530,19.14293381037567,0.03226583606557377,Very Cheap
20141125T000000,150000.0,2,1.0,720,4120,1.0,0,0,5,5,720,0,1915,0,98002,47.303,-122.217,940,6180,3400,5240,36.407766990291265,0.009836065573770493,Very Cheap
20141213T000000,410000.0,3,1.75,1640,17583,1.0,0,0,3,7,1110,530,1969,0,98034,47.726,-122.203,1420,11680,15943,10260,23.317977591992264,0.043934426229508196,Very Cheap
20140523T000000,449950.0,3,2.0,1560,4080,2.0,0,0,3,7,1560,0,1923,1982,98115,47.6892,-122.319,1900,4080,2520,2180,110.28186274509804,0.04917377049180328,Very Cheap
20141013T000000,194990.0,6,2.5,1560,7144,1.0,0,0,3,6,1060,500,1913,0,98118,47.5335,-122.272,1300,6232,5584,4932,27.294232922732363,0.01573639344262295,Very Cheap
20150102T000000,475000.0,4,1.75,1910,8775,1.0,0,0,3,7,1210,700,1956,0,98028,47.7396,-122.247,2210,8778,6865,6568,54.13105413105413,0.05245901639344262,Very Cheap
20150128T000000,530000.0,5,1.75,1570,3000,2.0,0,0,4,7,1570,0,1908,0,98105,47.6677,-122.316,1610,3000,1430,1390,176.66666666666666,0.05967213114754098,Very Cheap
20140722T000000,319950.0,4,2.5,2038,7643,2.0,0,0,3,8,2038,0,2011,0,98092,47.3296,-122.18,2634,6824,5605,4190,41.861834358236294,0.03212459016393442,Very Cheap
20150327T000000,210000.0,3,2.25,1720,9435,1.0,0,0,4,7,1220,500,1978,0,98023,47.2979,-122.377,1690,7215,7715,5525,22.257551669316374,0.017704918032786884,Very Cheap
20141226T000000,485000.0,3,2.75,1670,3330,1.5,0,0,4,7,1670,0,1925,0,98107,47.6551,-122.36,1370,5000,1660,3630,145.64564564564566,0.05377049180327869,Very Cheap
20150128T000000,774000.0,4,2.75,2830,10240,2.0,0,0,4,9,2830,0,1998,0,98075,47.5903,-121.986,3490,10240,7410,6750,75.5859375,0.09167213114754098,Very Cheap
20141015T000000,478000.0,4,2.0,1690,8208,1.0,0,0,4,7,1210,480,1958,0,98008,47.6052,-122.126,1620,8496,6518,6876,58.23586744639376,0.05285245901639344,Very Cheap
20141023T000000,385000.0,4,2.5,1620,5280,2.0,0,0,4,7,1620,0,1924,1971,98146,47.5132,-122.384,1590,5280,3660,3690,72.91666666666667,0.04065573770491803,Very Cheap
20150417T000000,595000.0,4,2.5,2360,43017,2.0,0,0,3,9,2360,0,1989,0,98077,47.774,-122.077,2750,40334,40657,37584,13.831740939628519,0.06819672131147542,Very Cheap
20150318T000000,285000.0,3,1.5,1480,7117,1.0,0,0,3,7,1170,310,1960,0,98028,47.7766,-122.248,2230,14775,5637,12545,40.04496276521006,0.02754098360655738,Very Cheap
20140514T000000,723000.0,4,2.5,2700,4004,2.0,0,0,3,9,2700,0,2004,0,98029,47.5521,-121.995,2260,4459,1304,2199,180.56943056943058,0.08498360655737705,Very Cheap
20140812T000000,279000.0,3,1.5,1780,16000,1.0,0,0,2,7,1240,540,1960,0,98198,47.419,-122.322,1860,9775,14220,7915,17.4375,0.02675409836065574,Very Cheap
20150306T000000,195000.0,3,1.5,1430,7560,1.0,0,0,5,6,1430,0,1958,0,98058,47.4518,-122.179,1150,7560,6130,6410,25.793650793650794,0.015737704918032787,Very Cheap
20141015T000000,625000.0,2,1.0,2160,2192,1.0,0,0,5,8,1170,990,1925,0,98119,47.6364,-122.371,1150,2152,32,1002,285.12773722627736,0.07213114754098361,Very Cheap
20150428T000000,270000.0,3,1.75,1800,9314,2.0,0,0,3,8,1800,0,1979,0,98011,47.7762,-122.198,2100,9658,7514,7558,28.988619282800087,0.025573770491803278,Very Cheap
20141007T000000,559000.0,2,2.0,1930,5520,1.0,0,0,3,8,1930,0,2006,0,98053,47.7191,-122.022,1640,4533,3590,2893,101.26811594202898,0.06347540983606557,Very Cheap
20150202T000000,474000.0,4,2.25,1960,14834,1.0,0,0,4,8,1330,630,1976,0,98072,47.7434,-122.095,1540,15000,12874,13460,31.953620062019684,0.05232786885245902,Very Cheap
20141114T000000,303500.0,4,2.5,1920,7345,2.0,0,0,3,8,1920,0,1992,0,98038,47.3526,-122.055,1860,7364,5425,5504,41.32062627637849,0.029967213114754098,Very Cheap
20141226T000000,350000.0,3,1.75,1470,8645,1.0,0,0,3,6,1470,0,1949,0,98155,47.7524,-122.323,1470,7680,7175,6210,40.48582995951417,0.036065573770491806,Very Cheap
20140806T000000,367500.0,5,3.0,2980,10064,1.0,0,0,3,7,1680,1300,1940,0,98155,47.7372,-122.316,1590,7800,7084,6210,36.516295707472175,0.03836065573770492,Very Cheap
20150225T000000,595000.0,5,3.0,2980,10064,1.0,0,0,3,7,1680,1300,1940,0,98155,47.7372,-122.316,1590,7800,7084,6210,59.12162162162162,0.06819672131147542,Very Cheap
20141006T000000,589000.0,3,2.0,2360,118483,1.0,0,0,3,8,2360,0,1981,0,98024,47.5595,-121.867,2660,91476,116123,88816,4.971177299697003,0.06740983606557377,Very Cheap
20150306T000000,585000.0,3,1.75,1790,87213,1.0,0,0,4,7,1790,0,1974,0,98077,47.732,-122.077,3270,39586,85423,36316,6.707715592858863,0.06688524590163934,Very Cheap
20141002T000000,482975.0,3,2.25,2130,8801,1.0,0,0,3,8,1370,760,1976,0,98155,47.7462,-122.29,2820,8801,6671,5981,54.877286671969095,0.05350491803278688,Very Cheap
20141119T000000,365500.0,4,2.5,2030,4499,2.0,0,0,3,8,2030,0,2003,0,98058,47.4511,-122.119,2030,4539,2469,2509,81.24027561680373,0.038098360655737705,Very Cheap
20140711T000000,570000.0,4,2.0,1790,7800,1.0,0,0,5,8,1790,0,1972,0,98008,47.6266,-122.103,2150,7838,6010,5688,73.07692307692308,0.06491803278688525,Very Cheap
20150202T000000,335000.0,3,2.5,2260,8040,2.0,0,0,3,8,2260,0,1990,0,98092,47.3203,-122.184,2390,8040,5780,5650,41.666666666666664,0.03409836065573771,Very Cheap
20150408T000000,767500.0,4,2.0,2350,4815,1.5,0,0,4,7,1450,900,1914,0,98103,47.6681,-122.338,1640,4013,2465,2373,159.39771547248182,0.09081967213114754,Very Cheap
20140519T000000,386591.0,3,2.5,1690,1613,2.0,0,0,3,8,1150,540,2014,0,98029,47.5518,-121.998,1690,1662,-77,-28,239.67203967761935,0.04086439344262295,Very Cheap
20140722T000000,279000.0,3,1.0,1320,5750,1.5,0,0,3,7,1320,0,1913,0,98108,47.5288,-122.325,1010,5700,4430,4690,48.52173913043478,0.02675409836065574,Very Cheap
20150409T000000,620000.0,4,2.5,2690,32780,2.0,0,0,3,9,2690,0,1998,0,98014,47.6612,-121.955,2840,36555,30090,33715,18.91397193410616,0.07147540983606557,Very Cheap
20140506T000000,407000.0,4,2.25,2810,23400,1.0,0,1,3,7,1710,1100,1958,0,98198,47.395,-122.311,1860,14900,20590,13040,17.39316239316239,0.04354098360655738,Very Cheap
20140827T000000,364250.0,3,2.5,2280,213879,2.0,0,0,3,8,2280,0,1994,0,98038,47.4213,-122.033,2380,178160,211599,175780,1.7030657521308776,0.0379344262295082,Very Cheap
20140527T000000,399000.0,4,2.5,2870,9292,2.0,0,0,3,8,2540,330,1979,0,98058,47.4522,-122.123,2590,7533,6422,4943,42.94016358157555,0.042491803278688525,Very Cheap
20140514T000000,766950.0,3,2.5,3030,30007,1.5,0,0,4,10,3030,0,1992,0,98077,47.743,-122.036,3360,34983,26977,31623,25.55903622488086,0.09074754098360656,Very Cheap
20140918T000000,710000.0,4,2.75,2940,4232,2.0,0,0,3,9,2940,0,2004,0,98029,47.5529,-121.99,2410,4000,1292,1590,167.76937618147448,0.08327868852459017,Very Cheap
20150224T000000,320000.0,3,1.0,1190,4120,1.0,0,0,3,6,1190,0,1929,0,98118,47.5513,-122.272,1360,4635,2930,3275,77.66990291262135,0.032131147540983604,Very Cheap
20141023T000000,300000.0,3,2.5,1800,3253,2.0,0,0,3,7,1800,0,2001,0,98108,47.5401,-122.292,1800,3081,1453,1281,92.22256378727329,0.029508196721311476,Very Cheap
20140710T000000,263000.0,3,1.75,1580,9187,1.0,0,0,3,8,1180,400,1993,0,98038,47.3538,-122.047,1620,6397,7607,4777,28.627408294328944,0.024655737704918034,Very Cheap
20141010T000000,445000.0,3,2.5,1730,4408,2.0,0,0,3,8,1730,0,1996,0,98029,47.5683,-122.005,1730,4408,2678,2678,100.95281306715063,0.04852459016393443,Very Cheap
20150406T000000,554000.0,3,2.0,1910,9001,1.0,0,0,4,7,1910,0,1957,0,98008,47.6037,-122.119,2040,8700,7091,6660,61.548716809243416,0.06281967213114754,Very Cheap
20140724T000000,335000.0,2,1.75,1000,5100,1.0,0,0,3,6,940,60,1906,0,98117,47.6787,-122.391,1900,5100,4100,3200,65.68627450980392,0.03409836065573771,Very Cheap
20141229T000000,307000.0,4,2.75,2520,6964,1.0,0,0,4,7,1260,1260,1987,0,98031,47.4038,-122.175,1930,6949,4444,5019,44.08385985066054,0.03042622950819672,Very Cheap
20150302T000000,404000.0,3,1.0,1420,8160,1.0,0,0,3,7,970,450,1947,0,98125,47.7164,-122.306,1340,8160,6740,6820,49.509803921568626,0.043147540983606555,Very Cheap
20140731T000000,775000.0,4,3.5,3080,5250,2.0,0,0,3,9,3080,0,2003,0,98075,47.5992,-121.972,2980,5509,2170,2529,147.61904761904762,0.09180327868852459,Very Cheap
20140521T000000,220000.0,3,1.0,1060,9126,1.0,0,2,5,7,1060,0,1956,0,98022,47.201,-121.999,1300,9126,8066,7826,24.10694718387026,0.01901639344262295,Very Cheap
20140903T000000,518000.0,4,2.5,2160,9750,2.0,0,0,3,8,2160,0,1983,0,98028,47.7438,-122.246,2840,10535,7590,7695,53.12820512820513,0.0580983606557377,Very Cheap
20141209T000000,1600000.0,4,3.5,4060,9486,2.0,0,0,3,10,4060,0,2005,0,98033,47.6634,-122.2,2410,9486,5426,7076,168.6696183849884,0.2,Cheap
20141023T000000,315000.0,1,2.25,1940,2550,2.0,0,0,4,7,1100,840,1979,0,98133,47.7313,-122.343,1580,5100,610,3520,123.52941176470588,0.031475409836065574,Very Cheap
20140731T000000,572650.0,4,2.5,2250,11349,2.0,0,0,3,8,2250,0,1991,0,98034,47.7111,-122.239,2110,9964,9099,7854,50.4581901489118,0.0652655737704918,Very Cheap
20140619T000000,350000.0,2,1.0,1620,9205,1.0,0,0,5,6,850,770,1921,0,98034,47.7119,-122.23,2460,5469,7585,3009,38.02281368821293,0.036065573770491806,Very Cheap
20140919T000000,285000.0,2,1.0,920,5850,1.0,0,0,4,6,920,0,1900,0,98108,47.5441,-122.304,1640,5476,4930,3836,48.717948717948715,0.02754098360655738,Very Cheap
20150325T000000,231000.0,3,2.5,1370,7247,2.0,0,0,3,7,1370,0,1995,0,98032,47.3767,-122.303,1720,8085,5877,6365,31.875258727749415,0.020459016393442622,Very Cheap
20140813T000000,179000.0,3,1.0,920,5200,1.0,0,0,4,6,920,0,1969,0,98042,47.3603,-122.085,920,5200,4280,4280,34.42307692307692,0.013639344262295083,Very Cheap
20150330T000000,244000.0,3,1.5,1360,9625,1.0,0,0,3,7,1360,0,1963,0,98030,47.3799,-122.211,1890,9625,8265,7735,25.350649350649352,0.02216393442622951,Very Cheap
20150306T000000,185850.0,3,1.5,1630,11662,1.0,0,0,3,7,1630,0,1943,1963,98188,47.4455,-122.278,1700,11662,10032,9962,15.936374549819927,0.014537704918032787,Very Cheap
20141222T000000,610000.0,6,2.5,3610,12033,2.0,0,0,3,8,3210,400,1970,0,98011,47.7692,-122.219,2210,8577,8423,6367,50.69392503947478,0.07016393442622951,Very Cheap
20141010T000000,419000.0,4,2.5,3010,9155,2.0,0,0,3,9,3010,0,2005,0,98038,47.3542,-122.027,3010,5762,6145,2752,45.76734025122884,0.04511475409836065,Very Cheap
20140826T000000,779000.0,3,1.75,2320,6400,1.0,0,2,4,8,1420,900,1957,0,98199,47.6449,-122.389,2540,7680,4080,5140,121.71875,0.09232786885245901,Very Cheap
20140915T000000,695000.0,5,3.0,3290,14134,1.0,0,0,3,7,1870,1420,2004,0,98052,47.6708,-122.14,1970,11470,10844,9500,49.172208858072736,0.08131147540983606,Very Cheap
20150320T000000,319900.0,3,2.5,2040,7580,2.0,0,2,3,8,2040,0,1998,0,98092,47.2618,-122.209,1960,7820,5540,5860,42.20316622691293,0.03211803278688525,Very Cheap
20150112T000000,329000.0,3,2.75,1920,7700,1.0,0,0,4,8,1320,600,1978,0,98023,47.3213,-122.378,2040,8000,5780,5960,42.72727272727273,0.03331147540983607,Very Cheap
20140827T000000,475226.0,3,2.5,2120,4512,2.0,0,0,3,8,2120,0,1988,0,98011,47.75,-122.183,2000,4553,2392,2553,105.32491134751773,0.05248865573770492,Very Cheap
20150325T000000,638000.0,3,2.5,2170,5000,2.0,0,0,3,9,2170,0,2003,0,98029,47.5453,-121.996,2170,5000,2830,2830,127.6,0.0738360655737705,Very Cheap
20150325T000000,440000.0,2,1.5,1330,15873,1.0,0,0,3,7,900,430,1984,0,98074,47.6359,-122.033,1610,12043,14543,10433,27.72002772002772,0.04786885245901639,Very Cheap
20150209T000000,214000.0,3,2.0,1580,5080,1.0,0,0,4,6,800,780,1942,0,98146,47.4963,-122.35,1580,7114,3500,5534,42.125984251968504,0.01822950819672131,Very Cheap
20150429T000000,600000.0,3,2.75,3580,14217,2.0,0,3,4,10,2210,1370,1989,0,98023,47.3244,-122.379,3990,14674,10637,10684,42.20299641274531,0.06885245901639345,Very Cheap
20150414T000000,935000.0,4,2.0,2580,4500,2.0,0,0,4,9,1850,730,1905,0,98102,47.6245,-122.316,2590,4100,1920,1510,207.77777777777777,0.11278688524590164,Cheap
20141027T000000,630000.0,4,1.75,1930,10210,1.5,0,2,3,8,1670,260,1941,0,98125,47.7078,-122.277,2730,6600,8280,3870,61.704211557296766,0.07278688524590164,Very Cheap
20140930T000000,575000.0,3,2.5,2120,4780,2.0,0,0,3,7,2120,0,2004,0,98053,47.681,-122.032,1690,2650,2660,960,120.2928870292887,0.06557377049180328,Very Cheap
20141106T000000,345000.0,3,2.5,1990,20466,1.5,0,0,4,8,1410,580,1987,0,98010,47.3259,-121.896,1660,93393,18476,91733,16.8572266197596,0.03540983606557377,Very Cheap
20140716T000000,323000.0,4,1.75,1310,9690,1.0,0,0,4,7,1310,0,1967,0,98011,47.7559,-122.226,2280,9618,8380,7338,33.333333333333336,0.03252459016393443,Very Cheap
20140516T000000,425000.0,3,2.5,2670,13218,1.0,0,0,4,10,2670,0,1988,0,98042,47.3683,-122.153,1960,13130,10548,11170,32.15312452715993,0.04590163934426229,Very Cheap
20150505T000000,411000.0,2,2.25,1910,108900,1.0,0,0,4,7,1010,900,1972,0,98038,47.4206,-122.023,2050,108900,106990,106850,3.7741046831955924,0.044065573770491806,Very Cheap
20140721T000000,299800.0,4,1.5,1530,9000,1.0,0,0,4,6,1530,0,1976,0,98014,47.6492,-121.908,1520,8500,7470,6980,33.31111111111111,0.029481967213114753,Very Cheap
20140505T000000,823000.0,6,1.75,2920,5000,2.5,0,0,4,9,2780,140,1908,0,98122,47.6024,-122.295,2020,5000,2080,2980,164.6,0.09809836065573771,Very Cheap
20140908T000000,200000.0,3,1.0,1010,8108,1.0,0,0,3,7,1010,0,1955,0,98155,47.735,-122.309,1110,8108,7098,6998,24.666995559940798,0.01639344262295082,Very Cheap
20140520T000000,760000.0,4,1.75,2450,13300,1.0,0,2,4,9,1630,820,1987,0,98006,47.5564,-122.13,3150,15500,10850,12350,57.142857142857146,0.0898360655737705,Very Cheap
20150428T000000,359950.0,4,2.5,1820,3899,2.0,0,0,3,7,1820,0,1999,0,98019,47.735,-121.985,1820,3899,2079,2079,92.31854321620928,0.037370491803278685,Very Cheap
20150203T000000,375000.0,4,2.5,2090,8325,1.0,0,0,4,7,1470,620,1983,0,98056,47.4888,-122.184,1700,8025,6235,6325,45.04504504504504,0.03934426229508197,Very Cheap
20140508T000000,295000.0,2,1.75,2200,89298,1.0,0,0,3,7,1100,1100,1973,0,98027,47.4633,-121.976,2590,89298,87098,86708,3.3035454321485362,0.028852459016393443,Very Cheap
20150319T000000,250000.0,4,3.0,2250,7882,2.0,0,0,3,8,1570,680,1986,0,98198,47.3703,-122.314,1550,7508,5632,5958,31.717838112154276,0.022950819672131147,Very Cheap
20141023T000000,497000.0,3,2.25,1450,1387,3.0,0,0,3,8,1450,0,2000,0,98115,47.6765,-122.302,1450,1429,-63,-21,358.32732516222063,0.055344262295081964,Very Cheap
20140813T000000,520000.0,4,2.5,2280,8798,2.0,0,0,4,8,2280,0,1987,0,98028,47.7471,-122.247,2180,8632,6518,6452,59.104341895885426,0.058360655737704915,Very Cheap
20140717T000000,365000.0,4,3.5,2720,6781,2.0,0,0,3,8,2100,620,1999,0,98055,47.4612,-122.215,2280,5942,4061,3662,53.82686919333432,0.0380327868852459,Very Cheap
20141208T000000,459900.0,3,2.25,2250,8000,1.0,0,0,3,8,1460,790,1976,0,98034,47.7229,-122.202,1930,9000,5750,7070,57.4875,0.050478688524590164,Very Cheap
20150506T000000,158000.0,3,2.0,1090,6090,1.0,0,0,3,7,940,150,1940,0,98118,47.5118,-122.259,1840,6090,5000,4250,25.94417077175698,0.010885245901639345,Very Cheap
20140606T000000,294700.0,3,2.0,1970,9600,1.0,0,0,4,7,1300,670,1967,0,98003,47.2824,-122.301,1710,7703,7630,5993,30.697916666666668,0.02881311475409836,Very Cheap
20140819T000000,439950.0,4,2.25,2780,15075,2.0,0,0,3,7,2780,0,1985,0,98059,47.477,-122.116,1650,25542,12295,23892,29.18407960199005,0.04786229508196721,Very Cheap
20150108T000000,899000.0,4,2.25,2290,40946,1.0,0,3,4,8,1550,740,1960,0,98008,47.616,-122.103,2790,20076,38656,17286,21.955746593073805,0.10806557377049181,Cheap
20140702T000000,535000.0,3,1.75,2330,12141,1.0,0,0,3,7,1390,940,1983,0,98072,47.7607,-122.146,1850,12141,9811,10291,44.065562968453996,0.06032786885245902,Very Cheap
20150124T000000,530000.0,4,4.5,4060,10800,2.0,0,0,3,10,4060,0,2007,0,98188,47.4241,-122.29,1830,9768,6740,7938,49.074074074074076,0.05967213114754098,Very Cheap
20150204T000000,215000.0,4,2.0,1470,7000,1.0,0,0,4,8,1470,0,1967,0,98032,47.3742,-122.289,1640,7000,5530,5360,30.714285714285715,0.018360655737704918,Very Cheap
20150203T000000,290000.0,2,1.0,1620,5400,1.0,0,0,3,6,920,700,1926,0,98125,47.7069,-122.299,1540,7245,3780,5705,53.7037037037037,0.02819672131147541,Very Cheap
20150311T000000,798000.0,5,2.75,3220,5934,2.0,0,0,3,9,3220,0,2006,0,98052,47.7076,-122.101,3100,5934,2714,2834,134.47927199191102,0.09481967213114754,Very Cheap
20141107T000000,785000.0,4,2.5,3270,9578,2.0,0,0,3,9,3270,0,1993,0,98027,47.5373,-122.051,3120,8784,6308,5664,81.9586552516183,0.09311475409836066,Very Cheap
20150318T000000,433000.0,3,1.75,2160,8565,1.0,0,0,3,8,1730,430,1971,0,98028,47.7664,-122.262,2910,9570,6405,6660,50.55458260361938,0.04695081967213115,Very Cheap
20140721T000000,425000.0,2,1.0,1150,6835,1.0,0,1,3,7,1010,140,1922,0,98118,47.5567,-122.273,1150,6561,5685,5411,62.179956108266275,0.04590163934426229,Very Cheap
20140724T000000,654000.0,4,2.5,2240,7540,1.0,0,0,3,8,1540,700,1962,0,98115,47.6965,-122.308,1960,7250,5300,5290,86.73740053050398,0.0759344262295082,Very Cheap
20141017T000000,215000.0,3,1.5,1280,5065,2.0,0,0,4,6,1280,0,1983,0,98002,47.3343,-122.217,1070,4491,3785,3421,42.44817374136229,0.018360655737704918,Very Cheap
20150318T000000,232000.0,3,1.0,840,6540,1.0,0,0,3,6,840,0,1970,2014,98042,47.3743,-122.116,1010,6600,5700,5590,35.47400611620795,0.02059016393442623,Very Cheap
20140507T000000,675000.0,3,1.75,1680,10500,1.0,0,0,4,8,1680,0,1959,0,98005,47.6098,-122.169,2250,10400,8820,8150,64.28571428571429,0.07868852459016394,Very Cheap
20141104T000000,665000.0,5,2.75,2330,8000,1.0,0,0,4,7,1550,780,1972,0,98052,47.6651,-122.144,1750,8419,5670,6669,83.125,0.07737704918032787,Very Cheap
20140623T000000,835000.0,4,2.5,3030,29163,2.0,0,0,3,10,3030,0,1998,0,98053,47.6569,-122.02,2780,40669,26133,37889,28.63217090148476,0.09967213114754099,Very Cheap
20140814T000000,525000.0,6,3.0,2880,7560,2.0,0,0,3,7,2880,0,1980,0,98144,47.5959,-122.3,1470,1815,4680,345,69.44444444444444,0.05901639344262295,Very Cheap
20150504T000000,780000.0,3,2.75,2910,3094,2.0,0,2,5,7,2010,900,1939,0,98125,47.7071,-122.276,2400,7530,184,5130,252.10084033613447,0.09245901639344262,Very Cheap
20140815T000000,844000.0,4,3.25,3090,67518,2.0,0,0,3,10,3090,0,1988,0,98053,47.6674,-122.046,3200,65775,64428,62575,12.500370271631269,0.10085245901639345,Cheap
20150127T000000,680000.0,4,2.75,2720,54048,2.0,0,0,3,8,2720,0,1985,0,98072,47.7181,-122.089,2580,37721,51328,35141,12.581409117821195,0.07934426229508197,Very Cheap
20140825T000000,290000.0,3,1.5,1310,8100,1.0,0,0,3,7,1310,0,1965,0,98034,47.7328,-122.201,1330,8100,6790,6770,35.80246913580247,0.02819672131147541,Very Cheap
20150325T000000,560000.0,2,1.0,1790,15783,1.0,0,0,4,8,1360,430,1959,0,98117,47.691,-122.387,1790,7494,13993,5704,35.48121396439207,0.06360655737704918,Very Cheap
20140617T000000,605500.0,3,2.5,2830,6536,2.0,0,0,3,9,2830,0,1989,0,98072,47.7462,-122.172,2710,6954,3706,4244,92.640758873929,0.06957377049180327,Very Cheap
20140826T000000,762500.0,4,2.5,3150,5979,2.0,0,0,3,9,3150,0,2005,0,98052,47.7082,-122.101,3150,6595,2829,3445,127.52968723866867,0.09016393442622951,Very Cheap
20150305T000000,1740000.0,5,3.25,3930,5500,2.0,0,0,3,9,2910,1020,2014,0,98033,47.6802,-122.208,2040,5115,1570,3075,316.3636363636364,0.2183606557377049,Cheap
20140624T000000,665000.0,6,2.75,2840,8346,1.0,0,0,5,8,1420,1420,1961,0,98118,47.5518,-122.266,2250,8346,5506,6096,79.67888809010304,0.07737704918032787,Very Cheap
20150311T000000,540000.0,5,1.0,2480,4400,1.5,0,0,3,7,1640,840,1919,0,98122,47.6046,-122.3,1940,4400,1920,2460,122.72727272727273,0.06098360655737705,Very Cheap
20141119T000000,375000.0,3,2.5,1930,6180,1.0,0,0,3,7,1330,600,1961,0,98155,47.7481,-122.327,1940,6180,4250,4240,60.679611650485434,0.03934426229508197,Very Cheap
20140516T000000,342000.0,3,1.0,1260,6826,1.0,0,0,3,6,720,540,1944,0,98125,47.731,-122.303,1300,6826,5566,5526,50.102549077058306,0.03501639344262295,Very Cheap
20150310T000000,340000.0,3,1.0,670,23522,1.0,0,0,4,6,670,0,1968,0,98024,47.5329,-121.89,1880,20270,22852,18390,14.45455318425304,0.03475409836065574,Very Cheap
20150330T000000,1250000.0,5,3.25,3930,12719,2.0,0,2,4,10,2540,1390,1974,0,98040,47.5631,-122.213,3600,15909,8789,12309,98.27816652252535,0.1540983606557377,Cheap
20141210T000000,693000.0,4,2.5,3160,13063,2.0,0,0,3,10,3160,0,1999,0,98075,47.5996,-122.021,3350,14213,9903,10863,53.05060093393554,0.08104918032786886,Very Cheap
20150420T000000,638500.0,4,1.75,1770,12462,1.0,0,2,4,8,1770,0,1962,0,98166,47.4355,-122.338,2310,14810,10692,12500,51.23575670036912,0.07390163934426229,Very Cheap
20150126T000000,805000.0,5,3.0,2240,18265,2.0,0,0,4,8,2240,0,1963,0,98027,47.5171,-122.029,1990,18265,16025,16275,44.073364358061866,0.09573770491803278,Very Cheap
20140709T000000,250000.0,3,1.0,990,8062,1.0,0,0,4,7,990,0,1960,0,98198,47.4151,-122.334,1420,8790,7072,7370,31.009675018605805,0.022950819672131147,Very Cheap
20150501T000000,325000.0,3,2.5,1580,4698,2.0,0,0,3,7,1580,0,1998,0,98038,47.3539,-122.025,2070,4698,3118,2628,69.17837377607492,0.03278688524590164,Very Cheap
20150401T000000,270000.0,4,1.75,1560,4290,2.0,0,0,3,7,1560,0,1994,0,98108,47.5292,-122.323,1250,6000,2730,4750,62.93706293706294,0.025573770491803278,Very Cheap
20140710T000000,880000.0,6,2.5,2640,3680,2.0,0,0,5,8,1760,880,1922,0,98126,47.5771,-122.38,1960,3680,1040,1720,239.1304347826087,0.10557377049180328,Cheap
20140806T000000,300000.0,2,1.75,2120,6350,1.0,0,0,4,6,1440,680,1924,0,98103,47.6974,-122.356,1590,6350,4230,4760,47.24409448818898,0.029508196721311476,Very Cheap
20141215T000000,290000.0,2,1.0,1200,8750,1.0,0,0,3,6,1200,0,1948,0,98155,47.7548,-122.327,1100,8408,7550,7308,33.142857142857146,0.02819672131147541,Very Cheap
20150501T000000,2850000.0,4,4.0,5040,17208,1.0,0,0,5,10,2870,2170,1976,0,98006,47.5701,-122.188,4050,18647,12168,14597,165.62064156206415,0.3639344262295082,Medium
20150123T000000,259950.0,3,1.0,1460,5825,1.0,0,0,5,5,1260,200,1942,0,98056,47.4958,-122.191,1150,5926,4365,4776,44.62660944206009,0.024255737704918033,Very Cheap
20141010T000000,1780000.0,4,3.25,4890,13402,2.0,0,0,3,13,4890,0,2004,0,98059,47.5303,-122.131,5790,13539,8512,7749,132.81599761229668,0.22360655737704918,Cheap
20141106T000000,299950.0,3,1.0,1580,5250,1.0,0,0,5,7,1580,0,1954,0,98056,47.4964,-122.168,1180,5940,3670,4760,57.13333333333333,0.029501639344262295,Very Cheap
20150406T000000,483000.0,3,2.25,2100,43560,1.0,0,0,4,8,1330,770,1977,0,98077,47.7511,-122.072,2100,43560,41460,41460,11.088154269972451,0.05350819672131148,Very Cheap
20140612T000000,890000.0,3,2.25,2060,8640,1.0,0,0,4,8,2060,0,1966,0,98033,47.6534,-122.195,2030,9000,6580,6970,103.00925925925925,0.10688524590163935,Cheap
20140508T000000,719000.0,3,2.5,1690,4500,1.5,0,1,4,8,1690,0,1928,0,98116,47.5841,-122.383,2140,7200,2810,5060,159.77777777777777,0.08445901639344262,Very Cheap
20141008T000000,785000.0,4,3.0,3370,100681,1.0,0,0,5,8,1920,1450,1977,0,98058,47.4319,-122.148,2440,43705,97311,41265,7.79690308995739,0.09311475409836066,Very Cheap
20150326T000000,660000.0,3,2.5,2330,3995,2.0,0,0,3,9,2330,0,2006,0,98029,47.5542,-122.001,2330,3740,1665,1410,165.20650813516897,0.07672131147540984,Very Cheap
20140618T000000,264000.0,4,1.75,1820,8118,1.0,0,0,4,7,1080,740,1980,0,98031,47.4104,-122.172,1810,8050,6298,6240,32.520325203252035,0.02478688524590164,Very Cheap
20140908T000000,575000.0,3,1.75,1890,11141,1.0,0,0,4,8,1890,0,1968,0,98006,47.5697,-122.163,2720,11144,9251,8424,51.61116596355803,0.06557377049180328,Very Cheap
20140624T000000,1215000.0,4,3.75,3820,53574,1.0,0,0,3,10,3820,0,1994,0,98072,47.7337,-122.121,3140,54014,49754,50874,22.678911412252212,0.14950819672131146,Cheap
20140815T000000,475000.0,3,2.5,2770,98881,2.0,0,0,3,9,2770,0,1991,0,98022,47.2568,-121.952,1830,74923,96111,73093,4.8037540073421585,0.05245901639344262,Very Cheap
20141121T000000,845800.0,4,3.5,3020,12750,2.0,0,0,3,10,3020,0,1990,0,98033,47.6524,-122.184,3120,14351,9730,11231,66.33725490196079,0.10108852459016393,Cheap
20140611T000000,352500.0,3,1.75,1170,8182,1.0,0,0,3,7,1170,0,1962,0,98155,47.7368,-122.298,1610,8183,7012,6573,43.08237594720117,0.03639344262295082,Very Cheap
20140623T000000,347000.0,3,1.0,1270,8400,1.0,0,0,3,7,1270,0,1955,0,98011,47.7604,-122.198,1390,8400,7130,7010,41.30952380952381,0.03567213114754098,Very Cheap
20150109T000000,560000.0,4,2.75,1950,6192,2.0,0,0,3,8,1950,0,1992,0,98029,47.5698,-121.999,2040,5441,4242,3401,90.43927648578811,0.06360655737704918,Very Cheap
20150504T000000,323000.0,4,2.75,2230,50094,1.0,0,2,4,7,1330,900,1977,0,98092,47.2576,-122.099,2230,40770,47864,38540,6.447877989379966,0.03252459016393443,Very Cheap
20150306T000000,595000.0,3,1.75,2220,22081,1.5,0,0,4,7,2220,0,1922,0,98166,47.4693,-122.364,2010,12360,19861,10350,26.946243376658664,0.06819672131147542,Very Cheap
20150220T000000,257500.0,4,2.0,2060,6400,1.0,0,0,3,7,1170,890,1977,0,98002,47.2924,-122.197,1890,8736,4340,6846,40.234375,0.023934426229508195,Very Cheap
20140528T000000,450000.0,3,1.0,1100,4600,1.0,0,0,3,7,1100,0,1917,0,98116,47.5686,-122.385,1200,5175,3500,3975,97.82608695652173,0.04918032786885246,Very Cheap
20141113T000000,410000.0,4,1.0,1140,7208,1.0,0,0,3,7,900,240,1970,0,98072,47.742,-122.173,1300,7991,6068,6691,56.88124306326304,0.043934426229508196,Very Cheap
20140613T000000,810000.0,3,1.75,1980,13503,1.0,0,2,4,9,1320,660,1952,0,98008,47.5867,-122.111,2450,10890,11523,8440,59.98666962897134,0.09639344262295083,Very Cheap
20140512T000000,372500.0,5,3.0,2480,10090,1.0,0,0,3,7,1300,1180,2004,0,98178,47.4964,-122.263,2290,9900,7610,7610,36.91774033696729,0.03901639344262295,Very Cheap
20141203T000000,325000.0,3,1.0,1050,9083,1.0,0,0,3,7,1050,0,1951,0,98155,47.7533,-122.307,1440,9071,8033,7631,35.78112958273698,0.03278688524590164,Very Cheap
20141021T000000,280000.0,3,1.0,1260,7660,1.0,0,0,3,6,1260,0,1947,0,98133,47.7476,-122.35,1990,7861,6400,5871,36.55352480417755,0.026885245901639345,Very Cheap
20140711T000000,258000.0,3,2.0,1680,19978,1.0,0,0,3,6,880,800,1948,0,98198,47.3924,-122.308,2150,11588,18298,9438,12.914205626188808,0.024,Very Cheap
20140827T000000,329950.0,4,1.0,1360,5900,1.5,0,0,4,7,1360,0,1949,0,98155,47.7512,-122.318,1050,5900,4540,4850,55.92372881355932,0.03343606557377049,Very Cheap
20141212T000000,836000.0,4,2.5,2450,12987,1.0,0,0,4,9,2030,420,1980,0,98007,47.6197,-122.15,2730,13685,10537,10955,64.37206437206437,0.0998032786885246,Very Cheap
20150409T000000,365000.0,5,2.5,2260,7040,2.0,0,0,3,8,2260,0,1999,0,98038,47.352,-122.038,2180,6910,4780,4730,51.84659090909091,0.0380327868852459,Very Cheap
20150211T000000,111300.0,2,1.0,1060,6000,1.0,0,0,4,5,1060,0,1908,0,98002,47.3066,-122.223,940,6000,4940,5060,18.55,0.004760655737704918,Very Cheap
20150427T000000,864000.0,4,2.5,3720,105850,2.0,0,0,4,10,3720,0,1984,0,98053,47.655,-122.029,2830,88256,102130,85426,8.162494095418044,0.10347540983606557,Cheap
20140623T000000,725000.0,3,1.75,1610,8613,1.0,0,0,5,7,1610,0,1962,0,98033,47.6527,-122.195,2010,8670,7003,6660,84.17508417508418,0.08524590163934426,Very Cheap
20150218T000000,550000.0,4,2.5,3350,6605,2.0,0,0,3,8,2670,680,1990,0,98011,47.7498,-122.181,2730,5962,3255,3232,83.27024981074943,0.06229508196721312,Very Cheap
20150416T000000,130000.0,2,1.0,790,7500,1.0,0,0,3,7,790,0,1951,0,98198,47.4007,-122.294,1560,7794,6710,6234,17.333333333333332,0.007213114754098361,Very Cheap
20140926T000000,765000.0,2,1.75,1660,4000,1.0,0,0,3,7,990,670,1940,0,98112,47.6394,-122.28,2070,4000,2340,1930,191.25,0.09049180327868853,Very Cheap
20150421T000000,255000.0,3,1.5,1420,7480,1.0,0,0,4,7,1420,0,1963,0,98058,47.4651,-122.184,1720,7700,6060,5980,34.09090909090909,0.02360655737704918,Very Cheap
20140622T000000,439500.0,3,2.5,2050,40003,1.0,0,0,4,8,1570,480,1977,0,98027,47.47,-122.0,2700,46769,37953,44069,10.986675999300052,0.04780327868852459,Very Cheap
20140908T000000,268000.0,3,1.75,1250,5546,1.0,0,0,4,7,1250,0,1987,0,98055,47.4725,-122.187,1640,4791,4296,3151,48.32311575910566,0.025311475409836064,Very Cheap
20150401T000000,985000.0,3,1.75,1700,8534,1.0,0,0,4,7,1700,0,1953,0,98004,47.6276,-122.205,2100,10443,6834,8343,115.42067026013592,0.11934426229508197,Cheap
20141118T000000,751305.0,4,2.5,2660,8469,2.0,0,0,3,10,2660,0,1994,0,98006,47.5529,-122.12,2920,10697,5809,7777,88.71236273467942,0.08869573770491804,Very Cheap
20150423T000000,280000.0,3,1.0,1350,7553,1.5,0,0,3,6,1350,0,1914,0,98118,47.5345,-122.274,1380,7470,6203,6090,37.071362372567194,0.026885245901639345,Very Cheap
20140616T000000,304000.0,4,2.0,1810,8750,1.0,0,0,2,7,1110,700,1967,0,98058,47.4307,-122.17,1810,8750,6940,6940,34.74285714285714,0.030032786885245903,Very Cheap
20150423T000000,200000.0,4,2.75,2210,13235,2.0,0,0,3,8,1730,480,1988,0,98003,47.3541,-122.303,1750,7542,11025,5792,15.11144692104269,0.01639344262295082,Very Cheap
20150220T000000,325000.0,3,1.5,2120,41325,1.0,0,0,4,7,1420,700,1973,0,98092,47.2906,-122.055,1780,42000,39205,40220,7.864488808227465,0.03278688524590164,Very Cheap
20150324T000000,736000.0,3,2.25,2470,11603,2.0,0,2,3,8,1540,930,1988,0,98052,47.6569,-122.123,2850,11250,9133,8400,63.43187106782729,0.08668852459016393,Very Cheap
20140710T000000,426500.0,4,2.5,2700,6515,2.0,0,0,3,9,2700,0,1998,0,98058,47.4356,-122.11,2900,6710,3815,3810,65.46431312356101,0.046098360655737705,Very Cheap
20140620T000000,640000.0,2,1.75,1760,4400,1.0,0,0,4,7,880,880,1930,0,98103,47.65,-122.34,1330,4180,2640,2850,145.45454545454547,0.0740983606557377,Very Cheap
20140521T000000,230000.0,5,2.0,1930,6120,1.5,0,0,3,6,1930,0,1941,1969,98146,47.5073,-122.337,1130,6120,4190,4990,37.58169934640523,0.020327868852459016,Very Cheap
20150324T000000,366350.0,4,1.0,1680,5043,1.5,0,0,4,6,1680,0,1911,0,98118,47.5354,-122.273,1560,5765,3363,4205,72.64525084275233,0.03820983606557377,Very Cheap
20150106T000000,365000.0,2,1.0,1390,8336,1.0,0,0,4,6,910,480,1946,0,98166,47.4646,-122.361,1610,7847,6946,6237,43.78598848368522,0.0380327868852459,Very Cheap
20150225T000000,482000.0,4,2.25,2240,8322,2.0,0,0,3,8,2240,0,1979,0,98034,47.728,-122.206,2240,6448,6082,4208,57.91876952655612,0.05337704918032787,Very Cheap
20140516T000000,345000.0,4,1.0,1980,7991,1.5,0,0,3,7,1980,0,1962,0,98058,47.4604,-122.17,1730,7700,6011,5970,43.173570266549866,0.03540983606557377,Very Cheap
20140514T000000,682000.0,3,1.75,1830,5120,1.5,0,2,5,8,1830,0,1903,0,98122,47.6051,-122.311,2120,5120,3290,3000,133.203125,0.07960655737704918,Very Cheap
20140815T000000,657500.0,3,1.75,980,6002,1.0,0,0,4,6,980,0,1942,0,98033,47.6643,-122.203,1150,6054,5022,4904,109.5468177274242,0.07639344262295082,Very Cheap
20150419T000000,895000.0,6,2.5,3550,6533,2.0,0,0,3,8,3550,0,1925,0,98144,47.5719,-122.284,3140,6234,2983,3094,136.99678555028316,0.10754098360655738,Cheap
20150403T000000,425000.0,3,1.5,1660,5665,1.0,0,0,5,7,920,740,1918,0,98118,47.5391,-122.274,1530,5665,4005,4135,75.02206531332745,0.04590163934426229,Very Cheap
20140806T000000,532500.0,4,2.5,2490,8750,2.0,0,0,3,8,2040,450,1976,0,98008,47.5931,-122.116,2120,10240,6260,8120,60.857142857142854,0.06,Very Cheap
20141008T000000,540000.0,4,2.5,2329,9436,2.0,0,0,3,9,2329,0,1995,0,98011,47.7366,-122.204,2660,10252,7107,7592,57.227638830012715,0.06098360655737705,Very Cheap
20140711T000000,578000.0,3,2.25,1790,9580,2.0,0,0,3,8,1790,0,1984,0,98006,47.5541,-122.162,2060,9995,7790,7935,60.33402922755741,0.06596721311475409,Very Cheap
20150209T000000,1086000.0,3,3.0,2830,6041,2.0,0,3,3,8,1840,990,1915,0,98118,47.5694,-122.283,3420,6360,3211,2940,179.77156099983446,0.13259016393442624,Cheap
20140904T000000,322500.0,3,1.0,1160,9750,1.0,0,0,3,7,1160,0,1968,0,98077,47.7429,-122.072,1160,10565,8590,9405,33.07692307692308,0.032459016393442626,Very Cheap
20150115T000000,140000.0,3,1.0,1000,10560,1.0,0,0,3,7,1000,0,1955,0,98003,47.3217,-122.317,1190,9375,9560,8185,13.257575757575758,0.008524590163934427,Very Cheap
20140910T000000,485000.0,3,2.5,2540,51836,1.0,0,0,4,8,1820,720,1976,0,98042,47.389,-122.088,1650,51836,49296,50186,9.356431823443167,0.05377049180327869,Very Cheap
20140819T000000,575000.0,2,1.5,1750,19709,1.5,0,0,4,8,1440,310,1978,0,98010,47.3351,-122.044,1950,21075,17959,19125,29.174488812217767,0.06557377049180328,Very Cheap
20140617T000000,421000.0,3,2.5,2890,21780,2.0,0,0,3,8,2890,0,2000,0,98188,47.4326,-122.286,2120,8117,18890,5997,19.32966023875115,0.045377049180327866,Very Cheap
20150311T000000,355000.0,4,2.0,1870,3497,1.0,0,0,3,7,1200,670,1954,0,98106,47.5309,-122.347,1270,3497,1627,2227,101.51558478696025,0.036721311475409836,Very Cheap
20150318T000000,515000.0,4,2.25,2200,6967,2.0,0,0,3,8,2200,0,1986,0,98011,47.7355,-122.202,1970,7439,4767,5469,73.91990813836658,0.057704918032786885,Very Cheap
20150428T000000,309000.0,3,1.0,1300,7200,1.0,0,0,4,7,1300,0,1952,0,98146,47.5063,-122.369,1740,7100,5900,5360,42.916666666666664,0.030688524590163933,Very Cheap
20150224T000000,815000.0,5,2.25,3410,35536,2.0,0,0,3,10,2530,880,1974,0,98005,47.65,-122.155,3140,43453,32126,40313,22.934488968932914,0.09704918032786886,Very Cheap
20141106T000000,285000.0,3,1.0,1160,7875,1.0,0,0,3,7,1160,0,1953,0,98125,47.724,-122.323,1600,7875,6715,6275,36.19047619047619,0.02754098360655738,Very Cheap
20141110T000000,700000.0,3,1.75,2100,5000,1.5,0,0,3,8,2100,0,1916,0,98117,47.6776,-122.36,1830,4200,2900,2370,140.0,0.08196721311475409,Very Cheap
20150330T000000,289000.0,3,2.5,1490,8628,2.0,0,0,3,7,1490,0,1994,0,98038,47.3643,-122.041,1640,8514,7138,6874,33.495595734816874,0.028065573770491802,Very Cheap
20141212T000000,458000.0,4,3.0,3280,62726,1.5,0,0,3,7,3280,0,1979,0,98077,47.7509,-122.056,3210,73616,59446,70406,7.301597423715844,0.05022950819672131,Very Cheap
20140818T000000,230000.0,3,1.75,1450,8378,1.0,0,0,4,8,1450,0,1978,0,98023,47.3093,-122.385,1860,8496,6928,6636,27.452852709477202,0.020327868852459016,Very Cheap
20140812T000000,432500.0,3,2.5,1930,7120,1.0,0,0,4,7,1420,510,1961,0,98133,47.7715,-122.34,1600,8352,5190,6752,60.74438202247191,0.046885245901639346,Very Cheap
20140731T000000,288000.0,3,1.75,1660,10440,1.0,0,0,3,7,1040,620,1978,0,98045,47.4448,-121.77,1240,10380,8780,9140,27.586206896551722,0.027934426229508195,Very Cheap
20140801T000000,354000.0,3,1.75,1260,12330,1.0,0,0,3,7,1260,0,1968,0,98072,47.7412,-122.095,1320,12800,11070,11480,28.710462287104622,0.03659016393442623,Very Cheap
20140604T000000,119500.0,3,1.0,1170,11000,1.0,0,0,2,6,1170,0,1980,0,98019,47.7346,-121.983,1590,10894,9830,9304,10.863636363636363,0.005836065573770492,Very Cheap
20141120T000000,805000.0,4,3.0,3350,23781,1.0,0,0,4,9,2020,1330,1979,0,98006,47.56,-122.132,2870,12036,20431,9166,33.850552962449015,0.09573770491803278,Very Cheap
20140611T000000,435000.0,3,2.5,1420,2581,3.0,0,0,3,7,1420,0,2004,0,98133,47.7027,-122.357,1420,2509,1161,1089,168.53932584269663,0.04721311475409836,Very Cheap
20140922T000000,260000.0,3,1.75,2170,10018,1.0,0,0,4,7,1630,540,1978,0,98001,47.3087,-122.264,2049,15263,7848,13214,25.953284088640448,0.024262295081967214,Very Cheap
20150401T000000,377000.0,4,1.75,1800,8385,1.0,0,0,5,6,900,900,1950,0,98133,47.7744,-122.338,1770,8385,6585,6615,44.96124031007752,0.03960655737704918,Very Cheap
20150320T000000,602000.0,4,2.5,2000,7376,2.0,0,0,3,8,2000,0,1990,0,98029,47.5719,-121.999,1950,5218,5376,3268,81.61605206073753,0.06911475409836065,Very Cheap
20141027T000000,530000.0,3,1.75,1660,4800,1.0,0,0,3,7,960,700,1941,1996,98116,47.5734,-122.412,1510,4800,3140,3290,110.41666666666667,0.05967213114754098,Very Cheap
20150325T000000,525000.0,4,2.0,1540,3740,1.0,0,0,4,7,770,770,1946,0,98117,47.6886,-122.375,1090,5080,2200,3990,140.37433155080214,0.05901639344262295,Very Cheap
20141110T000000,250000.0,2,1.5,1160,1086,2.0,0,0,3,7,890,270,2006,0,98155,47.768,-122.315,1160,1086,-74,-74,230.2025782688766,0.022950819672131147,Very Cheap
20140528T000000,681000.0,3,1.0,1700,6356,1.5,0,0,3,7,1700,0,1907,0,98118,47.5677,-122.281,2080,6000,4656,3920,107.14285714285714,0.07947540983606557,Very Cheap
20140905T000000,625000.0,3,1.75,1580,20588,1.0,0,0,3,8,1580,0,1970,0,98125,47.706,-122.29,2080,7800,19008,5720,30.357489799883428,0.07213114754098361,Very Cheap
20150508T000000,448500.0,3,2.5,2080,3920,2.0,0,0,3,8,2080,0,2010,0,98118,47.5412,-122.286,2110,3710,1840,1600,114.41326530612245,0.048983606557377046,Very Cheap
20141022T000000,260000.0,3,2.0,1030,7260,1.0,0,0,3,6,1030,0,1947,0,98146,47.5113,-122.347,1380,8100,6230,6720,35.81267217630854,0.024262295081967214,Very Cheap
20141030T000000,538000.0,3,1.75,1770,8050,1.0,0,0,4,7,1020,750,1963,0,98008,47.5862,-122.118,2000,7875,6280,5875,66.83229813664596,0.06072131147540984,Very Cheap
20140521T000000,385500.0,3,2.0,1540,7947,1.0,0,0,3,7,1120,420,1961,0,98011,47.7605,-122.217,1910,7950,6407,6040,48.50887127217818,0.04072131147540983,Very Cheap
20140905T000000,428400.0,4,2.5,2650,6000,2.0,0,0,3,9,2650,0,2000,0,98038,47.3768,-122.028,2630,6381,3350,3751,71.4,0.04634754098360656,Very Cheap
20140729T000000,346290.0,4,2.75,2690,9240,2.0,0,0,3,8,2690,0,1998,0,98022,47.1896,-122.014,2640,9240,6550,6600,37.47727272727273,0.035579016393442624,Very Cheap
20150203T000000,587000.0,4,2.75,2210,8430,2.0,0,0,3,9,2210,0,1999,0,98075,47.5994,-122.017,2460,8069,6220,5609,69.63226571767497,0.06714754098360656,Very Cheap
20140820T000000,355000.0,4,2.5,2390,6775,2.0,0,0,3,7,2390,0,2003,0,98056,47.4811,-122.182,2560,6346,4385,3786,52.398523985239855,0.036721311475409836,Very Cheap
20150428T000000,650000.0,5,2.75,2580,7865,1.0,0,0,4,8,1480,1100,1964,0,98007,47.6208,-122.139,2140,8400,5285,6260,82.64462809917356,0.07540983606557378,Very Cheap
20140730T000000,340000.0,4,2.5,2160,5455,2.0,0,0,3,7,2160,0,2003,0,98056,47.4799,-122.183,2160,5257,3295,3097,62.32813932172319,0.03475409836065574,Very Cheap
20140703T000000,565000.0,4,2.5,2230,8624,1.0,0,0,4,8,1430,800,1969,0,98052,47.6623,-122.152,1970,8402,6394,6432,65.51484230055658,0.06426229508196721,Very Cheap
20150219T000000,630000.0,4,2.0,2000,5000,1.5,0,0,5,7,2000,0,1925,0,98144,47.5787,-122.293,2200,5000,3000,2800,126.0,0.07278688524590164,Very Cheap
20141107T000000,227000.0,3,1.0,1280,7198,1.0,0,0,5,6,1280,0,1916,1983,98022,47.2094,-121.996,1260,7198,5918,5938,31.536537927202,0.019934426229508195,Very Cheap
20140729T000000,600000.0,4,2.75,2810,17674,1.0,0,0,4,8,1640,1170,1978,0,98052,47.6745,-122.144,2400,11240,14864,8840,33.94817245671608,0.06885245901639345,Very Cheap
20150202T000000,540400.0,4,1.75,1680,6758,1.0,0,0,3,8,1680,0,1974,0,98008,47.641,-122.113,1910,7000,5078,5090,79.96448653447766,0.06103606557377049,Very Cheap
20141001T000000,569000.0,3,2.5,2150,8060,2.0,0,0,3,8,2150,0,1995,0,98033,47.6952,-122.188,2150,7172,5910,5022,70.59553349875931,0.06478688524590163,Very Cheap
20140710T000000,735000.0,3,2.5,2820,8159,2.0,0,0,3,9,2820,0,2004,0,98029,47.5527,-121.992,2910,5000,5339,2090,90.08456918740042,0.08655737704918033,Very Cheap
20141216T000000,434000.0,3,2.25,1750,9353,1.0,0,0,3,7,1210,540,1987,0,98034,47.7305,-122.225,1930,8545,7603,6615,46.402223885384366,0.04708196721311476,Very Cheap
20150319T000000,578888.0,2,2.0,1060,4000,1.0,0,0,2,7,1000,60,1914,0,98103,47.6626,-122.337,1310,4000,2940,2690,144.722,0.06608367213114755,Very Cheap
20140523T000000,465425.0,4,2.75,2430,20720,1.0,0,0,3,7,2430,0,1967,0,98072,47.775,-122.139,2580,26950,18290,24370,22.462596525096526,0.05120327868852459,Very Cheap
20150422T000000,280500.0,4,2.75,2660,7754,1.5,0,0,3,8,1590,1070,1986,0,98023,47.3078,-122.337,2250,7754,5094,5504,36.17487748258963,0.026950819672131147,Very Cheap
20150205T000000,539950.0,2,2.0,1670,3507,1.0,0,0,3,9,1670,0,2007,0,98029,47.5545,-122.003,2330,3889,1837,1559,153.96350156829197,0.06097704918032787,Very Cheap
20140904T000000,406430.0,3,2.0,1380,15426,1.0,0,0,4,7,1380,0,1968,0,98075,47.5951,-122.036,1380,15426,14046,14046,26.34707636457928,0.04346622950819672,Very Cheap
20150205T000000,1150000.0,4,3.75,4160,35000,2.0,0,0,3,11,4160,0,1991,0,98053,47.669,-122.067,5330,36446,30840,31116,32.857142857142854,0.14098360655737704,Cheap
20141111T000000,250000.0,3,2.5,1790,6191,2.0,0,0,3,8,1790,0,1992,0,98031,47.4102,-122.195,1790,6758,4401,4968,40.381198513971896,0.022950819672131147,Very Cheap
20140508T000000,266000.0,3,2.5,1940,8547,1.0,0,0,3,7,1460,480,1989,0,98030,47.3491,-122.177,1750,7803,6607,6053,31.12203112203112,0.02504918032786885,Very Cheap
20140722T000000,258000.0,3,2.0,1390,7200,1.0,0,0,3,7,1390,0,1996,0,98058,47.434,-122.154,1630,7340,5810,5710,35.833333333333336,0.024,Very Cheap
20141223T000000,472000.0,3,2.0,2200,21890,1.0,0,2,3,8,1200,1000,1961,0,98155,47.7584,-122.271,2600,15162,19690,12562,21.5623572407492,0.052065573770491806,Very Cheap
20140806T000000,530000.0,3,2.25,1264,1536,2.0,0,0,3,8,1264,0,2003,0,98105,47.6694,-122.279,1264,2067,272,803,345.0520833333333,0.05967213114754098,Very Cheap
20140722T000000,302282.0,2,1.0,1095,5120,1.5,0,0,3,7,1095,0,1901,0,98122,47.6058,-122.313,1310,5120,4025,3810,59.039453125,0.029807475409836064,Very Cheap
20150311T000000,370000.0,2,1.0,850,6213,1.0,0,0,3,6,750,100,1916,0,98136,47.5282,-122.384,1880,5500,5363,3620,59.55255110252696,0.038688524590163934,Very Cheap
20141013T000000,625000.0,4,2.0,1760,5307,1.5,0,0,4,7,1170,590,1948,0,98105,47.6714,-122.28,1850,6600,3547,4750,117.76898436027888,0.07213114754098361,Very Cheap
20150409T000000,142500.0,1,1.0,690,6825,1.0,0,0,4,5,690,0,1917,0,98002,47.3109,-122.225,1330,5381,6135,4051,20.87912087912088,0.008852459016393442,Very Cheap
20150121T000000,334000.0,3,1.75,1400,7405,1.0,0,0,3,7,1400,0,1961,0,98133,47.7569,-122.334,1820,7440,6005,5620,45.10465901417961,0.0339672131147541,Very Cheap
20140708T000000,362000.0,5,3.0,1810,3000,2.0,0,0,3,7,1810,0,1998,0,98118,47.5622,-122.291,1670,3000,1190,1330,120.66666666666667,0.03763934426229508,Very Cheap
20150417T000000,181000.0,2,1.0,1310,4000,1.0,0,0,3,7,950,360,1942,0,98144,47.5798,-122.306,1310,4000,2690,2690,45.25,0.013901639344262294,Very Cheap
20141231T000000,241500.0,3,1.0,1400,10425,1.0,0,0,4,7,1400,0,1968,0,98003,47.2738,-122.301,1440,10425,9025,8985,23.165467625899282,0.02183606557377049,Very Cheap
20150204T000000,245000.0,3,1.75,2350,12720,1.0,0,0,4,7,1180,1170,1964,0,98030,47.3594,-122.175,1680,10400,10370,8720,19.261006289308177,0.022295081967213116,Very Cheap
20150506T000000,227500.0,3,1.0,1150,8848,1.0,0,0,3,7,1150,0,1968,0,98042,47.3626,-122.111,1220,9576,7698,8356,25.712025316455698,0.02,Very Cheap
20141003T000000,158550.0,5,1.5,1710,8100,1.5,0,0,4,7,1710,0,1961,0,98032,47.3839,-122.288,1480,8025,6390,6545,19.574074074074073,0.010957377049180327,Very Cheap
20140925T000000,450000.0,3,2.25,1660,10247,1.0,0,0,5,7,1130,530,1968,0,98034,47.7262,-122.222,1680,7637,8587,5957,43.915292280667515,0.04918032786885246,Very Cheap
20150204T000000,485000.0,3,1.75,1950,10080,1.0,0,0,4,7,1950,0,1967,0,98034,47.7282,-122.186,2340,8800,8130,6460,48.11507936507937,0.05377049180327869,Very Cheap
20141106T000000,353000.0,4,1.75,1780,9794,1.0,0,0,3,7,1780,0,1967,0,98077,47.7419,-122.073,1160,9750,8014,8590,36.0424749846845,0.03645901639344262,Very Cheap
20150406T000000,500000.0,4,3.0,2450,4668,2.0,0,0,3,8,2450,0,2004,0,98028,47.7721,-122.235,2460,4895,2218,2435,107.11225364181662,0.05573770491803279,Very Cheap
20140908T000000,360000.0,1,2.25,2060,10600,1.5,0,0,3,7,1560,500,1927,1983,98003,47.3291,-122.304,2060,11880,8540,9820,33.9622641509434,0.037377049180327866,Very Cheap
20150223T000000,357500.0,3,1.5,1540,11858,1.0,0,0,4,7,1540,0,1966,0,98059,47.4755,-122.157,1550,11473,10318,9923,30.148423005565864,0.03704918032786885,Very Cheap
20140506T000000,272000.0,3,2.5,1650,13816,2.0,0,0,3,7,1650,0,1998,0,98014,47.6553,-121.912,1650,15144,12166,13494,19.687319050376374,0.02583606557377049,Very Cheap
20150428T000000,422000.0,3,1.0,1160,7854,1.0,0,0,3,7,1160,0,1960,0,98125,47.7304,-122.308,1300,8317,6694,7017,53.73058314234785,0.04550819672131148,Very Cheap
20140917T000000,365000.0,2,2.0,1440,15000,1.0,0,0,3,7,1440,0,1985,0,98072,47.7648,-122.159,1780,15000,13560,13220,24.333333333333332,0.0380327868852459,Very Cheap
20140821T000000,450000.0,3,1.75,2150,13789,1.0,0,0,4,8,1610,540,1966,0,98155,47.7591,-122.295,2150,15480,11639,13330,32.6347088258757,0.04918032786885246,Very Cheap
20140922T000000,275053.0,2,1.0,1060,6504,1.0,0,0,3,6,1060,0,1950,0,98155,47.7412,-122.327,1100,7200,5444,6100,42.28982164821648,0.026236459016393442,Very Cheap
20141106T000000,1880000.0,3,2.75,2620,17919,1.0,0,1,4,9,2620,0,1949,0,98039,47.6144,-122.228,3400,14400,15299,11000,104.91656900496679,0.23672131147540984,Cheap
20150311T000000,725000.0,3,1.75,1630,9000,1.0,0,0,3,7,960,670,1955,0,98004,47.6023,-122.205,1880,9000,7370,7120,80.55555555555556,0.08524590163934426,Very Cheap
20140612T000000,235000.0,3,1.75,1840,9697,1.0,0,0,4,7,1500,340,1985,0,98030,47.3764,-122.179,1430,8079,7857,6649,24.234299267814787,0.02098360655737705,Very Cheap
20141211T000000,510000.0,2,1.0,820,4206,1.0,0,0,3,5,820,0,1949,0,98125,47.7076,-122.284,1810,7200,3386,5390,121.25534950071327,0.057049180327868855,Very Cheap
20150408T000000,489950.0,2,1.0,820,4206,1.0,0,0,3,5,820,0,1949,0,98125,47.7076,-122.284,1810,7200,3386,5390,116.48834997622444,0.05441967213114754,Very Cheap
20140730T000000,463000.0,3,2.5,2010,4195,2.0,0,0,3,8,2010,0,1998,0,98034,47.732,-122.197,2010,5779,2185,3769,110.36948748510132,0.05088524590163934,Very Cheap
20140617T000000,536000.0,4,2.25,1990,5948,2.0,0,0,3,8,1990,0,1991,0,98029,47.5712,-121.995,2150,6459,3958,4309,90.11432414256893,0.06045901639344262,Very Cheap
20141021T000000,375000.0,4,2.5,2990,6145,2.0,0,0,3,8,2990,0,2003,0,98003,47.2612,-122.294,2590,6512,3155,3922,61.02522375915378,0.03934426229508197,Very Cheap
20140908T000000,630000.0,4,2.5,2540,4727,2.0,0,0,3,9,2540,0,1999,0,98034,47.7034,-122.236,3640,5129,2187,1489,133.27691982229743,0.07278688524590164,Very Cheap
20140506T000000,362000.0,3,2.25,1640,14374,1.0,0,0,4,7,1140,500,1963,0,98148,47.4476,-122.332,2020,10500,12734,8480,25.184360651175734,0.03763934426229508,Very Cheap
20150204T000000,350000.0,4,2.75,2500,11659,1.0,0,2,3,9,1490,1010,1979,0,98003,47.3381,-122.332,2830,9915,9159,7085,30.01972724933528,0.036065573770491806,Very Cheap
20141003T000000,1691000.0,4,3.5,4020,13515,2.0,0,0,3,11,4020,0,2001,0,98004,47.6462,-122.212,3930,13515,9495,9585,125.12023677395487,0.2119344262295082,Cheap
20150224T000000,255000.0,3,2.0,1500,8775,1.0,0,0,3,6,1390,110,1943,0,98166,47.4809,-122.335,1310,8775,7275,7465,29.05982905982906,0.02360655737704918,Very Cheap
20140806T000000,269000.0,4,2.5,1594,7665,1.0,0,0,5,7,1088,506,1975,0,98002,47.3262,-122.211,1536,6000,6071,4464,35.09458577951729,0.02544262295081967,Very Cheap
20140825T000000,370000.0,4,3.0,2130,4838,1.5,0,0,4,7,2130,0,1930,0,98055,47.4871,-122.203,1070,4838,2708,3768,76.47788342290202,0.038688524590163934,Very Cheap
20150501T000000,270000.0,3,1.0,1130,7920,1.0,0,0,3,7,1130,0,1961,0,98059,47.4852,-122.125,1390,8580,6790,7190,34.09090909090909,0.025573770491803278,Very Cheap
20150224T000000,265000.0,3,2.0,1690,9516,1.0,0,0,3,7,1690,0,1997,0,98022,47.2132,-122.001,1850,9516,7826,7666,27.847835224884406,0.024918032786885248,Very Cheap
20150429T000000,487000.0,2,1.0,1440,4046,1.0,0,0,3,7,960,480,1946,0,98117,47.6901,-122.382,1400,4046,2606,2646,120.365793376174,0.054032786885245904,Very Cheap
20140804T000000,835000.0,4,3.25,3270,6027,2.0,0,0,3,10,3270,0,2001,0,98074,47.6346,-122.063,3270,6546,2757,3276,138.54322216691554,0.09967213114754099,Very Cheap
20140701T000000,850000.0,4,3.25,4350,112750,1.0,0,0,3,9,2200,2150,2006,0,98027,47.5435,-121.966,2180,223027,108400,220847,7.5388026607538805,0.10163934426229508,Cheap
20141201T000000,575000.0,4,2.75,1610,11201,1.0,0,0,5,7,1020,590,1982,0,98033,47.7024,-122.198,1610,9000,9591,7390,51.3347022587269,0.06557377049180328,Very Cheap
20140712T000000,335000.0,3,1.0,950,8000,1.0,0,0,3,7,950,0,1968,0,98034,47.7193,-122.184,2270,8540,7050,6270,41.875,0.03409836065573771,Very Cheap
20140808T000000,318000.0,3,1.0,1010,7200,1.0,0,0,5,6,1010,0,1948,0,98155,47.7601,-122.307,1590,7663,6190,6073,44.166666666666664,0.03186885245901639,Very Cheap
20150409T000000,510000.0,3,2.0,1420,11325,1.0,0,0,3,7,1420,0,1980,0,98027,47.5356,-122.046,2330,3474,9905,1144,45.033112582781456,0.057049180327868855,Very Cheap
20140502T000000,242500.0,3,1.5,1200,9720,1.0,0,0,4,7,1200,0,1965,0,98042,47.4225,-122.153,1380,10284,8520,8904,24.948559670781894,0.021967213114754098,Very Cheap
20141204T000000,750000.0,5,2.25,2020,8400,1.0,0,0,4,7,1010,1010,1963,0,98040,47.5763,-122.219,1890,9233,6380,7343,89.28571428571429,0.08852459016393442,Very Cheap
20140721T000000,439900.0,5,3.5,3390,7950,2.0,0,2,3,7,3390,0,2003,0,98056,47.4792,-122.181,2580,6900,4560,4320,55.333333333333336,0.047855737704918036,Very Cheap
20150407T000000,710000.0,2,1.0,1700,3040,1.5,0,0,3,8,1460,240,1914,0,98119,47.6442,-122.369,1620,3230,1340,1610,233.55263157894737,0.08327868852459017,Very Cheap
20140604T000000,2400000.0,5,3.25,3410,9088,2.0,0,3,3,9,2760,650,1912,0,98119,47.6285,-122.361,3540,7100,5678,3560,264.0845070422535,0.30491803278688523,Medium
20141215T000000,435000.0,3,1.75,2030,13700,1.0,0,0,3,8,1630,400,1976,0,98011,47.7726,-122.197,2120,11200,11670,9080,31.751824817518248,0.04721311475409836,Very Cheap
20141226T000000,874000.0,4,2.75,2860,6867,1.0,0,1,5,7,1560,1300,1946,0,98115,47.6723,-122.263,2290,5350,4007,3060,127.275374981797,0.10478688524590164,Cheap
20140616T000000,385000.0,4,1.75,1690,4080,1.0,0,0,4,7,870,820,1984,0,98144,47.572,-122.289,1320,4080,2390,2760,94.36274509803921,0.04065573770491803,Very Cheap
20141030T000000,110000.0,2,1.0,760,4746,1.0,0,0,3,5,760,0,1930,0,98055,47.4836,-122.214,1360,7810,3986,6450,23.17741255794353,0.0045901639344262295,Very Cheap
20140620T000000,477000.0,3,1.75,1780,8085,1.0,0,0,3,7,1210,570,1976,0,98011,47.7357,-122.197,1780,8085,6305,6305,58.998144712430424,0.052721311475409836,Very Cheap
20140912T000000,500000.0,3,2.0,1550,6394,1.5,0,0,5,8,1550,0,1918,0,98126,47.5222,-122.379,1440,6387,4844,4947,78.1983109164842,0.05573770491803279,Very Cheap
20140828T000000,885000.0,4,2.5,4090,11225,2.0,0,0,3,10,4090,0,2005,0,98075,47.581,-121.971,3510,8762,7135,5252,78.84187082405346,0.1062295081967213,Cheap
20140827T000000,235000.0,2,1.0,880,5600,1.0,0,0,5,7,880,0,1955,0,98178,47.5071,-122.265,1240,7015,4720,5775,41.964285714285715,0.02098360655737705,Very Cheap
20150504T000000,210000.0,3,2.75,1320,15236,1.0,0,0,3,7,880,440,1995,0,98030,47.365,-122.184,1490,8351,13916,6861,13.783145182462588,0.017704918032786884,Very Cheap
20150420T000000,320000.0,2,1.0,950,4000,1.0,0,0,3,6,950,0,1910,0,98144,47.5728,-122.312,1480,4000,3050,2520,80.0,0.032131147540983604,Very Cheap
20150313T000000,406000.0,3,1.75,1390,7904,1.0,0,0,3,7,1390,0,1985,0,98056,47.4892,-122.181,1910,7904,6514,5994,51.3663967611336,0.04340983606557377,Very Cheap
20141028T000000,350000.0,3,1.75,1900,10225,1.0,0,0,4,8,1220,680,1963,0,98166,47.4781,-122.357,1850,12630,8325,10780,34.229828850855746,0.036065573770491806,Very Cheap
20140610T000000,350000.0,2,0.75,1392,43710,1.5,0,0,4,7,1392,0,1978,0,98070,47.4491,-122.453,1640,99316,42318,97676,8.007320979180966,0.036065573770491806,Very Cheap
20140710T000000,720000.0,4,2.5,3340,8930,2.0,0,2,3,10,3340,0,1999,0,98065,47.535,-121.867,3160,7865,5590,4705,80.62709966405374,0.08459016393442623,Very Cheap
20140522T000000,604700.0,4,2.75,2750,14982,1.0,0,3,3,9,1720,1030,1981,0,98198,47.3566,-122.32,2860,16344,12232,13484,40.361767454278464,0.06946885245901639,Very Cheap
20140925T000000,343000.0,3,1.0,1400,5662,1.5,0,0,5,5,1400,0,1920,0,98027,47.5271,-122.036,1250,14375,4262,13125,60.57930060049453,0.035147540983606555,Very Cheap
20141209T000000,558000.0,3,2.25,2220,15757,1.0,0,0,3,8,1280,940,1982,0,98074,47.6212,-122.043,2020,14098,13537,12078,35.41283239195278,0.06334426229508197,Very Cheap
20150417T000000,364000.0,4,1.0,1210,7740,1.5,0,0,3,7,1210,0,1922,0,98126,47.5216,-122.374,1100,7740,6530,6640,47.02842377260982,0.03790163934426229,Very Cheap
20141028T000000,420000.0,3,1.75,2390,11242,1.0,0,0,3,7,1290,1100,1959,0,98155,47.7759,-122.272,2270,9650,8852,7380,37.359900373599004,0.04524590163934426,Very Cheap
20150515T000000,450000.0,5,2.0,1870,7344,1.5,0,0,3,7,1870,0,1960,0,98007,47.5951,-122.144,1870,7650,5474,5780,61.27450980392157,0.04918032786885246,Very Cheap
20140813T000000,392000.0,2,1.5,940,5000,1.0,0,0,4,7,810,130,1925,0,98126,47.5375,-122.374,940,5026,4060,4086,78.4,0.04157377049180328,Very Cheap
20140610T000000,100000.0,4,1.0,1120,2685,1.0,0,0,3,5,860,260,1939,0,98055,47.4904,-122.203,1120,4838,1565,3718,37.243947858473,0.003278688524590164,Very Cheap
20140612T000000,480000.0,3,2.5,1250,1103,3.0,0,2,3,8,1250,0,2005,0,98103,47.6619,-122.352,1250,1188,-147,-62,435.17679057116953,0.05311475409836065,Very Cheap
20140827T000000,212000.0,3,1.5,1060,9225,1.0,0,0,4,7,1060,0,1955,0,98003,47.3217,-122.318,1270,9375,8165,8105,22.981029810298104,0.017967213114754098,Very Cheap
20141203T000000,560000.0,5,2.5,2410,8960,1.0,0,0,5,7,1600,810,1978,0,98011,47.7372,-122.2,2410,11514,6550,9104,62.5,0.06360655737704918,Very Cheap
20150428T000000,359950.0,5,2.75,2844,3990,2.0,0,0,3,8,2844,0,2013,0,98092,47.3259,-122.167,2273,3900,1146,1627,90.21303258145363,0.037370491803278685,Very Cheap
20140910T000000,535000.0,4,2.5,2200,110642,1.0,0,0,5,7,1330,870,1979,0,98077,47.7409,-122.052,2290,51400,108442,49110,4.835415122647819,0.06032786885245902,Very Cheap
20150410T000000,980000.0,5,4.0,3460,5400,2.0,0,0,3,10,2830,630,2012,0,98056,47.5201,-122.204,1890,5400,1940,3510,181.4814814814815,0.11868852459016394,Cheap
20141113T000000,720000.0,2,1.0,1580,2199,2.0,0,2,3,8,1580,0,1921,1995,98103,47.6541,-122.329,2170,4405,619,2235,327.42155525238746,0.08459016393442623,Very Cheap
20140929T000000,619950.0,2,1.0,1520,5400,1.0,0,0,3,7,920,600,1951,0,98115,47.6796,-122.279,1600,5400,3880,3800,114.80555555555556,0.0714688524590164,Very Cheap
20140530T000000,489000.0,3,2.5,2260,19821,2.0,0,0,3,9,2260,0,1994,0,98058,47.448,-122.088,2750,22718,17561,19968,24.67080369305282,0.05429508196721312,Very Cheap
20140616T000000,415000.0,4,2.0,1800,2970,1.0,0,0,4,7,1000,800,1923,0,98115,47.6833,-122.312,1690,3801,1170,2111,139.73063973063972,0.04459016393442623,Very Cheap
20150415T000000,672500.0,4,2.5,2650,11108,2.0,0,0,3,10,2650,0,1987,0,98074,47.6304,-122.051,2650,11585,8458,8935,60.54195174648902,0.07836065573770491,Very Cheap
20141017T000000,352500.0,3,1.0,1000,4171,1.0,0,0,3,7,1000,0,1985,0,98052,47.6834,-122.097,1090,3479,3171,2389,84.51210740829538,0.03639344262295082,Very Cheap
20140903T000000,258750.0,4,2.0,2300,8400,1.0,0,0,4,6,1150,1150,1962,0,98003,47.3282,-122.332,1230,8400,6100,7170,30.803571428571427,0.024098360655737706,Very Cheap
20150223T000000,350000.0,3,1.0,1080,7000,1.0,0,0,4,6,1080,0,1916,0,98133,47.7637,-122.351,1410,7214,5920,5804,50.0,0.036065573770491806,Very Cheap
20140729T000000,152000.0,3,1.0,902,10464,1.0,0,0,3,7,902,0,1965,0,98198,47.363,-122.308,1510,7210,9562,5700,14.525993883792049,0.010098360655737704,Very Cheap
20140609T000000,378500.0,2,1.0,730,7528,1.0,0,0,3,7,730,0,1946,0,98115,47.6997,-122.305,1620,7528,6798,5908,50.27895855472901,0.03980327868852459,Very Cheap
20140730T000000,1017000.0,4,1.75,2600,41041,1.5,0,0,4,8,2600,0,1965,0,98033,47.6634,-122.172,2750,37318,38441,34568,24.780097950829656,0.12354098360655738,Cheap
20140502T000000,419000.0,3,1.5,1570,6700,1.0,0,0,4,7,1570,0,1956,0,98007,47.6022,-122.134,1570,7300,5130,5730,62.53731343283582,0.04511475409836065,Very Cheap
20140521T000000,895000.0,5,3.0,2876,13927,1.0,0,2,4,9,1970,906,1973,0,98040,47.5528,-122.229,3500,14454,11051,10954,64.26366051554534,0.10754098360655738,Cheap
20140926T000000,668500.0,4,2.25,2290,9546,1.0,0,0,4,8,1780,510,1976,0,98006,47.5617,-122.13,2360,8864,7256,6504,70.02933165723863,0.07783606557377049,Very Cheap
20140821T000000,487000.0,2,2.5,1470,2533,2.0,0,0,3,8,1470,0,2005,0,98033,47.6874,-122.165,1470,6511,1063,5041,192.26213975523095,0.054032786885245904,Very Cheap
20141202T000000,538000.0,3,3.5,2620,10137,2.0,0,0,3,8,1970,650,1992,0,98146,47.4979,-122.371,1960,7680,7517,5720,53.07290125283615,0.06072131147540984,Very Cheap
20140528T000000,898000.0,5,1.5,2680,28014,1.0,0,0,4,8,1450,1230,1963,0,98004,47.6348,-122.196,2900,22180,25334,19280,32.055400870993076,0.10793442622950819,Cheap
20140924T000000,315000.0,4,2.0,2020,7767,1.0,0,0,3,8,2020,0,1995,0,98003,47.3391,-122.309,1940,8239,5747,6299,40.55619930475087,0.031475409836065574,Very Cheap
20150428T000000,800000.0,3,2.5,2100,4440,2.0,0,4,3,7,2100,0,1945,0,98116,47.5865,-122.397,2100,6000,2340,3900,180.18018018018017,0.09508196721311475,Very Cheap
20140714T000000,516130.0,3,1.75,1510,8250,1.0,0,0,4,8,1510,0,1962,0,98008,47.6183,-122.113,1770,8250,6740,6480,62.56121212121212,0.05785311475409836,Very Cheap
20150128T000000,1600000.0,3,2.5,2850,19593,1.5,1,4,3,10,1790,1060,1978,0,98008,47.5894,-122.111,2850,18782,16743,15932,81.66181799622314,0.2,Cheap
20150427T000000,1200000.0,4,2.5,4280,12796,2.0,0,0,3,11,3400,880,1999,0,98006,47.5588,-122.124,3520,9593,8516,6073,93.77930603313536,0.14754098360655737,Cheap
20150312T000000,355425.0,4,2.5,3238,9112,1.0,0,2,4,8,1678,1560,1979,0,98198,47.4005,-122.311,3056,9668,5874,6612,39.006255487269534,0.03677704918032787,Very Cheap
20140624T000000,1157400.0,3,2.5,2740,5925,2.0,0,2,3,10,2740,0,1913,1992,98112,47.6313,-122.303,2740,5948,3185,3208,195.34177215189874,0.14195409836065573,Cheap
20140926T000000,689000.0,4,2.5,2020,9600,2.0,0,0,4,7,2020,0,1954,0,98136,47.5434,-122.395,2250,8550,7580,6300,71.77083333333333,0.08052459016393443,Very Cheap
20150113T000000,500000.0,3,3.25,1520,1500,3.0,0,0,3,7,1520,0,2000,0,98107,47.67,-122.389,1520,1323,-20,-197,333.3333333333333,0.05573770491803279,Very Cheap
20140718T000000,430000.0,5,2.5,3860,42733,1.0,0,3,4,8,2300,1560,1955,0,98001,47.3117,-122.254,2520,19353,38873,16833,10.06248098659116,0.04655737704918033,Very Cheap
20141121T000000,299500.0,4,2.25,1600,15312,1.0,0,0,4,7,1080,520,1979,0,98045,47.4629,-121.743,1620,12375,13712,10755,19.559822361546498,0.02944262295081967,Very Cheap
20140624T000000,349950.0,4,2.5,2090,5289,2.0,0,0,3,8,2090,0,1989,0,98058,47.4289,-122.164,2080,7109,3199,5029,66.1656267725468,0.036059016393442625,Very Cheap
20141028T000000,1419000.0,5,3.25,4020,4500,2.0,0,0,3,9,3120,900,2010,0,98004,47.6349,-122.204,3550,5775,480,2225,315.3333333333333,0.17626229508196722,Cheap
20141216T000000,998000.0,4,2.25,2910,10189,2.0,0,0,3,9,2910,0,1988,0,98006,47.5465,-122.155,2780,10125,7279,7345,97.94876827951713,0.12104918032786885,Cheap
20150505T000000,329000.0,3,1.0,900,9600,1.0,0,0,4,7,900,0,1970,0,98072,47.7423,-122.173,1220,8240,8700,7020,34.270833333333336,0.03331147540983607,Very Cheap
20141009T000000,575000.0,3,1.75,1720,5956,2.0,0,0,3,8,1720,0,1981,0,98033,47.6875,-122.202,1620,9324,4236,7704,96.5413028878442,0.06557377049180328,Very Cheap
20141002T000000,529900.0,5,2.25,3030,9430,2.0,0,0,4,8,2600,430,1961,0,98133,47.7515,-122.353,2230,8425,6400,6195,56.19300106044539,0.05965901639344262,Very Cheap
20141120T000000,1470000.0,4,2.5,3030,10189,1.0,0,0,3,9,2380,650,2003,0,98004,47.6367,-122.206,1940,10189,7159,8249,144.27323584257533,0.18295081967213114,Cheap
20140801T000000,725000.0,4,1.75,2190,9400,1.0,0,0,4,7,1450,740,1962,0,98033,47.6531,-122.196,1980,9000,7210,7020,77.12765957446808,0.08524590163934426,Very Cheap
20141023T000000,286000.0,3,2.5,1680,5000,2.0,0,0,3,8,1680,0,1987,0,98023,47.3196,-122.395,1720,5000,3320,3280,57.2,0.027672131147540982,Very Cheap
20150305T000000,335000.0,3,2.0,1210,9926,1.0,0,0,4,7,1210,0,1954,2015,98006,47.5731,-122.135,1690,9737,8716,8047,33.74974813620794,0.03409836065573771,Very Cheap
20140515T000000,395300.0,3,1.5,1120,7000,1.0,0,0,3,7,1120,0,1955,0,98007,47.5987,-122.146,1470,7950,5880,6480,56.47142857142857,0.04200655737704918,Very Cheap
20140715T000000,510000.0,4,2.75,3180,13348,2.0,0,0,3,8,3020,160,2004,0,98019,47.7439,-121.977,3020,10029,10168,7009,38.20797123164519,0.057049180327868855,Very Cheap
20150206T000000,203000.0,3,1.0,920,7500,1.0,0,0,4,7,920,0,1970,0,98032,47.3791,-122.289,1660,8000,6580,6340,27.066666666666666,0.01678688524590164,Very Cheap
20141204T000000,248000.0,2,1.0,700,8301,1.0,0,0,3,6,700,0,1953,0,98155,47.7712,-122.323,1250,8304,7601,7054,29.87591856402843,0.022688524590163933,Very Cheap
20150127T000000,265000.0,3,2.25,2540,7216,2.0,0,0,3,8,2540,0,1991,0,98023,47.2906,-122.349,2140,7531,4676,5391,36.7239467849224,0.024918032786885248,Very Cheap
20150504T000000,1000000.0,4,1.5,2100,4560,1.5,0,0,4,8,2100,0,1912,0,98103,47.6497,-122.336,1930,4560,2460,2630,219.2982456140351,0.12131147540983607,Cheap
20150406T000000,1000000.0,3,1.0,1540,24500,1.5,0,0,3,7,1540,0,1949,0,98125,47.7213,-122.29,1540,7250,22960,5710,40.816326530612244,0.12131147540983607,Cheap
20150406T000000,241400.0,3,2.0,1420,9828,1.0,0,0,4,7,1420,0,1990,0,98010,47.3287,-122.011,1550,7227,8408,5677,24.562474562474563,0.02182295081967213,Very Cheap
20150312T000000,309950.0,4,1.75,1450,10074,1.0,0,0,4,7,1450,0,1966,0,98058,47.4546,-122.182,1340,8023,8624,6683,30.767321818542783,0.03081311475409836,Very Cheap
20140826T000000,294010.0,3,1.75,1550,4057,1.0,0,0,3,6,830,720,1945,0,98106,47.5291,-122.351,1100,4116,2507,3016,72.46980527483362,0.028722622950819673,Very Cheap
20141216T000000,345000.0,3,2.25,1920,9672,2.0,0,0,4,8,1920,0,1984,0,98074,47.6233,-122.046,1950,10125,7752,8175,35.66997518610422,0.03540983606557377,Very Cheap
20150504T000000,625000.0,3,2.25,1920,9672,2.0,0,0,4,8,1920,0,1984,0,98074,47.6233,-122.046,1950,10125,7752,8175,64.61952026468155,0.07213114754098361,Very Cheap
20140709T000000,660000.0,4,2.5,2510,4543,2.0,0,0,3,8,2510,0,2002,0,98075,47.5962,-122.039,2550,4675,2033,2125,145.27845036319613,0.07672131147540984,Very Cheap
20150317T000000,559000.0,2,2.0,1660,4500,1.0,0,0,3,8,1660,0,2003,0,98053,47.7094,-122.031,1670,5580,2840,3910,124.22222222222223,0.06347540983606557,Very Cheap
20140707T000000,866000.0,4,3.25,3990,9786,2.0,0,0,3,9,3990,0,2004,0,98053,47.6784,-122.026,3920,8200,5796,4280,88.4937666053546,0.10373770491803279,Cheap
20140505T000000,770000.0,3,2.0,2350,5700,1.5,0,0,4,8,1810,540,1939,0,98112,47.639,-122.31,2170,6000,3350,3830,135.08771929824562,0.09114754098360656,Very Cheap
20140815T000000,259950.0,3,1.5,1350,7827,1.0,0,0,4,7,1350,0,1968,0,98030,47.3786,-122.219,1900,7827,6477,5927,33.211958604829434,0.024255737704918033,Very Cheap
20150311T000000,352000.0,5,2.75,2980,9838,1.0,0,0,3,7,1710,1270,1968,0,98030,47.3807,-122.222,2240,9838,6858,7598,35.7796300060988,0.03632786885245902,Very Cheap
20140624T000000,2466350.0,5,4.75,6390,13180,2.0,0,0,3,10,4560,1830,1940,0,98112,47.6312,-122.291,4010,8137,6790,4127,187.12822458270105,0.31361967213114755,Medium
20141106T000000,395000.0,3,2.0,1590,10229,1.0,0,0,3,7,1590,0,1966,0,98034,47.7239,-122.227,1320,10222,8639,8902,38.61570045947796,0.0419672131147541,Very Cheap
20150316T000000,276500.0,4,1.75,1400,6650,1.5,0,0,4,6,1400,0,1942,0,98168,47.4888,-122.332,1120,8645,5250,7525,41.578947368421055,0.02642622950819672,Very Cheap
20141020T000000,530000.0,3,2.25,1880,100623,1.5,0,0,3,8,1880,0,1987,2007,98024,47.5342,-121.883,2520,21689,98743,19169,5.26718543474156,0.05967213114754098,Very Cheap
20140724T000000,798000.0,4,3.25,3500,10260,2.0,0,0,3,10,3500,0,1987,0,98008,47.5902,-122.13,3500,10658,6760,7158,77.77777777777777,0.09481967213114754,Very Cheap
20140813T000000,380000.0,2,2.0,1370,5756,1.0,0,0,3,8,1370,0,1986,0,98034,47.714,-122.205,1380,5444,4386,4064,66.0180681028492,0.04,Very Cheap
20140819T000000,350000.0,4,2.5,2810,10433,2.0,0,0,3,8,2810,0,2001,0,98022,47.1895,-122.015,2640,9240,7623,6600,33.54739768043707,0.036065573770491806,Very Cheap
20140514T000000,325000.0,3,2.5,2220,6049,2.0,0,0,4,8,2220,0,1990,0,98031,47.3972,-122.182,1980,7226,3829,5246,53.727888907257395,0.03278688524590164,Very Cheap
20150402T000000,336000.0,3,2.5,2110,4549,2.0,0,0,4,8,2110,0,1989,0,98042,47.3885,-122.154,2110,4030,2439,1920,73.86238733787646,0.03422950819672131,Very Cheap
20141024T000000,286900.0,3,2.25,1720,17235,1.0,0,0,4,7,1440,280,1974,0,98042,47.3438,-122.073,1990,35048,15515,33058,16.646359152886568,0.02779016393442623,Very Cheap
20140930T000000,472000.0,5,2.25,1780,7245,1.0,0,0,4,8,1330,450,1976,0,98052,47.6946,-122.12,1780,7653,5465,5873,65.14837819185645,0.052065573770491806,Very Cheap
20140630T000000,263000.0,3,1.75,1410,8100,2.0,0,0,3,7,1410,0,1985,0,98038,47.3617,-122.046,1560,8100,6690,6540,32.46913580246913,0.024655737704918034,Very Cheap
20140716T000000,565000.0,3,3.0,2110,4000,1.0,0,2,4,7,1110,1000,1965,0,98126,47.5696,-122.375,1730,4000,1890,2270,141.25,0.06426229508196721,Very Cheap
20141008T000000,765000.0,3,2.5,2700,8444,2.0,0,0,3,10,2700,0,1992,0,98006,47.5597,-122.113,2840,9165,5744,6325,90.59687351965893,0.09049180327868853,Very Cheap
20140811T000000,1517000.0,3,2.25,2610,9409,1.0,1,4,4,8,2610,0,1963,0,98075,47.5789,-122.076,2970,9156,6799,6186,161.22861090445318,0.18911475409836065,Cheap
20141223T000000,405000.0,3,2.0,1660,8174,1.0,0,0,3,7,830,830,1981,0,98034,47.7103,-122.199,1610,9318,6514,7708,49.547345241008074,0.043278688524590166,Very Cheap
20150427T000000,1098000.0,4,3.5,4570,16219,2.0,0,0,3,11,4570,0,2002,0,98075,47.5859,-121.968,4700,16500,11649,11800,67.6983784450336,0.1341639344262295,Cheap
20140911T000000,555000.0,3,3.0,3760,188760,1.0,0,0,4,10,2640,1120,1979,0,98092,47.308,-122.087,2820,50543,185000,47723,2.940241576605213,0.06295081967213115,Very Cheap
20150427T000000,305000.0,3,2.5,1610,3516,2.0,0,0,3,8,1610,0,2006,0,98055,47.4491,-122.188,1610,3056,1906,1446,86.74630261660978,0.03016393442622951,Very Cheap
20140901T000000,289950.0,3,2.25,1740,9370,1.0,0,0,3,7,1390,350,1992,0,98198,47.391,-122.316,1740,7555,7630,5815,30.944503735325508,0.028190163934426228,Very Cheap
20140813T000000,487500.0,5,3.5,3530,218472,2.0,0,0,3,7,2380,1150,1999,0,98019,47.7309,-121.905,2110,211404,214942,209294,2.2314072283862463,0.054098360655737705,Very Cheap
20141029T000000,96500.0,3,1.0,840,12091,1.0,0,0,3,6,840,0,1959,0,98023,47.3281,-122.343,840,9324,11251,8484,7.98114299892482,0.002819672131147541,Very Cheap
20150225T000000,185000.0,3,1.0,840,12091,1.0,0,0,3,6,840,0,1959,0,98023,47.3281,-122.343,840,9324,11251,8484,15.300636837317013,0.014426229508196721,Very Cheap
20140827T000000,150550.0,4,1.0,1470,6061,1.5,0,0,3,7,1470,0,1945,0,98168,47.4819,-122.289,1230,6175,4591,4945,24.839135456195347,0.009908196721311475,Very Cheap
20140624T000000,339000.0,4,2.0,2470,5080,1.5,0,0,3,6,1970,500,1948,1988,98106,47.5308,-122.348,1060,5080,2610,4020,66.73228346456693,0.03462295081967213,Very Cheap
20150202T000000,675000.0,4,1.75,2220,7230,1.0,0,1,3,8,1280,940,1950,0,98125,47.7065,-122.279,2210,7230,5010,5020,93.3609958506224,0.07868852459016394,Very Cheap
20140624T000000,615000.0,3,1.75,1720,4080,1.0,0,0,4,7,960,760,1924,0,98144,47.5747,-122.287,1660,4080,2360,2420,150.73529411764707,0.07081967213114754,Very Cheap
20140604T000000,837500.0,4,2.5,2700,9320,2.0,0,0,4,8,2700,0,1994,0,98033,47.6861,-122.198,2120,8056,6620,5936,89.86051502145922,0.1,Very Cheap
20140819T000000,250000.0,2,1.0,950,11835,1.0,0,0,3,5,950,0,1932,0,98028,47.7494,-122.237,1690,12586,10885,10896,21.123785382340515,0.022950819672131147,Very Cheap
20140625T000000,583000.0,3,2.5,1790,8144,2.0,0,0,3,8,1790,0,1989,0,98074,47.6169,-122.045,1800,7503,6354,5703,71.58644400785855,0.06662295081967214,Very Cheap
20140904T000000,499000.0,3,2.5,1610,1728,3.0,0,0,3,8,1610,0,2000,0,98115,47.6776,-122.318,1540,3090,118,1550,288.77314814814815,0.05560655737704918,Very Cheap
20140716T000000,550000.0,3,2.5,2290,6328,2.0,0,0,3,8,2290,0,2001,0,98146,47.5103,-122.382,1600,6180,4038,4580,86.91529709228824,0.06229508196721312,Very Cheap
20140924T000000,400000.0,4,2.5,2170,204296,1.0,0,0,4,7,2170,0,1980,0,98022,47.281,-121.933,1760,154202,202126,152442,1.957943376277558,0.04262295081967213,Very Cheap
20150219T000000,990400.0,3,2.5,2100,4097,2.0,0,0,3,9,2100,0,2008,0,98004,47.5983,-122.2,1820,4764,1997,2944,241.73785696851354,0.12005245901639344,Cheap
20140821T000000,600000.0,3,2.5,2320,52272,1.5,0,0,3,8,2320,0,1974,0,98075,47.587,-122.068,2200,52272,49952,50072,11.47842056932966,0.06885245901639345,Very Cheap
20150212T000000,325000.0,2,1.0,1120,6236,1.0,0,0,4,6,1120,0,1954,0,98155,47.763,-122.291,1340,7784,5116,6444,52.116741500962156,0.03278688524590164,Very Cheap
20140710T000000,265000.0,3,2.5,1530,6000,2.0,0,0,4,7,1530,0,1991,0,98038,47.3487,-122.036,1360,6000,4470,4640,44.166666666666664,0.024918032786885248,Very Cheap
20150108T000000,1620500.0,3,2.5,3490,9362,1.0,0,3,5,9,1770,1720,1960,0,98105,47.6605,-122.27,3640,7425,5872,3785,173.09335612048707,0.20268852459016393,Cheap
20150309T000000,347500.0,3,1.5,1180,8353,1.0,0,0,3,7,1180,0,1960,0,98155,47.7652,-122.274,1710,8748,7173,7038,41.60181970549503,0.035737704918032784,Very Cheap
20150109T000000,629000.0,5,2.0,2050,3000,1.5,0,0,3,7,1470,580,1912,1984,98103,47.6864,-122.352,1560,4500,950,2940,209.66666666666666,0.07265573770491804,Very Cheap
20140708T000000,1087500.0,2,2.0,2360,11340,1.5,0,0,3,9,2360,0,1997,0,98040,47.5835,-122.227,3030,11340,8980,8310,95.8994708994709,0.13278688524590163,Cheap
20140630T000000,397500.0,4,2.5,2570,7859,2.0,0,0,3,8,2570,0,1992,0,98038,47.3736,-122.045,2150,7284,5289,5134,50.578954065402726,0.04229508196721311,Very Cheap
20141030T000000,404500.0,2,1.0,1270,3700,1.5,0,0,3,7,1270,0,1909,0,98144,47.5949,-122.307,1980,3200,2430,1220,109.32432432432432,0.043213114754098364,Very Cheap
20140513T000000,225000.0,3,1.5,1250,7500,1.0,0,0,3,7,1250,0,1967,0,98030,47.3719,-122.215,1260,7563,6250,6303,30.0,0.019672131147540985,Very Cheap
20150513T000000,267000.0,3,2.25,2510,9900,1.0,0,0,3,8,1610,900,1978,0,98023,47.2988,-122.374,1940,8510,7390,6570,26.96969696969697,0.025180327868852458,Very Cheap
20140611T000000,800000.0,4,3.75,2690,4000,2.0,0,3,4,9,2120,570,1909,1989,98119,47.6418,-122.372,2830,4000,1310,1170,200.0,0.09508196721311475,Very Cheap
20150210T000000,339000.0,4,2.5,2900,6918,2.0,0,0,3,8,2900,0,2001,0,98001,47.3504,-122.284,2720,10376,4018,7656,49.00260190806591,0.03462295081967213,Very Cheap
20150415T000000,1850000.0,4,2.5,3830,11972,1.0,1,4,3,11,2370,1460,1981,0,98155,47.7404,-122.284,3080,12297,8142,9217,154.5272302038089,0.23278688524590163,Cheap
20140930T000000,525000.0,5,1.0,1280,3876,1.5,0,0,3,7,1280,0,1923,0,98105,47.6605,-122.324,1420,3825,2596,2405,135.44891640866874,0.05901639344262295,Very Cheap
20141006T000000,1150000.0,5,3.5,4350,6218,2.0,0,2,3,10,3520,830,2007,0,98027,47.5396,-121.997,3260,5989,1868,2729,184.9469282727565,0.14098360655737704,Cheap
20141223T000000,565000.0,1,1.0,1370,6250,1.5,0,0,4,7,1370,0,1921,0,98136,47.5571,-122.385,1450,6250,4880,4800,90.4,0.06426229508196721,Very Cheap
20140520T000000,387000.0,2,2.25,1230,1280,2.0,0,0,3,8,960,270,2012,0,98144,47.5942,-122.298,1130,1357,50,227,302.34375,0.040918032786885244,Very Cheap
20140619T000000,720000.0,4,2.5,2440,34290,2.0,0,0,3,9,2440,0,1987,0,98053,47.6685,-122.044,2860,38119,31850,35259,20.99737532808399,0.08459016393442623,Very Cheap
20140711T000000,1500000.0,4,3.5,4410,12426,2.0,0,2,3,12,3420,990,1996,0,98006,47.5518,-122.107,4090,12127,8016,8037,120.71463061323033,0.18688524590163935,Cheap
20140826T000000,235000.0,2,1.0,910,7617,1.0,0,0,3,6,910,0,1936,0,98125,47.7332,-122.305,1310,6624,6707,5314,30.852041486149403,0.02098360655737705,Very Cheap
20150116T000000,365000.0,2,1.0,910,7617,1.0,0,0,3,6,910,0,1936,0,98125,47.7332,-122.305,1310,6624,6707,5314,47.91912826572141,0.0380327868852459,Very Cheap
20140521T000000,368250.0,3,2.5,2150,7484,2.0,0,0,3,8,2150,0,1988,0,98074,47.6191,-122.043,2150,6879,5334,4729,49.204970603955104,0.038459016393442624,Very Cheap
20141113T000000,580000.0,3,2.5,2150,7484,2.0,0,0,3,8,2150,0,1988,0,98074,47.6191,-122.043,2150,6879,5334,4729,77.4986638161411,0.06622950819672131,Very Cheap
20140717T000000,1100000.0,4,3.25,3190,11774,2.0,1,4,3,8,2610,580,1956,1991,98178,47.5033,-122.225,2240,8725,8584,6485,93.42619330728725,0.13442622950819672,Cheap
20150127T000000,215000.0,4,2.5,2130,4496,2.0,0,0,3,7,2130,0,2004,0,98001,47.3041,-122.28,3220,5400,2366,2180,47.820284697508896,0.018360655737704918,Very Cheap
20140909T000000,648000.0,4,2.5,2740,9959,2.0,0,0,3,9,2740,0,1989,0,98029,47.5672,-122.011,2630,9905,7219,7275,65.06677377246712,0.07514754098360656,Very Cheap
20140903T000000,705000.0,4,3.0,3150,9318,2.0,0,0,3,9,3150,0,2001,0,98075,47.5959,-122.018,3150,9318,6168,6168,75.66001287830007,0.08262295081967214,Very Cheap
20150109T000000,465000.0,3,2.25,1450,1540,2.0,0,0,3,8,1180,270,2005,0,98107,47.6685,-122.365,1450,1540,90,90,301.94805194805195,0.051147540983606556,Very Cheap
20141222T000000,650000.0,5,2.0,2400,3500,1.5,0,0,3,8,1900,500,1911,0,98103,47.6762,-122.356,1520,4000,1100,2480,185.71428571428572,0.07540983606557378,Very Cheap
20140721T000000,335000.0,4,2.25,2280,7500,1.0,0,0,4,7,1140,1140,1963,0,98198,47.4182,-122.332,1660,8000,5220,6340,44.666666666666664,0.03409836065573771,Very Cheap
20150428T000000,640000.0,4,2.0,2310,31850,1.5,0,0,4,8,2310,0,1984,0,98072,47.7713,-122.122,2710,36042,29540,33332,20.09419152276295,0.0740983606557377,Very Cheap
20150303T000000,638250.0,4,2.5,2460,8029,2.0,0,0,3,9,2460,0,1989,0,98074,47.6262,-122.03,2420,7987,5569,5567,79.49308755760369,0.0738688524590164,Very Cheap
20141017T000000,1460000.0,4,3.5,4200,14353,2.0,0,2,3,12,3640,560,1996,0,98040,47.5331,-122.217,3750,16316,10153,12566,101.7208945864976,0.18163934426229508,Cheap
20150427T000000,375000.0,4,2.0,1620,4600,2.0,0,0,3,7,1620,0,1909,0,98108,47.5533,-122.307,1620,4500,2980,2880,81.52173913043478,0.03934426229508197,Very Cheap
20140716T000000,842000.0,4,1.75,2170,9525,1.0,0,0,3,8,2170,0,1960,0,98040,47.5685,-122.217,1910,9525,7355,7615,88.39895013123359,0.10059016393442623,Cheap
20141008T000000,499950.0,3,2.25,2880,7200,1.0,0,0,3,8,1710,1170,1970,0,98133,47.7707,-122.35,1880,10200,4320,8320,69.4375,0.05573114754098361,Very Cheap
20150217T000000,810000.0,4,2.5,3280,25211,2.0,0,3,3,11,3280,0,1985,0,98074,47.6398,-122.05,3280,25211,21931,21931,32.12883265241363,0.09639344262295083,Very Cheap
20150226T000000,310000.0,5,2.0,2900,11970,2.0,0,0,4,7,2900,0,1969,0,98072,47.741,-122.095,1260,12398,9070,11138,25.89807852965748,0.03081967213114754,Very Cheap
20141031T000000,730000.0,3,2.5,2160,8809,1.0,0,0,3,9,1540,620,2014,0,98103,47.6994,-122.349,930,5420,6649,4490,82.86979225791804,0.0859016393442623,Very Cheap
20141113T000000,637800.0,4,1.75,2250,4750,1.5,0,0,4,7,1420,830,1924,0,98115,47.6738,-122.292,1930,4750,2500,2820,134.2736842105263,0.07380983606557377,Very Cheap
20150206T000000,225000.0,3,1.0,1340,4800,1.5,0,0,4,5,1340,0,1903,0,98055,47.477,-122.209,1240,4800,3460,3560,46.875,0.019672131147540985,Very Cheap
20140610T000000,417500.0,4,1.0,1390,10800,1.5,0,0,4,7,1390,0,1941,0,98177,47.7248,-122.359,1390,9360,9410,7970,38.657407407407405,0.04491803278688525,Very Cheap
20150320T000000,265000.0,4,2.0,1600,10160,1.0,0,0,4,7,1600,0,1972,0,98022,47.2015,-122.003,1540,9352,8560,7812,26.08267716535433,0.024918032786885248,Very Cheap
20140725T000000,550000.0,4,2.5,2050,8683,2.0,0,0,3,8,2050,0,1987,0,98074,47.62,-122.043,2010,8744,6633,6734,63.3421628469423,0.06229508196721312,Very Cheap
20150126T000000,625700.0,3,2.0,2570,159865,1.0,0,0,5,7,2570,0,1968,0,98024,47.5547,-121.892,2010,38322,157295,36312,3.913927376223689,0.07222295081967213,Very Cheap
20140801T000000,595000.0,3,2.5,2660,10637,2.0,0,0,3,9,2660,0,1991,0,98011,47.7383,-122.22,2590,8637,7977,6047,55.93682429256369,0.06819672131147542,Very Cheap
20140714T000000,270000.0,3,1.5,1540,13475,1.0,0,0,4,7,1540,0,1972,0,98059,47.4766,-122.153,1550,13475,11935,11925,20.037105751391465,0.025573770491803278,Very Cheap
20140718T000000,739375.0,5,3.0,2640,3200,2.0,0,0,4,7,2140,500,1906,0,98112,47.6188,-122.308,1540,2242,560,702,231.0546875,0.08713114754098361,Very Cheap
20140708T000000,357562.0,2,1.75,1210,1032,2.0,0,0,3,8,1210,0,2014,0,98029,47.5522,-121.999,1210,1090,-178,-120,346.4748062015504,0.03705731147540984,Very Cheap
20140611T000000,1010000.0,4,2.5,3760,29224,2.0,0,0,3,11,3760,0,1987,0,98052,47.7203,-122.128,3930,19916,25464,15986,34.56063509444292,0.12262295081967213,Cheap
20140930T000000,455000.0,2,1.75,1350,4286,1.0,0,0,3,8,1350,0,2004,0,98053,47.7171,-122.033,1440,4839,2936,3399,106.15958936070929,0.049836065573770495,Very Cheap
20150501T000000,310000.0,5,2.25,2600,9600,1.0,0,2,4,8,1810,790,1969,0,98023,47.3257,-122.365,2070,9660,7000,7590,32.291666666666664,0.03081967213114754,Very Cheap
20140811T000000,415000.0,3,2.75,3900,111514,2.0,0,0,3,6,3460,440,1967,2008,98024,47.5621,-121.924,2460,217800,107614,215340,3.7215058198970534,0.04459016393442623,Very Cheap
20140819T000000,452000.0,2,1.0,1340,8100,1.0,0,2,3,8,1340,0,1950,0,98177,47.7212,-122.364,1680,7752,6760,6072,55.80246913580247,0.04944262295081967,Very Cheap
20150113T000000,810000.0,3,2.0,1760,16928,1.0,0,0,3,7,1760,0,1953,0,98004,47.6363,-122.202,3430,10059,15168,6629,47.849716446124766,0.09639344262295083,Very Cheap
20140527T000000,730001.0,3,2.0,1840,4750,1.0,0,0,5,7,1010,830,1951,0,98117,47.6862,-122.395,1760,5510,2910,3750,153.6844210526316,0.08590177049180328,Very Cheap
20150430T000000,825000.0,3,2.25,2980,86636,1.0,0,0,3,9,2230,750,1989,0,98053,47.6627,-122.003,2980,107157,83656,104177,9.522600304723209,0.09836065573770492,Very Cheap
20140716T000000,665000.0,3,2.5,1730,3000,2.0,0,0,3,8,1730,0,1996,0,98103,47.6532,-122.34,1730,1774,1270,44,221.66666666666666,0.07737704918032787,Very Cheap
20140604T000000,327500.0,4,1.75,1650,7800,1.0,0,0,3,8,1650,0,1968,0,98058,47.4507,-122.139,1750,10400,6150,8650,41.98717948717949,0.033114754098360656,Very Cheap
20140728T000000,699950.0,3,2.5,3370,36218,2.0,0,0,4,9,3370,0,1988,0,98075,47.5855,-121.987,2980,31793,32848,28813,19.32602573306091,0.08196065573770492,Very Cheap
20140728T000000,424000.0,3,2.5,2200,34680,2.0,0,0,3,9,2200,0,1985,0,98092,47.3139,-122.116,2560,35840,32480,33280,12.226066897347174,0.04577049180327869,Very Cheap
20140625T000000,657000.0,4,2.5,2180,3375,1.5,0,0,4,7,1420,760,1926,0,98117,47.6846,-122.361,1560,3375,1195,1815,194.66666666666666,0.07632786885245901,Very Cheap
20140717T000000,445000.0,3,1.75,1490,10844,1.0,0,0,3,7,1210,280,1974,0,98008,47.6208,-122.106,2090,9944,9354,7854,41.03651789007746,0.04852459016393443,Very Cheap
20140731T000000,450000.0,3,2.5,1530,762,2.0,0,0,3,8,1050,480,2007,0,98119,47.642,-122.374,1610,1482,-768,-128,590.5511811023622,0.04918032786885246,Very Cheap
20140926T000000,350000.0,3,1.0,1180,7455,1.0,0,0,4,7,1180,0,1964,0,98034,47.7276,-122.241,1450,8154,6275,6704,46.948356807511736,0.036065573770491806,Very Cheap
20141112T000000,460000.0,4,2.5,2080,17532,2.0,0,0,3,9,2080,0,1996,0,98059,47.4835,-122.136,2550,12560,15452,10010,26.23773671001597,0.050491803278688525,Very Cheap
20140626T000000,385000.0,4,2.5,3200,22651,1.0,0,0,5,8,1610,1590,1970,0,98031,47.3931,-122.183,2030,5500,19451,3470,16.99704207319765,0.04065573770491803,Very Cheap
20141104T000000,272000.0,4,2.25,1880,6160,2.0,0,0,3,7,1880,0,1993,0,98023,47.3214,-122.347,1580,6405,4280,4825,44.15584415584416,0.02583606557377049,Very Cheap
20150120T000000,535000.0,3,2.5,2510,5544,2.0,0,0,3,7,2510,0,2001,0,98053,47.6903,-122.042,2660,5614,3034,2954,96.5007215007215,0.06032786885245902,Very Cheap
20150430T000000,216500.0,2,1.0,1060,5200,1.0,0,0,3,6,1060,0,1969,0,98042,47.3688,-122.08,910,5200,4140,4290,41.63461538461539,0.018557377049180326,Very Cheap
20150225T000000,325000.0,3,2.5,2130,12245,2.0,0,0,3,8,2130,0,1989,0,98042,47.3406,-122.057,1910,12216,10115,10306,26.541445487954267,0.03278688524590164,Very Cheap
20150406T000000,420200.0,3,1.75,1320,7280,1.0,0,0,3,7,1320,0,1968,0,98034,47.7229,-122.18,1370,7800,5960,6430,57.71978021978022,0.04527213114754099,Very Cheap
20141202T000000,258000.0,3,1.75,1040,5650,1.0,0,0,5,6,1040,0,1951,0,98178,47.5111,-122.256,1290,5650,4610,4360,45.663716814159294,0.024,Very Cheap
20141202T000000,450000.0,3,2.0,1150,4500,1.5,0,0,3,7,1150,0,1917,1991,98103,47.6985,-122.348,1230,5400,3350,4170,100.0,0.04918032786885246,Very Cheap
20141208T000000,720168.0,4,2.25,2120,3794,2.0,0,0,4,7,1420,700,1926,0,98117,47.6893,-122.359,1420,3840,1674,2420,189.81760674749606,0.08461219672131147,Very Cheap
20141002T000000,652000.0,3,2.0,2130,5000,1.5,0,0,5,7,1330,800,1925,0,98107,47.6746,-122.362,2010,5000,2870,2990,130.4,0.07567213114754098,Very Cheap
20140730T000000,569500.0,4,2.5,2340,8248,2.0,0,0,3,8,2340,0,1989,0,98074,47.6314,-122.03,2140,9963,5908,7823,69.04704170708051,0.06485245901639344,Very Cheap
20150424T000000,411000.0,4,1.75,2250,292288,1.0,0,0,4,7,2250,0,1963,0,98042,47.3787,-122.091,1550,23798,290038,22248,1.4061473615064595,0.044065573770491806,Very Cheap
20140519T000000,524950.0,3,1.75,1890,3825,1.0,0,0,3,7,1290,600,1974,0,98117,47.6831,-122.381,1320,3825,1935,2505,137.24183006535947,0.05900983606557377,Very Cheap
20150323T000000,153000.0,2,1.0,1140,10152,1.0,0,0,3,6,760,380,1942,0,98155,47.7369,-122.321,1340,10141,9012,8801,15.070921985815604,0.010229508196721311,Very Cheap
20141022T000000,775000.0,3,2.5,2780,5467,2.0,0,2,3,9,2780,0,2000,0,98126,47.5791,-122.378,2630,5000,2687,2370,141.75964880190233,0.09180327868852459,Very Cheap
20150112T000000,338500.0,4,2.5,2390,6111,2.0,0,0,3,8,2390,0,1997,0,98030,47.3677,-122.173,2520,6500,3721,3980,55.39191621665849,0.03455737704918033,Very Cheap
20150501T000000,570000.0,3,1.75,2390,9000,1.0,0,0,3,8,1500,890,1975,0,98052,47.6809,-122.113,2040,9000,6610,6960,63.333333333333336,0.06491803278688525,Very Cheap
20141029T000000,653000.0,3,2.0,2680,8429,1.0,0,0,4,9,1880,800,1950,1991,98038,47.372,-122.036,1570,8640,5749,7070,77.47063708624985,0.07580327868852459,Very Cheap
20141120T000000,435000.0,2,2.5,1560,1222,2.0,0,0,3,8,1080,480,2008,0,98122,47.604,-122.307,1560,2081,-338,521,355.9738134206219,0.04721311475409836,Very Cheap
20141126T000000,207000.0,2,1.0,1130,8160,1.0,0,0,4,6,1130,0,1952,0,98168,47.4997,-122.317,1060,6120,7030,5060,25.36764705882353,0.017311475409836064,Very Cheap
20140725T000000,540000.0,2,1.0,1120,7500,1.0,0,2,4,7,1120,0,1971,0,98008,47.619,-122.096,3040,16940,6380,13900,72.0,0.06098360655737705,Very Cheap
20140625T000000,386000.0,4,2.25,2050,9583,2.0,0,2,3,8,1770,280,1965,0,98198,47.3978,-122.313,2230,9730,7533,7500,40.279661901283525,0.04078688524590164,Very Cheap
20140827T000000,265000.0,5,2.25,2600,8075,1.5,0,0,4,8,2600,0,1969,0,98092,47.2961,-122.188,2200,8800,5475,6600,32.81733746130031,0.024918032786885248,Very Cheap
20150107T000000,250000.0,3,2.25,1050,572,2.0,0,0,3,7,740,310,2006,0,98106,47.5549,-122.363,1260,1062,-478,-198,437.06293706293707,0.022950819672131147,Very Cheap
20150105T000000,1697000.0,3,2.0,2600,6600,2.0,0,4,3,10,1930,670,1970,2014,98122,47.6055,-122.285,2670,6270,4000,3600,257.1212121212121,0.21272131147540985,Cheap
20141203T000000,455000.0,4,2.5,2811,7251,2.0,0,0,3,9,2811,0,2009,0,98038,47.3686,-122.058,3040,7250,4440,4210,62.74996552199696,0.049836065573770495,Very Cheap
20140527T000000,1795000.0,4,3.25,4060,13000,2.0,0,3,3,11,4060,0,2000,0,98040,47.581,-122.246,3220,13800,8940,10580,138.07692307692307,0.22557377049180327,Cheap
20141030T000000,759000.0,3,2.0,2260,7200,1.0,0,3,3,7,1130,1130,1941,0,98144,47.5886,-122.288,2260,6000,4940,3740,105.41666666666667,0.08970491803278688,Very Cheap
20150326T000000,970000.0,4,2.75,4430,74358,2.0,0,0,3,10,4430,0,1990,0,98053,47.6392,-121.988,3820,80875,69928,77055,13.044998520670271,0.11737704918032787,Cheap
20141104T000000,280000.0,1,0.0,600,24501,1.0,0,0,2,3,600,0,1950,0,98045,47.5316,-121.749,990,22549,23901,21559,11.42810497530713,0.026885245901639345,Very Cheap
20140827T000000,690000.0,3,2.25,2430,8327,1.0,0,0,4,9,1430,1000,1978,0,98006,47.5534,-122.16,2550,10427,5897,7877,82.86297586165486,0.08065573770491803,Very Cheap
20140708T000000,789900.0,3,2.5,3420,25150,1.0,0,0,4,10,1750,1670,1987,0,98006,47.5706,-122.152,2900,19604,21730,16704,31.407554671968192,0.09375737704918033,Very Cheap
20150318T000000,447500.0,2,1.0,1180,5100,1.5,0,0,3,7,1180,0,1926,0,98103,47.6947,-122.346,980,5100,3920,4120,87.74509803921569,0.04885245901639344,Very Cheap
20140613T000000,440000.0,4,2.25,2010,7575,1.0,0,0,3,7,1220,790,1974,0,98034,47.7328,-122.2,1820,7831,5565,6011,58.085808580858085,0.04786885245901639,Very Cheap
20150414T000000,278000.0,3,2.0,1230,7789,1.0,0,0,3,7,1230,0,1994,0,98042,47.3718,-122.073,1470,8670,6559,7200,35.691359609706,0.02662295081967213,Very Cheap
20140714T000000,980000.0,5,2.5,2750,6000,1.5,0,0,3,8,1750,1000,1904,1994,98103,47.6729,-122.334,1520,4158,3250,2638,163.33333333333334,0.11868852459016394,Cheap
20140630T000000,245000.0,3,2.75,1300,14197,1.0,0,0,3,7,860,440,1996,0,98030,47.3652,-122.183,1550,7596,12897,6046,17.25716700711418,0.022295081967213116,Very Cheap
20141021T000000,287000.0,3,1.5,1150,11475,1.0,0,0,3,7,1150,0,1971,0,98045,47.4629,-121.744,1640,11475,10325,9835,25.010893246187365,0.02780327868852459,Very Cheap
20140603T000000,435000.0,3,1.75,2220,132858,1.0,0,0,3,7,1110,1110,1988,0,98027,47.4853,-122.034,2130,77536,130638,75406,3.2741724246940342,0.04721311475409836,Very Cheap
20140715T000000,585000.0,3,2.5,2050,11690,2.0,0,0,4,9,2050,0,1989,0,98059,47.5279,-122.161,2410,10172,9640,7762,50.042771599657826,0.06688524590163934,Very Cheap
20140701T000000,616000.0,4,1.75,1700,5846,1.0,0,0,3,8,1700,0,1957,0,98199,47.6539,-122.408,1480,5177,4146,3697,105.37119397878891,0.07095081967213114,Very Cheap
20150115T000000,203000.0,3,1.75,1610,9000,1.0,0,0,4,7,1100,510,1978,0,98092,47.3187,-122.179,1610,8000,7390,6390,22.555555555555557,0.01678688524590164,Very Cheap
20150506T000000,860000.0,4,2.75,2720,3840,2.0,0,0,3,8,1790,930,1920,2009,98107,47.6624,-122.361,1360,3880,1120,2520,223.95833333333334,0.10295081967213114,Cheap
20150330T000000,833000.0,4,2.5,2190,12690,1.0,0,2,3,8,1170,1020,1973,0,98033,47.6627,-122.189,2630,10843,10500,8213,65.64223798266352,0.09940983606557377,Very Cheap
20141211T000000,565000.0,4,2.75,2730,6856,2.0,0,0,3,8,2730,0,2003,0,98072,47.7739,-122.164,2520,5569,4126,3049,82.40956826137689,0.06426229508196721,Very Cheap
20150212T000000,572500.0,3,2.5,2490,7589,2.0,0,0,3,9,2490,0,1991,0,98056,47.5355,-122.179,2500,10386,5099,7886,75.43813414152062,0.06524590163934427,Very Cheap
20140516T000000,254000.0,4,2.0,1510,4235,1.0,0,0,3,7,1510,0,1955,0,98108,47.546,-122.293,1510,4268,2725,2758,59.976387249114524,0.023475409836065574,Very Cheap
20150402T000000,1525000.0,4,4.25,4720,21000,3.0,0,4,5,11,4720,0,1971,0,98177,47.7591,-122.376,3010,20000,16280,16990,72.61904761904762,0.1901639344262295,Cheap
20150121T000000,900000.0,4,3.0,3810,217800,2.0,0,0,3,9,3810,0,2003,0,98077,47.7696,-122.021,2580,217364,213990,214784,4.132231404958677,0.10819672131147541,Cheap
20150226T000000,899000.0,3,2.5,1950,3730,2.0,0,0,3,9,1950,0,1996,0,98033,47.6731,-122.199,2080,4000,1780,1920,241.01876675603216,0.10806557377049181,Cheap
20150424T000000,560000.0,3,2.0,1300,6000,1.0,0,0,5,7,1300,0,1943,0,98136,47.5482,-122.392,1230,6000,4700,4770,93.33333333333333,0.06360655737704918,Very Cheap
20150304T000000,512500.0,3,1.75,1610,7200,1.0,0,0,3,7,1180,430,1976,0,98007,47.5966,-122.144,1520,7973,5590,6453,71.18055555555556,0.05737704918032787,Very Cheap
20150223T000000,775000.0,4,2.5,2040,5000,1.5,0,0,5,7,1180,860,1924,0,98117,47.6786,-122.36,1540,5000,2960,3460,155.0,0.09180327868852459,Very Cheap
20140611T000000,200000.0,2,1.0,700,4700,1.0,0,0,5,5,700,0,1953,0,98056,47.4953,-122.169,960,5200,4000,4240,42.5531914893617,0.01639344262295082,Very Cheap
20140731T000000,172000.0,3,1.0,970,4700,1.0,0,0,4,6,720,250,1943,0,98106,47.5285,-122.354,1560,4600,3730,3040,36.59574468085106,0.012721311475409836,Very Cheap
20140522T000000,219900.0,3,1.0,910,6000,1.0,0,0,2,6,910,0,1956,0,98146,47.5065,-122.338,1090,6957,5090,5867,36.65,0.01900327868852459,Very Cheap
20140711T000000,641200.0,3,1.0,1060,9123,1.0,0,0,3,7,1060,0,1952,0,98004,47.6218,-122.193,1620,9121,8063,7501,70.2838978406226,0.07425573770491803,Very Cheap
20140715T000000,473000.0,5,3.25,2180,7200,2.0,0,0,4,7,2180,0,1982,0,98034,47.7078,-122.234,1840,7644,5020,5804,65.69444444444444,0.05219672131147541,Very Cheap
20140701T000000,540000.0,3,1.75,2050,9580,1.0,0,0,3,8,1400,650,1984,0,98074,47.6212,-122.038,1740,11952,7530,10212,56.36743215031315,0.06098360655737705,Very Cheap
20150504T000000,295000.0,2,1.0,750,4500,1.0,0,0,3,6,750,0,1945,0,98122,47.607,-122.297,1540,4000,3750,2460,65.55555555555556,0.028852459016393443,Very Cheap
20140528T000000,370000.0,3,1.0,800,2296,1.0,0,0,4,6,800,0,1908,0,98103,47.6546,-122.356,1480,1472,1496,-8,161.14982578397212,0.038688524590163934,Very Cheap
20140714T000000,1727000.0,4,2.25,3470,8000,1.5,0,1,3,9,2360,1110,1906,2002,98122,47.6149,-122.287,3010,8000,4530,4990,215.875,0.21665573770491803,Cheap
20140509T000000,275000.0,3,1.5,1390,48257,1.0,0,0,3,6,1390,0,1922,2013,98024,47.5603,-121.894,1440,45302,46867,43862,5.6986551173922955,0.02622950819672131,Very Cheap
20141014T000000,89000.0,3,1.0,900,4750,1.0,0,0,4,6,900,0,1969,0,98023,47.3026,-122.363,900,3404,3850,2504,18.736842105263158,0.0018360655737704918,Very Cheap
20140805T000000,175000.0,2,1.75,1050,9800,1.5,0,0,4,6,1050,0,1975,0,98019,47.7595,-121.473,1230,12726,8750,11496,17.857142857142858,0.013114754098360656,Very Cheap
20150218T000000,490000.0,3,2.5,2410,11900,1.0,0,2,4,9,1600,810,1989,0,98023,47.3384,-122.34,3090,11902,9490,8812,41.1764705882353,0.05442622950819672,Very Cheap
20140515T000000,342400.0,3,2.25,1180,9630,2.0,0,0,3,7,1180,0,1986,0,98028,47.7352,-122.232,2660,5979,8450,3319,35.55555555555556,0.03506885245901639,Very Cheap
20140623T000000,345000.0,3,1.0,1140,4200,2.0,0,0,4,7,1140,0,1904,0,98144,47.6012,-122.296,1510,4000,3060,2490,82.14285714285714,0.03540983606557377,Very Cheap
20141125T000000,399000.0,2,1.0,700,3400,1.0,0,0,3,6,700,0,1946,0,98112,47.6212,-122.296,1570,4512,2700,2942,117.3529411764706,0.042491803278688525,Very Cheap
20140815T000000,550000.0,4,2.5,2060,9719,1.0,0,0,4,8,1320,740,1960,0,98006,47.5549,-122.176,2050,9643,7659,7593,56.59018417532668,0.06229508196721312,Very Cheap
20141203T000000,652450.0,3,2.25,2230,11835,1.0,0,0,5,8,1630,600,1974,0,98006,47.563,-122.178,2190,10384,9605,8194,55.128855090832275,0.0757311475409836,Very Cheap
20150429T000000,438000.0,2,2.25,1950,29347,1.0,0,0,3,8,1350,600,1953,0,98133,47.739,-122.351,2125,7751,27397,5626,14.924864551742939,0.04760655737704918,Very Cheap
20150403T000000,605000.0,3,1.75,2100,5058,1.0,0,2,3,7,1340,760,1941,0,98126,47.5743,-122.378,1640,5000,2958,3360,119.61249505733491,0.06950819672131148,Very Cheap
20140929T000000,395000.0,4,2.5,2130,11733,1.0,0,0,5,7,1330,800,1969,0,98059,47.512,-122.16,1800,9131,9603,7331,33.66572914003239,0.0419672131147541,Very Cheap
20141112T000000,449950.0,3,2.0,1880,3048,2.0,0,0,4,7,1880,0,1902,0,98122,47.6031,-122.303,1680,3600,1168,1920,147.6213910761155,0.04917377049180328,Very Cheap
20150330T000000,651100.0,4,2.5,2310,5526,2.0,0,0,3,9,2310,0,2003,0,98074,47.6299,-122.02,2500,5769,3216,3269,117.82482808541441,0.07555409836065574,Very Cheap
20150204T000000,241000.0,3,1.0,880,6050,1.0,0,0,3,6,880,0,1945,0,98178,47.4995,-122.248,1130,6050,5170,4920,39.83471074380165,0.02177049180327869,Very Cheap
20141007T000000,3418800.0,5,5.0,5450,20412,2.0,0,0,3,11,5450,0,2014,0,98039,47.6209,-122.237,3160,17825,14962,14665,167.4897119341564,0.4385311475409836,High
20141219T000000,268500.0,2,1.5,1290,1749,1.0,0,0,3,8,660,630,1969,0,98008,47.6118,-122.116,1860,1749,459,-111,153.516295025729,0.02537704918032787,Very Cheap
20150123T000000,200000.0,2,1.0,1010,7200,1.0,0,0,3,6,1010,0,1956,0,98166,47.4815,-122.339,1290,9000,6190,7710,27.77777777777778,0.01639344262295082,Very Cheap
20141201T000000,400375.0,4,1.75,1690,7680,1.0,0,0,5,6,890,800,1946,0,98126,47.5296,-122.375,1060,7680,5990,6620,52.132161458333336,0.04267213114754098,Very Cheap
20140528T000000,429000.0,2,1.75,1350,6315,1.0,0,0,3,8,1350,0,2005,0,98053,47.7141,-122.032,1665,5390,4965,3725,67.93349168646081,0.04642622950819672,Very Cheap
20141024T000000,230000.0,3,1.0,680,2400,1.0,0,0,4,6,680,0,1903,0,98144,47.5982,-122.299,1470,3600,1720,2130,95.83333333333333,0.020327868852459016,Very Cheap
20150218T000000,1200000.0,4,2.25,2860,10702,2.0,0,0,3,10,2860,0,1982,0,98004,47.6451,-122.189,2890,10572,7842,7682,112.12857409829938,0.14754098360655737,Cheap
20150409T000000,314200.0,1,1.0,610,6000,1.0,0,0,4,5,610,0,1918,0,98117,47.6911,-122.367,970,5000,5390,4030,52.36666666666667,0.03137049180327869,Very Cheap
20150423T000000,513000.0,4,2.5,2660,8887,1.0,0,0,4,8,1880,780,1967,0,98166,47.439,-122.342,1910,9620,6227,7710,57.72476651288399,0.05744262295081967,Very Cheap
20150402T000000,535000.0,2,1.0,1390,5346,1.0,0,0,5,7,960,430,1908,0,98118,47.5567,-122.279,1450,5040,3956,3590,100.07482229704452,0.06032786885245902,Very Cheap
20150305T000000,420000.0,6,3.0,2290,6344,2.0,0,0,3,7,2290,0,1980,0,98126,47.565,-122.37,1360,3202,4054,1842,66.20428751576293,0.04524590163934426,Very Cheap
20140623T000000,345950.0,3,2.5,2110,4118,2.0,0,0,3,8,2110,0,1989,0,98042,47.3878,-122.153,2110,4044,2008,1934,84.00922778047595,0.0355344262295082,Very Cheap
20140820T000000,483500.0,3,2.0,1200,2016,1.0,0,1,4,7,600,600,1931,0,98116,47.5811,-122.404,1730,4520,816,2790,239.83134920634922,0.05357377049180328,Very Cheap
20141208T000000,695000.0,4,2.25,2360,2500,2.0,0,3,3,8,1520,840,2001,0,98117,47.6771,-122.358,1810,3900,140,2090,278.0,0.08131147540983606,Very Cheap
20141006T000000,295000.0,4,2.5,2350,8906,2.0,0,0,3,7,2350,0,1993,0,98031,47.4205,-122.215,2000,8165,6556,6165,33.1237368066472,0.028852459016393443,Very Cheap
20150408T000000,434975.0,3,2.25,1590,9960,1.0,0,0,3,7,1060,530,1976,0,98155,47.7742,-122.287,1860,9760,8370,7900,43.67218875502008,0.047209836065573774,Very Cheap
20140708T000000,513000.0,3,2.5,1810,4592,2.0,0,0,3,8,1810,0,1992,0,98029,47.5764,-121.996,1810,4758,2782,2948,111.71602787456446,0.05744262295081967,Very Cheap
20150323T000000,360000.0,3,1.75,1900,11407,1.0,0,0,3,8,1900,0,1963,0,98155,47.7455,-122.294,1710,11407,9507,9697,31.559568685894625,0.037377049180327866,Very Cheap
20150317T000000,234900.0,3,1.0,1250,8000,1.0,0,0,3,7,1250,0,1956,0,98146,47.5065,-122.337,1040,6973,6750,5933,29.3625,0.020970491803278687,Very Cheap
20140616T000000,963000.0,4,3.5,3280,6603,2.0,0,0,3,10,3280,0,2007,0,98027,47.5642,-122.126,3280,7333,3323,4053,145.84279872785098,0.11645901639344262,Cheap
20140819T000000,595000.0,2,1.5,870,4800,1.0,0,0,3,7,870,0,1924,0,98119,47.6509,-122.37,2090,4800,3930,2710,123.95833333333333,0.06819672131147542,Very Cheap
20141024T000000,942500.0,4,3.25,3570,14408,2.0,0,2,3,10,3570,0,2006,0,98065,47.536,-121.857,4100,14577,10838,10477,65.41504719600222,0.1137704918032787,Cheap
20140905T000000,1029000.0,4,3.25,3780,11200,2.0,0,0,3,11,3780,0,2002,0,98059,47.521,-122.15,3720,11813,7420,8093,91.875,0.12511475409836065,Cheap
20150325T000000,350000.0,3,1.0,1190,3600,1.5,0,0,3,6,1190,0,1904,0,98144,47.5985,-122.298,1680,3600,2410,1920,97.22222222222223,0.036065573770491806,Very Cheap
20141106T000000,416500.0,4,2.0,2280,39848,2.0,0,0,4,8,2280,0,1991,0,98070,47.5003,-122.465,1900,38472,37568,36572,10.45221843003413,0.04478688524590164,Very Cheap
20140916T000000,209900.0,3,1.0,1030,60720,1.5,0,0,3,5,1030,0,1912,0,98042,47.375,-122.166,1330,10342,59690,9012,3.456851119894598,0.017691803278688526,Very Cheap
20140622T000000,802000.0,3,1.75,2870,5000,1.5,0,0,4,8,1840,1030,1907,0,98144,47.5788,-122.292,2200,5000,2130,2800,160.4,0.09534426229508197,Very Cheap
20140731T000000,230000.0,4,1.5,1520,8800,1.0,0,0,4,7,1520,0,1960,0,98002,47.3136,-122.208,1370,8800,7280,7430,26.136363636363637,0.020327868852459016,Very Cheap
20140702T000000,489000.0,3,3.0,3700,10375,2.0,0,0,3,9,3700,0,1982,0,98188,47.4286,-122.291,2130,9132,6675,7002,47.13253012048193,0.05429508196721312,Very Cheap
20140714T000000,497000.0,3,1.5,2240,28750,1.0,0,0,3,8,1620,620,1956,0,98034,47.7137,-122.254,3200,23873,26510,20673,17.286956521739132,0.055344262295081964,Very Cheap
20140702T000000,250000.0,3,2.25,1920,7738,1.0,0,0,3,8,1520,400,1965,0,98148,47.4562,-122.33,2170,8452,5818,6282,32.30808994572241,0.022950819672131147,Very Cheap
20140815T000000,925000.0,3,3.0,2560,3600,2.0,0,0,3,10,2110,450,1994,0,98119,47.633,-122.37,2160,3600,1040,1440,256.94444444444446,0.11147540983606558,Cheap
20140723T000000,390000.0,4,2.5,1840,15496,2.0,0,0,3,8,1840,0,1991,0,98059,47.4683,-122.07,1840,15040,13656,13200,25.16778523489933,0.04131147540983607,Very Cheap
20150310T000000,415000.0,3,2.75,2080,9600,1.0,0,0,3,7,2080,0,1988,0,98028,47.7698,-122.238,2220,9600,7520,7380,43.229166666666664,0.04459016393442623,Very Cheap
20150404T000000,785000.0,3,2.0,1600,9638,1.0,0,0,5,7,1600,0,1952,0,98040,47.5753,-122.224,1800,11400,8038,9600,81.44843328491389,0.09311475409836066,Very Cheap
20140924T000000,575000.0,3,2.0,2168,4000,1.5,0,0,3,8,2168,0,1907,0,98105,47.6561,-122.325,1770,4000,1832,2230,143.75,0.06557377049180328,Very Cheap
20150126T000000,170000.0,2,1.0,860,8636,1.0,0,0,3,6,860,0,1924,0,98146,47.5081,-122.356,1100,8636,7776,7536,19.68503937007874,0.012459016393442624,Very Cheap
20141014T000000,750000.0,4,1.75,2100,3400,1.0,0,0,5,7,1100,1000,1915,0,98119,47.6429,-122.371,1890,3771,1300,1881,220.58823529411765,0.08852459016393442,Very Cheap
20150321T000000,230000.0,3,1.0,1140,9639,1.0,0,0,4,7,1140,0,1967,0,98001,47.3112,-122.265,1140,9639,8499,8499,23.861396410416017,0.020327868852459016,Very Cheap
20150105T000000,855000.0,4,3.0,3090,35074,2.0,0,0,3,9,3090,0,1978,0,98005,47.6359,-122.159,3120,35150,31984,32030,24.37703141928494,0.10229508196721311,Cheap
20140805T000000,235000.0,3,1.0,1330,45738,2.0,0,0,2,6,1330,0,1967,0,98058,47.436,-122.185,1490,24000,44408,22510,5.137959683414229,0.02098360655737705,Very Cheap
20140908T000000,335000.0,2,1.0,1360,69260,1.0,0,0,4,5,1360,0,1937,0,98065,47.5229,-121.838,1460,69260,67900,67800,4.836846664741554,0.03409836065573771,Very Cheap
20140703T000000,1195000.0,5,3.0,3420,18129,2.0,0,0,3,9,2540,880,1952,2005,98040,47.5333,-122.217,3750,16316,14709,12566,65.91648739588504,0.14688524590163934,Cheap
20150330T000000,677000.0,4,2.0,2180,6000,1.5,0,0,3,8,2060,120,1927,0,98144,47.5958,-122.306,1370,4500,3820,3130,112.83333333333333,0.07895081967213115,Very Cheap
20141022T000000,575000.0,3,2.0,1800,5000,2.0,0,0,5,7,1600,200,1925,0,98136,47.5447,-122.389,1640,5000,3200,3360,115.0,0.06557377049180328,Very Cheap
20150218T000000,450000.0,2,1.0,1120,4590,1.0,0,0,3,7,1120,0,1924,0,98118,47.5663,-122.285,1120,5100,3470,3980,98.03921568627452,0.04918032786885246,Very Cheap
20150327T000000,817250.0,3,2.5,2980,7202,2.0,0,0,3,8,2980,0,1999,0,98033,47.6769,-122.177,2430,7280,4222,4850,113.47542349347404,0.09734426229508197,Very Cheap
20141202T000000,440000.0,4,2.25,2600,28600,1.0,0,0,3,8,1810,790,1968,0,98072,47.7757,-122.139,2580,26950,26000,24370,15.384615384615385,0.04786885245901639,Very Cheap
20140507T000000,526000.0,2,2.0,1550,2400,1.5,0,0,4,7,1550,0,1900,0,98103,47.654,-122.346,1180,1224,850,44,219.16666666666666,0.059147540983606556,Very Cheap
20140725T000000,762500.0,3,2.25,3330,15258,2.0,0,0,3,10,3330,0,1986,0,98077,47.7262,-122.06,3360,14850,11928,11490,49.973784244330844,0.09016393442622951,Very Cheap
20150414T000000,325000.0,4,2.5,2200,7719,2.0,0,0,3,8,2200,0,2000,0,98030,47.3649,-122.194,2460,7348,5519,4888,42.10389946884312,0.03278688524590164,Very Cheap
20140710T000000,840000.0,4,3.5,3840,85728,2.0,0,0,3,11,3840,0,1998,0,98014,47.615,-121.954,2430,42643,81888,40213,9.798432250839866,0.10032786885245902,Cheap
20150503T000000,377500.0,2,1.0,840,4500,1.0,0,0,3,6,840,0,1939,0,98136,47.5441,-122.39,1300,5000,3660,3700,83.88888888888889,0.039672131147540986,Very Cheap
20140923T000000,212500.0,3,1.5,1270,7128,1.0,0,0,4,6,1270,0,1954,0,98198,47.422,-122.321,1270,7986,5858,6716,29.812008978675646,0.018032786885245903,Very Cheap
20140515T000000,749400.0,4,2.5,3240,20301,2.0,0,0,3,10,3240,0,1985,0,98052,47.719,-122.114,3010,23650,17061,20640,36.91443771242796,0.08844590163934427,Very Cheap
20140626T000000,663000.0,3,2.5,2480,37843,1.5,1,3,4,8,2480,0,1974,0,98070,47.4003,-122.422,2350,42122,35363,39772,17.519752662315355,0.07711475409836066,Very Cheap
20140721T000000,1476000.0,3,2.25,4470,22518,2.0,0,2,3,9,3240,1230,1953,2004,98006,47.574,-122.18,2930,21837,18048,18907,65.54756195043964,0.1837377049180328,Cheap
20141015T000000,261000.0,3,1.0,1780,7800,1.0,0,0,3,7,1060,720,1957,0,98178,47.4932,-122.263,1450,7800,6020,6350,33.46153846153846,0.02439344262295082,Very Cheap
20150410T000000,515000.0,4,2.5,1850,9248,2.0,0,0,3,8,1850,0,1997,0,98028,47.735,-122.244,2080,8711,7398,6631,55.687716262975776,0.057704918032786885,Very Cheap
20140512T000000,410000.0,3,2.25,2200,16921,2.0,0,0,3,8,2200,0,1987,0,98038,47.3727,-122.051,2060,16921,14721,14861,24.230246439335737,0.043934426229508196,Very Cheap
20140708T000000,336000.0,3,2.25,2760,10160,1.0,0,0,3,8,2760,0,1969,0,98058,47.4504,-122.15,2760,9600,7400,6840,33.07086614173228,0.03422950819672131,Very Cheap
20150225T000000,440000.0,2,1.0,1090,4128,1.0,0,0,3,7,1090,0,1948,0,98115,47.696,-122.314,1090,5413,3038,4323,106.5891472868217,0.04786885245901639,Very Cheap
20150109T000000,908950.0,4,2.75,3090,6200,2.0,0,0,3,9,3090,0,2014,0,98006,47.5538,-122.189,2890,10108,3110,7218,146.6048387096774,0.1093704918032787,Cheap
20141125T000000,554000.0,2,1.0,820,3700,1.0,0,0,5,7,820,0,1968,0,98040,47.588,-122.251,1750,9000,2880,7250,149.72972972972974,0.06281967213114754,Very Cheap
20140509T000000,387000.0,3,2.25,1445,1606,2.0,0,0,3,7,1300,145,2003,0,98027,47.5348,-122.072,1410,1286,161,-124,240.97135740971356,0.040918032786885244,Very Cheap
20150505T000000,268643.0,4,2.25,1810,9240,2.0,0,0,3,7,1810,0,1961,0,98055,47.4362,-122.187,1660,9240,7430,7580,29.073917748917747,0.025395803278688525,Very Cheap
20140721T000000,514000.0,3,1.75,1620,5000,1.0,0,0,3,7,920,700,1954,0,98117,47.681,-122.372,1610,5000,3380,3390,102.8,0.05757377049180328,Very Cheap
20140723T000000,420000.0,2,1.75,1060,4182,2.0,0,0,3,7,1060,0,1977,0,98115,47.6787,-122.308,1760,4590,3122,2830,100.43041606886658,0.04524590163934426,Very Cheap
20140910T000000,199000.0,3,1.75,1050,9871,1.0,0,0,5,7,1050,0,1968,0,98042,47.3816,-122.087,1300,10794,8821,9494,20.160064836389424,0.016262295081967214,Very Cheap
20150317T000000,225000.0,3,1.0,1010,15701,1.0,0,0,4,7,1010,0,1949,0,98188,47.4518,-122.292,1260,9800,14691,8540,14.330297433284505,0.019672131147540985,Very Cheap
20140819T000000,320000.0,4,2.5,2050,8424,2.0,0,0,4,8,2050,0,1993,0,98022,47.196,-122.011,1970,8448,6374,6478,37.98670465337132,0.032131147540983604,Very Cheap
20141023T000000,204995.0,2,1.0,970,8185,1.0,0,0,5,6,970,0,1904,0,98031,47.4025,-122.201,1500,12541,7215,11041,25.045204642638975,0.017048524590163934,Very Cheap
20141229T000000,376000.0,3,2.0,1540,1827,2.0,0,0,3,8,1540,0,2005,0,98029,47.5479,-121.999,1560,2058,287,498,205.80186097427477,0.039475409836065574,Very Cheap
20141215T000000,705000.0,4,2.75,3000,6222,2.0,0,0,3,9,3000,0,2004,0,98029,47.5582,-122.025,3340,7222,3222,3882,113.3076181292189,0.08262295081967214,Very Cheap
20140602T000000,725995.0,4,2.5,3190,7869,2.0,0,2,3,9,3190,0,2001,0,98065,47.5317,-121.866,2630,6739,4679,4109,92.2601347058076,0.08537639344262295,Very Cheap
20150126T000000,285000.0,4,2.5,1870,8190,1.0,0,0,3,7,1100,770,1977,0,98058,47.4521,-122.161,1590,9150,6320,7560,34.798534798534796,0.02754098360655738,Very Cheap
20140502T000000,285000.0,4,2.5,2200,9397,2.0,0,0,3,8,2200,0,1987,0,98001,47.3406,-122.269,2310,9176,7197,6866,30.328828349473238,0.02754098360655738,Very Cheap
20140820T000000,731000.0,4,2.5,3070,5936,2.0,0,0,3,9,3070,0,2005,0,98075,47.5902,-121.988,3160,5936,2866,2776,123.14690026954177,0.0860327868852459,Very Cheap
20150501T000000,1564350.0,4,3.75,3730,17000,2.0,0,3,4,10,2820,910,1986,0,98040,47.5355,-122.242,3880,15550,13270,11670,92.02058823529411,0.19532459016393441,Cheap
20141006T000000,510000.0,4,2.5,2440,10423,1.0,0,0,3,7,2440,0,1955,1993,98034,47.725,-122.172,1990,7758,7983,5768,48.930250407752084,0.057049180327868855,Very Cheap
20141023T000000,620000.0,2,1.0,990,4332,1.0,0,0,3,7,990,0,1909,0,98103,47.6528,-122.331,1920,3420,3342,1500,143.12096029547553,0.07147540983606557,Very Cheap
20150422T000000,1110000.0,3,4.0,4160,31796,2.0,0,0,3,11,4160,0,1989,0,98053,47.6635,-122.017,4300,36192,27636,31892,34.910051578814944,0.13573770491803278,Cheap
20140722T000000,796000.0,4,3.5,3670,4960,2.0,0,0,3,9,2870,800,2005,0,98177,47.7022,-122.374,1520,6335,1290,4815,160.48387096774192,0.09455737704918032,Very Cheap
20140930T000000,255000.0,3,1.5,910,25500,1.0,0,0,3,5,910,0,1943,0,98188,47.4565,-122.276,1580,10019,24590,8439,10.0,0.02360655737704918,Very Cheap
20150428T000000,807000.0,3,2.5,1940,4000,2.0,0,0,4,9,1940,0,2000,0,98199,47.659,-122.398,1410,4000,2060,2590,201.75,0.096,Very Cheap
20141110T000000,315000.0,4,2.5,1780,6000,2.0,0,0,3,9,1780,0,2000,0,98038,47.3774,-122.027,2650,6000,4220,3350,52.5,0.031475409836065574,Very Cheap
20150227T000000,637000.0,3,2.25,2200,7355,2.0,0,0,4,8,2200,0,1986,0,98052,47.7266,-122.103,2290,7868,5155,5578,86.60774983004758,0.07370491803278688,Very Cheap
20141203T000000,2725000.0,4,4.25,6410,43838,2.5,0,2,4,12,5610,800,1906,0,98144,47.5703,-122.28,2270,6630,37428,4360,62.160682512888364,0.3475409836065574,Medium
20141211T000000,490000.0,3,2.0,2070,10023,1.0,0,0,3,8,1220,850,1981,0,98074,47.6492,-122.062,2130,9694,7953,7564,48.88755861518507,0.05442622950819672,Very Cheap
20140610T000000,253000.0,3,1.75,2040,7281,1.0,0,0,3,7,1020,1020,1962,0,98188,47.4681,-122.282,1740,7527,5241,5787,34.747974179370964,0.023344262295081967,Very Cheap
20140508T000000,325900.0,4,2.5,2320,6270,2.0,0,0,3,8,2320,0,2004,0,98042,47.3501,-122.14,2150,6270,3950,4120,51.97767145135566,0.03290491803278688,Very Cheap
20141015T000000,425000.0,2,2.0,1440,6677,1.0,0,0,3,7,870,570,1952,0,98118,47.5513,-122.264,2020,7642,5237,5622,63.65134042234536,0.04590163934426229,Very Cheap
20140905T000000,215000.0,4,2.5,1700,6675,2.0,0,0,3,7,1700,0,1997,0,98038,47.3638,-122.053,1570,7540,4975,5970,32.20973782771536,0.018360655737704918,Very Cheap
20150408T000000,315000.0,4,2.5,1700,6675,2.0,0,0,3,7,1700,0,1997,0,98038,47.3638,-122.053,1570,7540,4975,5970,47.19101123595506,0.031475409836065574,Very Cheap
20140516T000000,724800.0,3,2.0,2050,3933,1.0,0,0,3,8,1180,870,1926,2001,98112,47.6436,-122.303,1940,4000,1883,2060,184.28680396643784,0.08521967213114755,Very Cheap
20140709T000000,295000.0,2,1.0,800,6500,1.0,0,0,4,6,800,0,1953,0,98133,47.7621,-122.358,1220,7000,5700,5780,45.38461538461539,0.028852459016393443,Very Cheap
20150316T000000,509007.0,3,1.75,1800,7620,1.0,0,0,3,8,1350,450,1951,0,98177,47.7165,-122.361,1770,7620,5820,5850,66.7988188976378,0.05691895081967213,Very Cheap
20150413T000000,306000.0,5,2.0,1460,169448,1.5,0,0,3,6,1460,0,1910,0,98030,47.3714,-122.177,2250,6059,167988,3809,1.805863745809924,0.030295081967213113,Very Cheap
20140717T000000,205000.0,3,1.75,1290,7210,1.0,0,0,3,7,1290,0,1984,0,98023,47.2889,-122.363,1350,7509,5920,6159,28.43273231622746,0.017049180327868854,Very Cheap
20140731T000000,275000.0,3,1.5,1900,9737,1.0,0,0,4,7,1200,700,1968,0,98031,47.4125,-122.207,1670,9737,7837,8067,28.242785252131046,0.02622950819672131,Very Cheap
20141106T000000,685000.0,3,1.75,1480,7000,1.0,0,2,3,8,1480,0,1963,0,98122,47.6018,-122.291,1850,4000,5520,2150,97.85714285714286,0.08,Very Cheap
20150420T000000,465000.0,4,2.5,2090,12833,1.0,0,0,3,7,1220,870,1969,0,98034,47.7266,-122.175,1740,11200,10743,9460,36.23470739499727,0.051147540983606556,Very Cheap
20140708T000000,560000.0,4,2.25,1950,9800,1.0,0,0,3,8,1330,620,1968,0,98033,47.666,-122.178,2170,9800,7850,7630,57.142857142857146,0.06360655737704918,Very Cheap
20150223T000000,458500.0,3,1.75,1250,9605,1.0,0,0,3,7,1250,0,1964,0,98008,47.6325,-122.121,1570,9605,8355,8035,47.73555439875065,0.050295081967213114,Very Cheap
20150331T000000,354000.0,3,1.0,990,7590,1.0,0,0,3,6,990,0,1959,0,98008,47.6228,-122.121,1100,7590,6600,6490,46.640316205533594,0.03659016393442623,Very Cheap
20150113T000000,441000.0,3,2.5,2740,7923,2.0,0,0,3,9,2740,0,1998,0,98058,47.4349,-122.105,2740,8815,5183,6075,55.660734570238546,0.048,Very Cheap
20140829T000000,194000.0,3,1.75,1260,10488,1.0,0,0,2,7,1110,150,1952,0,98106,47.5417,-122.357,1540,9120,9228,7580,18.497330282227306,0.01560655737704918,Very Cheap
20140515T000000,316500.0,4,2.5,2150,6807,2.0,0,0,4,8,2150,0,1991,0,98031,47.4053,-122.189,1910,7240,4657,5330,46.49625385632437,0.031672131147540986,Very Cheap
20140825T000000,524950.0,3,1.75,1750,3250,1.5,0,0,4,7,1230,520,1929,0,98117,47.6807,-122.366,1480,3600,1500,2120,161.52307692307693,0.05900983606557377,Very Cheap
20150427T000000,1052000.0,3,2.25,2880,6092,2.0,0,4,4,8,1920,960,1983,0,98116,47.5878,-122.381,2880,5308,3212,2428,172.6854891661195,0.12813114754098362,Cheap
20150412T000000,925000.0,4,2.25,2590,13894,2.0,0,0,4,9,2590,0,1975,0,98005,47.6351,-122.165,2720,13894,11304,11174,66.57550021592054,0.11147540983606558,Cheap
20141020T000000,780000.0,3,1.75,2430,4524,1.5,0,0,4,7,1830,600,1924,0,98103,47.674,-122.35,1610,4100,2094,2490,172.41379310344828,0.09245901639344262,Very Cheap
20140519T000000,241000.0,2,2.0,1470,3128,2.0,0,0,3,6,1470,0,2005,0,98038,47.349,-122.021,1180,2576,1658,1396,77.0460358056266,0.02177049180327869,Very Cheap
20140619T000000,519000.0,3,2.75,2020,10744,1.0,0,0,5,7,1270,750,1954,0,98166,47.4403,-122.343,2020,11069,8724,9049,48.3060312732688,0.05822950819672131,Very Cheap
20140828T000000,286000.0,2,1.0,610,4000,1.0,0,0,4,6,610,0,1918,0,98136,47.5469,-122.391,870,5160,3390,4290,71.5,0.027672131147540982,Very Cheap
20141009T000000,400000.0,3,2.0,3000,17800,1.0,0,0,3,8,1500,1500,1962,0,98125,47.7058,-122.315,2400,8300,14800,5900,22.471910112359552,0.04262295081967213,Very Cheap
20141009T000000,255000.0,2,1.0,920,43560,1.0,0,0,4,5,920,0,1923,0,98024,47.5245,-121.931,1530,11875,42640,10345,5.853994490358127,0.02360655737704918,Very Cheap
20150121T000000,152000.0,3,1.75,1070,7754,1.0,0,0,3,6,1070,0,1953,0,98146,47.5079,-122.344,950,7740,6684,6790,19.602785659014703,0.010098360655737704,Very Cheap
20141201T000000,599000.0,4,2.0,3410,15143,2.0,0,0,4,8,3410,0,1972,1987,98052,47.6709,-122.052,2350,25936,11733,23586,39.556230601598095,0.06872131147540983,Very Cheap
20141024T000000,330000.0,4,2.5,1820,3905,2.0,0,0,3,7,1820,0,2001,0,98019,47.7346,-121.985,1820,3863,2085,2043,84.50704225352112,0.03344262295081967,Very Cheap
20140519T000000,461000.0,2,1.0,1060,7193,1.0,0,0,3,7,1060,0,1926,0,98133,47.7102,-122.356,1980,7560,6133,5580,64.09008758515223,0.05062295081967213,Very Cheap
20150310T000000,620000.0,5,2.5,3070,34991,2.0,0,0,3,9,3070,0,1995,0,98059,47.4721,-122.148,2150,19515,31921,17365,17.718841987939754,0.07147540983606557,Very Cheap
20141006T000000,352500.0,4,2.5,2300,219106,1.0,0,0,4,7,1840,460,1958,0,98038,47.4044,-121.963,2120,123710,216806,121590,1.608810347503035,0.03639344262295082,Very Cheap
20140806T000000,435000.0,3,2.0,1610,6911,1.0,0,0,3,7,1260,350,1988,0,98034,47.7188,-122.177,1630,6911,5301,5281,62.94313413398929,0.04721311475409836,Very Cheap
20140516T000000,725000.0,5,2.75,2830,5310,2.0,0,0,3,9,2830,0,2006,0,98052,47.7074,-122.101,3150,6581,2480,3431,136.53483992467042,0.08524590163934426,Very Cheap
20141105T000000,300000.0,3,1.0,970,12300,1.0,0,0,3,7,970,0,1982,0,98028,47.7335,-122.227,2040,9994,11330,7954,24.390243902439025,0.029508196721311476,Very Cheap
20141111T000000,252000.0,3,2.5,1680,8284,2.0,0,0,3,7,1680,0,1989,0,98038,47.3609,-122.048,1550,8284,6604,6734,30.420086914534043,0.02321311475409836,Very Cheap
20141005T000000,464625.0,4,2.75,2040,8996,1.0,0,0,4,8,1260,780,1974,0,98033,47.666,-122.185,2470,9180,6956,6710,51.64795464650956,0.0510983606557377,Very Cheap
20141212T000000,340000.0,3,1.0,1450,9586,2.0,0,0,3,7,1450,0,1950,0,98155,47.7443,-122.326,1500,8592,8136,7092,35.468391404131026,0.03475409836065574,Very Cheap
20140620T000000,1325000.0,4,2.25,2870,6280,1.5,0,0,4,9,1980,890,1905,0,98112,47.6329,-122.31,2370,4760,3410,2390,210.98726114649682,0.16393442622950818,Cheap
20150206T000000,455000.0,5,2.0,1870,13970,1.0,0,0,4,7,1120,750,1969,0,98027,47.5243,-122.042,1860,13970,12100,12110,32.5697924123121,0.049836065573770495,Very Cheap
20150513T000000,495000.0,4,3.5,2490,18042,2.0,0,0,3,8,2490,0,2003,0,98070,47.4161,-122.441,1960,21107,15552,19147,27.43598270701696,0.05508196721311476,Very Cheap
20150421T000000,925000.0,4,2.5,3350,4501,2.0,0,0,3,9,2640,710,2002,0,98117,47.688,-122.379,1000,4500,1151,3500,205.50988669184625,0.11147540983606558,Cheap
20141211T000000,587000.0,4,2.75,3190,8737,2.0,0,0,3,9,3190,0,2006,0,98065,47.523,-121.877,3240,7131,5547,3891,67.18553279157605,0.06714754098360656,Very Cheap
20140505T000000,524000.0,3,1.75,1560,5520,1.0,0,0,4,6,780,780,1944,0,98199,47.6515,-122.399,1470,6000,3960,4530,94.92753623188406,0.05888524590163934,Very Cheap
20140613T000000,1030000.0,4,2.5,2750,4800,2.0,0,0,3,9,1960,790,1905,2005,98103,47.6709,-122.337,2400,5300,2050,2900,214.58333333333334,0.12524590163934426,Cheap
20140930T000000,176000.0,2,1.0,920,2332,1.0,0,0,4,8,920,0,1980,0,98198,47.3779,-122.32,1310,2853,1412,1543,75.47169811320755,0.013245901639344262,Very Cheap
20140521T000000,249900.0,2,1.0,1140,5500,1.0,0,0,3,6,1140,0,1947,0,98106,47.5187,-122.363,1110,5500,4360,4390,45.43636363636364,0.02293770491803279,Very Cheap
20140605T000000,499500.0,3,2.5,2520,53143,1.5,0,0,3,7,2520,0,1988,0,98019,47.743,-121.925,2020,56628,50623,54608,9.399168281805695,0.055672131147540986,Very Cheap
20140911T000000,600000.0,5,3.5,3150,10542,1.0,0,0,5,9,1620,1530,1974,0,98011,47.7469,-122.217,3150,11807,7392,8657,56.91519635742743,0.06885245901639345,Very Cheap
20140814T000000,294000.0,4,2.5,2040,7800,2.0,0,0,3,7,2040,0,2003,0,98168,47.473,-122.293,1860,10954,5760,9094,37.69230769230769,0.028721311475409836,Very Cheap
20150415T000000,272000.0,4,2.0,1780,19843,1.0,0,0,3,7,1780,0,1963,0,98058,47.4414,-122.154,2210,13500,18063,11290,13.707604696870433,0.02583606557377049,Very Cheap
20140515T000000,390000.0,3,2.5,2240,10800,2.0,0,0,3,8,2240,0,1996,0,98028,47.7433,-122.229,1900,9900,8560,8000,36.111111111111114,0.04131147540983607,Very Cheap
20150109T000000,700000.0,4,2.5,3270,9650,1.0,0,3,4,9,2320,950,1971,0,98166,47.409,-122.333,2340,17357,6380,15017,72.53886010362694,0.08196721311475409,Very Cheap
20150420T000000,635000.0,5,2.75,3110,6621,2.0,0,0,3,9,3110,0,2006,0,98065,47.543,-121.888,3550,7953,3511,4403,95.90696269445704,0.07344262295081967,Very Cheap
20150416T000000,920000.0,4,1.5,1850,3600,2.0,0,0,3,8,1660,190,1929,0,98112,47.6376,-122.307,1970,3600,1750,1630,255.55555555555554,0.11081967213114755,Cheap
20140804T000000,500000.0,3,1.75,1570,8530,1.0,0,0,4,7,1190,380,1983,0,98033,47.6881,-122.184,1530,8708,6960,7178,58.61664712778429,0.05573770491803279,Very Cheap
20140821T000000,263500.0,2,1.0,750,4515,1.0,0,0,3,6,750,0,1942,0,98106,47.5198,-122.351,1020,5000,3765,3980,58.36101882613511,0.024721311475409836,Very Cheap
20150313T000000,975000.0,4,2.25,2240,9990,2.0,0,0,4,10,2240,0,1967,0,98040,47.5516,-122.217,2600,11480,7750,8880,97.5975975975976,0.1180327868852459,Cheap
20141114T000000,575000.0,3,2.5,1870,3485,2.0,0,0,3,8,1870,0,2001,0,98029,47.5493,-122.004,1940,3485,1615,1545,164.99282639885223,0.06557377049180328,Very Cheap
20140612T000000,822000.0,4,2.5,2683,40386,2.0,0,0,4,9,2683,0,1987,0,98052,47.6982,-122.138,2683,34800,37703,32117,20.353587876987074,0.09796721311475409,Very Cheap
20150116T000000,300000.0,3,1.0,1490,7200,1.0,0,0,3,7,1490,0,1954,0,98125,47.7276,-122.307,1280,7200,5710,5920,41.666666666666664,0.029508196721311476,Very Cheap
20150330T000000,487600.0,4,2.5,2340,12080,2.0,0,0,3,8,2340,0,1999,0,98019,47.7325,-121.969,2200,12403,9740,10203,40.36423841059602,0.05411147540983607,Very Cheap
20140707T000000,500000.0,4,2.0,1700,8640,1.0,0,0,3,7,850,850,1955,2010,98006,47.5774,-122.153,1620,9000,6940,7380,57.870370370370374,0.05573770491803279,Very Cheap
20140911T000000,680000.0,2,2.0,1450,989,3.0,0,0,3,9,1450,0,2014,0,98109,47.6354,-122.346,1490,1240,-461,-250,687.5631951466128,0.07934426229508197,Very Cheap
20140910T000000,419000.0,3,2.5,3310,21096,2.0,0,2,3,9,3310,0,2004,0,98023,47.3049,-122.386,3310,13835,17786,10525,19.86158513462268,0.04511475409836065,Very Cheap
20140807T000000,450000.0,4,1.75,1520,5250,1.0,0,0,3,6,1520,0,1949,0,98199,47.6581,-122.39,1530,5250,3730,3720,85.71428571428571,0.04918032786885246,Very Cheap
20140618T000000,650000.0,5,1.75,1260,4500,1.5,0,0,3,7,1260,0,1926,0,98119,47.6452,-122.369,1410,4388,3240,2978,144.44444444444446,0.07540983606557378,Very Cheap
20140623T000000,550000.0,3,1.75,1840,8086,1.0,0,0,4,8,1840,0,1964,0,98052,47.67,-122.155,1840,8060,6246,6220,68.0187979223349,0.06229508196721312,Very Cheap
20141203T000000,330000.0,4,2.0,1750,5202,1.0,0,1,4,6,1070,680,1942,0,98108,47.5677,-122.317,2090,5400,3452,3310,63.437139561707035,0.03344262295081967,Very Cheap
20150123T000000,282510.0,4,1.0,1450,32234,1.5,0,0,4,6,1450,0,1932,0,98030,47.3818,-122.21,1530,10125,30784,8595,8.764348203760004,0.027214426229508197,Very Cheap
20141120T000000,2385000.0,4,4.0,6330,13296,2.0,0,2,3,13,4900,1430,2000,0,98033,47.6488,-122.201,2200,9196,6966,6996,179.37725631768953,0.30295081967213117,Medium
20141120T000000,230000.0,2,2.0,1260,10200,1.0,0,0,3,7,1020,240,1983,0,98003,47.2593,-122.312,1560,10200,8940,8640,22.54901960784314,0.020327868852459016,Very Cheap
20141004T000000,750000.0,4,1.75,2100,6613,2.0,0,0,3,8,2100,0,1909,2004,98116,47.567,-122.385,1630,5750,4513,4120,113.41297444427643,0.08852459016393442,Very Cheap
20140916T000000,321000.0,4,2.5,2430,5366,2.0,0,0,3,8,2430,0,2002,0,98092,47.3352,-122.19,2100,5414,2936,3314,59.82109578829668,0.032262295081967214,Very Cheap
20141027T000000,2196000.0,4,3.25,4250,18000,2.0,0,3,5,10,3350,900,1980,0,98040,47.5612,-122.229,3790,14537,13750,10747,122.0,0.2781639344262295,Cheap
20150318T000000,245000.0,4,2.0,1830,10416,1.0,0,0,3,7,1370,460,1958,0,98146,47.4878,-122.341,1830,9271,8586,7441,23.521505376344088,0.022295081967213116,Very Cheap
20141223T000000,510000.0,2,1.0,1310,4000,1.0,0,0,3,6,1310,0,1913,0,98103,47.6854,-122.329,1550,4000,2690,2450,127.5,0.057049180327868855,Very Cheap
20140624T000000,751000.0,4,3.25,3090,9571,2.0,0,0,3,9,2370,720,2004,0,98052,47.7058,-122.131,3630,9110,6481,5480,78.46619997910354,0.08865573770491804,Very Cheap
20140523T000000,675000.0,4,2.5,2560,36601,2.0,0,0,4,9,2560,0,1987,0,98075,47.5851,-121.992,2790,36601,34041,33811,18.442119067785033,0.07868852459016394,Very Cheap
20150126T000000,295000.0,3,1.75,1930,13350,1.0,0,0,3,8,1930,0,1967,0,98023,47.3317,-122.365,2270,13350,11420,11080,22.09737827715356,0.028852459016393443,Very Cheap
20141028T000000,312000.0,2,1.0,1460,6000,1.0,0,0,2,7,1260,200,1925,0,98115,47.7009,-122.317,1580,6380,4540,4800,52.0,0.031081967213114754,Very Cheap
20140925T000000,730000.0,3,3.0,3460,13129,2.0,0,0,3,9,2560,900,1988,0,98077,47.7315,-122.058,3460,12568,9669,9108,55.602102216467365,0.0859016393442623,Very Cheap
20150102T000000,762500.0,5,3.5,3290,5880,2.0,0,0,3,9,2670,620,2005,0,98052,47.7067,-122.119,3090,5680,2590,2590,129.6768707482993,0.09016393442622951,Very Cheap
20140528T000000,150000.0,3,1.0,820,7680,1.5,0,0,3,6,820,0,1910,0,98106,47.528,-122.359,1470,6912,6860,5442,19.53125,0.009836065573770493,Very Cheap
20150309T000000,270000.0,3,1.0,1480,7374,1.0,0,0,3,6,760,720,1954,0,98133,47.7775,-122.336,1480,8934,5894,7454,36.61513425549227,0.025573770491803278,Very Cheap
20150406T000000,400000.0,4,2.0,1420,9301,1.0,0,0,4,7,1420,0,1963,0,98008,47.6325,-122.121,1530,8075,7881,6545,43.006128373293194,0.04262295081967213,Very Cheap
20140826T000000,650000.0,3,2.5,2790,6720,2.0,0,0,3,8,2790,0,2002,0,98075,47.5958,-122.038,2620,6720,3930,4100,96.72619047619048,0.07540983606557378,Very Cheap
20141006T000000,530000.0,2,1.5,1390,5000,1.0,0,0,4,8,970,420,1954,0,98116,47.5673,-122.401,1610,5000,3610,3390,106.0,0.05967213114754098,Very Cheap
20140630T000000,248000.0,3,1.0,950,9400,1.0,0,0,4,7,950,0,1954,0,98006,47.5746,-122.136,1260,9400,8450,8140,26.382978723404257,0.022688524590163933,Very Cheap
20150108T000000,760000.0,4,3.5,3000,5300,1.0,0,0,5,7,1780,1220,1949,0,98115,47.6748,-122.279,1360,5450,2300,4090,143.39622641509433,0.0898360655737705,Very Cheap
20150220T000000,199000.0,4,1.0,1280,10521,1.5,0,0,3,7,1280,0,1960,0,98198,47.4215,-122.289,1540,9384,9241,7844,18.914551848683587,0.016262295081967214,Very Cheap
20141020T000000,240000.0,2,1.0,870,8400,1.0,0,0,3,7,870,0,1960,0,98188,47.4493,-122.282,1070,12465,7530,11395,28.571428571428573,0.021639344262295083,Very Cheap
20150504T000000,415000.0,3,1.5,1360,1795,2.0,0,0,3,7,1360,0,1945,0,98199,47.6471,-122.397,1580,1795,435,215,231.19777158774374,0.04459016393442623,Very Cheap
20141202T000000,228000.0,3,1.0,1000,16376,1.0,0,0,3,7,1000,0,1959,0,98059,47.4825,-122.108,1420,16192,15376,14772,13.922813873961896,0.020065573770491802,Very Cheap
20150225T000000,525000.0,4,2.5,2740,12106,1.0,0,0,3,8,1980,760,1992,0,98133,47.7648,-122.355,2170,11156,9366,8986,43.36692549149182,0.05901639344262295,Very Cheap
20140623T000000,399950.0,3,1.75,1560,5223,1.0,0,0,4,7,810,750,1940,0,98125,47.7175,-122.288,1440,8491,3663,7051,76.57476546046334,0.04261639344262295,Very Cheap
20150413T000000,781000.0,4,2.5,2590,8571,2.0,0,0,3,9,2590,0,1988,0,98052,47.691,-122.105,2360,8155,5981,5795,91.12122272780306,0.09259016393442623,Very Cheap
20150428T000000,827000.0,3,2.5,1850,1330,2.5,0,0,3,9,1560,290,2004,0,98115,47.6831,-122.325,1810,2071,-520,261,621.8045112781955,0.09862295081967214,Very Cheap
20140716T000000,525000.0,5,2.25,2500,8621,1.5,0,0,4,7,2500,0,1968,0,98034,47.7379,-122.185,1980,7395,6121,5415,60.897807678923556,0.05901639344262295,Very Cheap
20150224T000000,671300.0,4,2.5,3280,5232,2.0,0,0,3,7,3280,0,2004,0,98053,47.6798,-122.033,2600,5080,1952,2480,128.3065749235474,0.07820327868852459,Very Cheap
20140604T000000,175000.0,2,1.0,670,2378,1.0,0,0,3,5,670,0,1919,0,98126,47.5769,-122.372,700,2970,1708,2270,73.59125315391086,0.013114754098360656,Very Cheap
20150302T000000,1100000.0,5,2.75,2890,22547,1.0,0,0,4,10,2150,740,1963,0,98040,47.5476,-122.219,3010,17809,19657,14799,48.78697831197055,0.13442622950819672,Cheap
20150506T000000,800000.0,5,2.5,3000,10560,1.0,0,0,3,8,1500,1500,1966,0,98004,47.6249,-122.206,2690,11616,7560,8926,75.75757575757575,0.09508196721311475,Very Cheap
20140711T000000,329950.0,4,2.5,1920,4600,2.0,0,0,3,7,1920,0,2002,0,98038,47.3795,-122.023,2200,6600,2680,4400,71.72826086956522,0.03343606557377049,Very Cheap
20140805T000000,445000.0,4,3.25,1960,7200,2.0,0,0,3,7,1960,0,1979,0,98034,47.7291,-122.218,1980,7529,5240,5549,61.80555555555556,0.04852459016393443,Very Cheap
20140819T000000,237000.0,3,1.75,2000,12208,1.0,0,0,3,7,1140,860,1979,0,98032,47.3752,-122.236,1060,8194,10208,7134,19.413499344692006,0.021245901639344263,Very Cheap
20140923T000000,1112500.0,6,4.0,3600,6224,2.0,0,0,3,9,2610,990,1945,2006,98199,47.6531,-122.405,1430,6224,2624,4794,178.7435732647815,0.1360655737704918,Cheap
20141210T000000,438900.0,4,2.5,2740,5700,2.0,0,0,3,9,2740,0,2006,0,98038,47.3535,-122.026,3010,5281,2960,2271,77.0,0.047724590163934426,Very Cheap
20140808T000000,1280000.0,9,4.5,3650,5000,2.0,0,0,3,8,2530,1120,1915,2010,98105,47.6604,-122.289,2510,5000,1350,2490,256.0,0.1580327868852459,Cheap
20141017T000000,600000.0,4,2.5,2310,3866,2.0,0,0,3,8,2310,0,2005,0,98029,47.5498,-121.996,1950,4023,1556,2073,155.1991722710812,0.06885245901639345,Very Cheap
20150120T000000,670000.0,4,2.5,2095,4569,2.0,0,0,3,9,2095,0,2002,0,98052,47.6603,-122.087,2095,4385,2474,2290,146.64040271394177,0.0780327868852459,Very Cheap
20150504T000000,519000.0,2,2.0,1560,4823,1.0,0,0,3,8,1560,0,2004,0,98053,47.7111,-122.032,1855,4989,3263,3134,107.60937176031516,0.05822950819672131,Very Cheap
20150311T000000,320000.0,3,2.25,1880,7350,1.0,0,0,3,8,1390,490,1984,0,98058,47.4457,-122.123,1910,8400,5470,6490,43.53741496598639,0.032131147540983604,Very Cheap
20140522T000000,270000.0,2,1.5,840,867,2.0,0,0,3,7,840,0,2005,0,98115,47.6955,-122.304,840,1322,27,482,311.4186851211073,0.025573770491803278,Very Cheap
20140602T000000,1000000.0,3,2.5,2730,5832,2.0,0,0,3,9,2730,0,1998,0,98005,47.6216,-122.161,2360,5832,3102,3472,171.46776406035664,0.12131147540983607,Cheap
20140815T000000,330000.0,1,1.0,860,4800,1.0,0,0,3,6,860,0,1907,0,98122,47.6146,-122.299,1380,4800,3940,3420,68.75,0.03344262295081967,Very Cheap
20140710T000000,657500.0,3,2.0,2320,10960,1.0,0,0,3,7,1510,810,1956,0,98005,47.6157,-122.174,2160,10960,8640,8800,59.99087591240876,0.07639344262295082,Very Cheap
20140828T000000,450000.0,3,1.75,1540,61419,1.0,0,0,3,7,1540,0,1967,0,98028,47.7663,-122.228,3790,8529,59879,4739,7.326723001025742,0.04918032786885246,Very Cheap
20150416T000000,150000.0,3,1.0,890,6488,1.5,0,0,3,5,890,0,1928,0,98014,47.7087,-121.352,1330,16250,5598,14920,23.11960542540074,0.009836065573770493,Very Cheap
20140616T000000,792500.0,4,2.5,4290,175421,2.0,0,0,3,10,4290,0,2004,0,98010,47.3585,-121.988,3370,63162,171131,59792,4.5177031256235,0.0940983606557377,Very Cheap
20150220T000000,540000.0,3,2.5,1950,13227,2.0,0,0,4,9,1950,0,1978,0,98034,47.7217,-122.256,2650,12943,11277,10293,40.825584032660466,0.06098360655737705,Very Cheap
20140721T000000,229900.0,3,1.0,1010,8848,1.0,0,0,4,7,1010,0,1968,0,98003,47.2742,-122.299,1380,10650,7838,9270,25.983273056057865,0.020314754098360657,Very Cheap
20150506T000000,533000.0,4,2.5,2830,6536,2.0,0,0,3,8,2830,0,2003,0,98038,47.3888,-122.032,2830,6872,3706,4042,81.5483476132191,0.060065573770491806,Very Cheap
20141222T000000,239000.0,4,1.75,1500,12560,1.0,0,0,4,7,1000,500,1977,0,98002,47.2918,-122.197,1700,9020,11060,7320,19.028662420382165,0.021508196721311476,Very Cheap
20150306T000000,713900.0,3,2.5,3370,167706,1.0,0,0,3,10,3370,0,2000,0,98038,47.4379,-122.022,3350,213444,164336,210094,4.256854256854257,0.08379016393442623,Very Cheap
20141028T000000,427500.0,4,2.5,3160,8726,2.0,0,0,3,9,3160,0,1999,0,98092,47.2582,-122.223,2500,8648,5566,6148,48.99151959660784,0.04622950819672131,Very Cheap
20140722T000000,302000.0,3,1.0,1110,7000,1.5,0,0,4,7,1110,0,1955,0,98133,47.754,-122.341,1800,7000,5890,5200,43.142857142857146,0.02977049180327869,Very Cheap
20140708T000000,1150000.0,3,2.5,3830,48743,2.0,0,0,3,11,3830,0,1991,0,98006,47.5663,-122.125,2950,8299,44913,5349,23.59313132142051,0.14098360655737704,Cheap
20140528T000000,555000.0,3,2.5,3160,4270,2.0,0,0,3,8,2650,510,2006,0,98011,47.7453,-122.194,2720,12523,1110,9803,129.97658079625293,0.06295081967213115,Very Cheap
20141230T000000,495000.0,3,2.25,2100,3000,2.0,0,0,3,7,2100,0,1996,0,98144,47.595,-122.306,1650,4500,900,2850,165.0,0.05508196721311476,Very Cheap
20140722T000000,495000.0,3,1.5,2240,13288,1.0,0,0,3,7,2240,0,1953,0,98033,47.6762,-122.17,2150,9900,11048,7750,37.25165562913907,0.05508196721311476,Very Cheap
20140917T000000,340000.0,2,0.75,1060,48292,1.0,1,2,5,6,560,500,1947,0,98070,47.4285,-122.511,750,80201,47232,79451,7.040503603081255,0.03475409836065574,Very Cheap
20150512T000000,464950.0,4,2.25,2350,36116,1.0,0,0,4,9,2350,0,1983,0,98042,47.3533,-122.082,2580,36116,33766,33536,12.873795547679698,0.051140983606557375,Very Cheap
20150327T000000,320000.0,4,2.5,1940,7040,2.0,0,0,3,8,1940,0,1998,0,98092,47.2632,-122.209,2400,7145,5100,4745,45.45454545454545,0.032131147540983604,Very Cheap
20150129T000000,440000.0,1,1.0,1160,64469,1.0,0,0,3,7,1160,0,2009,0,98072,47.7433,-122.082,1580,48352,63309,46772,6.8249856520188,0.04786885245901639,Very Cheap
20140602T000000,686000.0,3,1.5,1840,9990,2.0,0,0,5,8,1840,0,1961,0,98177,47.7145,-122.369,2100,12474,8150,10374,68.66866866866867,0.0801311475409836,Very Cheap
20141201T000000,555000.0,4,1.75,2260,11000,1.0,0,0,3,8,1620,640,1976,0,98008,47.6224,-122.109,1960,10000,8740,8040,50.45454545454545,0.06295081967213115,Very Cheap
20141027T000000,361500.0,2,1.0,840,3860,1.0,0,0,4,6,840,0,1909,0,98117,47.6842,-122.365,1390,3860,3020,2470,93.65284974093264,0.03757377049180328,Very Cheap
20140610T000000,1240000.0,5,3.0,2830,7500,2.0,0,0,3,9,2460,370,1923,0,98105,47.6579,-122.277,2900,5000,4670,2100,165.33333333333334,0.15278688524590164,Cheap
20140709T000000,154950.0,4,1.0,1600,10183,1.0,0,0,4,6,1600,0,1966,0,98002,47.277,-122.211,1410,10416,8583,9006,15.216537366198565,0.010485245901639344,Very Cheap
20140617T000000,247200.0,3,1.75,1370,8719,1.0,0,0,3,7,1370,0,1982,0,98042,47.3664,-122.087,1370,7525,7349,6155,28.351875215047595,0.02258360655737705,Very Cheap
20140822T000000,250000.0,3,2.25,1960,7414,1.0,0,0,3,7,1490,470,1984,0,98023,47.2977,-122.374,1580,8038,5454,6458,33.719989209603455,0.022950819672131147,Very Cheap
20140619T000000,590300.0,3,1.5,1470,7200,2.0,0,0,4,7,1470,0,1907,0,98118,47.5602,-122.28,1530,7200,5730,5670,81.98611111111111,0.06758032786885246,Very Cheap
20140505T000000,541125.0,5,2.75,2740,8426,1.0,0,0,4,8,1370,1370,1960,0,98006,47.5563,-122.184,2020,8783,5686,6763,64.22086399240446,0.06113114754098361,Very Cheap
20150218T000000,310000.0,2,2.5,1090,923,2.0,0,0,3,7,1090,0,2004,0,98027,47.5347,-122.071,1410,1326,-167,-84,335.86132177681475,0.03081967213114754,Very Cheap
20150310T000000,704111.0,4,2.75,2460,9520,1.0,0,1,3,8,1680,780,1976,0,98034,47.7021,-122.233,2380,9600,7060,7220,73.96123949579832,0.0825063606557377,Very Cheap
20141028T000000,277500.0,3,2.25,1820,19602,1.0,0,0,4,7,1820,0,1964,0,98001,47.331,-122.286,1520,8773,17782,7253,14.156718702173247,0.026557377049180327,Very Cheap
20150217T000000,325000.0,4,2.75,1960,8937,1.0,0,0,5,7,980,980,1954,0,98188,47.451,-122.278,1480,10016,6977,8536,36.36567080675842,0.03278688524590164,Very Cheap
20141121T000000,289200.0,3,2.25,1760,7023,2.0,0,0,3,7,1760,0,1995,0,98019,47.7468,-121.98,1760,7082,5263,5322,41.178983340452795,0.028091803278688526,Very Cheap
20140904T000000,185000.0,1,1.0,720,5000,1.0,0,0,4,6,720,0,1908,0,98118,47.5289,-122.272,1170,5000,4280,3830,37.0,0.014426229508196721,Very Cheap
20150401T000000,1445000.0,4,3.5,3470,8580,2.0,0,0,3,11,2500,970,2007,0,98199,47.6433,-122.403,1940,7920,5110,5980,168.41491841491842,0.179672131147541,Cheap
20150318T000000,420550.0,4,2.0,1370,8100,1.0,0,0,2,7,1370,0,1947,0,98155,47.749,-122.312,1280,8100,6730,6820,51.91975308641975,0.045318032786885246,Very Cheap
20150410T000000,603000.0,4,2.25,2370,11310,1.0,0,0,3,8,1550,820,1968,0,98155,47.7684,-122.289,1890,8621,8940,6731,53.315649867374006,0.06924590163934426,Very Cheap
20141126T000000,345000.0,3,1.0,1390,2640,1.5,0,0,3,7,1230,160,1903,0,98122,47.6078,-122.307,1780,3920,1250,2140,130.6818181818182,0.03540983606557377,Very Cheap
20150416T000000,650000.0,3,2.0,1840,3075,1.0,0,0,5,7,920,920,1928,0,98103,47.6894,-122.35,1480,3774,1235,2294,211.3821138211382,0.07540983606557378,Very Cheap
20140625T000000,589950.0,5,3.0,2790,19439,1.0,0,3,5,7,1500,1290,1973,0,98058,47.4088,-122.089,1620,19439,16649,17819,30.34878337363033,0.0675344262295082,Very Cheap
20140819T000000,309950.0,2,2.25,1460,1607,2.0,0,0,3,8,1460,0,2007,0,98106,47.5395,-122.369,1460,1826,147,366,192.87492221530803,0.03081311475409836,Very Cheap
20140911T000000,775000.0,3,2.5,2620,241200,1.5,0,0,4,9,2620,0,1998,0,98027,47.4574,-122.01,2620,172933,238580,170313,3.213101160862355,0.09180327868852459,Very Cheap
20141029T000000,590000.0,4,1.5,2230,5109,1.5,0,0,3,7,1330,900,1918,0,98115,47.6996,-122.31,1630,5109,2879,3479,115.48248189469564,0.06754098360655737,Very Cheap
20150428T000000,863500.0,4,3.0,3250,2760,2.5,0,0,3,8,2420,830,1905,2007,98122,47.6104,-122.303,1260,2780,-490,1520,312.8623188405797,0.10340983606557377,Cheap
20141119T000000,517500.0,3,1.0,1190,7000,1.0,0,0,3,7,1190,0,1943,0,98199,47.6453,-122.403,1350,7000,5810,5650,73.92857142857143,0.0580327868852459,Very Cheap
20141224T000000,700000.0,3,3.0,2090,7440,1.5,0,0,5,7,1290,800,1922,0,98103,47.6891,-122.331,1570,4960,5350,3390,94.08602150537635,0.08196721311475409,Very Cheap
20140722T000000,699000.0,3,2.5,2580,8154,1.0,0,0,3,10,2090,490,1956,1997,98177,47.7259,-122.361,1660,8155,5574,6495,85.72479764532744,0.08183606557377049,Very Cheap
20140722T000000,350000.0,3,2.5,2100,3574,2.0,0,0,3,7,1690,410,2005,0,98019,47.7453,-121.984,1970,2962,1474,992,97.92949076664802,0.036065573770491806,Very Cheap
20140717T000000,795000.0,4,2.5,3160,16564,2.0,0,0,3,10,3160,0,1987,0,98074,47.6365,-122.04,3160,12415,13404,9255,47.99565322385897,0.09442622950819672,Very Cheap
20140514T000000,543000.0,3,2.5,2090,7640,1.0,0,0,3,7,1360,730,1962,2014,98133,47.7369,-122.338,2090,7668,5550,5578,71.07329842931937,0.06137704918032787,Very Cheap
20150223T000000,325000.0,3,2.5,1570,3143,2.0,0,0,3,7,1570,0,2001,0,98019,47.7364,-121.969,1740,3591,1573,1851,103.40439070951321,0.03278688524590164,Very Cheap
20150508T000000,337500.0,3,1.0,1020,6000,1.5,0,0,3,7,1020,0,1900,0,98108,47.5254,-122.318,1240,6000,4980,4760,56.25,0.03442622950819672,Very Cheap
20150227T000000,425000.0,2,1.0,1300,11080,1.0,0,0,4,7,1300,0,1955,0,98034,47.7281,-122.233,1600,9259,9780,7659,38.35740072202166,0.04590163934426229,Very Cheap
20150317T000000,780000.0,3,2.5,2110,9773,1.0,0,0,3,9,2110,0,1986,0,98006,47.5628,-122.115,2560,11787,7663,9227,79.81172618438555,0.09245901639344262,Very Cheap
20140723T000000,259000.0,2,1.0,1210,17389,1.0,0,0,4,5,1210,0,1948,0,98059,47.5044,-122.148,2140,14419,16179,12279,14.894473517741101,0.024131147540983607,Very Cheap
20140813T000000,524400.0,4,1.75,1990,12950,1.0,0,0,4,8,1850,140,1968,0,98006,47.5434,-122.166,2090,12850,10960,10760,40.49420849420849,0.05893770491803279,Very Cheap
20140527T000000,260000.0,3,2.0,1630,8018,1.0,0,0,3,7,1630,0,2003,0,98001,47.2638,-122.243,1610,8397,6388,6787,32.42703916188576,0.024262295081967214,Very Cheap
20150420T000000,273000.0,2,2.0,1384,1822,2.0,0,0,3,7,1384,0,1990,0,98028,47.7525,-122.244,1078,1315,438,237,149.83534577387485,0.025967213114754098,Very Cheap
20150402T000000,639900.0,4,2.5,3380,75794,2.0,0,0,3,10,3380,0,1997,0,98001,47.3511,-122.266,3710,17913,72414,14203,8.442620787925165,0.07408524590163934,Very Cheap
20140826T000000,420000.0,4,2.5,2480,8626,2.0,0,0,3,10,2480,0,2001,0,98001,47.3185,-122.262,2990,9033,6146,6043,48.690006955715276,0.04524590163934426,Very Cheap
20140813T000000,510500.0,3,1.0,1270,8000,1.0,0,0,4,7,1270,0,1957,0,98007,47.5874,-122.136,1470,8000,6730,6530,63.8125,0.05711475409836066,Very Cheap
20150408T000000,290000.0,4,1.0,1010,7200,1.5,0,0,3,6,1010,0,1947,0,98155,47.742,-122.325,1360,7200,6190,5840,40.27777777777778,0.02819672131147541,Very Cheap
20150428T000000,226000.0,3,1.75,1490,6269,1.0,0,0,4,6,990,500,1944,0,98056,47.4917,-122.188,1490,7722,4779,6232,36.05040676343914,0.01980327868852459,Very Cheap
20140529T000000,300000.0,2,1.0,820,3844,1.0,0,0,4,6,820,0,1916,0,98133,47.7049,-122.349,1520,3844,3024,2324,78.04370447450572,0.029508196721311476,Very Cheap
20140728T000000,407450.0,3,2.0,1810,10860,1.0,0,0,3,7,1810,0,1967,0,98053,47.6393,-121.967,1420,11982,9050,10562,37.51841620626151,0.0436,Very Cheap
20150506T000000,390000.0,4,2.25,3060,7920,1.0,0,0,3,7,1530,1530,1965,0,98178,47.4879,-122.245,1850,7800,4860,5950,49.24242424242424,0.04131147540983607,Very Cheap
20150501T000000,1058800.0,6,2.75,2980,20000,1.0,0,4,3,8,2130,850,1965,0,98177,47.7599,-122.375,2730,20000,17020,17270,52.94,0.12902295081967213,Cheap
20140817T000000,610000.0,3,2.5,3440,18167,2.0,0,0,3,11,3440,0,1991,0,98023,47.2909,-122.342,3990,20239,14727,16249,33.577365552925635,0.07016393442622951,Very Cheap
20150123T000000,239975.0,3,2.5,1820,7242,1.0,0,0,3,7,1220,600,1959,0,98188,47.4318,-122.292,1350,8214,5422,6864,33.136564484948906,0.021636065573770492,Very Cheap
20140807T000000,375000.0,3,2.5,2320,5760,1.0,0,0,3,7,1480,840,1987,0,98178,47.504,-122.248,1660,5762,3440,4102,65.10416666666667,0.03934426229508197,Very Cheap
20150428T000000,742500.0,4,2.5,2620,4400,2.0,0,0,3,9,2620,0,2004,0,98029,47.5524,-121.991,2640,4554,1780,1914,168.75,0.08754098360655738,Very Cheap
20150429T000000,450000.0,4,1.75,2190,11625,1.0,0,0,4,8,2020,170,1956,0,98146,47.4979,-122.363,1920,8855,9435,6935,38.70967741935484,0.04918032786885246,Very Cheap
20140626T000000,300000.0,3,2.25,1780,10395,1.0,0,0,3,8,1780,0,1967,0,98058,47.4539,-122.15,2080,9360,8615,7280,28.86002886002886,0.029508196721311476,Very Cheap
20150501T000000,216600.0,3,1.75,2200,7700,1.0,0,0,3,7,1240,960,1975,0,98031,47.4119,-122.181,1770,7360,5500,5590,28.12987012987013,0.018570491803278688,Very Cheap
20140514T000000,525000.0,3,1.75,1600,6120,1.5,0,0,3,7,1600,0,1924,0,98115,47.6847,-122.291,1670,4590,4520,2920,85.7843137254902,0.05901639344262295,Very Cheap
20140620T000000,455000.0,4,2.25,2450,21000,1.0,0,2,4,8,1650,800,1954,0,98166,47.4559,-122.344,1820,12480,18550,10660,21.666666666666668,0.049836065573770495,Very Cheap
20141003T000000,390000.0,4,2.25,2680,35218,2.0,0,0,3,8,2680,0,1986,0,98027,47.4613,-121.997,2980,35218,32538,32238,11.073882673632802,0.04131147540983607,Very Cheap
20140916T000000,450000.0,3,1.75,1850,8667,1.0,0,0,4,7,880,970,1982,0,98033,47.7025,-122.198,1450,10530,6817,9080,51.92107995846314,0.04918032786885246,Very Cheap
20141202T000000,382000.0,4,1.0,1740,4400,1.5,0,0,3,7,1740,0,1924,0,98122,47.6058,-122.3,1590,4400,2660,2810,86.81818181818181,0.040262295081967214,Very Cheap
20140513T000000,287000.0,3,2.25,1490,9600,1.0,0,0,4,7,1170,320,1987,0,98019,47.7378,-121.977,1590,10104,8110,8514,29.895833333333332,0.02780327868852459,Very Cheap
20150113T000000,460000.0,4,2.0,1960,190357,1.0,0,3,2,8,1960,0,1971,0,98027,47.5538,-121.958,2560,189100,188397,186540,2.4165121324668912,0.050491803278688525,Very Cheap
20141028T000000,435000.0,3,2.25,1380,3015,2.0,0,0,3,7,1380,0,2009,0,98052,47.6783,-122.157,1930,3612,1635,1682,144.27860696517413,0.04721311475409836,Very Cheap
20140612T000000,575000.0,2,1.0,1510,4032,1.5,0,0,3,8,1310,200,1935,0,98199,47.6371,-122.393,1700,4042,2522,2342,142.609126984127,0.06557377049180328,Very Cheap
20150504T000000,626700.0,3,1.5,1410,3600,1.0,0,0,3,7,1410,0,1906,0,98109,47.6402,-122.357,1370,3600,2190,2230,174.08333333333334,0.07235409836065573,Very Cheap
20150318T000000,352000.0,4,1.5,1440,8680,1.5,0,0,3,7,1440,0,1922,0,98178,47.502,-122.228,1440,9000,7240,7560,40.55299539170507,0.03632786885245902,Very Cheap
20150316T000000,650000.0,3,1.0,920,6750,1.0,0,0,4,7,920,0,1951,0,98004,47.6322,-122.212,1460,8933,5830,7473,96.29629629629629,0.07540983606557378,Very Cheap
20141006T000000,197000.0,3,1.0,1090,17630,1.0,0,0,4,7,1090,0,1962,0,98002,47.288,-122.196,1300,12000,16540,10700,11.174134997163925,0.016,Very Cheap
20140703T000000,340000.0,8,2.75,2790,6695,1.0,0,0,3,7,1470,1320,1977,0,98133,47.7565,-122.331,1760,7624,3905,5864,50.78416728902166,0.03475409836065574,Very Cheap
20140721T000000,560000.0,3,2.0,1840,14985,1.0,0,0,3,7,1840,0,1968,0,98033,47.6916,-122.158,2300,16067,13145,13767,37.37070403737071,0.06360655737704918,Very Cheap
20150107T000000,354000.0,3,1.75,1340,6300,1.0,0,0,3,7,1340,0,1972,0,98034,47.7186,-122.218,1780,7200,4960,5420,56.19047619047619,0.03659016393442623,Very Cheap
20140801T000000,670000.0,4,2.5,2570,9086,2.0,0,0,3,9,2570,0,1999,0,98074,47.6373,-122.064,2760,6733,6516,3973,73.73981950253136,0.0780327868852459,Very Cheap
20150126T000000,769000.0,4,3.5,3010,6202,2.0,0,0,3,9,3010,0,2005,0,98029,47.5533,-121.993,2520,5001,3192,2481,123.99226056110932,0.09101639344262295,Very Cheap
20140905T000000,650000.0,4,2.5,2160,3139,1.0,0,0,3,7,1080,1080,1940,0,98103,47.6662,-122.338,1650,3740,979,2090,207.07231602421155,0.07540983606557378,Very Cheap
20140615T000000,650000.0,3,1.75,2140,9484,1.0,0,0,3,7,1290,850,1953,0,98004,47.6234,-122.191,1960,9630,7344,7670,68.53648249683678,0.07540983606557378,Very Cheap
20141212T000000,289950.0,4,1.75,2090,7416,1.0,0,0,4,7,1050,1040,1970,0,98031,47.4107,-122.179,1710,7527,5326,5817,39.09789644012945,0.028190163934426228,Very Cheap
20141201T000000,300000.0,3,1.75,1810,21138,1.0,0,0,4,7,1240,570,1977,0,98058,47.4674,-122.178,1850,12200,19328,10350,14.192449616803861,0.029508196721311476,Very Cheap
20141203T000000,471000.0,4,1.75,1760,5750,1.0,0,2,5,7,1070,690,1962,0,98126,47.5521,-122.373,1860,5750,3990,3890,81.91304347826087,0.051934426229508196,Very Cheap
20140718T000000,639000.0,4,2.5,2500,8540,2.0,0,0,3,9,2500,0,1990,0,98029,47.5759,-121.994,2560,8475,6040,5915,74.82435597189695,0.0739672131147541,Very Cheap
20141009T000000,287000.0,2,1.0,930,6900,1.0,0,2,3,7,930,0,1952,0,98178,47.506,-122.242,1910,7194,5970,5284,41.594202898550726,0.02780327868852459,Very Cheap
20150401T000000,740000.0,4,2.5,3030,8335,2.0,0,0,3,10,3030,0,1992,0,98075,47.578,-122.056,2850,8678,5305,5828,88.78224355128974,0.08721311475409836,Very Cheap
20150417T000000,499922.0,3,2.0,1460,3000,1.0,0,0,4,7,940,520,1990,0,98117,47.682,-122.365,1460,3000,1540,1540,166.64066666666668,0.055727475409836066,Very Cheap
20141219T000000,675000.0,4,2.5,2940,14071,2.0,0,0,3,9,2940,0,1986,0,98029,47.5627,-122.018,2670,10982,11131,8312,47.97100419302111,0.07868852459016394,Very Cheap
20140909T000000,738515.0,5,2.75,3360,9200,2.0,0,0,3,9,3360,0,2014,0,98011,47.7754,-122.173,3360,9713,5840,6353,80.2733695652174,0.0870183606557377,Very Cheap
20141030T000000,445000.0,3,1.75,2110,4800,1.0,0,0,3,8,1210,900,1956,0,98108,47.567,-122.318,1660,4800,2690,3140,92.70833333333333,0.04852459016393443,Very Cheap
20150501T000000,1039000.0,4,2.25,2740,11343,1.0,0,2,5,10,1980,760,1953,0,98125,47.7117,-122.278,2790,10027,8603,7237,91.5983425901437,0.1264262295081967,Cheap
20141001T000000,346000.0,2,1.0,1070,2196,1.0,0,0,4,7,880,190,1917,0,98144,47.5726,-122.308,1160,3600,1126,2440,157.5591985428051,0.03554098360655738,Very Cheap
20150408T000000,450000.0,3,2.0,1680,4886,2.0,0,0,3,7,1180,500,1940,0,98118,47.5536,-122.286,1400,4900,3206,3500,92.09987720016373,0.04918032786885246,Very Cheap
20140812T000000,350000.0,4,2.5,2260,13755,1.0,0,0,4,9,2260,0,1975,0,98042,47.3767,-122.161,2650,13650,11495,11000,25.44529262086514,0.036065573770491806,Very Cheap
20140728T000000,2400000.0,4,3.5,5860,7200,2.0,0,0,5,10,3690,2170,1907,0,98112,47.6287,-122.287,4150,7200,1340,3050,333.3333333333333,0.30491803278688523,Medium
20140801T000000,594950.0,4,2.25,2380,35008,1.0,0,0,3,8,2380,0,1977,0,98075,47.5834,-122.001,2250,34794,32628,32544,16.99468692870201,0.06819016393442623,Very Cheap
20150514T000000,1695000.0,5,3.0,3320,5354,2.0,0,0,3,9,3320,0,2004,0,98103,47.6542,-122.331,2330,4040,2034,1710,316.5857302951065,0.2124590163934426,Cheap
20141010T000000,219000.0,2,1.0,1050,9000,1.5,0,0,4,7,1050,0,1984,0,98003,47.2887,-122.299,1550,9600,7950,8050,24.333333333333332,0.018885245901639345,Very Cheap
20150409T000000,450000.0,4,2.5,2070,3982,2.0,0,0,3,7,2070,0,2004,0,98065,47.531,-121.854,2340,4067,1912,1727,113.00853842290306,0.04918032786885246,Very Cheap
20150415T000000,402000.0,4,2.25,1790,7311,2.0,0,0,3,7,1790,0,1992,0,98056,47.5055,-122.189,1400,7203,5521,5803,54.985638079606076,0.04288524590163934,Very Cheap
20150217T000000,275000.0,2,1.0,840,4000,1.0,0,0,3,6,840,0,1942,0,98108,47.5531,-122.307,1100,4000,3160,2900,68.75,0.02622950819672131,Very Cheap
20141001T000000,421500.0,3,1.5,990,4500,1.0,0,0,5,7,990,0,1948,0,98122,47.6051,-122.298,1490,4000,3510,2510,93.66666666666667,0.045442622950819675,Very Cheap
20140507T000000,560000.0,3,3.0,4120,60392,2.0,0,2,3,9,3180,940,1994,0,98014,47.6804,-121.913,2770,64033,56272,61263,9.272751357795734,0.06360655737704918,Very Cheap
20150318T000000,314000.0,3,1.75,1620,9600,1.0,0,0,4,7,1620,0,1966,0,98059,47.4749,-122.155,1660,10200,7980,8540,32.708333333333336,0.03134426229508197,Very Cheap
20150423T000000,287000.0,4,2.0,1340,8190,1.0,0,0,4,7,1340,0,1942,0,98146,47.4905,-122.343,1410,9721,6850,8311,35.042735042735046,0.02780327868852459,Very Cheap
20150403T000000,277000.0,4,1.0,1500,5750,1.5,0,0,3,6,1500,0,1925,0,98055,47.4768,-122.206,1330,5750,4250,4420,48.17391304347826,0.026491803278688525,Very Cheap
20141222T000000,337500.0,2,1.0,1300,6731,1.0,0,0,3,7,1300,0,1950,0,98116,47.5697,-122.395,1240,6731,5431,5491,50.14113801812509,0.03442622950819672,Very Cheap
20140819T000000,792000.0,4,2.75,3100,10245,2.0,0,0,3,10,3100,0,1999,0,98052,47.6858,-122.107,3140,9028,7145,5888,77.30600292825768,0.0940327868852459,Very Cheap
20141113T000000,435000.0,3,2.5,3380,7074,2.0,0,0,3,8,2200,1180,1999,0,98019,47.7462,-121.978,2060,6548,3694,4488,61.492790500424086,0.04721311475409836,Very Cheap
20150325T000000,313100.0,4,2.5,2660,9030,1.0,0,0,4,7,1450,1210,1977,0,98055,47.4558,-122.212,1870,9030,6370,7160,34.673311184939095,0.031226229508196722,Very Cheap
20140625T000000,575000.0,3,2.25,1700,3333,1.5,0,0,3,7,1100,600,1924,0,98117,47.6784,-122.361,1700,3750,1633,2050,172.5172517251725,0.06557377049180328,Very Cheap
20150202T000000,510000.0,4,2.5,1840,7800,1.0,0,2,3,8,1240,600,1972,0,98177,47.7762,-122.384,2010,9100,5960,7090,65.38461538461539,0.057049180327868855,Very Cheap
20150319T000000,299950.0,2,1.0,890,5200,1.0,0,0,4,6,890,0,1941,0,98126,47.5311,-122.373,950,5200,4310,4250,57.68269230769231,0.029501639344262295,Very Cheap
20150323T000000,1028000.0,3,3.0,2800,5800,1.0,0,0,3,9,1580,1220,1953,2010,98199,47.6493,-122.413,2580,5800,3000,3220,177.24137931034483,0.12498360655737704,Cheap
20140514T000000,364000.0,4,1.75,2010,8625,1.0,0,0,4,7,1340,670,1957,0,98133,47.7496,-122.355,1500,8400,6615,6900,42.20289855072464,0.03790163934426229,Very Cheap
20140729T000000,335000.0,3,1.0,1380,7470,1.0,0,0,5,7,1380,0,1965,0,98133,47.7479,-122.343,1440,7473,6090,6033,44.84605087014726,0.03409836065573771,Very Cheap
20141209T000000,219950.0,3,1.0,1210,8000,1.0,0,0,3,6,1210,0,1954,0,98198,47.4211,-122.314,1430,8000,6790,6570,27.49375,0.01900983606557377,Very Cheap
20150113T000000,215000.0,3,2.0,1280,6994,1.0,0,0,3,7,1280,0,1991,0,98038,47.3889,-122.048,1290,7514,5714,6224,30.740634829854162,0.018360655737704918,Very Cheap
20150511T000000,640000.0,4,2.5,4090,215186,2.0,0,0,4,8,3670,420,1979,0,98092,47.2964,-122.116,2430,142005,211096,139575,2.9741711821401022,0.0740983606557377,Very Cheap
20140630T000000,535000.0,3,1.0,1580,6300,1.0,0,0,3,7,1180,400,1925,0,98199,47.6505,-122.384,1560,1601,4720,41,84.92063492063492,0.06032786885245902,Very Cheap
20140819T000000,253000.0,4,2.0,1910,7826,1.0,0,0,4,7,1140,770,1973,0,98003,47.3493,-122.306,1540,7826,5916,6286,32.32813697929977,0.023344262295081967,Very Cheap
20140530T000000,650000.0,2,2.5,1740,2500,2.0,0,2,3,8,1210,530,1994,0,98112,47.622,-122.3,1640,2500,760,860,260.0,0.07540983606557378,Very Cheap
20150408T000000,672000.0,3,2.25,1130,4445,1.5,0,0,4,8,1130,0,1930,0,98117,47.6845,-122.375,1330,4445,3315,3115,151.1811023622047,0.07829508196721312,Very Cheap
20141007T000000,606000.0,3,1.75,1970,8540,1.0,0,3,4,8,1130,840,1950,0,98177,47.7213,-122.365,2280,8540,6570,6260,70.96018735362998,0.06963934426229508,Very Cheap
20150305T000000,292000.0,3,2.25,1780,9720,1.0,0,0,3,8,1280,500,1981,0,98059,47.4762,-122.156,1710,9790,7940,8080,30.041152263374485,0.028459016393442622,Very Cheap
20140604T000000,289950.0,3,2.0,1670,7757,1.0,0,0,3,8,1670,0,1992,0,98030,47.3802,-122.207,2290,7859,6087,5569,37.37914142065232,0.028190163934426228,Very Cheap
20140722T000000,257500.0,4,1.5,1360,9323,1.0,0,0,4,7,1360,0,1968,0,98023,47.3168,-122.401,1180,9611,7963,8431,27.619864850370053,0.023934426229508195,Very Cheap
20141104T000000,380000.0,3,2.5,1840,6985,1.0,0,0,3,7,1290,550,1971,0,98133,47.7586,-122.342,2160,7990,5145,5830,54.40229062276306,0.04,Very Cheap
20141222T000000,360000.0,3,1.75,1255,1113,3.0,0,0,3,8,1255,0,2010,0,98103,47.6958,-122.343,1010,1038,-142,28,323.45013477088946,0.037377049180327866,Very Cheap
20140623T000000,269500.0,3,1.75,1840,7412,1.0,0,0,4,7,1240,600,1976,0,98031,47.3933,-122.188,1980,7350,5572,5370,36.3599568267674,0.025508196721311476,Very Cheap
20140630T000000,449000.0,4,2.5,2960,6031,2.0,0,0,3,9,2960,0,2005,0,98038,47.3596,-122.04,2570,5012,3071,2442,74.448681810645,0.049049180327868855,Very Cheap
20141003T000000,375000.0,4,1.5,1430,7232,1.5,0,0,3,7,1430,0,1948,0,98125,47.7197,-122.328,1540,7232,5802,5692,51.85287610619469,0.03934426229508197,Very Cheap
20140619T000000,2200000.0,5,4.75,5990,10450,2.0,1,4,3,11,4050,1940,2002,0,98027,47.5554,-122.077,3330,14810,4460,11480,210.52631578947367,0.2786885245901639,Cheap
20140519T000000,810000.0,4,2.5,3480,59242,2.0,0,0,3,11,3480,0,1988,0,98072,47.7391,-122.102,2930,39400,55762,36470,13.672732183248371,0.09639344262295083,Very Cheap
20140918T000000,994000.0,5,3.25,4260,7861,2.0,0,0,3,10,4260,0,2005,0,98074,47.611,-121.992,4020,7528,3601,3508,126.44701691896705,0.12052459016393442,Cheap
20150225T000000,275000.0,5,2.25,1820,10500,1.0,0,0,4,7,1080,740,1979,0,98031,47.4058,-122.177,1820,7500,8680,5680,26.19047619047619,0.02622950819672131,Very Cheap
20150429T000000,300000.0,2,1.0,1290,2482,2.0,0,0,3,7,1290,0,2008,0,98053,47.6972,-122.025,1290,2482,1192,1192,120.87026591458502,0.029508196721311476,Very Cheap
20150414T000000,380000.0,5,2.5,2130,8428,2.0,0,0,3,7,2130,0,2013,0,98168,47.4726,-122.282,1500,11810,6298,10310,45.08780256288562,0.04,Very Cheap
20150302T000000,200000.0,3,2.0,1170,10051,1.0,0,0,4,7,1170,0,1957,0,98198,47.4229,-122.324,1440,9800,8881,8360,19.898517560441746,0.01639344262295082,Very Cheap
20140902T000000,635000.0,3,3.5,1730,1349,3.0,0,0,3,9,1350,380,2009,0,98102,47.6224,-122.326,1830,3300,-381,1470,470.71905114899926,0.07344262295081967,Very Cheap
20141106T000000,280000.0,2,1.0,880,5750,1.0,0,0,3,6,880,0,1939,0,98126,47.5642,-122.379,1190,5750,4870,4560,48.69565217391305,0.026885245901639345,Very Cheap
20140625T000000,574000.0,3,2.5,2380,6832,2.0,0,0,3,8,2380,0,2002,0,98065,47.5372,-121.876,2580,6832,4452,4252,84.01639344262296,0.06544262295081968,Very Cheap
20150204T000000,1050000.0,4,1.0,1330,9729,1.0,0,0,3,6,1330,0,1952,0,98004,47.6223,-122.208,2920,10353,8399,7433,107.92476102374344,0.12786885245901639,Cheap
20140508T000000,545000.0,3,2.25,1780,191228,2.0,0,2,3,8,1780,0,1988,0,98045,47.4575,-121.748,2440,87120,189448,84680,2.8500010458719434,0.06163934426229508,Very Cheap
20150327T000000,271950.0,3,1.5,1220,8400,1.0,0,0,4,7,1220,0,1962,0,98006,47.5467,-122.173,2110,9119,7180,7009,32.375,0.02582950819672131,Very Cheap
20140716T000000,630000.0,5,1.75,2490,24969,1.0,0,2,4,8,1540,950,1959,0,98023,47.336,-122.35,2790,15600,22479,12810,25.231286795626577,0.07278688524590164,Very Cheap
20140819T000000,400000.0,2,1.0,1180,10800,1.0,0,0,3,7,1180,0,1984,0,98011,47.7273,-122.236,1600,10800,9620,9200,37.03703703703704,0.04262295081967213,Very Cheap
20140910T000000,334000.0,4,2.5,2310,6200,2.0,0,0,3,8,2310,0,1998,0,98092,47.3321,-122.172,2480,6200,3890,3720,53.87096774193548,0.0339672131147541,Very Cheap
20141222T000000,332500.0,4,2.0,1440,4855,2.0,0,0,4,7,1440,0,1972,0,98144,47.5717,-122.287,1300,4080,3415,2780,68.48609680741504,0.033770491803278686,Very Cheap
20140923T000000,525000.0,2,1.5,1620,1444,2.0,0,0,3,9,1080,540,2007,0,98144,47.5892,-122.309,1660,1642,-176,-18,363.57340720221606,0.05901639344262295,Very Cheap
20150224T000000,408000.0,3,2.5,2620,8403,2.0,0,0,3,8,2620,0,1991,0,98038,47.3675,-122.042,2190,7842,5783,5652,48.554087825776506,0.04367213114754098,Very Cheap
20150427T000000,846450.0,4,2.5,3710,7491,2.0,0,0,3,9,3710,0,2003,0,98029,47.5596,-122.016,3040,7491,3781,4451,112.99559471365639,0.10117377049180327,Cheap
20141020T000000,411100.0,3,1.5,1040,10323,1.0,0,0,4,7,1040,0,1958,0,98005,47.5882,-122.155,1580,7200,9283,5620,39.82369466240434,0.04407868852459016,Very Cheap
20140709T000000,409124.0,5,3.25,3320,11340,2.0,0,0,4,8,2480,840,1999,0,98042,47.3904,-122.154,2330,8339,8020,6009,36.07795414462081,0.043819540983606554,Very Cheap
20140707T000000,335950.0,2,1.5,800,5192,1.0,0,0,5,7,800,0,1951,0,98146,47.5119,-122.386,1190,5320,4392,4130,64.7053158705701,0.03422295081967213,Very Cheap
20150331T000000,480000.0,5,2.5,2040,9597,1.0,0,0,4,7,1240,800,1963,0,98052,47.6544,-122.134,1800,8553,7557,6753,50.01562988433886,0.05311475409836065,Very Cheap
20141224T000000,280000.0,2,1.75,1960,30144,1.0,0,0,3,7,980,980,1957,0,98031,47.4234,-122.212,1960,10140,28184,8180,9.288747346072187,0.026885245901639345,Very Cheap
20140721T000000,668000.0,4,2.5,2670,4410,2.0,0,0,3,8,2670,0,1999,0,98075,47.5978,-122.038,2670,4410,1740,1740,151.47392290249434,0.07777049180327869,Very Cheap
20150427T000000,750000.0,4,2.5,2930,8641,2.0,0,0,3,8,2930,0,2010,0,98034,47.7199,-122.246,2120,11175,5711,9055,86.79550977896076,0.08852459016393442,Very Cheap
20140514T000000,394475.0,2,1.0,830,4000,1.0,0,0,3,6,830,0,1955,0,98117,47.6929,-122.379,950,4000,3170,3050,98.61875,0.0418983606557377,Very Cheap
20150326T000000,848000.0,5,1.75,2290,4320,2.0,0,0,3,7,1980,310,1928,0,98105,47.664,-122.31,2870,4320,2030,1450,196.2962962962963,0.10137704918032787,Cheap
20140924T000000,675000.0,3,1.5,2510,3600,2.5,0,0,4,8,2510,0,1907,0,98112,47.6195,-122.313,1740,1885,1090,145,187.5,0.07868852459016394,Very Cheap
20141106T000000,175000.0,3,1.0,1280,7572,1.0,0,0,4,6,1280,0,1958,0,98058,47.4491,-122.176,1170,7667,6292,6497,23.111463285789753,0.013114754098360656,Very Cheap
20141106T000000,560000.0,4,1.5,1810,6000,1.0,0,1,3,8,1350,460,1952,0,98136,47.5233,-122.386,2020,6000,4190,3980,93.33333333333333,0.06360655737704918,Very Cheap
20140531T000000,538888.0,5,2.75,2080,13189,2.0,0,0,3,8,2080,0,1987,0,98074,47.6288,-122.031,2030,11847,11109,9817,40.858897566153615,0.06083777049180328,Very Cheap
20140908T000000,359000.0,4,1.75,1680,9244,2.0,0,0,3,8,1680,0,1991,0,98166,47.4612,-122.352,1840,9387,7564,7547,38.836001730852445,0.03724590163934426,Very Cheap
20140701T000000,300000.0,3,2.25,1660,5128,2.0,0,0,3,7,1660,0,2001,0,98019,47.7362,-121.967,1680,4652,3468,2972,58.50234009360374,0.029508196721311476,Very Cheap
20140917T000000,273000.0,3,2.5,1650,5994,2.0,0,0,4,7,1650,0,1989,0,98030,47.3603,-122.19,1930,6666,4344,4736,45.545545545545544,0.025967213114754098,Very Cheap
20140710T000000,670000.0,3,2.5,1420,1438,2.0,0,0,3,9,1280,140,2003,0,98102,47.6265,-122.323,1490,1439,18,-51,465.92489568845616,0.0780327868852459,Very Cheap
20141118T000000,530000.0,4,2.25,2240,8376,1.0,0,0,3,8,1740,500,1984,0,98074,47.6323,-122.029,1890,7875,6136,5985,63.276026743075455,0.05967213114754098,Very Cheap
20140711T000000,625000.0,3,1.5,1230,3060,1.0,0,0,3,7,910,320,1927,0,98103,47.667,-122.333,1260,4488,1830,3228,204.2483660130719,0.07213114754098361,Very Cheap
20150505T000000,248000.0,3,1.0,1260,6000,1.0,0,0,4,6,1260,0,1954,0,98198,47.4187,-122.323,1520,6600,4740,5080,41.333333333333336,0.022688524590163933,Very Cheap
20140819T000000,533000.0,3,2.5,2060,4812,2.0,0,0,3,8,2060,0,1990,0,98029,47.5793,-122.002,1930,5264,2752,3334,110.76475477971738,0.060065573770491806,Very Cheap
20141211T000000,549950.0,4,3.5,3090,10510,1.0,0,0,3,8,2190,900,1991,0,98034,47.7176,-122.214,2200,7408,7420,5208,52.326355851569936,0.062288524590163936,Very Cheap
20141014T000000,485000.0,4,1.75,3220,7392,1.0,0,0,4,8,2010,1210,1959,0,98177,47.7719,-122.361,1660,8363,4172,6703,65.61147186147186,0.05377049180327869,Very Cheap
20150506T000000,353500.0,3,2.5,2020,4845,2.0,0,0,3,7,2020,0,2001,0,98038,47.3848,-122.033,1930,5134,2825,3204,72.96181630546955,0.036524590163934424,Very Cheap
20140915T000000,435000.0,2,1.75,1910,12142,1.0,0,0,3,9,1910,0,1976,0,98074,47.6276,-122.053,2580,12326,10232,9746,35.82605830999835,0.04721311475409836,Very Cheap
20141104T000000,241000.0,3,1.0,1150,10000,1.0,0,0,3,6,1000,150,1951,0,98178,47.5075,-122.262,1340,10000,8850,8660,24.1,0.02177049180327869,Very Cheap
20140519T000000,885000.0,4,2.75,2730,3560,1.5,0,0,3,8,1550,1180,1921,2007,98115,47.6737,-122.304,1860,3560,830,1700,248.59550561797752,0.1062295081967213,Cheap
20140513T000000,799200.0,6,3.0,2890,2370,2.5,0,0,3,7,2290,600,1906,0,98102,47.6227,-122.323,2180,2460,-520,280,337.2151898734177,0.09497704918032787,Very Cheap
20150114T000000,760000.0,3,2.5,2280,12746,1.0,0,0,4,8,1490,790,1973,0,98005,47.6362,-122.175,2100,12746,10466,10646,59.62654950572729,0.0898360655737705,Very Cheap
20141113T000000,270000.0,2,1.0,1040,5700,1.0,0,0,3,6,1040,0,1922,0,98118,47.519,-122.26,1380,5700,4660,4320,47.36842105263158,0.025573770491803278,Very Cheap
20150217T000000,675000.0,4,1.75,2440,7475,1.0,0,0,4,9,2040,400,1969,0,98052,47.6339,-122.096,2040,8480,5035,6440,90.3010033444816,0.07868852459016394,Very Cheap
20141222T000000,499000.0,3,2.5,1720,5940,1.0,0,0,4,8,1000,720,1977,0,98052,47.6631,-122.129,1720,6136,4220,4416,84.006734006734,0.05560655737704918,Very Cheap
20140714T000000,1202500.0,3,2.5,3430,28718,1.5,0,0,3,10,3430,0,1984,0,98033,47.6477,-122.183,3440,35021,25288,31581,41.87269308447664,0.1478688524590164,Cheap
20140627T000000,320000.0,4,2.5,2570,4865,2.0,0,0,3,8,2570,0,2005,0,98038,47.3588,-122.038,2570,4933,2295,2363,65.775950668037,0.032131147540983604,Very Cheap
20150505T000000,890000.0,4,3.25,4360,210254,1.0,0,0,3,10,2320,2040,2000,0,98038,47.4375,-122.008,2410,87120,205894,84710,4.232975353619907,0.10688524590163935,Cheap
20140822T000000,275000.0,4,2.75,2060,7350,1.0,0,0,3,7,1210,850,1978,0,98001,47.3424,-122.275,1940,7420,5290,5480,37.414965986394556,0.02622950819672131,Very Cheap
20140610T000000,490000.0,4,2.5,3020,8302,2.0,0,0,4,10,3020,0,1994,0,98042,47.363,-122.127,3020,8406,5282,5386,59.02192242833052,0.05442622950819672,Very Cheap
20140725T000000,550000.0,3,2.5,2340,4200,1.5,0,0,3,7,1540,800,1906,0,98122,47.6033,-122.303,1590,4200,1860,2610,130.95238095238096,0.06229508196721312,Very Cheap
20150507T000000,390000.0,5,2.0,2400,9537,1.0,0,0,5,7,1210,1190,1959,0,98056,47.5112,-122.186,1760,9533,7137,7773,40.89336269267065,0.04131147540983607,Very Cheap
20141020T000000,277000.0,3,2.25,1610,11920,1.0,0,0,4,7,1110,500,1968,0,98032,47.3683,-122.279,1690,11839,10310,10149,23.238255033557046,0.026491803278688525,Very Cheap
20150317T000000,236000.0,3,1.75,1090,7647,1.0,0,0,3,7,1090,0,1994,0,98003,47.2613,-122.302,1660,9219,6557,7559,30.861775859814305,0.021114754098360656,Very Cheap
20150304T000000,265953.0,3,1.75,1470,13068,1.0,0,0,4,7,1470,0,1975,0,98092,47.3096,-122.197,2090,16988,11598,14898,20.351469237832873,0.025043016393442624,Very Cheap
20150302T000000,545000.0,3,2.25,1670,6240,1.0,0,0,4,8,1240,430,1974,0,98008,47.6413,-122.113,1910,7000,4570,5090,87.33974358974359,0.06163934426229508,Very Cheap
20140506T000000,535000.0,3,2.5,1850,10109,2.0,0,0,3,8,1850,0,1991,0,98034,47.7163,-122.229,1780,9660,8259,7880,52.92313779800178,0.06032786885245902,Very Cheap
20141007T000000,1450000.0,3,2.75,3940,9671,1.0,0,4,5,9,2140,1800,1967,0,98006,47.5654,-122.158,3390,9360,5731,5970,149.93278874987075,0.18032786885245902,Cheap
20140630T000000,490000.0,4,3.0,2330,3497,2.0,0,0,3,9,1920,410,2003,0,98108,47.554,-122.308,2330,5242,1167,2912,140.12010294538175,0.05442622950819672,Very Cheap
20150408T000000,319950.0,4,2.5,2020,7200,1.5,0,0,4,6,2020,0,1954,0,98065,47.5223,-121.818,1440,7200,5180,5760,44.4375,0.03212459016393442,Very Cheap
20140704T000000,625000.0,3,1.5,1300,7200,1.0,0,0,5,7,1300,0,1960,0,98033,47.6821,-122.196,2280,7200,5900,4920,86.80555555555556,0.07213114754098361,Very Cheap
20150220T000000,248000.0,3,1.0,1180,6947,1.0,0,0,4,7,1180,0,1968,0,98031,47.4233,-122.177,1760,8657,5767,6897,35.6988628184828,0.022688524590163933,Very Cheap
20150421T000000,475000.0,3,1.75,1320,7840,1.0,0,0,3,8,1320,0,1966,0,98007,47.6024,-122.143,2050,7644,6520,5594,60.58673469387755,0.05245901639344262,Very Cheap
20140619T000000,410000.0,6,2.75,2520,9324,1.0,0,0,4,7,1320,1200,1962,0,98155,47.7636,-122.294,1820,11000,6804,9180,43.972543972543974,0.043934426229508196,Very Cheap
20140505T000000,670000.0,3,2.5,1680,2000,3.0,0,0,3,9,1680,0,1909,1998,98105,47.6604,-122.29,1950,5000,320,3050,335.0,0.0780327868852459,Very Cheap
20150331T000000,430000.0,3,2.5,2000,35438,2.0,0,0,3,7,2000,0,1968,2005,98027,47.4733,-121.994,2000,51836,33438,49836,12.13386759975168,0.04655737704918033,Very Cheap
20141028T000000,313000.0,2,1.0,1180,4900,1.0,0,0,5,6,1180,0,1954,0,98027,47.5321,-122.029,1650,7121,3720,5471,63.87755102040816,0.03121311475409836,Very Cheap
20140714T000000,950000.0,3,3.25,3330,15093,2.5,0,0,3,9,3330,0,1988,0,98040,47.5395,-122.242,4340,20031,11763,15691,62.943086198900154,0.11475409836065574,Cheap
20140527T000000,751750.0,2,2.0,1880,5400,1.5,0,0,3,8,1880,0,1902,0,98112,47.6238,-122.311,1590,5400,3520,3810,139.21296296296296,0.08875409836065573,Very Cheap
20140909T000000,760000.0,4,2.5,2990,5280,2.0,0,0,3,9,2210,780,2003,0,98027,47.5353,-122.066,2990,6299,2290,3309,143.93939393939394,0.0898360655737705,Very Cheap
20150128T000000,310650.0,3,1.75,1510,12408,1.0,0,0,4,7,1510,0,1969,0,98059,47.5069,-122.141,1480,17800,10898,16320,25.036266924564796,0.030904918032786884,Very Cheap
20140502T000000,367500.0,4,3.0,3110,7231,2.0,0,0,3,8,3110,0,1997,0,98092,47.3279,-122.191,2820,7311,4121,4491,50.82284607938045,0.03836065573770492,Very Cheap
20140804T000000,580000.0,4,2.5,2150,5000,2.0,0,0,3,8,2150,0,2001,0,98115,47.6962,-122.314,2030,6380,2850,4350,116.0,0.06622950819672131,Very Cheap
20140702T000000,580000.0,3,2.25,1900,3960,1.5,0,0,3,8,1200,700,1905,0,98122,47.6122,-122.298,1310,3960,2060,2650,146.46464646464648,0.06622950819672131,Very Cheap
20140602T000000,665000.0,4,2.5,2720,10000,2.0,0,0,3,10,2720,0,1987,0,98074,47.6293,-122.051,2720,10020,7280,7300,66.5,0.07737704918032787,Very Cheap
20141105T000000,239950.0,3,2.25,1560,8280,2.0,0,0,4,7,1560,0,1979,0,98001,47.3393,-122.259,1920,8120,6720,6200,28.979468599033815,0.021632786885245902,Very Cheap
20140813T000000,470000.0,4,2.5,1990,30083,2.0,0,0,3,8,1990,0,1998,0,98155,47.7678,-122.272,2220,11627,28093,9407,15.623441810989595,0.05180327868852459,Very Cheap
20140815T000000,733000.0,3,1.75,1740,3060,1.0,0,0,5,8,950,790,1930,2014,98115,47.6816,-122.31,1800,3960,1320,2160,239.54248366013073,0.08629508196721311,Very Cheap
20150130T000000,250000.0,4,2.0,2130,8400,1.0,0,0,3,7,1350,780,1962,0,98031,47.4133,-122.209,1550,8596,6270,7046,29.761904761904763,0.022950819672131147,Very Cheap
20140908T000000,402000.0,4,1.75,1510,9176,1.0,0,0,5,7,1510,0,1957,0,98133,47.7651,-122.339,1480,9176,7666,7696,43.80993897122929,0.04288524590163934,Very Cheap
20140611T000000,295000.0,5,3.5,2100,5107,2.0,0,0,3,7,1410,690,1999,0,98178,47.5108,-122.257,1410,5650,3007,4240,57.7638535343646,0.028852459016393443,Very Cheap
20141016T000000,355000.0,5,2.5,2344,8000,1.0,0,0,4,8,1560,784,1976,0,98023,47.3185,-122.377,2344,8000,5656,5656,44.375,0.036721311475409836,Very Cheap
20140909T000000,289000.0,3,1.5,1970,22486,1.0,0,0,4,6,1970,0,1968,0,98058,47.4511,-122.089,1850,20160,20516,18310,12.852441519167481,0.028065573770491802,Very Cheap
20141112T000000,376000.0,3,2.25,1470,9140,2.0,0,2,3,7,1470,0,1982,0,98133,47.7162,-122.349,1400,8204,7670,6804,41.137855579868706,0.039475409836065574,Very Cheap
20140627T000000,212700.0,2,1.0,940,5040,1.0,0,0,3,7,940,0,1926,0,98126,47.5375,-122.374,940,5040,4100,4100,42.20238095238095,0.018059016393442623,Very Cheap
20140527T000000,325000.0,3,1.75,1780,13095,1.0,0,0,4,9,1780,0,1983,0,98042,47.367,-122.152,2750,13095,11315,10345,24.818633066055746,0.03278688524590164,Very Cheap
20140811T000000,415000.0,4,2.5,2230,5743,2.0,0,0,3,7,2230,0,2002,0,98019,47.7245,-121.957,2490,6300,3513,3810,72.26188403273551,0.04459016393442623,Very Cheap
20150402T000000,935000.0,3,2.5,3570,15151,1.0,0,0,4,8,2400,1170,1981,0,98177,47.7475,-122.364,3140,14375,11581,11235,61.71209821133919,0.11278688524590164,Cheap
20150116T000000,372000.0,3,2.5,1920,15260,2.0,0,0,3,7,1920,0,1990,0,98019,47.7317,-121.964,2370,15235,13340,12865,24.37745740498034,0.03895081967213115,Very Cheap
20141021T000000,240000.0,3,1.5,1290,8366,1.0,0,0,3,7,1020,270,1957,0,98168,47.4853,-122.318,1770,8400,7076,6630,28.68754482428879,0.021639344262295083,Very Cheap
20140915T000000,334950.0,3,1.75,1880,16262,1.0,0,0,5,7,1880,0,1980,0,98059,47.5089,-122.155,1900,7972,14382,6072,20.59709752797934,0.03409180327868853,Very Cheap
20150430T000000,426500.0,4,2.5,2960,4640,2.0,0,0,3,9,2960,0,2005,0,98038,47.3597,-122.04,2750,4623,1680,1873,91.91810344827586,0.046098360655737705,Very Cheap
20150224T000000,430000.0,2,1.75,1840,14874,1.0,0,2,3,8,1300,540,1952,0,98166,47.4382,-122.348,2920,15084,13034,12164,28.90950652144682,0.04655737704918033,Very Cheap
20141211T000000,400000.0,3,1.5,1890,6183,1.0,0,0,3,7,1090,800,1967,0,98118,47.5396,-122.269,1750,6183,4293,4433,64.69351447517387,0.04262295081967213,Very Cheap
20150428T000000,455850.0,3,2.25,1820,6000,1.0,0,0,4,7,1120,700,1964,0,98108,47.5684,-122.3,1970,6232,4180,4262,75.975,0.049947540983606556,Very Cheap
20140602T000000,1965220.0,4,3.5,4370,8510,2.0,0,1,3,10,3610,760,2003,0,98004,47.5876,-122.204,2960,10347,4140,7387,230.93066980023502,0.24789770491803279,Cheap
20140604T000000,400000.0,3,1.75,1530,10731,1.0,0,0,3,7,1530,0,1986,0,98028,47.7655,-122.244,2100,12593,9201,10493,37.27518404622123,0.04262295081967213,Very Cheap
20140808T000000,397500.0,3,1.0,1030,10480,1.0,0,0,4,7,1030,0,1954,0,98006,47.5742,-122.139,1480,12200,9450,10720,37.9293893129771,0.04229508196721311,Very Cheap
20141211T000000,755000.0,3,2.5,2000,1950,3.0,0,0,3,8,2000,0,2005,0,98109,47.6476,-122.356,1560,1340,-50,-220,387.1794871794872,0.08918032786885247,Very Cheap
20140709T000000,287000.0,5,1.5,1730,9230,1.0,0,0,3,7,1010,720,1962,0,98058,47.4646,-122.184,1730,9230,7500,7500,31.094257854821237,0.02780327868852459,Very Cheap
20140716T000000,480000.0,4,2.5,3620,16000,2.0,0,0,3,9,3620,0,1976,0,98038,47.3711,-122.06,2590,16000,12380,13410,30.0,0.05311475409836065,Very Cheap
20150416T000000,490000.0,3,2.5,2040,9622,2.0,0,0,3,8,2040,0,1995,0,98045,47.4833,-121.8,2390,9868,7582,7478,50.92496362502598,0.05442622950819672,Very Cheap
20140618T000000,365000.0,3,2.5,2640,6715,2.0,0,0,3,8,1680,960,1991,0,98058,47.441,-122.125,2260,7373,4075,5113,54.35591958302308,0.0380327868852459,Very Cheap
20150224T000000,260000.0,3,2.5,1600,2244,2.0,0,0,3,7,1600,0,2005,0,98056,47.4899,-122.164,1600,1700,644,100,115.8645276292335,0.024262295081967214,Very Cheap
20150414T000000,505000.0,4,1.0,1480,12675,1.5,0,0,4,7,1480,0,1929,0,98133,47.763,-122.342,1820,7995,11195,6175,39.84220907297831,0.05639344262295082,Very Cheap
20140627T000000,260000.0,2,1.0,700,4800,1.0,0,0,3,7,700,0,1922,0,98122,47.6147,-122.3,1440,4800,4100,3360,54.166666666666664,0.024262295081967214,Very Cheap
20150106T000000,430000.0,2,1.0,700,4800,1.0,0,0,3,7,700,0,1922,0,98122,47.6147,-122.3,1440,4800,4100,3360,89.58333333333333,0.04655737704918033,Very Cheap
20140724T000000,905000.0,4,2.5,3520,12193,2.0,0,0,4,10,3520,0,1993,0,98027,47.5535,-122.095,3470,11318,8673,7848,74.22291478717297,0.10885245901639344,Cheap
20141203T000000,440000.0,3,2.0,1650,6408,2.0,0,0,4,8,1650,0,1977,0,98052,47.6638,-122.128,1750,6402,4758,4652,68.66416978776529,0.04786885245901639,Very Cheap
20140913T000000,439500.0,4,1.0,1360,5500,1.5,0,0,3,7,1360,0,1950,0,98115,47.6878,-122.285,1530,5790,4140,4260,79.9090909090909,0.04780327868852459,Very Cheap
20150127T000000,270000.0,3,2.0,1350,6696,1.0,0,0,5,6,680,670,1944,0,98056,47.4919,-122.187,1350,6700,5346,5350,40.32258064516129,0.025573770491803278,Very Cheap
20150429T000000,306500.0,3,2.5,1970,6291,2.0,0,0,4,7,1970,0,1998,0,98042,47.3627,-122.073,1980,8852,4321,6872,48.720394213956446,0.03036065573770492,Very Cheap
20141019T000000,380000.0,3,2.0,1470,1656,2.0,0,0,3,8,1310,160,2003,0,98126,47.5653,-122.369,1470,2288,186,818,229.46859903381642,0.04,Very Cheap
20140722T000000,215000.0,4,1.75,1610,9652,1.0,0,0,5,7,1610,0,1969,0,98042,47.3281,-122.135,1220,9800,8042,8580,22.275176129299627,0.018360655737704918,Very Cheap
20150206T000000,299900.0,2,1.0,810,6150,1.0,0,0,3,7,810,0,1950,0,98133,47.7289,-122.34,1080,7200,5340,6120,48.764227642276424,0.029495081967213115,Very Cheap
20150327T000000,1450000.0,4,3.5,2820,7809,2.0,0,0,3,10,2820,0,1995,0,98004,47.622,-122.195,2630,7904,4989,5274,185.68318606735818,0.18032786885245902,Cheap
20140513T000000,239950.0,3,1.0,1900,33888,1.5,0,0,4,5,1900,0,1942,0,98001,47.2738,-122.271,1430,19200,31988,17770,7.080677525967895,0.021632786885245902,Very Cheap
20140623T000000,494000.0,4,2.5,1830,7345,1.0,0,0,4,8,1540,290,1973,0,98177,47.7741,-122.373,1990,7700,5515,5710,67.2566371681416,0.05495081967213115,Very Cheap
20150105T000000,317500.0,4,1.5,1730,7700,1.0,0,0,4,7,1010,720,1963,0,98059,47.4996,-122.163,1650,8066,5970,6416,41.23376623376623,0.03180327868852459,Very Cheap
20150303T000000,670000.0,4,2.5,2110,7291,2.0,0,0,4,7,2110,0,1977,0,98033,47.6888,-122.201,2350,8625,5181,6275,91.89411603346592,0.0780327868852459,Very Cheap
20140820T000000,650000.0,3,2.5,3060,7831,2.0,0,2,3,9,3060,0,2004,0,98065,47.5401,-121.861,3140,7438,4771,4298,83.00344783552548,0.07540983606557378,Very Cheap
20150320T000000,852000.0,4,2.5,2620,7328,2.0,0,0,3,8,2620,0,1983,0,98118,47.5514,-122.263,1670,5080,4708,3410,116.26637554585153,0.1019016393442623,Cheap
20140617T000000,250000.0,2,1.5,1088,1360,2.0,0,0,3,7,1088,0,1983,0,98034,47.7094,-122.213,1098,1469,272,371,183.8235294117647,0.022950819672131147,Very Cheap
20141210T000000,264950.0,3,1.5,1400,10853,1.0,0,0,4,7,1400,0,1964,0,98055,47.4433,-122.194,1620,10849,9453,9229,24.412604809730027,0.024911475409836067,Very Cheap
20140925T000000,582500.0,2,2.0,1540,6804,1.0,0,0,5,7,1020,520,1942,0,98177,47.7044,-122.372,1380,6930,5264,5550,85.6114050558495,0.06655737704918033,Very Cheap
20150311T000000,384000.0,3,2.5,1540,1564,2.0,0,0,3,7,1300,240,1998,0,98144,47.586,-122.313,1540,2875,24,1335,245.5242966751918,0.04052459016393443,Very Cheap
20141028T000000,817000.0,3,1.5,2310,3360,1.5,0,0,3,8,1790,520,1926,0,98119,47.6431,-122.359,1930,4320,1050,2390,243.1547619047619,0.09731147540983606,Very Cheap
20141201T000000,320000.0,4,1.75,1730,9520,1.0,0,0,4,7,1730,0,1971,0,98059,47.4756,-122.157,1550,11211,7790,9661,33.61344537815126,0.032131147540983604,Very Cheap
20140630T000000,445800.0,4,2.25,2070,39446,1.0,0,0,3,8,1470,600,1977,0,98155,47.7765,-122.276,2140,12043,37376,9903,11.301526136997413,0.048629508196721315,Very Cheap
20150307T000000,263300.0,2,1.0,900,4500,1.0,0,0,3,7,900,0,1951,0,98118,47.5273,-122.265,1175,5320,3600,4145,58.51111111111111,0.024695081967213116,Very Cheap
20150128T000000,215000.0,3,1.0,860,6635,1.0,0,0,3,6,860,0,1952,0,98133,47.7508,-122.339,1170,8000,5775,6830,32.403918613413715,0.018360655737704918,Very Cheap
20141115T000000,842500.0,5,4.0,2980,4500,1.5,0,0,3,7,2070,910,1921,0,98115,47.6736,-122.323,1560,4225,1520,2665,187.22222222222223,0.10065573770491804,Cheap
20150411T000000,850000.0,5,4.0,2980,4500,1.5,0,0,3,7,2070,910,1921,0,98115,47.6736,-122.323,1560,4225,1520,2665,188.88888888888889,0.10163934426229508,Cheap
20141001T000000,386000.0,5,2.5,2740,12413,2.0,0,0,3,7,2740,0,1990,0,98031,47.4199,-122.183,1900,7416,9673,5516,31.096431160879725,0.04078688524590164,Very Cheap
20141209T000000,251100.0,4,2.5,1790,5257,2.0,0,0,3,7,1790,0,1996,0,98030,47.3849,-122.204,1680,5320,3467,3640,47.76488491535096,0.023095081967213115,Very Cheap
20141126T000000,435000.0,3,1.75,1750,16748,1.0,0,0,3,7,1330,420,1978,0,98072,47.7421,-122.089,1750,16050,14998,14300,25.9732505373776,0.04721311475409836,Very Cheap
20140922T000000,870000.0,4,4.0,3610,12811,2.0,0,0,3,10,3610,0,2000,0,98075,47.5812,-121.993,3530,11783,9201,8253,67.91038950901569,0.10426229508196722,Cheap
20150206T000000,800000.0,6,1.0,1430,20620,2.0,0,0,3,7,1430,0,1954,0,98004,47.6255,-122.209,2450,10080,19190,7630,38.797284190106694,0.09508196721311475,Very Cheap
20140714T000000,555000.0,3,1.75,1570,15500,1.0,0,0,4,7,1570,0,1968,0,98052,47.6916,-122.122,1610,7500,13930,5890,35.806451612903224,0.06295081967213115,Very Cheap
20140723T000000,280000.0,2,1.0,2280,37500,2.0,0,0,3,7,2280,0,1932,0,98136,47.525,-122.389,2360,6000,35220,3640,7.466666666666667,0.026885245901639345,Very Cheap
20150317T000000,356000.0,3,1.0,940,2366,1.0,0,0,3,6,940,0,1916,0,98107,47.6744,-122.383,1500,5000,1426,3500,150.46491969568893,0.03685245901639344,Very Cheap
20141203T000000,675000.0,4,2.5,2920,6000,2.0,0,4,3,9,2920,0,2004,0,98065,47.5333,-121.859,3100,6001,3080,2901,112.5,0.07868852459016394,Very Cheap
20141226T000000,605000.0,4,2.25,2260,11900,2.0,0,0,3,9,2260,0,1976,0,98074,47.6415,-122.057,2470,11900,9640,9430,50.84033613445378,0.06950819672131148,Very Cheap
20140625T000000,690500.0,5,2.0,2000,4211,1.5,0,2,4,7,1280,720,1908,0,98112,47.6283,-122.301,1680,4000,2211,2320,163.97530277843742,0.08072131147540984,Very Cheap
20140619T000000,437000.0,2,1.75,1440,4225,1.0,0,0,3,8,1440,0,2005,0,98053,47.7143,-122.032,1680,6200,2785,4520,103.4319526627219,0.047475409836065574,Very Cheap
20140710T000000,850000.0,5,2.0,2310,13430,1.5,0,0,4,8,2310,0,1966,0,98004,47.6395,-122.203,2810,13906,11120,11096,63.29113924050633,0.10163934426229508,Cheap
20140612T000000,350000.0,4,2.25,2300,4600,1.5,0,0,4,7,1340,960,1904,0,98144,47.5895,-122.311,1540,3000,2300,1460,76.08695652173913,0.036065573770491806,Very Cheap
20140622T000000,480000.0,2,2.25,1490,6770,1.5,0,0,3,8,1490,0,1926,0,98108,47.5577,-122.297,1820,7875,5280,6055,70.90103397341211,0.05311475409836065,Very Cheap
20140723T000000,379500.0,3,2.25,1830,25641,2.0,0,0,3,8,1830,0,1989,0,98059,47.4786,-122.112,1500,25641,23811,24141,14.8005148005148,0.0399344262295082,Very Cheap
20140924T000000,600000.0,5,4.5,4440,9784,2.0,0,0,3,10,4440,0,2012,0,98168,47.4702,-122.275,2720,10080,5344,7360,61.324611610793134,0.06885245901639345,Very Cheap
20150330T000000,1436000.0,4,3.5,4970,16582,2.0,0,3,4,11,3930,1040,1992,0,98006,47.5496,-122.12,3580,13335,11612,9755,86.59992763237246,0.17849180327868852,Cheap
20141218T000000,303000.0,2,1.5,1000,1075,2.0,0,0,3,7,840,160,2007,0,98144,47.5708,-122.288,1000,1083,75,83,281.86046511627904,0.029901639344262296,Very Cheap
20150206T000000,800000.0,4,2.5,4940,10037,1.0,0,4,3,9,3450,1490,1953,0,98178,47.5095,-122.247,2430,9272,5097,6842,79.70509116269801,0.09508196721311475,Very Cheap
20140724T000000,549000.0,2,2.0,1980,6000,1.5,0,0,5,7,1220,760,1906,0,98103,47.6809,-122.351,1280,3900,4020,2620,91.5,0.06216393442622951,Very Cheap
20141126T000000,324950.0,3,2.5,1560,9600,1.0,0,0,3,7,1210,350,1964,0,98188,47.457,-122.27,2070,9600,8040,7530,33.848958333333336,0.03278032786885246,Very Cheap
20140926T000000,170000.0,2,1.0,870,6537,1.0,0,0,3,6,870,0,1948,0,98168,47.4906,-122.306,1100,8701,5667,7601,26.00581306409668,0.012459016393442624,Very Cheap
20140715T000000,178000.0,3,1.0,840,6500,1.0,0,0,5,6,840,0,1969,0,98042,47.3704,-122.08,870,5200,5660,4330,27.384615384615383,0.013508196721311476,Very Cheap
20150421T000000,144000.0,3,1.0,1250,8314,1.0,0,0,3,6,1250,0,1958,0,98058,47.4522,-122.178,1188,7700,7064,6512,17.32018282415203,0.009049180327868852,Very Cheap
20150317T000000,1580000.0,4,2.75,3120,20031,1.0,0,2,4,9,1980,1140,1954,1997,98040,47.5389,-122.242,3330,18777,16911,15447,78.87773950376916,0.19737704918032786,Cheap
20150427T000000,258000.0,2,1.0,750,7000,1.0,0,0,3,6,750,0,1932,0,98024,47.5655,-121.89,1100,8777,6250,7677,36.857142857142854,0.024,Very Cheap
20141016T000000,345000.0,3,1.75,710,5050,1.0,0,0,4,6,710,0,1950,0,98126,47.5194,-122.375,900,5050,4340,4150,68.31683168316832,0.03540983606557377,Very Cheap
20140610T000000,470000.0,3,1.75,2290,14800,1.0,0,0,3,8,1620,670,1965,0,98155,47.7735,-122.273,2320,12474,12510,10154,31.756756756756758,0.05180327868852459,Very Cheap
20150313T000000,2903000.0,5,2.5,3750,91681,2.0,1,4,3,10,3750,0,1925,0,98118,47.5379,-122.264,3540,24293,87931,20753,31.664139789051166,0.37088524590163935,Medium
20140521T000000,350000.0,3,1.5,980,7790,1.0,0,0,5,7,980,0,1969,0,98034,47.7141,-122.213,1390,7280,6810,5890,44.929396662387674,0.036065573770491806,Very Cheap
20140626T000000,225500.0,2,1.75,1590,11276,1.0,0,0,4,7,1590,0,1972,0,98002,47.3177,-122.21,1750,10687,9686,8937,19.998226321390565,0.019737704918032787,Very Cheap
20150224T000000,473000.0,2,1.0,940,4000,1.0,0,0,3,6,720,220,1942,0,98199,47.6488,-122.385,1180,6000,3060,4820,118.25,0.05219672131147541,Very Cheap
20150226T000000,279000.0,3,1.75,1750,9623,1.0,0,0,3,7,1150,600,1962,0,98198,47.3997,-122.313,1820,9623,7873,7803,28.993037514288684,0.02675409836065574,Very Cheap
20150414T000000,470000.0,3,1.0,1460,8227,1.0,0,0,3,6,880,580,1948,0,98125,47.7009,-122.301,1530,8128,6767,6598,57.12896560106965,0.05180327868852459,Very Cheap
20140820T000000,565000.0,3,1.75,1540,4800,1.0,0,0,4,6,770,770,1925,0,98105,47.67,-122.284,1510,4080,3260,2570,117.70833333333333,0.06426229508196721,Very Cheap
20150422T000000,695000.0,3,2.0,2560,6800,1.0,0,1,4,8,1380,1180,1952,0,98136,47.5506,-122.395,1780,6800,4240,5020,102.20588235294117,0.08131147540983606,Very Cheap
20140711T000000,315000.0,3,1.75,1660,37642,1.0,0,0,4,7,1660,0,1991,0,98022,47.2559,-122.007,2070,54450,35982,52380,8.368311991923914,0.031475409836065574,Very Cheap
20150304T000000,529000.0,3,2.5,1880,4499,2.0,0,0,3,8,1880,0,1993,0,98029,47.5664,-121.999,2130,5114,2619,2984,117.58168481884863,0.05954098360655738,Very Cheap
20150126T000000,750000.0,5,3.75,3500,101494,1.5,0,0,3,8,3500,0,1967,1990,98053,47.6745,-122.054,3250,38636,97994,35386,7.389599385185331,0.08852459016393442,Very Cheap
20141029T000000,481500.0,3,2.25,1840,10500,2.0,0,0,3,7,1840,0,1993,0,98034,47.7326,-122.234,1840,7374,8660,5534,45.857142857142854,0.053311475409836065,Very Cheap
20150327T000000,211000.0,3,2.0,1060,7412,1.0,0,0,3,7,1060,0,1987,0,98038,47.3897,-122.051,1080,7093,6352,6013,28.467350242849434,0.01783606557377049,Very Cheap
20150410T000000,455000.0,3,2.25,1790,7500,1.0,0,0,3,7,1390,400,1973,0,98034,47.7321,-122.198,1940,7192,5710,5252,60.666666666666664,0.049836065573770495,Very Cheap
20141103T000000,238950.0,2,1.0,810,4838,1.0,0,0,3,5,810,0,1938,0,98055,47.4909,-122.203,890,4838,4028,3948,49.390243902439025,0.021501639344262295,Very Cheap
20140918T000000,722500.0,4,3.5,2600,5100,2.0,0,0,3,8,1820,780,2003,0,98117,47.6948,-122.395,2000,6720,2500,4720,141.66666666666666,0.08491803278688524,Very Cheap
20140730T000000,795000.0,4,2.5,3230,19193,1.0,0,3,4,8,2000,1230,1973,0,98075,47.5755,-122.07,3230,13420,15963,10190,41.42135153441359,0.09442622950819672,Very Cheap
20150507T000000,327500.0,4,2.25,2240,9600,2.0,0,0,3,8,2240,0,1971,0,98032,47.361,-122.281,2050,9240,7360,7190,34.114583333333336,0.033114754098360656,Very Cheap
20150323T000000,585000.0,4,3.0,3400,5100,2.0,0,0,3,9,3400,0,2006,0,98038,47.3548,-122.002,3400,5672,1700,2272,114.70588235294117,0.06688524590163934,Very Cheap
20140613T000000,775000.0,4,2.0,3140,10875,1.0,0,1,3,7,1940,1200,1939,1969,98199,47.6656,-122.406,3300,10080,7735,6780,71.26436781609195,0.09180327868852459,Very Cheap
20141024T000000,645000.0,4,2.5,2780,4200,2.0,0,0,3,8,2780,0,2001,0,98075,47.5989,-122.039,2510,4200,1420,1690,153.57142857142858,0.07475409836065573,Very Cheap
20150105T000000,445000.0,4,2.75,2320,12368,1.0,0,0,3,8,1670,650,1968,0,98133,47.7373,-122.35,2070,9575,10048,7505,35.979948253557566,0.04852459016393443,Very Cheap
20140502T000000,257950.0,3,1.75,1370,5858,1.0,0,0,3,7,1370,0,1987,0,98198,47.3815,-122.313,1400,7500,4488,6100,44.03379993171731,0.02399344262295082,Very Cheap
20150324T000000,375000.0,5,1.75,2230,7560,1.0,0,0,3,7,1230,1000,1959,0,98178,47.5055,-122.26,1380,6570,5330,5190,49.6031746031746,0.03934426229508197,Very Cheap
20140709T000000,245000.0,3,2.5,1610,7223,2.0,0,0,3,7,1610,0,1994,0,98030,47.3661,-122.173,1610,7162,5613,5552,33.91942406202409,0.022295081967213116,Very Cheap
20140811T000000,725000.0,3,2.5,3410,41022,2.0,0,0,3,11,3410,0,1990,0,98042,47.3228,-122.08,2150,21429,37612,19279,17.673443518112233,0.08524590163934426,Very Cheap
20150304T000000,702000.0,4,2.5,2810,4922,2.0,0,0,3,9,2810,0,2005,0,98074,47.614,-122.041,2920,4922,2112,2002,142.62494920763916,0.08222950819672131,Very Cheap
20140818T000000,330000.0,3,1.75,1850,14986,2.0,0,0,3,6,1850,0,1943,2005,98059,47.4837,-122.148,2660,10650,13136,7990,22.020552515681302,0.03344262295081967,Very Cheap
20150416T000000,940000.0,3,1.5,1790,4800,1.5,0,0,3,8,1790,0,1912,0,98119,47.6332,-122.362,1780,3600,3010,1820,195.83333333333334,0.11344262295081967,Cheap
20150305T000000,354500.0,3,1.0,1150,11396,1.5,0,0,4,7,1150,0,1950,0,98155,47.7435,-122.296,1600,8146,10246,6546,31.107406107406106,0.036655737704918034,Very Cheap
20150222T000000,279950.0,4,2.75,2420,8700,1.5,0,0,4,7,2420,0,1914,0,98002,47.3109,-122.229,1070,4804,6280,3734,32.17816091954023,0.026878688524590164,Very Cheap
20150507T000000,284000.0,3,2.25,1580,7034,1.0,0,0,4,7,1180,400,1989,0,98038,47.3564,-122.04,1470,7358,5454,5888,40.37531987489338,0.027409836065573772,Very Cheap
20141013T000000,480000.0,5,2.0,1760,21562,1.0,0,1,3,8,1560,200,1959,0,98028,47.7597,-122.263,2150,12676,19802,10526,22.261385771264262,0.05311475409836065,Very Cheap
20150408T000000,647500.0,5,2.0,1760,21562,1.0,0,1,3,8,1560,200,1959,0,98028,47.7597,-122.263,2150,12676,19802,10526,30.02968184769502,0.07508196721311475,Very Cheap
20150406T000000,625000.0,3,2.5,2750,35000,2.0,0,0,3,9,2750,0,1993,0,98077,47.75,-122.024,2780,35862,32250,33082,17.857142857142858,0.07213114754098361,Very Cheap
20140710T000000,152000.0,3,1.0,920,4875,1.0,0,0,4,7,920,0,1978,0,98042,47.3623,-122.09,1160,4875,3955,3715,31.17948717948718,0.010098360655737704,Very Cheap
20150127T000000,322000.0,3,1.0,960,10181,1.0,0,0,3,7,960,0,1961,0,98034,47.7231,-122.229,1740,10194,9221,8454,31.627541498870446,0.03239344262295082,Very Cheap
20140731T000000,445000.0,3,1.75,1120,4000,1.0,0,0,4,7,870,250,1916,0,98107,47.6684,-122.368,1470,4000,2880,2530,111.25,0.04852459016393443,Very Cheap
20140730T000000,595000.0,3,1.0,1560,3960,1.5,0,0,4,7,1560,0,1907,0,98144,47.5936,-122.301,1280,3960,2400,2680,150.25252525252526,0.06819672131147542,Very Cheap
20150513T000000,165000.0,3,1.0,1380,7334,1.0,0,0,3,7,980,400,1981,0,98055,47.4339,-122.192,1910,7859,5954,5949,22.497954731388056,0.01180327868852459,Very Cheap
20140610T000000,278500.0,4,2.5,1940,6206,2.0,0,0,3,7,1940,0,1990,0,98023,47.3063,-122.359,2060,7092,4266,5032,44.87592652271995,0.026688524590163933,Very Cheap
20150313T000000,517500.0,3,1.75,1810,10625,1.0,0,0,3,8,1370,440,1973,0,98027,47.5322,-122.049,2140,10922,8815,8782,48.705882352941174,0.0580327868852459,Very Cheap
20140618T000000,343566.0,2,1.0,1100,4200,1.0,0,0,3,7,1100,0,1954,0,98136,47.5312,-122.392,1240,4000,3100,2760,81.80142857142857,0.03522177049180328,Very Cheap
20141105T000000,286285.0,4,2.25,1980,9714,1.0,0,0,3,7,1170,810,1977,0,98002,47.3207,-122.209,1610,9272,7734,7662,29.47138151122092,0.02770950819672131,Very Cheap
20150206T000000,474905.0,4,1.5,1340,6200,1.0,0,0,5,6,1340,0,1959,0,98008,47.6214,-122.119,1210,7178,4860,5968,76.59758064516129,0.05244655737704918,Very Cheap
20140714T000000,550000.0,3,1.75,1680,4800,1.0,0,0,4,7,1400,280,1960,0,98126,47.5535,-122.377,1540,5000,3120,3460,114.58333333333333,0.06229508196721312,Very Cheap
20150129T000000,286000.0,4,2.5,2060,16000,2.0,0,0,3,6,2060,0,1993,0,98001,47.2849,-122.251,1530,8000,13940,6470,17.875,0.027672131147540982,Very Cheap
20140808T000000,900000.0,3,3.25,2620,7215,1.0,0,0,4,8,1770,850,1980,0,98004,47.5836,-122.2,2180,8931,4595,6751,124.74012474012474,0.10819672131147541,Cheap
20140820T000000,449950.0,3,2.25,1610,5159,2.0,0,0,3,7,1610,0,1985,0,98029,47.5675,-122.019,1610,5210,3549,3600,87.21651482845513,0.04917377049180328,Very Cheap
20140612T000000,259000.0,4,1.5,1490,7560,2.0,0,0,3,7,1490,0,1966,0,98198,47.3684,-122.318,1490,7689,6070,6199,34.25925925925926,0.024131147540983607,Very Cheap
20141202T000000,340000.0,3,2.25,1900,8125,1.0,0,0,3,7,1540,360,1969,0,98058,47.4564,-122.162,1480,8284,6225,6804,41.84615384615385,0.03475409836065574,Very Cheap
20150415T000000,785000.0,4,2.5,3440,56192,2.0,0,0,3,9,3440,0,1994,0,98053,47.6969,-122.046,3150,44431,52752,41281,13.96996013667426,0.09311475409836066,Very Cheap
20140509T000000,490000.0,2,1.0,1840,3300,1.5,0,0,4,6,1130,710,1910,0,98107,47.6757,-122.362,1320,4000,1460,2680,148.4848484848485,0.05442622950819672,Very Cheap
20140527T000000,344950.0,4,2.0,2330,6250,1.0,0,0,4,7,1400,930,1941,0,98030,47.3782,-122.228,2050,9000,3920,6950,55.192,0.03540327868852459,Very Cheap
20140827T000000,950000.0,3,2.0,2250,2975,2.0,0,0,4,9,1880,370,1905,0,98112,47.6289,-122.309,2690,4800,725,2110,319.327731092437,0.11475409836065574,Cheap
20140709T000000,810000.0,4,1.75,2000,3988,1.0,0,4,4,7,1000,1000,1958,0,98116,47.5925,-122.391,1690,4144,1988,2454,203.10932798395186,0.09639344262295083,Very Cheap
20150309T000000,998160.0,2,2.5,3010,16050,1.0,0,3,4,9,1260,1750,1976,0,98006,47.5643,-122.16,3010,11612,13040,8602,62.19065420560748,0.12107016393442623,Cheap
20141210T000000,377000.0,3,1.75,1680,7389,1.0,0,0,3,8,1150,530,1979,0,98056,47.5199,-122.184,2100,10348,5709,8248,51.02178914602788,0.03960655737704918,Very Cheap
20140826T000000,595000.0,3,2.0,1530,6773,1.0,0,0,4,8,1530,0,1984,0,98033,47.6653,-122.194,2240,7201,5243,4961,87.84881145725676,0.06819672131147542,Very Cheap
20140818T000000,313300.0,2,1.0,970,4800,1.0,0,0,3,6,970,0,1911,1940,98116,47.5754,-122.414,1180,5900,3830,4720,65.27083333333333,0.031252459016393445,Very Cheap
20140725T000000,360000.0,5,1.75,1550,5225,1.5,0,0,4,7,1550,0,1941,0,98108,47.554,-122.306,1220,5225,3675,4005,68.89952153110048,0.037377049180327866,Very Cheap
20150323T000000,188000.0,3,1.75,1660,7350,1.0,0,0,2,8,1660,0,1979,0,98023,47.3118,-122.337,1840,7673,5690,5833,25.578231292517007,0.014819672131147541,Very Cheap
20140912T000000,755000.0,3,2.5,3680,203860,1.5,0,0,3,9,3680,0,1994,0,98014,47.6903,-121.929,2410,144183,200180,141773,3.703522024919062,0.08918032786885247,Very Cheap
20140910T000000,1289000.0,5,3.5,3210,4060,2.0,0,2,3,10,2290,920,1917,2003,98117,47.6801,-122.357,1940,5000,850,3060,317.48768472906403,0.15921311475409836,Cheap
20140714T000000,455000.0,3,1.0,1480,13280,2.5,0,0,3,6,1480,0,1940,0,98027,47.5378,-122.043,1510,8723,11800,7213,34.26204819277108,0.049836065573770495,Very Cheap
20141009T000000,817500.0,5,3.5,3600,9312,2.0,0,3,3,10,2680,920,2005,0,98052,47.6582,-122.122,3420,9860,5712,6440,87.78994845360825,0.09737704918032787,Very Cheap
20140922T000000,550000.0,3,2.25,1700,1481,3.0,0,0,3,8,1700,0,2002,0,98103,47.6598,-122.349,1560,1350,-219,-210,371.3706954760297,0.06229508196721312,Very Cheap
20150505T000000,260000.0,3,1.75,1680,8725,1.0,0,0,3,8,1240,440,1978,0,98023,47.3107,-122.397,2020,8352,7045,6332,29.799426934097422,0.024262295081967214,Very Cheap
20140626T000000,320000.0,3,2.0,1550,34175,1.5,0,0,3,7,1550,0,1999,0,98045,47.4855,-121.698,2300,35174,32625,32874,9.363569861009509,0.032131147540983604,Very Cheap
20140916T000000,1153000.0,3,3.25,3780,10623,1.0,0,1,3,11,2650,1130,1999,0,98006,47.5506,-122.101,3850,11170,6843,7320,108.53807775581286,0.14137704918032787,Cheap
20150420T000000,362000.0,4,2.5,2360,7370,1.0,0,0,3,7,1460,900,1985,0,98125,47.7201,-122.308,1590,9906,5010,8316,49.11804613297151,0.03763934426229508,Very Cheap
20150423T000000,503500.0,3,2.5,1810,1750,2.0,0,0,3,7,1350,460,1997,0,98199,47.6513,-122.386,1640,1563,-60,-77,287.7142857142857,0.05619672131147541,Very Cheap
20140602T000000,653000.0,3,2.5,2290,3475,2.0,0,0,3,9,2290,0,2006,0,98029,47.5551,-122.001,2340,3626,1185,1286,187.9136690647482,0.07580327868852459,Very Cheap
20140604T000000,760000.0,4,2.75,3370,12447,2.0,0,0,3,10,3370,0,1991,0,98077,47.7309,-122.058,3700,13129,9077,9429,61.05888969229533,0.0898360655737705,Very Cheap
20141125T000000,775000.0,4,1.75,2090,5050,1.0,0,0,4,7,1090,1000,1916,0,98117,47.6802,-122.358,1760,5000,2960,3240,153.46534653465346,0.09180327868852459,Very Cheap
20141021T000000,1339000.0,4,3.75,2130,34689,1.5,1,4,3,9,2130,0,1955,0,98136,47.5489,-122.398,3030,28598,32559,25568,38.60013260687826,0.16577049180327869,Cheap
20150224T000000,417500.0,5,1.75,2060,10911,1.0,0,0,4,7,1360,700,1954,0,98177,47.7767,-122.365,2060,9688,8851,7628,38.2641371093392,0.04491803278688525,Very Cheap
20140711T000000,525000.0,3,1.5,1560,9350,1.0,0,0,4,7,1220,340,1969,0,98052,47.6729,-122.148,1870,8671,7790,6801,56.149732620320854,0.05901639344262295,Very Cheap
20150414T000000,217000.0,2,1.0,730,2400,1.0,0,1,3,4,730,0,1934,0,98198,47.35,-122.322,1220,4382,1670,3162,90.41666666666667,0.01862295081967213,Very Cheap
20140709T000000,525000.0,4,2.75,2910,6308,1.0,0,0,3,8,1640,1270,1985,0,98011,47.7352,-122.201,1970,7127,3398,5157,83.2276474318326,0.05901639344262295,Very Cheap
20150324T000000,442500.0,4,2.25,2490,8700,1.0,0,0,3,7,1890,600,1976,0,98155,47.7397,-122.324,1470,7975,6210,6505,50.86206896551724,0.04819672131147541,Very Cheap
20140709T000000,525000.0,4,1.75,1710,10440,1.0,0,0,4,7,1710,0,1955,0,98006,47.5756,-122.158,1480,10440,8730,8960,50.28735632183908,0.05901639344262295,Very Cheap
20150225T000000,425500.0,4,1.75,1520,10630,1.0,0,0,4,7,1520,0,1967,0,98034,47.7347,-122.193,1550,8039,9110,6489,40.02822201317027,0.045967213114754095,Very Cheap
20140815T000000,710000.0,3,2.75,2930,218235,2.0,0,2,3,8,2930,0,1990,0,98024,47.5481,-121.886,2450,218235,215305,215785,3.2533736568378124,0.08327868852459017,Very Cheap
20141114T000000,545000.0,4,3.0,3160,10948,1.0,0,3,3,8,1930,1230,1991,0,98070,47.3733,-122.422,2380,13623,7788,11243,49.78078187796858,0.06163934426229508,Very Cheap
20150212T000000,410000.0,5,2.75,2910,16410,1.5,0,0,4,8,2910,0,1967,0,98058,47.44,-122.145,1980,18000,13500,16020,24.98476538695917,0.043934426229508196,Very Cheap
20150422T000000,245000.0,3,2.25,1700,8100,1.0,0,0,3,7,1200,500,1980,0,98038,47.3601,-122.046,1700,8100,6400,6400,30.246913580246915,0.022295081967213116,Very Cheap
20140711T000000,194900.0,2,1.0,810,6697,1.0,0,0,4,6,810,0,1923,0,98002,47.3057,-122.216,1140,6695,5887,5555,29.102583246229656,0.015724590163934425,Very Cheap
20140506T000000,284000.0,4,2.5,2000,5390,2.0,0,0,3,7,2000,0,2003,0,98042,47.3732,-122.129,2330,5390,3390,3060,52.69016697588126,0.027409836065573772,Very Cheap
20140819T000000,280000.0,2,1.75,1894,52769,1.5,0,0,4,6,1520,374,1936,0,98001,47.3088,-122.273,1820,50529,50875,48709,5.306145653698194,0.026885245901639345,Very Cheap
20141002T000000,280000.0,3,1.75,2080,87991,1.0,0,0,3,6,1040,1040,1970,0,98014,47.6724,-121.865,2080,84300,85911,82220,3.1821436283256244,0.026885245901639345,Very Cheap
20140512T000000,360000.0,4,2.0,1730,5500,1.0,0,0,5,7,1010,720,1943,0,98106,47.5304,-122.353,1080,4900,3770,3820,65.45454545454545,0.037377049180327866,Very Cheap
20140905T000000,405000.0,2,1.0,720,4323,1.0,0,0,3,6,720,0,1942,0,98199,47.6604,-122.401,1460,3300,3603,1840,93.6849410131853,0.043278688524590166,Very Cheap
20150414T000000,865000.0,4,2.5,3560,13981,2.0,0,0,3,10,3560,0,2000,0,98075,47.6002,-121.98,3840,13624,10421,9784,61.869680280380514,0.10360655737704919,Cheap
20140610T000000,483300.0,4,2.0,1210,11100,1.0,0,0,4,7,1210,0,1955,0,98006,47.5747,-122.145,1280,11100,9890,9820,43.54054054054054,0.053547540983606555,Very Cheap
20150318T000000,355000.0,4,2.5,2130,9268,2.0,0,0,4,8,2130,0,1985,0,98092,47.262,-122.22,2100,8400,7138,6300,38.30384117393181,0.036721311475409836,Very Cheap
20150430T000000,274950.0,3,2.25,1570,8767,1.0,0,0,3,7,1180,390,1990,0,98038,47.3568,-122.038,1570,7434,7197,5864,31.36192540207597,0.02622295081967213,Very Cheap
20141205T000000,1925000.0,3,4.5,3950,6134,2.0,0,3,3,11,2880,1070,1998,0,98199,47.6413,-122.405,3050,5281,2184,2231,313.8245842843169,0.24262295081967214,Cheap
20141231T000000,755000.0,3,3.25,3450,15586,2.0,0,0,3,11,2690,760,1989,0,98166,47.4294,-122.343,3560,15046,12136,11486,48.44090850763506,0.08918032786885247,Very Cheap
20150209T000000,1940000.0,4,5.75,7220,223462,2.0,0,4,3,12,6220,1000,2000,0,98053,47.7097,-122.013,2680,7593,216242,4913,8.68156554581987,0.24459016393442623,Cheap
20140616T000000,309212.0,3,1.75,1150,9600,1.0,0,0,3,7,1150,0,1979,0,98045,47.4434,-121.774,1520,9976,8450,8456,32.209583333333335,0.03071632786885246,Very Cheap
20140604T000000,219950.0,3,2.25,1500,7615,1.0,0,0,3,7,1150,350,1984,0,98023,47.3146,-122.351,1540,8649,6115,7109,28.883782009192384,0.01900983606557377,Very Cheap
20140723T000000,690000.0,3,2.5,1300,5150,1.5,0,0,4,7,1300,0,1920,0,98117,47.6838,-122.362,1400,4017,3850,2617,133.98058252427185,0.08065573770491803,Very Cheap
20141005T000000,250800.0,3,1.75,1290,4000,1.0,0,0,3,6,1170,120,1943,0,98106,47.5309,-122.354,1140,4000,2710,2860,62.7,0.023055737704918033,Very Cheap
20150325T000000,557500.0,3,2.0,2510,35255,1.0,0,2,3,9,2510,0,1994,0,98038,47.4012,-122.025,3140,36450,32745,33310,15.813359807119557,0.06327868852459016,Very Cheap
20140624T000000,941000.0,4,1.75,2320,3825,1.5,0,0,5,8,1820,500,1926,0,98105,47.6659,-122.327,1940,3825,1505,1885,246.01307189542484,0.11357377049180328,Cheap
20150421T000000,3650000.0,6,4.75,5480,19401,1.5,1,4,5,11,3910,1570,1936,0,98105,47.6515,-122.277,3510,15810,13921,12300,188.1346322354518,0.46885245901639344,High
20150422T000000,305000.0,4,2.75,2030,8600,1.0,0,0,4,7,1230,800,1977,0,98042,47.3942,-122.16,1810,8600,6570,6790,35.46511627906977,0.03016393442622951,Very Cheap
20140729T000000,815000.0,4,1.5,2060,16110,1.0,0,0,4,8,2060,0,1949,0,98004,47.5983,-122.202,2060,16110,14050,14050,50.58969584109249,0.09704918032786886,Very Cheap
20140512T000000,1015000.0,3,2.5,2920,34527,1.0,0,4,4,9,1800,1120,1954,1983,98116,47.5799,-122.4,2480,7933,31607,5453,29.397283285544646,0.12327868852459016,Cheap
20140908T000000,1240000.0,4,3.0,3330,6990,1.5,0,3,5,9,2330,1000,1928,0,98144,47.5886,-122.287,2620,5310,3660,2690,177.39628040057224,0.15278688524590164,Cheap
20141226T000000,535000.0,3,2.5,2110,8164,2.0,0,0,3,9,2110,0,1990,0,98056,47.5269,-122.171,2390,7499,6054,5109,65.53160215580598,0.06032786885245902,Very Cheap
20140721T000000,775000.0,3,1.0,1175,10454,1.0,0,0,4,6,1175,0,1949,0,98004,47.6388,-122.218,2010,10800,9279,8790,74.13430265926918,0.09180327868852459,Very Cheap
20140718T000000,255000.0,3,2.0,1590,8670,1.0,0,0,3,7,1590,0,1994,0,98042,47.3725,-122.073,1590,9253,7080,7663,29.41176470588235,0.02360655737704918,Very Cheap
20140811T000000,327000.0,2,1.0,1070,9750,1.0,0,0,3,7,1070,0,1947,0,98155,47.7532,-122.318,1500,8775,8680,7275,33.53846153846154,0.033049180327868855,Very Cheap
20141120T000000,560000.0,4,2.0,2720,8819,2.0,0,3,3,8,2240,480,1976,0,98003,47.338,-122.333,2960,9672,6099,6712,63.49926295498356,0.06360655737704918,Very Cheap
20150130T000000,1339000.0,4,3.5,2980,6349,2.0,0,3,3,9,2980,0,1998,0,98033,47.6819,-122.208,2870,6349,3369,3479,210.89935422901243,0.16577049180327869,Cheap
20141204T000000,199500.0,3,1.75,1160,5200,1.0,0,0,4,7,1160,0,1977,0,98042,47.3643,-122.09,1470,5200,4040,3730,38.36538461538461,0.016327868852459015,Very Cheap
20141223T000000,760000.0,4,2.5,3580,97574,2.0,0,0,3,9,3580,0,2004,0,98038,47.3901,-122.071,2510,27068,93994,24558,7.788960173816795,0.0898360655737705,Very Cheap
20150330T000000,439000.0,3,2.25,3020,6000,3.0,0,2,3,8,1980,1040,1994,0,98108,47.5249,-122.319,1150,6000,2980,4850,73.16666666666667,0.04773770491803279,Very Cheap
20140930T000000,527000.0,4,2.25,2380,5250,1.0,0,0,4,7,1410,970,1961,0,98008,47.6164,-122.115,2150,8560,2870,6410,100.38095238095238,0.059278688524590166,Very Cheap
20140716T000000,199950.0,3,2.75,2270,13590,1.5,0,0,4,6,1300,970,1948,0,98022,47.2099,-122.001,1160,13545,11320,12385,14.713024282560706,0.01638688524590164,Very Cheap
20150204T000000,254000.0,3,2.25,1660,8188,2.0,0,0,4,7,1660,0,1988,0,98042,47.3766,-122.115,1660,7000,6528,5340,31.021006350757204,0.023475409836065574,Very Cheap
20150323T000000,393000.0,2,1.0,830,5000,1.0,0,0,4,7,830,0,1921,0,98103,47.6914,-122.352,1110,5000,4170,3890,78.6,0.041704918032786885,Very Cheap
20141121T000000,585000.0,5,2.25,2480,12614,1.0,0,0,4,8,1860,620,1979,0,98011,47.7393,-122.2,2470,12392,10134,9922,46.377041382590775,0.06688524590163934,Very Cheap
20140716T000000,450000.0,2,2.0,1900,7740,1.0,0,0,4,7,1150,750,1923,0,98126,47.5227,-122.372,1140,7740,5840,6600,58.13953488372093,0.04918032786885246,Very Cheap
20140625T000000,565000.0,2,1.75,1670,4008,1.0,0,0,3,9,1670,0,2005,0,98029,47.5539,-122.001,2330,3752,2338,1422,140.9680638722555,0.06426229508196721,Very Cheap
20140522T000000,330000.0,5,2.25,2000,7900,1.0,0,0,4,7,1300,700,1986,0,98188,47.4291,-122.292,2000,9132,5900,7132,41.77215189873418,0.03344262295081967,Very Cheap
20150511T000000,870000.0,3,2.0,2320,65340,1.5,0,0,3,9,2320,0,1992,0,98074,47.6106,-122.055,3100,59603,63020,56503,13.314967860422406,0.10426229508196722,Cheap
20140723T000000,585000.0,4,2.5,1860,8117,1.0,0,0,4,8,1460,400,1966,0,98008,47.6228,-122.104,2040,8199,6257,6159,72.07096217814464,0.06688524590163934,Very Cheap
20141106T000000,500000.0,3,2.5,2110,208737,2.0,0,3,3,9,2110,0,1977,0,98092,47.2674,-122.072,2390,125017,206627,122627,2.3953587528804188,0.05573770491803279,Very Cheap
20140515T000000,225000.0,3,2.0,1400,7384,1.0,0,0,3,7,1150,250,1979,0,98058,47.4655,-122.174,1820,7992,5984,6172,30.471289274106176,0.019672131147540985,Very Cheap
20150325T000000,295000.0,3,2.0,1400,7384,1.0,0,0,3,7,1150,250,1979,0,98058,47.4655,-122.174,1820,7992,5984,6172,39.95124593716143,0.028852459016393443,Very Cheap
20140626T000000,775000.0,3,2.75,2850,14800,1.0,0,0,4,9,1920,930,1976,0,98006,47.559,-122.146,3300,10809,11950,7509,52.36486486486486,0.09180327868852459,Very Cheap
20140717T000000,280000.0,3,1.0,1370,11050,1.0,0,0,3,7,1370,0,1981,0,98045,47.4485,-121.776,1520,10000,9680,8480,25.339366515837103,0.026885245901639345,Very Cheap
20140908T000000,539000.0,3,2.5,2170,3200,1.5,0,0,5,7,1280,890,1923,0,98103,47.6543,-122.347,1180,1224,1030,44,168.4375,0.06085245901639344,Very Cheap
20150324T000000,567500.0,3,1.75,2570,14033,1.0,0,2,4,8,2570,0,1953,0,98166,47.4335,-122.338,2550,16100,11463,13550,40.44039050808808,0.06459016393442622,Very Cheap
20150205T000000,442500.0,4,2.25,1970,7902,1.0,0,0,3,8,1310,660,1960,0,98125,47.7249,-122.298,1860,8021,5932,6161,55.99848139711465,0.04819672131147541,Very Cheap
20150507T000000,598200.0,5,3.75,2980,4635,3.0,0,0,3,8,2980,0,1997,0,98118,47.5508,-122.268,1100,5150,1655,4050,129.06148867313917,0.06861639344262295,Very Cheap
20141014T000000,610000.0,4,2.5,2300,10843,2.0,0,0,5,8,2300,0,1955,0,98033,47.6988,-122.202,1780,10843,8543,9063,56.25749331365858,0.07016393442622951,Very Cheap
20141121T000000,544900.0,3,2.5,1990,4936,2.0,0,0,3,8,1990,0,2004,0,98075,47.5911,-122.018,2250,4815,2946,2565,110.39303079416531,0.06162622950819672,Very Cheap
20141216T000000,557500.0,4,2.5,2390,38258,2.0,0,0,3,8,2390,0,2001,0,98072,47.7433,-122.094,1960,17113,35868,15153,14.572115635945423,0.06327868852459016,Very Cheap
20140811T000000,532500.0,3,2.5,2160,7500,1.0,0,1,3,7,1430,730,1979,0,98074,47.6188,-122.064,1560,7500,5340,5940,71.0,0.06,Very Cheap
20140609T000000,1350000.0,4,3.25,3300,15907,2.0,0,0,5,10,3300,0,1985,0,98040,47.5413,-122.216,2740,11358,12607,8618,84.86829697617401,0.16721311475409836,Cheap
20150430T000000,750000.0,3,2.0,1840,2825,1.0,0,0,3,7,1040,800,1920,0,98112,47.6428,-122.302,1820,3750,985,1930,265.4867256637168,0.08852459016393442,Very Cheap
20141119T000000,530000.0,3,2.5,2030,10958,2.0,0,0,3,8,2030,0,1983,0,98052,47.7251,-122.11,1960,10282,8928,8322,48.366490235444424,0.05967213114754098,Very Cheap
20140717T000000,346100.0,3,2.5,1400,2036,2.0,0,0,3,7,1400,0,2003,0,98136,47.5516,-122.382,1500,2036,636,536,169.9901768172888,0.03555409836065574,Very Cheap
20140810T000000,260000.0,4,2.25,2320,16800,2.0,0,0,4,9,2320,0,1977,0,98092,47.2959,-122.166,2700,15680,14480,12980,15.476190476190476,0.024262295081967214,Very Cheap
20140829T000000,365000.0,3,1.75,1410,9150,1.0,0,0,5,7,1410,0,1959,0,98006,47.5683,-122.178,1800,9940,7740,8140,39.89071038251366,0.0380327868852459,Very Cheap
20140908T000000,615000.0,3,2.0,1860,42800,1.0,0,0,4,7,930,930,1983,0,98075,47.5898,-122.004,1980,11250,40940,9270,14.369158878504672,0.07081967213114754,Very Cheap
20140724T000000,318400.0,4,2.5,1820,6916,2.0,0,0,3,7,1820,0,1994,0,98038,47.3862,-122.029,1680,6995,5096,5315,46.038172353961826,0.03192131147540984,Very Cheap
20150303T000000,498500.0,4,2.5,1910,7172,2.0,0,0,3,8,1910,0,1993,0,98155,47.7615,-122.309,1630,10127,5262,8497,69.5064138315672,0.055540983606557376,Very Cheap
20150408T000000,450000.0,3,1.75,1540,7490,1.0,0,0,5,7,1540,0,1971,0,98034,47.7222,-122.177,1270,7350,5950,6080,60.08010680907877,0.04918032786885246,Very Cheap
20150327T000000,200000.0,3,2.0,1430,7905,1.0,0,0,4,7,1430,0,1988,0,98092,47.2757,-122.145,1870,8400,6475,6530,25.30044275774826,0.01639344262295082,Very Cheap
20140909T000000,234000.0,3,1.0,1010,8906,1.0,0,0,5,7,1010,0,1968,0,98042,47.3627,-122.108,1150,10414,7896,9264,26.274421738154054,0.020852459016393442,Very Cheap
20140804T000000,121800.0,2,1.0,940,8384,1.0,0,0,3,5,940,0,1947,0,98146,47.5065,-122.364,1290,8384,7444,7094,14.52767175572519,0.006137704918032787,Very Cheap
20140626T000000,805000.0,3,2.75,2600,5875,1.5,0,2,5,8,1600,1000,1929,0,98116,47.5773,-122.406,2260,5492,3275,3232,137.0212765957447,0.09573770491803278,Very Cheap
20140708T000000,410000.0,4,2.25,2060,7283,1.0,0,0,3,8,1220,840,1963,2013,98155,47.7435,-122.317,1500,8134,5223,6634,56.295482630784015,0.043934426229508196,Very Cheap
20150218T000000,475000.0,3,2.5,1920,4534,2.0,0,0,3,8,1920,0,1986,0,98034,47.7144,-122.204,1380,5100,2614,3720,104.76400529333921,0.05245901639344262,Very Cheap
20141030T000000,1337500.0,4,2.5,2900,21074,2.0,0,0,3,11,2900,0,1986,0,98199,47.6696,-122.416,3390,20000,18174,16610,63.46683116636614,0.16557377049180327,Cheap
20140918T000000,269000.0,1,1.0,1020,7920,1.0,0,0,3,7,1020,0,1947,1983,98106,47.5385,-122.355,1000,7168,6900,6168,33.964646464646464,0.02544262295081967,Very Cheap
20140724T000000,573000.0,4,2.25,2150,9520,2.0,0,0,4,8,2150,0,1979,0,98052,47.6885,-122.113,2000,9520,7370,7520,60.1890756302521,0.06531147540983606,Very Cheap
20150327T000000,330000.0,3,2.5,1660,2890,2.0,0,0,3,7,1660,0,2001,0,98108,47.5434,-122.293,1540,2890,1230,1350,114.18685121107266,0.03344262295081967,Very Cheap
20140626T000000,252750.0,4,1.0,1230,7410,1.5,0,0,3,7,1230,0,1944,0,98166,47.4798,-122.344,1020,7648,6180,6628,34.10931174089069,0.023311475409836066,Very Cheap
20150406T000000,745000.0,2,2.5,2170,7546,1.0,0,0,3,8,2170,0,2007,0,98053,47.7242,-122.032,2170,7083,5376,4913,98.72780280943546,0.08786885245901639,Very Cheap
20150304T000000,280000.0,3,2.0,1280,7633,1.0,0,0,3,7,1280,0,1991,0,98038,47.3883,-122.05,1450,6783,6353,5333,36.68282457749247,0.026885245901639345,Very Cheap
20150430T000000,535000.0,4,2.5,2240,6920,1.0,0,0,5,8,1380,860,1974,0,98146,47.5011,-122.375,1540,7000,4680,5460,77.3121387283237,0.06032786885245902,Very Cheap
20150312T000000,580000.0,4,1.5,1780,5100,1.0,0,0,3,7,1320,460,1953,0,98115,47.6944,-122.288,1880,5100,3320,3220,113.72549019607843,0.06622950819672131,Very Cheap
20141212T000000,301000.0,3,1.75,1840,7200,1.0,0,0,4,7,1220,620,1968,0,98055,47.456,-122.209,1770,8075,5360,6305,41.80555555555556,0.029639344262295083,Very Cheap
20140624T000000,600000.0,4,1.75,1740,7700,1.0,0,0,5,7,1740,0,1968,0,98008,47.6259,-122.111,1740,8120,5960,6380,77.92207792207792,0.06885245901639345,Very Cheap
20140811T000000,538900.0,5,3.0,3040,6604,2.0,0,0,3,9,3040,0,2005,0,98106,47.548,-122.356,1650,6825,3564,5175,81.60205935796488,0.060839344262295085,Very Cheap
20150209T000000,366000.0,3,2.5,2370,4375,2.0,0,0,3,8,2370,0,2006,0,98038,47.354,-121.999,2380,4606,2005,2226,83.65714285714286,0.03816393442622951,Very Cheap
20140819T000000,303000.0,4,2.5,2100,6783,2.0,0,0,3,8,2100,0,2003,0,98042,47.3504,-122.141,2100,6192,4683,4092,44.67049977885891,0.029901639344262296,Very Cheap
20140522T000000,432000.0,3,2.25,1470,1578,2.0,0,0,3,8,1090,380,2007,0,98136,47.5388,-122.387,1470,1668,108,198,273.7642585551331,0.046819672131147544,Very Cheap
20150409T000000,300000.0,2,1.5,1300,6120,1.0,0,0,3,6,820,480,1945,0,98146,47.5088,-122.338,1250,6120,4820,4870,49.01960784313726,0.029508196721311476,Very Cheap
20141020T000000,908800.0,3,3.0,3420,7826,2.0,0,0,4,8,2430,990,1939,0,98144,47.5873,-122.29,980,6300,4406,5320,116.12573473038589,0.10935081967213114,Cheap
20140625T000000,500000.0,3,1.5,1190,4750,1.0,0,0,3,7,970,220,1940,0,98107,47.6726,-122.386,1460,4750,3560,3290,105.26315789473684,0.05573770491803279,Very Cheap
20140626T000000,254000.0,5,2.0,2080,16117,1.0,0,0,5,7,1740,340,1959,0,98001,47.3424,-122.289,1510,13068,14037,11558,15.759756778556804,0.023475409836065574,Very Cheap
20140917T000000,470000.0,5,1.5,2180,4268,1.5,0,0,4,7,1340,840,1924,0,98117,47.6848,-122.389,1530,3880,2088,2350,110.12183692596064,0.05180327868852459,Very Cheap
20150317T000000,480000.0,3,2.0,1460,7860,1.0,0,0,5,7,1460,0,1967,0,98008,47.6233,-122.108,1850,8148,6400,6298,61.06870229007634,0.05311475409836065,Very Cheap
20150130T000000,536000.0,3,1.75,1530,8503,1.0,0,0,4,7,1150,380,1983,0,98033,47.6872,-122.185,1610,8549,6973,6939,63.036575326355404,0.06045901639344262,Very Cheap
20150430T000000,1349000.0,4,3.5,4740,8611,2.0,0,3,3,11,3640,1100,2006,0,98027,47.5375,-122.07,4042,8321,3871,4279,156.66008593659274,0.16708196721311475,Cheap
20140515T000000,550000.0,3,2.25,1980,40887,1.0,0,0,4,8,1980,0,1980,0,98052,47.6478,-122.029,2460,35700,38907,33240,13.451708366962604,0.06229508196721312,Very Cheap
20141202T000000,260000.0,3,1.75,1710,6400,1.0,0,0,4,7,1240,470,1976,0,98023,47.3036,-122.377,1600,6400,4690,4800,40.625,0.024262295081967214,Very Cheap
20150424T000000,284900.0,2,1.5,1160,982,2.0,0,0,3,7,890,270,2006,0,98155,47.7675,-122.315,1160,1008,-178,-152,290.12219959266804,0.027527868852459017,Very Cheap
20141029T000000,740000.0,3,2.5,2200,3000,2.0,0,0,3,9,1530,670,2002,0,98109,47.6451,-122.35,2200,3300,800,1100,246.66666666666666,0.08721311475409836,Very Cheap
20141002T000000,425000.0,2,1.0,1170,5000,1.0,0,0,4,7,1030,140,1920,0,98136,47.5449,-122.388,1170,5850,3830,4680,85.0,0.04590163934426229,Very Cheap
20140902T000000,230000.0,3,1.0,1120,7500,1.0,0,0,3,7,1120,0,1965,0,98146,47.5112,-122.359,1120,5000,6380,3880,30.666666666666668,0.020327868852459016,Very Cheap
20150413T000000,675000.0,3,1.5,1710,4000,2.0,0,0,3,8,1710,0,1926,0,98116,47.5714,-122.385,1910,4000,2290,2090,168.75,0.07868852459016394,Very Cheap
20140729T000000,267500.0,3,1.75,1650,7807,1.0,0,0,3,7,1650,0,1986,0,98030,47.3514,-122.167,1810,8475,6157,6665,34.26412194184706,0.025245901639344263,Very Cheap
20140825T000000,814000.0,4,2.5,2840,8820,1.0,0,2,5,8,1420,1420,1952,0,98118,47.5542,-122.265,2310,8750,5980,6440,92.29024943310658,0.09691803278688525,Very Cheap
20150427T000000,1250000.0,4,3.0,3310,217800,1.5,0,0,3,9,3310,0,1989,0,98053,47.6616,-121.999,2810,217800,214490,214990,5.73921028466483,0.1540983606557377,Cheap
20140916T000000,460000.0,3,2.0,1860,7232,1.0,0,0,3,7,1320,540,1985,0,98125,47.7165,-122.319,1830,7220,5372,5390,63.60619469026549,0.050491803278688525,Very Cheap
20150120T000000,445000.0,3,2.5,2250,9608,2.0,0,0,3,8,2250,0,1994,0,98045,47.4865,-121.802,2020,9834,7358,7814,46.31557035803497,0.04852459016393443,Very Cheap
20140924T000000,715000.0,3,2.5,2890,7027,2.0,0,0,3,8,2890,0,2004,0,98074,47.6111,-122.009,2890,7197,4137,4307,101.75039134765903,0.0839344262295082,Very Cheap
20150219T000000,425000.0,3,1.75,2120,5992,1.0,0,0,3,7,1060,1060,1947,0,98125,47.7083,-122.308,1840,11000,3872,9160,70.9279038718291,0.04590163934426229,Very Cheap
20140715T000000,370000.0,4,2.5,2130,4750,2.0,0,0,3,8,2130,0,2009,0,98058,47.4324,-122.184,2130,4071,2620,1941,77.89473684210526,0.038688524590163934,Very Cheap
20150429T000000,302000.0,2,1.75,1170,8200,1.0,0,0,4,6,780,390,1937,0,98003,47.3263,-122.305,1780,9020,7030,7240,36.829268292682926,0.02977049180327869,Very Cheap
20140623T000000,453000.0,4,1.75,2120,7420,1.0,0,0,4,7,1060,1060,1956,0,98008,47.6019,-122.13,1540,7420,5300,5880,61.05121293800539,0.04957377049180328,Very Cheap
20140520T000000,290000.0,3,1.75,1280,10716,1.0,0,0,4,7,1280,0,1969,0,98059,47.4755,-122.145,1440,9870,9436,8430,27.06233669279582,0.02819672131147541,Very Cheap
20141229T000000,1035000.0,4,2.5,3170,47502,2.0,0,0,3,10,3170,0,1988,0,98033,47.6495,-122.185,3190,35110,44332,31920,21.788556271314892,0.1259016393442623,Cheap
20140520T000000,925000.0,4,2.25,2260,41984,1.0,0,0,4,9,2260,0,1967,0,98033,47.6622,-122.171,2650,37318,39724,34668,22.032202743902438,0.11147540983606558,Cheap
20140529T000000,600000.0,3,1.75,2930,19876,1.0,0,0,3,9,2030,900,1993,0,98072,47.7443,-122.17,2740,11499,16946,8759,30.187160394445563,0.06885245901639345,Very Cheap
20140805T000000,354000.0,3,1.5,1060,5750,1.0,0,2,4,7,1060,0,1981,0,98126,47.5512,-122.371,1060,5750,4690,4690,61.56521739130435,0.03659016393442623,Very Cheap
20140617T000000,204950.0,4,1.75,1740,9344,1.0,0,0,3,7,1180,560,1978,0,98023,47.3196,-122.399,1440,12884,7604,11444,21.933861301369863,0.017042622950819673,Very Cheap
20150422T000000,675000.0,4,2.5,2990,5400,2.0,0,0,3,8,2990,0,2005,0,98074,47.6122,-122.009,2890,6538,2410,3648,125.0,0.07868852459016394,Very Cheap
20150422T000000,995000.0,4,3.25,3530,20012,2.0,0,0,3,11,3530,0,1986,0,98052,47.7193,-122.127,3850,20707,16482,16857,49.720167899260446,0.12065573770491804,Cheap
20150331T000000,800000.0,5,2.0,2960,10960,1.0,0,0,4,7,1500,1460,1957,0,98005,47.6162,-122.174,2160,10960,8000,8800,72.99270072992701,0.09508196721311475,Very Cheap
20140909T000000,472500.0,3,2.5,1650,3711,2.0,0,0,3,8,1650,0,1996,0,98052,47.6863,-122.093,1760,3762,2061,2002,127.32417138237672,0.05213114754098361,Very Cheap
20141202T000000,549950.0,4,2.5,2720,13500,1.0,0,0,3,8,1510,1210,1969,0,98007,47.6191,-122.145,2510,12350,10780,9840,40.737037037037034,0.062288524590163936,Very Cheap
20141013T000000,575575.0,3,1.75,1516,2897,1.0,0,0,3,7,998,518,1925,0,98103,47.6842,-122.341,2100,3854,1381,1754,198.67966862271314,0.06564918032786886,Very Cheap
20150303T000000,545000.0,4,3.25,4386,12275,1.0,0,0,3,10,2356,2030,2006,0,98092,47.3329,-122.2,3060,10925,7889,7865,44.39918533604888,0.06163934426229508,Very Cheap
20141119T000000,340000.0,3,2.25,2580,7434,1.0,0,0,3,7,1630,950,1963,0,98133,47.7446,-122.332,1920,7737,4854,5817,45.73580844767285,0.03475409836065574,Very Cheap
20150331T000000,225000.0,3,1.0,960,5512,1.0,0,0,4,6,960,0,1963,0,98056,47.4944,-122.165,1090,5837,4552,4747,40.8200290275762,0.019672131147540985,Very Cheap
20141028T000000,299950.0,2,1.75,1460,10506,1.0,0,0,3,7,1460,0,1983,0,98031,47.4048,-122.178,1460,8153,9046,6693,28.550352179706834,0.029501639344262295,Very Cheap
20150223T000000,829900.0,4,3.5,3840,4000,2.0,0,0,3,8,2640,1200,2001,0,98105,47.6642,-122.291,1620,4000,160,2380,207.475,0.09900327868852458,Very Cheap
20150330T000000,340000.0,4,2.5,2090,4200,2.0,0,0,3,7,2090,0,2007,0,98038,47.3659,-122.017,2090,4200,2110,2110,80.95238095238095,0.03475409836065574,Very Cheap
20141008T000000,515000.0,4,2.25,2470,7800,1.0,0,0,3,8,1470,1000,1975,0,98052,47.6913,-122.115,2050,8050,5330,6000,66.02564102564102,0.057704918032786885,Very Cheap
20140711T000000,601000.0,4,2.5,2090,6906,2.0,0,0,4,8,2090,0,1992,0,98029,47.5718,-121.996,2090,6370,4816,4280,87.0257746886765,0.06898360655737705,Very Cheap
20150504T000000,470000.0,3,2.5,2070,8581,2.0,0,0,3,8,2070,0,1994,0,98059,47.5101,-122.151,2440,7849,6511,5409,54.77217107563221,0.05180327868852459,Very Cheap
20140708T000000,371500.0,3,1.0,1650,6400,1.0,0,0,4,7,980,670,1954,0,98106,47.52,-122.365,1230,6400,4750,5170,58.046875,0.038885245901639345,Very Cheap
20141119T000000,550000.0,3,1.75,1880,45738,1.0,0,0,4,8,1410,470,1980,0,98072,47.7662,-122.114,2340,38556,43858,36216,12.025012025012025,0.06229508196721312,Very Cheap
20141214T000000,242550.0,4,2.5,2060,7720,2.0,0,0,3,8,2060,0,1995,0,98023,47.2956,-122.374,1630,7720,5660,6090,31.41839378238342,0.02197377049180328,Very Cheap
20140506T000000,367500.0,3,1.5,1410,9647,1.0,0,0,3,8,1410,0,1961,0,98177,47.7608,-122.361,2090,9272,8237,7182,38.09474448014927,0.03836065573770492,Very Cheap
20140924T000000,359000.0,4,3.5,2770,8763,2.0,0,0,3,8,2100,670,1996,0,98003,47.2625,-122.308,2030,7242,5993,5212,40.967705123816046,0.03724590163934426,Very Cheap
20150311T000000,204900.0,3,2.0,1390,8245,1.0,0,0,2,7,1390,0,1984,0,98001,47.2669,-122.254,1260,8245,6855,6985,24.851425106124925,0.017036065573770492,Very Cheap
20140930T000000,850000.0,4,2.75,5440,239580,1.0,0,0,2,9,2720,2720,1969,0,98001,47.354,-122.293,1970,40392,234140,38422,3.547875448701895,0.10163934426229508,Cheap
20141021T000000,187000.0,3,1.5,1280,4452,2.0,0,0,3,6,1280,0,1985,0,98002,47.3344,-122.216,1070,4366,3172,3296,42.00359389038634,0.014688524590163935,Very Cheap
20140528T000000,326000.0,3,2.75,1720,28000,1.0,0,0,4,7,1720,0,1958,0,98058,47.4375,-122.176,2000,41817,26280,39817,11.642857142857142,0.032918032786885244,Very Cheap
20150225T000000,340000.0,3,2.75,1720,28000,1.0,0,0,4,7,1720,0,1958,0,98058,47.4375,-122.176,2000,41817,26280,39817,12.142857142857142,0.03475409836065574,Very Cheap
20140625T000000,330000.0,6,2.25,3040,28535,1.0,0,0,3,8,1890,1150,1951,0,98030,47.3864,-122.223,1360,8250,25495,6890,11.564745049938672,0.03344262295081967,Very Cheap
20150102T000000,782000.0,4,3.5,3780,7769,2.0,0,0,3,9,3110,670,2001,0,98052,47.691,-122.129,3310,7945,3989,4635,100.65645514223195,0.09272131147540984,Very Cheap
20141103T000000,612000.0,4,2.5,2670,5974,2.0,0,0,3,8,2670,0,1999,0,98034,47.7122,-122.231,2140,5729,3304,3589,102.44392366923334,0.07042622950819673,Very Cheap
20141031T000000,400000.0,3,2.0,1350,7216,1.0,0,0,3,7,1350,0,1964,0,98177,47.7616,-122.365,1920,7600,5866,5680,55.432372505543235,0.04262295081967213,Very Cheap
20140603T000000,941500.0,5,3.5,3490,9680,2.0,0,4,3,9,2460,1030,1980,0,98177,47.7757,-122.391,3080,13489,6190,10409,97.26239669421487,0.11363934426229508,Cheap
20150109T000000,313000.0,2,1.5,870,747,2.0,0,0,3,8,800,70,2004,0,98103,47.6967,-122.342,1710,1280,-123,-430,419.00937081659976,0.03121311475409836,Very Cheap
20150409T000000,735000.0,4,2.25,2410,4250,1.5,0,0,5,7,1460,950,1929,0,98117,47.6849,-122.376,1360,5074,1840,3714,172.94117647058823,0.08655737704918033,Very Cheap
20150319T000000,471000.0,3,1.75,1640,10123,1.0,0,0,3,8,1340,300,1977,0,98011,47.7698,-122.167,2210,10852,8483,8642,46.52770917712141,0.051934426229508196,Very Cheap
20150224T000000,350000.0,3,1.0,1540,9800,1.0,0,0,4,7,1540,0,1950,0,98155,47.7604,-122.329,1560,9450,8260,7890,35.714285714285715,0.036065573770491806,Very Cheap
20140723T000000,530000.0,4,2.5,2370,9601,1.0,0,0,3,8,1570,800,1976,0,98027,47.5327,-122.054,2550,10500,7231,7950,55.20258306426414,0.05967213114754098,Very Cheap
20140507T000000,415000.0,4,3.0,1830,9548,2.0,0,0,3,7,1830,0,1991,0,98028,47.7379,-122.224,1740,9750,7718,8010,43.46459991621282,0.04459016393442623,Very Cheap
20140621T000000,639500.0,4,2.25,2330,8994,2.0,0,0,3,8,2330,0,1986,0,98052,47.7264,-122.104,2330,8396,6664,6066,71.10295752724038,0.07403278688524591,Very Cheap
20140611T000000,580379.0,4,2.75,2240,27820,1.5,0,0,4,8,2240,0,1976,0,98075,47.5936,-122.054,2330,20000,25580,17670,20.86193386053199,0.0662792131147541,Very Cheap
20141119T000000,378000.0,2,2.5,1700,2513,2.0,0,0,3,8,1700,0,2009,0,98065,47.5163,-121.878,1760,2891,813,1131,150.41782729805013,0.03973770491803279,Very Cheap
20150115T000000,265000.0,3,2.25,1750,9298,1.0,0,0,4,7,1410,340,1969,0,98058,47.4579,-122.164,1720,7875,7548,6155,28.500752850075283,0.024918032786885248,Very Cheap
20140924T000000,212000.0,3,1.75,1100,9750,1.0,0,0,4,6,1100,0,1967,0,98023,47.2955,-122.362,1100,9900,8650,8800,21.743589743589745,0.017967213114754098,Very Cheap
20150123T000000,400000.0,4,3.0,2320,13068,2.0,0,2,3,8,2320,0,1998,0,98198,47.3497,-122.317,2220,25265,10748,23045,30.609121518212426,0.04262295081967213,Very Cheap
20150206T000000,750000.0,4,2.5,2540,6491,2.0,0,0,3,8,2540,0,1997,0,98008,47.6363,-122.117,1990,8447,3951,6457,115.54460021568326,0.08852459016393442,Very Cheap
20140505T000000,384900.0,5,2.5,3090,12750,1.0,0,0,3,8,1750,1340,1968,0,98023,47.3408,-122.335,1760,25919,9660,24159,30.188235294117646,0.04064262295081967,Very Cheap
20140806T000000,176000.0,2,1.0,770,5200,1.0,0,0,5,6,770,0,1969,0,98042,47.3627,-122.087,1150,5330,4430,4180,33.84615384615385,0.013245901639344262,Very Cheap
20140909T000000,350000.0,3,2.75,2370,4632,2.0,0,0,3,7,2370,0,2002,0,98038,47.3794,-122.022,2290,5012,2262,2722,75.56131260794473,0.036065573770491806,Very Cheap
20140729T000000,168000.0,3,1.0,1200,7210,1.0,0,0,4,6,1200,0,1977,0,98030,47.3729,-122.183,1200,7650,6010,6450,23.300970873786408,0.01219672131147541,Very Cheap
20141114T000000,358000.0,4,2.0,2200,3060,1.0,0,0,3,7,1100,1100,1908,2000,98118,47.565,-122.284,1410,5100,860,3690,116.99346405228758,0.03711475409836065,Very Cheap
20150428T000000,580000.0,3,2.75,2660,32757,1.0,0,0,4,8,2660,0,1975,0,98077,47.7649,-122.098,2720,35191,30097,32471,17.706139145831425,0.06622950819672131,Very Cheap
20140623T000000,442500.0,3,1.75,1600,10280,1.0,0,0,3,7,1050,550,1977,0,98034,47.725,-122.174,1590,8100,8680,6510,43.04474708171206,0.04819672131147541,Very Cheap
20150317T000000,515000.0,2,2.5,1330,1249,3.0,0,0,3,8,1330,0,2004,0,98105,47.6668,-122.285,1430,1328,-81,-102,412.3298638911129,0.057704918032786885,Very Cheap
20141117T000000,554000.0,5,2.5,3440,12900,1.0,0,2,4,8,1720,1720,1958,0,98166,47.4426,-122.342,2100,10751,9460,8651,42.945736434108525,0.06281967213114754,Very Cheap
20140610T000000,659000.0,3,2.5,2510,6320,2.0,0,0,3,9,2510,0,1996,0,98075,47.5868,-122.033,2518,5819,3810,3301,104.27215189873418,0.07659016393442623,Very Cheap
20150317T000000,414999.0,4,2.5,2150,10098,1.0,0,0,3,7,1090,1060,1963,0,98034,47.7166,-122.201,1880,10000,7948,8120,41.09714795008912,0.044590032786885246,Very Cheap
20140502T000000,275000.0,3,1.5,1180,10277,1.0,0,0,3,6,1180,0,1983,0,98045,47.488,-121.787,1680,11104,9097,9424,26.758781745645617,0.02622950819672131,Very Cheap
20141119T000000,193000.0,2,1.0,680,8640,1.0,0,0,4,5,680,0,1951,0,98188,47.4559,-122.289,1320,13140,7960,11820,22.337962962962962,0.015475409836065573,Very Cheap
20140820T000000,525000.0,4,2.5,2840,4750,2.0,0,0,3,9,2840,0,2002,0,98058,47.4511,-122.121,2460,4750,1910,2290,110.52631578947368,0.05901639344262295,Very Cheap
20141009T000000,424000.0,3,2.5,1820,7500,2.0,0,0,3,8,1820,0,1985,0,98052,47.7155,-122.104,2040,8304,5680,6264,56.53333333333333,0.04577049180327869,Very Cheap
20150108T000000,455000.0,2,1.0,1070,5150,1.0,0,0,4,6,870,200,1908,0,98117,47.6853,-122.366,1520,3860,4080,2340,88.3495145631068,0.049836065573770495,Very Cheap
20140822T000000,463000.0,2,1.0,1250,5650,2.0,0,1,4,7,1250,0,1943,0,98126,47.5495,-122.377,1210,5650,4400,4440,81.94690265486726,0.05088524590163934,Very Cheap
20150504T000000,1100000.0,4,2.5,2190,6300,1.0,0,3,3,7,1240,950,1960,0,98033,47.6918,-122.216,2730,14659,4110,11929,174.6031746031746,0.13442622950819672,Cheap
20141208T000000,523000.0,3,1.75,3000,5413,2.0,0,0,4,8,1900,1100,1963,0,98115,47.6962,-122.312,1550,5413,2413,3863,96.61924995381489,0.05875409836065574,Very Cheap
20140808T000000,615000.0,4,1.75,2270,9830,1.0,0,0,4,8,2270,0,1959,0,98005,47.5999,-122.176,2540,11990,7560,9450,62.56358087487284,0.07081967213114754,Very Cheap
20141103T000000,1515000.0,4,4.0,4500,11795,2.0,0,0,3,12,4500,0,1991,0,98027,47.5533,-122.098,3930,11576,7295,7646,128.44425604069522,0.18885245901639344,Cheap
20140808T000000,870000.0,5,4.0,3400,5000,2.0,0,0,3,8,2320,1080,1900,2013,98107,47.6655,-122.363,1910,5000,1600,3090,174.0,0.10426229508196722,Cheap
20140817T000000,710000.0,3,2.5,2830,9680,2.0,0,0,3,10,2830,0,1991,0,98074,47.6249,-122.024,2970,8691,6850,5721,73.34710743801652,0.08327868852459017,Very Cheap
20140707T000000,215000.0,3,1.0,960,9563,1.0,0,0,5,7,960,0,1967,0,98023,47.2864,-122.357,1280,9600,8603,8320,22.482484575969885,0.018360655737704918,Very Cheap
20140908T000000,590000.0,2,1.0,1530,6450,1.0,0,0,4,7,1530,0,1920,0,98117,47.6833,-122.398,1530,5000,4920,3470,91.47286821705427,0.06754098360655737,Very Cheap
20140814T000000,323000.0,5,2.5,2500,13034,1.0,0,0,3,7,1300,1200,1962,0,98092,47.3343,-122.194,2440,13300,10534,10860,24.78134110787172,0.03252459016393443,Very Cheap
20140722T000000,279000.0,4,2.0,1560,7569,1.5,0,0,4,7,1560,0,1966,0,98058,47.4496,-122.155,1480,8755,6009,7275,36.86087990487515,0.02675409836065574,Very Cheap
20140919T000000,535100.0,3,2.25,2070,7207,1.0,0,0,3,8,1720,350,1973,0,98177,47.7735,-122.371,2350,7980,5137,5630,74.24725960871375,0.060340983606557375,Very Cheap
20141027T000000,830000.0,5,2.25,2710,19800,1.0,0,0,5,9,1910,800,1959,0,98005,47.5958,-122.175,2120,16400,17090,14280,41.91919191919192,0.09901639344262295,Very Cheap
20140703T000000,815000.0,4,2.5,3150,4203,2.0,0,0,3,9,3150,0,2002,0,98033,47.688,-122.164,3150,5169,1053,2019,193.90911253866287,0.09704918032786886,Very Cheap
20150309T000000,535900.0,3,2.25,1880,10880,1.0,0,0,3,8,1480,400,1975,0,98008,47.5937,-122.116,2120,10240,9000,8120,49.255514705882355,0.06044590163934426,Very Cheap
20150309T000000,230000.0,3,1.0,1250,8800,1.0,0,0,3,7,1250,0,1955,0,98146,47.497,-122.357,1480,8200,7550,6720,26.136363636363637,0.020327868852459016,Very Cheap
20150217T000000,325500.0,4,1.75,2290,8142,1.0,0,0,4,7,1490,800,1969,0,98055,47.4564,-122.211,1840,8142,5852,6302,39.97789240972734,0.03285245901639344,Very Cheap
20150130T000000,359000.0,3,2.25,1990,4331,2.0,0,0,3,7,1990,0,1997,0,98056,47.4917,-122.167,1690,3688,2341,1998,82.89078734703301,0.03724590163934426,Very Cheap
20140509T000000,505000.0,3,2.5,2100,5824,2.0,0,2,3,8,2100,0,1999,0,98065,47.5334,-121.867,1890,4140,3724,2250,86.71016483516483,0.05639344262295082,Very Cheap
20140930T000000,253905.0,3,1.0,940,8400,1.0,0,0,5,7,940,0,1958,0,98056,47.5112,-122.167,950,8400,7460,7450,30.226785714285715,0.023462950819672132,Very Cheap
20140711T000000,369950.0,3,1.75,1640,4860,1.0,0,0,3,8,1200,440,1965,0,98125,47.7125,-122.32,1480,7200,3220,5720,76.12139917695474,0.03868196721311475,Very Cheap
20150121T000000,350000.0,3,2.25,1860,8378,2.0,0,0,3,7,1860,0,1995,0,98038,47.3875,-122.032,1870,8378,6518,6508,41.77608021007401,0.036065573770491806,Very Cheap
20140807T000000,650000.0,4,2.25,2100,2500,3.0,0,0,3,8,2100,0,2001,0,98115,47.6726,-122.298,1660,4000,400,2340,260.0,0.07540983606557378,Very Cheap
20140825T000000,295000.0,3,1.75,1500,15246,1.0,0,0,3,6,1500,0,1925,1998,98070,47.4367,-122.463,1500,16988,13746,15488,19.34933753115571,0.028852459016393443,Very Cheap
20150507T000000,620000.0,3,1.75,1680,28046,1.0,0,3,3,8,1180,500,1948,0,98177,47.7648,-122.37,2190,26308,26366,24118,22.106539256935037,0.07147540983606557,Very Cheap
20150320T000000,1998000.0,2,2.5,3900,920423,2.0,0,0,3,12,3900,0,2009,0,98065,47.5371,-121.756,2720,411962,916523,409242,2.1707410614467477,0.2521967213114754,Cheap
20140507T000000,246000.0,3,1.0,1400,7410,1.0,0,0,3,6,1400,0,1944,0,98166,47.4798,-122.343,1070,7410,6010,6340,33.19838056680162,0.02242622950819672,Very Cheap
20140916T000000,430000.0,3,2.75,2600,12860,1.0,0,0,3,7,1350,1250,1965,0,98014,47.695,-121.918,2260,12954,10260,10694,33.43701399688958,0.04655737704918033,Very Cheap
20150123T000000,509990.0,3,2.0,1440,4859,2.0,0,0,2,6,1440,0,1921,0,98118,47.5503,-122.285,1360,4558,3419,3198,104.95781024902243,0.057047868852459015,Very Cheap
20141209T000000,490000.0,4,1.75,1870,9500,1.0,0,0,4,7,1090,780,1962,0,98033,47.7012,-122.187,2010,10000,7630,7990,51.578947368421055,0.05442622950819672,Very Cheap
20141202T000000,385000.0,4,2.75,2960,10454,1.0,0,1,3,8,2360,600,1979,0,98198,47.4006,-122.322,1870,10500,7494,8630,36.828008417830496,0.04065573770491803,Very Cheap
20150429T000000,769000.0,4,2.5,2440,6733,2.0,0,0,3,9,2440,0,1999,0,98074,47.6374,-122.064,2570,6496,4293,3926,114.21357492945195,0.09101639344262295,Very Cheap
20150212T000000,185000.0,2,1.0,1122,9100,1.0,0,0,4,6,1122,0,1960,0,98023,47.328,-122.341,840,9344,7978,8504,20.32967032967033,0.014426229508196721,Very Cheap
20140509T000000,303500.0,3,1.5,1060,10464,1.0,0,0,4,7,1060,0,1973,0,98034,47.7313,-122.229,1420,10464,9404,9044,29.00420489296636,0.029967213114754098,Very Cheap
20150211T000000,468000.0,4,2.5,2150,8165,1.0,0,0,3,8,1430,720,1957,0,98177,47.773,-122.371,2360,7980,6015,5620,57.317819963257804,0.05154098360655738,Very Cheap
20140721T000000,449950.0,4,2.5,3100,10000,2.0,0,0,3,9,3100,0,1978,0,98042,47.3741,-122.15,1850,9438,6900,7588,44.995,0.04917377049180328,Very Cheap
20140616T000000,235000.0,2,1.5,880,1805,2.0,0,0,3,7,880,0,1999,0,98133,47.7064,-122.342,880,5060,925,4180,130.1939058171745,0.02098360655737705,Very Cheap
20141202T000000,520000.0,4,2.5,2490,34947,2.0,0,0,3,9,2150,340,1985,0,98027,47.4823,-122.031,2490,39639,32457,37149,14.87967493633216,0.058360655737704915,Very Cheap
20141106T000000,203000.0,2,1.0,1080,9067,1.0,0,0,3,6,1080,0,1951,0,98168,47.4815,-122.331,1080,6647,7987,5567,22.388882761663176,0.01678688524590164,Very Cheap
20140826T000000,657000.0,5,2.5,2530,10190,1.0,0,0,4,7,1290,1240,1960,0,98008,47.616,-122.115,2040,8560,7660,6520,64.47497546614328,0.07632786885245901,Very Cheap
20140709T000000,275000.0,3,1.0,1200,7800,1.0,0,0,4,7,1200,0,1954,0,98126,47.5196,-122.371,1230,7070,6600,5840,35.256410256410255,0.02622950819672131,Very Cheap
20141024T000000,540000.0,4,2.25,2850,7453,2.0,0,0,3,9,2850,0,1991,0,98072,47.7439,-122.174,2700,8468,4603,5768,72.45404535086543,0.06098360655737705,Very Cheap
20140624T000000,455000.0,4,2.5,2950,4502,2.0,0,0,3,7,2950,0,2005,0,98059,47.5002,-122.151,2360,4502,1552,2142,101.06619280319858,0.049836065573770495,Very Cheap
20141016T000000,458500.0,2,1.75,1160,6828,1.0,0,0,3,7,860,300,1941,0,98115,47.6937,-122.298,1250,6828,5668,5578,67.14997070884593,0.050295081967213114,Very Cheap
20150424T000000,549900.0,4,3.5,3420,4751,2.0,0,0,3,10,3420,0,2003,0,98055,47.4734,-122.193,3490,5700,1331,2210,115.74405388339297,0.062281967213114756,Very Cheap
20140502T000000,750000.0,3,1.75,2240,10578,2.0,0,0,5,8,1550,690,1923,0,98115,47.6954,-122.292,1570,10578,8338,9008,70.90187180941577,0.08852459016393442,Very Cheap
20140623T000000,235000.0,4,1.75,1450,8891,1.5,0,0,3,7,1180,270,1962,0,98168,47.478,-122.278,1450,9013,7441,7563,26.43122258463615,0.02098360655737705,Very Cheap
20140911T000000,286000.0,4,2.5,1820,7930,2.0,0,0,5,7,1820,0,1989,0,98038,47.359,-122.05,1490,7930,6110,6440,36.0655737704918,0.027672131147540982,Very Cheap
20150318T000000,2650000.0,4,3.5,4700,13730,2.0,0,3,3,11,3500,1200,1958,1995,98033,47.6899,-122.217,3210,15306,9030,12096,193.0080116533139,0.3377049180327869,Medium
20150210T000000,602000.0,4,1.75,2430,14000,1.0,0,0,4,7,1580,850,1963,0,98052,47.6554,-122.134,1910,8285,11570,6375,43.0,0.06911475409836065,Very Cheap
20140820T000000,640000.0,3,1.5,1960,4080,1.5,0,0,3,7,1960,0,1915,0,98115,47.6768,-122.31,1880,4080,2120,2200,156.86274509803923,0.0740983606557377,Very Cheap
20141009T000000,267000.0,3,1.75,1440,10920,1.0,0,0,4,8,1440,0,1977,0,98030,47.3812,-122.168,1720,8260,9480,6540,24.45054945054945,0.025180327868852458,Very Cheap
20150421T000000,712000.0,4,2.5,2730,4385,2.0,0,0,3,8,2730,0,2001,0,98075,47.5975,-122.038,2670,4644,1655,1974,162.37172177879134,0.08354098360655737,Very Cheap
20141010T000000,244500.0,2,1.0,910,9000,1.0,0,0,3,5,910,0,1923,0,98065,47.526,-121.81,1290,9000,8090,7710,27.166666666666668,0.02222950819672131,Very Cheap
20150512T000000,301000.0,2,1.0,910,9000,1.0,0,0,3,5,910,0,1923,0,98065,47.526,-121.81,1290,9000,8090,7710,33.44444444444444,0.029639344262295083,Very Cheap
20140818T000000,990000.0,4,2.5,2430,6325,2.0,0,0,4,8,2020,410,1919,0,98109,47.6413,-122.354,2340,4375,3895,2035,156.52173913043478,0.12,Cheap
20150422T000000,739999.0,4,2.75,3350,6500,2.0,0,0,3,10,3350,0,1999,0,98075,47.5838,-122.027,2960,6970,3150,4010,113.846,0.08721298360655738,Very Cheap
20140610T000000,480000.0,4,1.75,2320,4322,1.0,0,0,3,7,1140,1180,1910,0,98144,47.5755,-122.289,1820,4322,2002,2502,111.05969458583989,0.05311475409836065,Very Cheap
20140729T000000,305000.0,3,2.5,1260,1622,3.0,0,0,3,8,1260,0,2009,0,98133,47.7325,-122.343,1340,1188,362,-152,188.039457459926,0.03016393442622951,Very Cheap
20150115T000000,703300.0,3,2.0,1980,3525,1.5,0,0,4,8,1590,390,1932,0,98117,47.6847,-122.368,1760,3760,1545,2000,199.5177304964539,0.0824,Very Cheap
20150330T000000,265000.0,4,1.5,1580,8468,2.0,0,0,4,7,1580,0,1971,0,98001,47.3336,-122.281,1580,8260,6888,6680,31.294284364666982,0.024918032786885248,Very Cheap
20150422T000000,600000.0,4,2.5,2710,35009,2.0,0,2,3,9,2710,0,1992,0,98045,47.4815,-121.714,2330,35040,32299,32710,17.13845011282813,0.06885245901639345,Very Cheap
20140721T000000,253000.0,3,1.0,1400,9750,1.0,0,0,3,7,1400,0,1968,1998,98198,47.3862,-122.304,1640,8050,8350,6410,25.94871794871795,0.023344262295081967,Very Cheap
20150326T000000,617950.0,4,2.5,2410,7950,2.0,0,0,3,8,2410,0,1997,0,98034,47.7185,-122.226,1920,7713,5540,5793,77.72955974842768,0.07120655737704919,Very Cheap
20141212T000000,385000.0,4,3.25,1790,2460,2.0,0,0,4,7,1100,690,2000,0,98106,47.534,-122.346,1260,4040,670,2780,156.5040650406504,0.04065573770491803,Very Cheap
20141219T000000,319000.0,3,2.0,1640,9234,1.0,0,0,5,7,1060,580,1967,0,98118,47.5162,-122.274,2230,10354,7594,8124,34.54624214858133,0.032,Very Cheap
20150423T000000,696000.0,3,2.5,1670,8023,1.0,0,0,5,7,1170,500,1960,0,98008,47.615,-122.117,1960,8964,6353,7004,86.7505920478624,0.08144262295081967,Very Cheap
20140630T000000,345000.0,2,1.0,970,5750,1.0,0,0,4,6,970,0,1932,0,98126,47.5518,-122.37,1650,8625,4780,6975,60.0,0.03540983606557377,Very Cheap
20141022T000000,380000.0,3,2.5,1610,1778,3.0,0,0,3,7,1610,0,2002,0,98115,47.6902,-122.306,1120,2187,168,1067,213.72328458942633,0.04,Very Cheap
20140508T000000,647500.0,4,1.75,2060,26036,1.0,0,0,4,8,1160,900,1947,0,98166,47.4444,-122.351,2590,21891,23976,19301,24.86941158396067,0.07508196721311475,Very Cheap
20140925T000000,725000.0,3,2.5,3570,35271,2.0,0,0,3,9,3570,0,1997,0,98027,47.4782,-122.035,3510,37194,31701,33684,20.5551302769981,0.08524590163934426,Very Cheap
20141219T000000,269950.0,3,1.75,1400,7735,1.0,0,0,4,7,1400,0,1989,0,98038,47.357,-122.04,1530,7754,6335,6224,34.89980607627666,0.025567213114754097,Very Cheap
20140611T000000,875000.0,4,2.5,3470,32109,2.0,0,0,3,10,3470,0,1995,0,98077,47.7311,-122.036,3800,35181,28639,31381,27.25092653150207,0.10491803278688525,Cheap
20140530T000000,299950.0,3,1.0,1210,9525,1.0,0,0,3,7,1210,0,1955,0,98106,47.5274,-122.345,1680,7620,8315,5940,31.490813648293962,0.029501639344262295,Very Cheap
20140703T000000,1875000.0,4,3.25,3930,10929,2.0,0,0,3,10,3930,0,2006,0,98004,47.6259,-122.194,1780,9999,6999,8219,171.56189953335164,0.2360655737704918,Cheap
20140602T000000,430000.0,2,1.0,990,4802,1.0,0,0,3,7,990,0,1947,0,98117,47.6876,-122.395,1180,5000,3812,3820,89.5460224906289,0.04655737704918033,Very Cheap
20150129T000000,495000.0,5,2.5,2200,4942,2.0,0,0,3,8,2200,0,1989,0,98029,47.5772,-122.001,2200,5924,2742,3724,100.16187778227439,0.05508196721311476,Very Cheap
20141113T000000,275000.0,3,1.5,1510,16200,1.0,0,0,3,7,1510,0,1970,0,98031,47.3926,-122.167,1650,13950,14690,12300,16.97530864197531,0.02622950819672131,Very Cheap
20140916T000000,333000.0,3,1.0,1620,5040,1.0,0,0,3,7,1120,500,1964,0,98118,47.5263,-122.286,1790,6178,3420,4388,66.07142857142857,0.033836065573770495,Very Cheap
20140519T000000,247000.0,3,2.25,1580,7941,2.0,0,0,4,7,1580,0,1986,0,98023,47.2843,-122.357,1730,8051,6361,6321,31.10439491247954,0.022557377049180326,Very Cheap
20150309T000000,204555.0,3,1.75,1260,15000,1.5,0,0,4,7,1260,0,1983,0,98092,47.2737,-122.153,2400,21715,13740,19315,13.637,0.016990819672131147,Very Cheap
20140715T000000,432000.0,3,2.0,2190,13673,1.0,0,0,4,9,2190,0,1994,0,98042,47.3542,-122.098,2770,13804,11483,11034,31.595114459153077,0.046819672131147544,Very Cheap
20140521T000000,175000.0,3,1.75,1230,13056,1.0,0,0,4,7,1230,0,1962,0,98001,47.3171,-122.279,1690,15750,11826,14060,13.403799019607844,0.013114754098360656,Very Cheap
20150320T000000,556300.0,4,2.5,2030,7140,1.0,0,0,4,7,1400,630,1968,0,98008,47.6244,-122.109,1800,7565,5110,5765,77.91316526610645,0.06312131147540984,Very Cheap
20140625T000000,286000.0,2,1.0,780,3475,1.0,0,0,4,5,780,0,1930,0,98045,47.4944,-121.789,1210,6769,2695,5559,82.3021582733813,0.027672131147540982,Very Cheap
20140906T000000,320000.0,2,1.5,1110,1200,3.0,0,0,3,8,1110,0,2000,0,98103,47.6931,-122.342,1110,1363,90,253,266.6666666666667,0.032131147540983604,Very Cheap
20150420T000000,815000.0,3,2.5,2790,53143,2.0,0,0,4,9,2790,0,1991,0,98077,47.7687,-122.036,2740,47916,50353,45176,15.335980279622904,0.09704918032786886,Very Cheap
20150327T000000,385000.0,4,1.75,1660,10757,1.0,0,0,3,7,1000,660,1980,0,98056,47.5071,-122.194,1880,8319,9097,6439,35.79064795017198,0.04065573770491803,Very Cheap
20140508T000000,1039000.0,4,1.0,3410,5000,2.0,0,0,5,8,2190,1220,1910,0,98144,47.5807,-122.291,2550,5000,1590,2450,207.8,0.1264262295081967,Cheap
20141028T000000,350000.0,4,2.25,2390,13002,2.0,0,0,3,8,2390,0,1987,0,98023,47.3111,-122.35,2450,11200,10612,8750,26.918935548377174,0.036065573770491806,Very Cheap
20140729T000000,277000.0,4,2.5,1850,5880,2.0,0,0,3,8,1850,0,1998,0,98092,47.3322,-122.173,2370,6500,4030,4130,47.10884353741496,0.026491803278688525,Very Cheap
20150219T000000,415000.0,6,2.0,2500,5200,1.0,0,0,3,8,1250,1250,1966,0,98118,47.5517,-122.268,1800,5200,2700,3400,79.8076923076923,0.04459016393442623,Very Cheap
20141204T000000,295000.0,3,1.0,1000,8320,1.0,0,0,5,6,1000,0,1951,0,98155,47.7548,-122.316,1090,8450,7320,7360,35.45673076923077,0.028852459016393443,Very Cheap
20140805T000000,969000.0,4,2.0,2450,5000,2.0,0,4,5,8,2200,250,1919,0,98116,47.5619,-122.405,2360,6090,2550,3730,193.8,0.11724590163934426,Cheap
20141104T000000,339888.0,4,1.75,1440,6144,1.0,0,0,5,6,720,720,1947,0,98106,47.5257,-122.357,960,5160,4704,4200,55.3203125,0.03473940983606558,Very Cheap
20140822T000000,269950.0,3,2.25,1660,7003,2.0,0,0,3,7,1660,0,1996,0,98030,47.3599,-122.188,1840,6680,5343,4840,38.54776524346708,0.025567213114754097,Very Cheap
20141001T000000,1185000.0,3,2.5,2510,4600,2.0,0,2,3,10,2510,0,2006,0,98034,47.7051,-122.223,2560,7500,2090,4940,257.60869565217394,0.14557377049180328,Cheap
20141216T000000,780000.0,4,2.5,3090,12511,2.0,0,0,4,10,3090,0,1998,0,98075,47.5932,-121.983,3100,10882,9421,7782,62.34513628007353,0.09245901639344262,Very Cheap
20150408T000000,198000.0,3,1.0,860,5185,1.0,0,0,4,6,860,0,1968,0,98042,47.3634,-122.086,1120,5494,4325,4374,38.1870781099325,0.016131147540983607,Very Cheap
20150508T000000,350000.0,2,1.0,1220,28703,1.0,0,0,4,7,1220,0,1953,0,98056,47.4952,-122.172,2740,6720,27483,3980,12.19384733303139,0.036065573770491806,Very Cheap
20141201T000000,350000.0,3,1.0,1010,7680,1.0,0,0,4,7,1010,0,1967,0,98034,47.732,-122.231,1320,7373,6670,6053,45.572916666666664,0.036065573770491806,Very Cheap
20141206T000000,319000.0,4,2.25,2390,7350,2.0,0,0,3,8,2390,0,1990,0,98023,47.2938,-122.348,2390,7350,4960,4960,43.40136054421769,0.032,Very Cheap
20140908T000000,311000.0,4,2.25,3340,8000,2.0,0,0,4,8,3340,0,1973,0,98023,47.317,-122.385,2230,8000,4660,5770,38.875,0.030950819672131147,Very Cheap
20141018T000000,394000.0,5,3.25,3620,4650,2.0,0,0,3,8,2790,830,2004,0,98038,47.3552,-122.026,2850,4650,1030,1800,84.73118279569893,0.041836065573770495,Very Cheap
20140613T000000,1335000.0,5,2.25,4200,5800,2.5,0,0,4,9,2910,1290,1906,0,98112,47.6284,-122.312,3060,5800,1600,2740,230.17241379310346,0.16524590163934427,Cheap
20140624T000000,2700000.0,5,2.75,3831,13800,2.0,1,4,3,9,3831,0,1959,1980,98040,47.5919,-122.251,3850,36563,9969,32713,195.65217391304347,0.3442622950819672,Medium
20141125T000000,396000.0,3,1.0,1980,9540,1.0,0,0,3,7,1080,900,1949,0,98133,47.7551,-122.353,1680,9529,7560,7849,41.509433962264154,0.0420983606557377,Very Cheap
20150402T000000,809000.0,4,1.75,1790,8372,1.0,0,0,4,8,1340,450,1976,0,98033,47.6605,-122.189,2180,10500,6582,8320,96.6316292403249,0.09626229508196721,Very Cheap
20140722T000000,480000.0,3,2.0,1580,7400,1.0,0,0,3,7,1050,530,1977,0,98052,47.6715,-122.162,1560,7458,5820,5898,64.86486486486487,0.05311475409836065,Very Cheap
20140909T000000,535000.0,6,1.75,2460,6000,1.0,0,0,4,7,1230,1230,1913,0,98115,47.6721,-122.323,1560,4275,3540,2715,89.16666666666667,0.06032786885245902,Very Cheap
20150213T000000,425000.0,5,2.75,2110,5120,2.0,0,0,3,7,1870,240,1947,1983,98106,47.5294,-122.357,1580,5120,3010,3540,83.0078125,0.04590163934426229,Very Cheap
20140801T000000,408000.0,3,2.5,1470,1204,3.0,0,0,3,8,1470,0,2006,0,98117,47.6998,-122.366,1460,1245,-266,-215,338.8704318936877,0.04367213114754098,Very Cheap
20150409T000000,1255000.0,4,2.5,3510,13100,2.0,0,0,4,10,3510,0,1966,0,98040,47.5306,-122.227,3230,12745,9590,9515,95.80152671755725,0.15475409836065573,Cheap
20150420T000000,310000.0,1,0.75,520,2885,1.0,0,0,4,6,520,0,1947,0,98117,47.6886,-122.378,980,4241,2365,3261,107.45233968804159,0.03081967213114754,Very Cheap
20141103T000000,292000.0,3,2.5,1950,7421,2.0,0,0,3,8,1950,0,1996,0,98038,47.3842,-122.036,2200,4668,5471,2468,39.347796792885056,0.028459016393442622,Very Cheap
20150227T000000,217000.0,2,1.0,770,9715,1.0,0,0,4,6,770,0,1942,0,98168,47.4924,-122.312,1140,9715,8945,8575,22.33659289758106,0.01862295081967213,Very Cheap
20150127T000000,398500.0,4,2.5,2250,6064,2.0,0,0,3,8,2250,0,2005,0,98056,47.4956,-122.174,1520,7840,3814,6320,65.71569920844327,0.042426229508196724,Very Cheap
20150326T000000,2250000.0,3,3.0,4040,7200,1.5,0,2,4,9,3340,700,1930,0,98112,47.6288,-122.284,3450,10800,3160,7350,312.5,0.28524590163934427,Cheap
20150325T000000,700000.0,4,1.75,2360,6000,1.0,0,0,3,7,1280,1080,1955,0,98109,47.6465,-122.357,1700,3460,3640,1760,116.66666666666667,0.08196721311475409,Very Cheap
20140912T000000,585000.0,4,2.5,2330,45860,2.0,0,0,3,9,2330,0,1989,0,98075,47.5842,-121.992,2930,5020,43530,2090,12.75621456607065,0.06688524590163934,Very Cheap
20141008T000000,399950.0,3,1.0,1720,8910,1.0,0,0,4,7,1720,0,1954,0,98155,47.7736,-122.296,1870,8640,7190,6770,44.88776655443322,0.04261639344262295,Very Cheap
20140613T000000,235000.0,3,1.75,1900,8540,1.0,0,0,3,6,950,950,1980,0,98168,47.4868,-122.303,1370,10204,6640,8834,27.517564402810304,0.02098360655737705,Very Cheap
20140715T000000,212000.0,3,1.0,1040,6800,1.0,0,0,5,6,1040,0,1951,0,98178,47.492,-122.224,1430,6080,5760,4650,31.176470588235293,0.017967213114754098,Very Cheap
20140821T000000,310000.0,3,2.0,2070,9195,1.0,0,0,3,8,1220,850,1982,0,98074,47.6491,-122.061,2080,9551,7125,7471,33.71397498640565,0.03081967213114754,Very Cheap
20141216T000000,539000.0,3,2.0,2070,9195,1.0,0,0,3,8,1220,850,1982,0,98074,47.6491,-122.061,2080,9551,7125,7471,58.61881457313758,0.06085245901639344,Very Cheap
20141205T000000,390000.0,3,3.0,1550,1608,2.0,0,0,3,8,1280,270,2001,0,98122,47.6042,-122.303,1940,1883,58,-57,242.53731343283582,0.04131147540983607,Very Cheap
20141201T000000,560000.0,3,2.5,2020,11935,1.0,0,0,4,9,2020,0,1976,0,98052,47.632,-122.092,2410,12350,9915,9940,46.9208211143695,0.06360655737704918,Very Cheap
20140916T000000,800000.0,5,2.5,3320,9024,2.0,0,0,3,9,3320,0,1999,0,98075,47.5865,-122.056,3320,7665,5704,4345,88.65248226950355,0.09508196721311475,Very Cheap
20140609T000000,1900000.0,4,3.25,4130,112521,2.0,0,0,3,11,4130,0,1978,0,98005,47.6392,-122.165,3140,26147,108391,23007,16.88573688467042,0.23934426229508196,Cheap
20141027T000000,472000.0,5,2.0,2030,9804,1.0,0,0,3,7,1110,920,1963,0,98008,47.6297,-122.114,1930,7990,7774,6060,48.14361485108119,0.052065573770491806,Very Cheap
20140923T000000,502550.0,3,1.75,1770,7875,1.0,0,0,4,7,1170,600,1958,0,98008,47.606,-122.125,1670,8000,6105,6330,63.81587301587302,0.056072131147540984,Very Cheap
20150327T000000,830000.0,4,3.25,3330,7809,2.0,0,0,3,9,3330,0,2004,0,98075,47.5977,-121.976,3100,6465,4479,3365,106.28761685234986,0.09901639344262295,Very Cheap
20140723T000000,224950.0,4,2.5,2260,9686,1.0,0,0,4,7,1520,740,1965,0,98002,47.286,-122.218,1750,9916,7426,8166,23.224241172826762,0.019665573770491804,Very Cheap
20140618T000000,375000.0,3,2.5,1950,6871,2.0,0,0,3,8,1950,0,1997,0,98155,47.7603,-122.307,1950,7663,4921,5713,54.5772085577063,0.03934426229508197,Very Cheap
20141208T000000,645000.0,3,2.5,2930,19900,1.5,0,0,3,9,2930,0,1983,0,98077,47.7234,-122.066,3160,20492,16970,17332,32.41206030150754,0.07475409836065573,Very Cheap
20140523T000000,599000.0,3,2.75,1960,2500,1.5,0,0,5,7,1410,550,1926,0,98103,47.6744,-122.353,2040,5000,540,2960,239.6,0.06872131147540983,Very Cheap
20150509T000000,515000.0,4,2.5,2980,12534,2.0,0,0,3,9,2980,0,1996,0,98031,47.3999,-122.211,2630,12534,9554,9904,41.08823998723472,0.057704918032786885,Very Cheap
20140528T000000,135000.0,2,1.0,780,6685,1.0,0,0,4,5,780,0,1948,0,98002,47.305,-122.215,880,6695,5905,5815,20.19446522064323,0.007868852459016393,Very Cheap
20141023T000000,485000.0,3,2.5,1650,4218,2.0,0,0,3,8,1650,0,2000,0,98075,47.5998,-122.016,1650,4559,2568,2909,114.98340445708867,0.05377049180327869,Very Cheap
20140714T000000,890000.0,3,3.25,4030,12765,2.0,0,0,4,9,2800,1230,1975,0,98005,47.6331,-122.166,2670,13447,8735,10777,69.72189580885232,0.10688524590163935,Cheap
20150408T000000,215000.0,3,1.0,1010,10125,1.0,0,0,4,7,1010,0,1972,0,98042,47.3423,-122.088,1230,10125,9115,8895,21.234567901234566,0.018360655737704918,Very Cheap
20141217T000000,299500.0,3,1.0,1190,9600,1.0,0,0,3,7,1190,0,1981,0,98045,47.4805,-121.762,1360,10140,8410,8780,31.197916666666668,0.02944262295081967,Very Cheap
20140813T000000,800000.0,2,1.0,1050,8750,1.0,0,0,4,7,1050,0,1951,0,98004,47.6294,-122.215,3360,20115,7700,16755,91.42857142857143,0.09508196721311475,Very Cheap
20150209T000000,275000.0,3,2.5,1560,4244,2.0,0,0,3,7,1560,0,2002,0,98038,47.3834,-122.027,1670,4251,2684,2581,64.79736098020736,0.02622950819672131,Very Cheap
20150219T000000,256400.0,3,1.5,1490,7800,1.0,0,0,3,7,1010,480,1963,0,98003,47.3431,-122.304,1570,7800,6310,6230,32.87179487179487,0.02379016393442623,Very Cheap
20150224T000000,310000.0,2,1.0,770,8149,1.0,0,0,4,6,770,0,1948,0,98155,47.7439,-122.301,820,8149,7379,7329,38.04147748189962,0.03081967213114754,Very Cheap
20150304T000000,385000.0,1,1.0,620,5100,1.0,0,0,3,6,620,0,1954,0,98144,47.5699,-122.287,1540,2676,4480,1136,75.49019607843137,0.04065573770491803,Very Cheap
20150310T000000,203000.0,3,1.5,1200,9120,1.0,0,0,3,7,1000,200,1963,0,98055,47.4545,-122.187,1640,9200,7920,7560,22.25877192982456,0.01678688524590164,Very Cheap
20150310T000000,285000.0,4,2.0,2120,6865,1.0,0,0,3,7,1060,1060,1954,0,98133,47.7775,-122.337,1460,7780,4745,6320,41.51493080844865,0.02754098360655738,Very Cheap
20150127T000000,473975.0,3,2.5,2330,3610,2.0,0,0,3,8,2330,0,1999,0,98074,47.6022,-122.021,1830,2948,1280,1118,131.2950138504155,0.052324590163934426,Very Cheap
20140714T000000,320000.0,3,1.75,2000,9760,1.0,0,0,4,8,1400,600,1978,0,98058,47.4417,-122.134,1890,8089,7760,6199,32.78688524590164,0.032131147540983604,Very Cheap
20140612T000000,599000.0,5,2.75,2820,4608,1.0,0,0,3,7,1450,1370,1967,0,98117,47.6886,-122.361,1620,3840,1788,2220,129.99131944444446,0.06872131147540983,Very Cheap
20140714T000000,580000.0,3,2.0,2040,4800,1.0,0,0,4,7,1020,1020,1925,0,98126,47.5561,-122.377,1640,4800,2760,3160,120.83333333333333,0.06622950819672131,Very Cheap
20141209T000000,269500.0,4,2.25,1700,7056,2.0,0,0,3,7,1700,0,1999,0,98001,47.3385,-122.262,1650,6025,5356,4375,38.19444444444444,0.025508196721311476,Very Cheap
20141117T000000,274000.0,2,1.0,820,6200,1.0,0,0,4,6,820,0,1954,0,98166,47.4163,-122.34,1410,14000,5380,12590,44.193548387096776,0.026098360655737705,Very Cheap
20150326T000000,347000.0,2,1.75,1315,2162,2.0,0,0,4,8,1315,0,1974,0,98028,47.752,-122.253,1640,2128,847,488,160.49953746530988,0.03567213114754098,Very Cheap
20140521T000000,270000.0,3,1.75,1390,10905,1.0,0,0,3,6,860,530,1957,0,98106,47.5517,-122.36,1390,10839,9515,9449,24.759284731774414,0.025573770491803278,Very Cheap
20150303T000000,1430000.0,3,2.0,1890,12017,1.0,0,2,3,8,1890,0,1949,0,98004,47.6203,-122.21,2000,12210,10127,10210,118.9980860447699,0.17770491803278687,Cheap
20150220T000000,220000.0,3,1.75,1460,7226,1.0,0,0,3,7,1460,0,1993,0,98198,47.3839,-122.321,1760,7226,5766,5466,30.445613063935788,0.01901639344262295,Very Cheap
20150304T000000,243000.0,3,1.0,1480,15416,1.0,0,2,4,8,1480,0,1955,0,98022,47.2142,-121.987,1190,10758,13936,9568,15.762843798650753,0.022032786885245903,Very Cheap
20140527T000000,457500.0,3,1.75,1840,4030,1.0,0,0,5,7,1050,790,1925,0,98108,47.5549,-122.311,1840,5040,2190,3200,113.52357320099256,0.05016393442622951,Very Cheap
20141219T000000,340000.0,2,1.75,1880,7208,1.0,0,0,3,7,940,940,1951,0,98115,47.6946,-122.328,1880,8051,5328,6171,47.16981132075472,0.03475409836065574,Very Cheap
20140918T000000,657500.0,4,1.5,1910,5000,1.5,0,0,3,7,1610,300,1912,0,98105,47.6597,-122.29,2170,5000,3090,2830,131.5,0.07639344262295082,Very Cheap
20150112T000000,332500.0,4,2.5,2220,4720,2.0,0,0,3,7,2220,0,1998,0,98038,47.3541,-122.024,2090,4717,2500,2627,70.44491525423729,0.033770491803278686,Very Cheap
20140717T000000,340000.0,3,2.0,1410,10015,1.0,0,3,3,6,1410,0,1993,0,98045,47.4948,-121.776,1570,10485,8605,8915,33.94907638542187,0.03475409836065574,Very Cheap
20140902T000000,350000.0,4,3.0,3380,16133,1.0,0,1,3,8,2330,1050,1959,0,98118,47.5501,-122.261,2500,11100,12753,8600,21.694663112874235,0.036065573770491806,Very Cheap
20150213T000000,428000.0,4,2.5,1950,5602,1.0,0,0,5,7,1120,830,1966,0,98118,47.5437,-122.291,2000,6050,3652,4050,76.40128525526598,0.04629508196721312,Very Cheap
20150504T000000,515055.0,4,2.5,2400,8320,2.0,0,0,3,8,2400,0,1999,0,98045,47.4808,-121.781,2430,9258,5920,6828,61.90564903846154,0.057712131147540986,Very Cheap
20150204T000000,450000.0,3,1.75,1560,8968,1.0,0,0,4,8,1560,0,1972,0,98008,47.6243,-122.1,1990,8034,7408,6044,50.17841213202498,0.04918032786885246,Very Cheap
20150226T000000,190000.0,3,1.0,1040,8910,1.0,0,0,3,6,1040,0,1943,0,98168,47.5024,-122.32,1330,9720,7870,8390,21.32435465768799,0.015081967213114755,Very Cheap
20140717T000000,1000000.0,4,2.75,3090,16538,3.0,0,0,4,8,2590,500,1919,1987,98116,47.5803,-122.403,1500,5130,13448,3630,60.46680372475511,0.12131147540983607,Cheap
20141119T000000,299000.0,3,2.5,1850,4600,2.0,0,0,3,7,1850,0,2005,0,98058,47.4661,-122.145,2160,4751,2750,2591,65.0,0.02937704918032787,Very Cheap
20141103T000000,508000.0,2,1.0,1200,2500,2.0,0,2,3,7,1090,110,1927,0,98112,47.6304,-122.301,2690,4800,1300,2110,203.2,0.05678688524590164,Very Cheap
20141001T000000,294000.0,4,2.25,2190,3746,2.0,0,0,3,8,2190,0,2005,0,98038,47.3896,-122.034,2200,3591,1556,1391,78.4837159636946,0.028721311475409836,Very Cheap
20141024T000000,320000.0,2,1.0,1380,5820,1.0,0,0,3,7,1380,0,1918,1976,98117,47.6875,-122.392,1540,4076,4440,2536,54.982817869415804,0.032131147540983604,Very Cheap
20150406T000000,641000.0,5,2.75,3710,8674,2.0,0,0,3,9,3710,0,1996,0,98056,47.514,-122.176,3250,8678,4964,5428,73.8990085312428,0.0742295081967213,Very Cheap
20141021T000000,675000.0,3,2.5,2320,98445,1.0,0,0,4,8,1380,940,1978,0,98072,47.7323,-122.116,2830,54014,96125,51184,6.856620447965869,0.07868852459016394,Very Cheap
20141224T000000,255000.0,3,1.5,1110,10296,1.0,0,0,5,7,1110,0,1964,0,98042,47.422,-122.153,1330,10296,9186,8966,24.766899766899765,0.02360655737704918,Very Cheap
20150430T000000,286651.0,3,2.5,1830,4997,2.0,0,0,3,7,1830,0,2004,0,98001,47.3035,-122.283,2488,4998,3167,2510,57.364618771262755,0.027757508196721313,Very Cheap
20150213T000000,607500.0,4,2.5,2460,45738,1.0,0,0,4,8,1650,810,1969,0,98075,47.5952,-122.056,2550,32040,43278,29490,13.282172373081464,0.06983606557377049,Very Cheap
20150203T000000,765000.0,3,1.0,1270,6500,1.0,0,0,4,7,1270,0,1956,0,98033,47.6874,-122.214,2260,7200,5230,4940,117.6923076923077,0.09049180327868853,Very Cheap
20141020T000000,334950.0,4,1.75,1700,40973,1.0,0,0,3,8,1700,0,1961,0,98031,47.3439,-122.198,2760,40973,39273,38213,8.174895662997583,0.03409180327868853,Very Cheap
20140819T000000,426000.0,3,1.0,1130,9147,1.0,0,0,5,7,1130,0,1952,0,98033,47.7006,-122.197,1930,9906,8017,7976,46.5726467694326,0.046032786885245904,Very Cheap
20140825T000000,775000.0,3,1.75,1640,18730,1.5,0,0,4,7,1640,0,1946,0,98004,47.5975,-122.196,1670,12154,17090,10484,41.37746930058729,0.09180327868852459,Very Cheap
20141204T000000,343000.0,2,1.5,1040,8526,1.0,0,0,5,6,1040,0,1953,0,98155,47.7349,-122.295,1310,8504,7486,7194,40.229885057471265,0.035147540983606555,Very Cheap
20140908T000000,470101.0,4,2.5,2320,7800,2.0,0,0,3,8,2320,0,1986,0,98028,47.7738,-122.266,2090,5721,5480,3631,60.26935897435897,0.051816524590163934,Very Cheap
20150505T000000,195000.0,3,1.5,1200,7800,1.0,0,0,4,7,1200,0,1958,0,98002,47.3137,-122.212,1390,8415,6600,7025,25.0,0.015737704918032787,Very Cheap
20150303T000000,772500.0,4,1.0,1720,4410,1.5,0,2,3,7,1720,0,1928,0,98117,47.6791,-122.402,2140,4500,2690,2360,175.17006802721087,0.09147540983606557,Very Cheap
20140625T000000,450000.0,3,1.5,2330,11740,1.0,0,0,3,8,1330,1000,1954,0,98155,47.7481,-122.292,2630,11740,9410,9110,38.33049403747871,0.04918032786885246,Very Cheap
20140902T000000,1437500.0,4,3.75,4410,9231,3.0,0,3,3,11,4410,0,2001,0,98118,47.5427,-122.265,2160,6600,4821,4440,155.7252735348283,0.17868852459016393,Cheap
20140918T000000,525000.0,4,1.75,1650,8560,1.0,0,0,3,8,1650,0,1970,0,98052,47.6652,-122.146,1700,8560,6910,6860,61.33177570093458,0.05901639344262295,Very Cheap
20141008T000000,280000.0,3,1.5,1370,11400,2.0,0,0,3,7,1370,0,1980,0,98045,47.4477,-121.77,1390,9600,10030,8210,24.56140350877193,0.026885245901639345,Very Cheap
20140718T000000,270000.0,3,2.5,1770,8640,1.0,0,0,3,7,1420,350,1986,0,98001,47.326,-122.273,1894,7974,6870,6080,31.25,0.025573770491803278,Very Cheap
20140505T000000,406100.0,3,2.25,1410,1332,3.0,0,0,3,8,1410,0,2005,0,98103,47.6916,-122.34,1430,1448,-78,18,304.87987987987987,0.04342295081967213,Very Cheap
20141020T000000,332544.0,2,1.75,1710,4187,1.0,0,0,3,7,1710,0,1987,0,98055,47.4732,-122.188,1760,4084,2477,2324,79.42297587771674,0.03377626229508197,Very Cheap
20150427T000000,110000.0,2,1.0,790,8250,1.0,0,0,3,6,790,0,1947,0,98188,47.4523,-122.286,900,8250,7460,7350,13.333333333333334,0.0045901639344262295,Very Cheap
20141209T000000,685000.0,6,2.25,2770,5854,1.5,0,0,3,8,2120,650,1921,0,98112,47.6466,-122.304,2300,5450,3084,3150,117.01400751622822,0.08,Very Cheap
20140729T000000,461000.0,4,1.0,1260,8505,1.5,0,0,5,7,1260,0,1951,0,98177,47.7181,-122.371,1480,8100,7245,6620,54.203409758965314,0.05062295081967213,Very Cheap
20150414T000000,615000.0,3,2.25,2300,8067,1.0,0,0,4,8,1300,1000,1979,0,98034,47.7091,-122.198,2120,9524,5767,7404,76.23651915210115,0.07081967213114754,Very Cheap
20150503T000000,550000.0,2,1.0,1070,3000,1.0,0,0,4,7,870,200,1926,0,98103,47.6828,-122.353,1890,3300,1930,1410,183.33333333333334,0.06229508196721312,Very Cheap
20141022T000000,1060000.0,4,3.5,3850,8100,2.0,0,1,3,11,2430,1420,1995,0,98033,47.6855,-122.19,2620,9346,4250,6726,130.8641975308642,0.12918032786885245,Cheap
20141022T000000,685000.0,3,2.5,2320,219978,2.0,0,0,4,8,2320,0,1993,0,98053,47.6847,-122.064,2340,88862,217658,86522,3.113947758412205,0.08,Very Cheap
20141126T000000,1555000.0,5,2.5,2870,16238,2.0,0,0,4,8,2870,0,1962,0,98039,47.6308,-122.238,2870,16238,13368,13368,95.76302500307919,0.1940983606557377,Cheap
20140603T000000,312000.0,4,2.5,1830,5175,2.0,0,0,3,7,1830,0,2003,0,98038,47.3565,-122.016,1830,5175,3345,3345,60.289855072463766,0.031081967213114754,Very Cheap
20140701T000000,507500.0,3,1.75,1990,9594,1.0,0,0,3,8,1190,800,1977,0,98052,47.6617,-122.137,1930,9765,7604,7835,52.897644361058994,0.05672131147540983,Very Cheap
20140918T000000,217000.0,3,1.0,1110,9827,1.0,0,0,3,7,1110,0,1966,0,98198,47.369,-122.311,1540,10187,8717,8647,22.082018927444796,0.01862295081967213,Very Cheap
20141212T000000,439000.0,3,2.25,1830,13477,1.0,0,3,4,7,1170,660,1981,0,98034,47.7243,-122.21,1960,11344,11647,9384,32.574014988498924,0.04773770491803279,Very Cheap
20140626T000000,620000.0,6,3.5,3600,6875,2.0,0,0,3,8,2740,860,2004,0,98065,47.5401,-121.879,3150,6663,3275,3513,90.18181818181819,0.07147540983606557,Very Cheap
20140812T000000,915000.0,4,2.5,3210,8532,2.0,0,0,3,10,3210,0,1998,0,98007,47.625,-122.144,2950,6753,5322,3803,107.24331926863573,0.11016393442622952,Cheap
20141204T000000,425000.0,4,2.0,1490,5300,1.0,0,0,3,7,1110,380,1977,0,98144,47.5949,-122.296,1330,1499,3810,169,80.18867924528301,0.04590163934426229,Very Cheap
20150227T000000,435000.0,2,1.0,990,5643,1.0,0,0,3,7,870,120,1947,0,98115,47.6802,-122.298,1280,5700,4653,4420,77.08665603402446,0.04721311475409836,Very Cheap
20141229T000000,305000.0,3,2.25,1646,12414,2.0,0,0,3,7,1646,0,1996,0,98038,47.363,-122.035,1654,8734,10768,7080,24.569034960528434,0.03016393442622951,Very Cheap
20150326T000000,276000.0,2,1.0,720,4000,1.0,0,0,3,6,720,0,1918,0,98106,47.5346,-122.353,1630,4000,3280,2370,69.0,0.026360655737704918,Very Cheap
20140630T000000,327500.0,3,2.25,2310,7200,2.0,0,0,3,8,2310,0,1990,0,98031,47.4051,-122.193,1960,7201,4890,5241,45.486111111111114,0.033114754098360656,Very Cheap
20140617T000000,810000.0,3,2.5,2670,10481,2.0,0,0,3,9,2670,0,2003,0,98033,47.6673,-122.176,2620,8895,7811,6275,77.28270203224884,0.09639344262295083,Very Cheap
20141121T000000,715000.0,3,3.25,3060,9055,2.0,0,0,3,10,2460,600,1994,0,98052,47.6971,-122.101,2990,9598,5995,6608,78.961899503037,0.0839344262295082,Very Cheap
20140805T000000,272000.0,3,1.5,1380,11760,1.0,0,0,4,7,1380,0,1963,0,98055,47.4243,-122.202,1650,9855,10380,8205,23.12925170068027,0.02583606557377049,Very Cheap
20150421T000000,266000.0,2,1.0,700,5559,1.0,0,0,5,6,700,0,1949,0,98155,47.7492,-122.311,1230,8100,4859,6870,47.850332793667924,0.02504918032786885,Very Cheap
20150427T000000,543000.0,3,1.5,1710,8364,2.0,0,2,3,7,1710,0,1944,0,98136,47.5175,-122.393,2430,9040,6654,6610,64.92109038737446,0.06137704918032787,Very Cheap
20141007T000000,400000.0,3,2.5,1450,8064,1.0,0,0,3,8,1450,0,1984,0,98074,47.6256,-122.037,1710,9554,6614,7844,49.6031746031746,0.04262295081967213,Very Cheap
20140806T000000,509500.0,5,2.25,2060,9000,1.0,0,0,4,7,1320,740,1961,0,98007,47.6122,-122.137,2050,8800,6940,6750,56.611111111111114,0.056983606557377046,Very Cheap
20140521T000000,495000.0,3,3.5,2380,6250,2.0,0,3,3,8,1670,710,1997,0,98118,47.5137,-122.252,2540,4010,3870,1470,79.2,0.05508196721311476,Very Cheap
20150313T000000,424950.0,4,2.5,2760,5564,2.0,0,0,3,7,2760,0,2001,0,98056,47.4814,-122.189,2670,5626,2804,2956,76.37491013659238,0.04589508196721311,Very Cheap
20140926T000000,230000.0,3,1.0,940,10875,1.0,0,0,3,7,940,0,1957,0,98056,47.5121,-122.168,1250,11200,9935,9950,21.149425287356323,0.020327868852459016,Very Cheap
20140806T000000,235000.0,4,1.5,1760,6150,1.5,0,0,3,7,1760,0,1951,0,98031,47.3871,-122.224,1760,8276,4390,6516,38.21138211382114,0.02098360655737705,Very Cheap
20150309T000000,763000.0,3,2.0,1360,8752,1.0,0,2,4,6,1360,0,1942,0,98033,47.6879,-122.208,2530,7680,7392,5150,87.1800731261426,0.0902295081967213,Very Cheap
20140919T000000,350000.0,3,1.75,2010,6150,2.0,0,0,5,7,2010,0,1939,0,98178,47.4975,-122.231,1770,7380,4140,5610,56.91056910569106,0.036065573770491806,Very Cheap
20141126T000000,900000.0,3,1.5,2160,2260,2.0,0,2,5,8,1620,540,1917,0,98119,47.6321,-122.371,2570,2400,100,-170,398.2300884955752,0.10819672131147541,Cheap
20141007T000000,250000.0,3,1.0,930,6060,1.0,0,0,4,6,930,0,1973,0,98118,47.5289,-122.28,1640,6364,5130,4724,41.254125412541256,0.022950819672131147,Very Cheap
20150126T000000,225000.0,3,2.5,1020,2040,2.0,0,0,3,7,720,300,2004,0,98106,47.5294,-122.361,1060,1478,1020,418,110.29411764705883,0.019672131147540985,Very Cheap
20141226T000000,255000.0,2,2.0,1360,5433,1.0,0,0,3,8,1360,0,1974,2003,98198,47.3804,-122.32,1160,5264,4073,4104,46.93539480949752,0.02360655737704918,Very Cheap
20140604T000000,161700.0,4,1.75,1720,7200,1.0,0,0,3,7,1220,500,1974,0,98023,47.306,-122.375,1790,7200,5480,5410,22.458333333333332,0.011370491803278688,Very Cheap
20150202T000000,336000.0,3,3.0,1790,13350,1.0,0,0,3,7,1190,600,1988,0,98178,47.4958,-122.262,1740,10624,11560,8884,25.168539325842698,0.03422950819672131,Very Cheap
20141023T000000,410500.0,3,1.0,1150,6800,1.0,0,0,3,7,1150,0,1954,0,98133,47.727,-122.339,1210,6800,5650,5590,60.36764705882353,0.044,Very Cheap
20141111T000000,502700.0,4,3.5,2710,14016,2.0,0,0,4,8,2710,0,1968,0,98155,47.7601,-122.286,1590,27903,11306,26313,35.86615296803653,0.056091803278688526,Very Cheap
20140923T000000,505000.0,3,2.5,2400,9601,1.0,0,0,5,7,1390,1010,1977,0,98034,47.7256,-122.211,2010,9943,7201,7933,52.59868763670451,0.05639344262295082,Very Cheap
20141216T000000,250000.0,3,1.0,1660,7650,1.5,0,0,3,7,1350,310,1910,0,98118,47.5576,-122.277,1750,5760,5990,4010,32.6797385620915,0.022950819672131147,Very Cheap
20150422T000000,570000.0,3,1.0,1660,7650,1.5,0,0,3,7,1350,310,1910,0,98118,47.5576,-122.277,1750,5760,5990,4010,74.50980392156863,0.06491803278688525,Very Cheap
20150318T000000,349900.0,4,2.5,2290,8796,2.0,0,0,3,8,2290,0,1994,0,98198,47.3762,-122.318,2130,8796,6506,6666,39.77944520236471,0.036052459016393444,Very Cheap
20141209T000000,465000.0,3,2.5,2870,25663,2.0,0,0,3,10,2870,0,1988,0,98003,47.2769,-122.333,2950,24347,22793,21397,18.119471612827805,0.051147540983606556,Very Cheap
20140530T000000,625000.0,4,3.25,4240,25639,2.0,0,3,3,10,3550,690,1989,0,98023,47.3241,-122.378,3590,24967,21399,21377,24.376925777136393,0.07213114754098361,Very Cheap
20150219T000000,655000.0,3,1.75,1800,5102,1.0,0,0,3,7,1170,630,1952,0,98199,47.6514,-122.407,1720,5102,3302,3382,128.3810270482164,0.0760655737704918,Very Cheap
20150327T000000,469000.0,4,1.75,2960,11347,1.0,0,0,4,8,1570,1390,1946,0,98166,47.4738,-122.353,1660,8911,8387,7251,41.33251079580506,0.05167213114754098,Very Cheap
20141009T000000,355000.0,3,2.25,1980,7200,1.0,0,0,3,8,1300,680,1964,0,98177,47.7625,-122.36,1820,8250,5220,6430,49.30555555555556,0.036721311475409836,Very Cheap
20150224T000000,596000.0,3,2.5,1730,2631,2.0,0,0,3,8,1730,0,2001,0,98005,47.5878,-122.165,1730,2751,901,1021,226.5298365640441,0.06832786885245902,Very Cheap
20150402T000000,790000.0,4,2.5,3020,36893,2.0,0,0,3,9,3020,0,1986,2007,98077,47.768,-122.092,3020,36444,33873,33424,21.41327623126338,0.09377049180327869,Very Cheap
20141008T000000,885000.0,4,2.25,4470,86225,2.0,0,0,3,10,4470,0,1991,0,98053,47.6377,-121.985,3850,97049,81755,93199,10.263844592635547,0.1062295081967213,Cheap
20140912T000000,1030000.0,4,3.25,2830,4000,2.0,0,0,3,9,1910,920,1912,2012,98144,47.5845,-122.291,2740,4000,1170,1260,257.5,0.12524590163934426,Cheap
20150403T000000,710000.0,4,1.75,2120,5400,1.0,0,0,4,8,1060,1060,1941,0,98199,47.6501,-122.395,2052,6000,3280,3948,131.4814814814815,0.08327868852459017,Very Cheap
20140814T000000,428040.0,3,2.5,2150,9266,2.0,0,0,3,8,2150,0,1988,0,98028,47.7445,-122.248,2150,12550,7116,10400,46.19469026548673,0.04630032786885246,Very Cheap
20150414T000000,1370000.0,5,2.25,3510,13843,1.0,0,2,3,8,1850,1660,1959,0,98040,47.5817,-122.246,2680,8750,10333,6070,98.96698692479954,0.16983606557377048,Cheap
20140605T000000,546000.0,2,1.0,970,3400,1.0,0,0,3,7,970,0,1924,0,98109,47.6444,-122.357,1180,3600,2430,2420,160.58823529411765,0.06177049180327869,Very Cheap
20140803T000000,540000.0,4,1.0,1360,5766,1.5,0,0,5,7,1360,0,1951,0,98115,47.6827,-122.289,1500,5704,4406,4204,93.65244536940686,0.06098360655737705,Very Cheap
20140908T000000,435000.0,3,2.5,1470,3000,1.0,0,0,3,7,930,540,1985,0,98115,47.6832,-122.286,1470,5588,1530,4118,145.0,0.04721311475409836,Very Cheap
20150406T000000,540000.0,4,2.25,3040,10283,1.0,0,0,4,8,1430,1610,1984,0,98074,47.6268,-122.038,1870,11074,7243,9204,52.51385782359234,0.06098360655737705,Very Cheap
20141113T000000,284000.0,2,1.0,860,7204,1.0,0,0,3,7,860,0,1918,0,98106,47.5361,-122.351,1200,7500,6344,6300,39.422543031649084,0.027409836065573772,Very Cheap
20140714T000000,208000.0,2,1.0,820,5700,1.0,0,0,5,5,820,0,1942,0,98056,47.4915,-122.184,1000,5700,4880,4700,36.49122807017544,0.01744262295081967,Very Cheap
20141203T000000,315000.0,3,1.75,1900,7076,1.0,0,0,3,7,1130,770,1977,0,98155,47.7569,-122.326,1540,10113,5176,8573,44.51667608818541,0.031475409836065574,Very Cheap
20140731T000000,417500.0,2,1.0,1330,5510,1.0,0,0,3,6,850,480,1910,0,98117,47.6901,-122.362,1200,4150,4180,2950,75.77132486388385,0.04491803278688525,Very Cheap
20140917T000000,345000.0,3,1.75,1240,38095,1.0,0,0,3,7,1240,0,1978,0,98053,47.6522,-121.97,2060,38552,36855,36492,9.056306601916262,0.03540983606557377,Very Cheap
20140902T000000,375000.0,3,2.5,1330,1064,3.0,0,0,3,8,1330,0,2004,0,98117,47.6835,-122.387,1330,1113,-266,-217,352.4436090225564,0.03934426229508197,Very Cheap
20140623T000000,389800.0,3,1.75,1880,12821,1.0,0,0,3,7,1880,0,1959,0,98155,47.7681,-122.305,1540,12868,10941,11328,30.403244676702286,0.041285245901639345,Very Cheap
20150408T000000,475000.0,3,1.75,1890,7560,1.0,0,0,3,8,1430,460,1973,0,98034,47.7322,-122.185,1890,9095,5670,7205,62.83068783068783,0.05245901639344262,Very Cheap
20140508T000000,569000.0,4,2.25,2250,41688,2.0,0,0,3,8,2250,0,1980,0,98053,47.6695,-122.05,2350,37920,39438,35570,13.649011706006524,0.06478688524590163,Very Cheap
20150331T000000,985000.0,5,4.25,4650,108464,2.0,0,0,3,10,3260,1390,1999,0,98024,47.5669,-121.956,2810,155509,103814,152699,9.081354182032749,0.11934426229508197,Cheap
20150129T000000,532000.0,3,2.5,1830,8022,2.0,0,0,3,8,1830,0,1987,0,98074,47.6198,-122.044,2030,7736,6192,5706,66.3176265270506,0.059934426229508196,Very Cheap
20140811T000000,280000.0,2,1.0,720,5000,1.0,0,0,5,6,720,0,1951,0,98126,47.5195,-122.374,810,5000,4280,4190,56.0,0.026885245901639345,Very Cheap
20150217T000000,435000.0,4,2.0,1960,50112,1.0,0,0,4,7,1050,910,1963,0,98058,47.4353,-122.084,2340,44967,48152,42627,8.680555555555555,0.04721311475409836,Very Cheap
20150316T000000,223000.0,3,1.0,1220,71191,1.0,0,0,3,6,1220,0,1952,0,98023,47.3261,-122.353,1960,15378,69971,13418,3.13241842367715,0.019409836065573772,Very Cheap
20150115T000000,390000.0,2,1.0,1800,119790,1.0,0,0,4,7,1200,600,1947,1977,98027,47.4617,-122.012,2320,79208,117990,76888,3.255697470573504,0.04131147540983607,Very Cheap
20141027T000000,315000.0,3,1.75,1340,12800,1.0,0,0,3,7,880,460,1981,0,98058,47.4437,-122.137,1500,7875,11460,6375,24.609375,0.031475409836065574,Very Cheap
20141014T000000,612000.0,3,3.0,1740,3700,1.0,0,0,3,7,1740,0,1982,0,98122,47.6102,-122.309,1830,2480,1960,650,165.40540540540542,0.07042622950819673,Very Cheap
20140513T000000,591000.0,3,1.75,1680,2400,1.0,0,0,5,7,870,810,1922,0,98122,47.6155,-122.3,1440,3600,720,2160,246.25,0.06767213114754099,Very Cheap
20140711T000000,800000.0,4,2.25,3220,8436,2.0,0,0,3,8,3220,0,1968,0,98008,47.6381,-122.116,2500,7632,5216,5132,94.8316737790422,0.09508196721311475,Very Cheap
20150122T000000,225000.0,3,2.0,1610,8400,1.0,0,0,3,8,1610,0,1990,0,98022,47.1958,-122.009,1930,8459,6790,6529,26.785714285714285,0.019672131147540985,Very Cheap
20140508T000000,589900.0,2,3.0,3160,66646,2.0,0,0,3,7,3160,0,1993,0,98077,47.7479,-122.034,3140,38790,63486,35650,8.851243885604537,0.06752786885245901,Very Cheap
20141126T000000,565000.0,4,2.5,2520,13156,1.0,0,0,3,8,1520,1000,1979,0,98052,47.6558,-122.135,2050,10940,10636,8890,42.94618425053208,0.06426229508196721,Very Cheap
20150219T000000,650000.0,3,1.5,2120,8448,1.0,0,0,3,7,1060,1060,1940,0,98199,47.6438,-122.403,1620,7920,6328,6300,76.94128787878788,0.07540983606557378,Very Cheap
20140918T000000,499000.0,3,2.5,2090,8505,2.0,0,0,3,8,2090,0,1951,1977,98177,47.7195,-122.371,1640,8100,6415,6460,58.671369782480895,0.05560655737704918,Very Cheap
20140515T000000,280000.0,3,1.0,1330,20562,1.5,0,0,3,5,1330,0,1959,0,98045,47.4807,-121.775,1350,20562,19232,19212,13.61735239762669,0.026885245901639345,Very Cheap
20150128T000000,649950.0,3,2.5,2420,7500,1.0,0,2,4,8,1210,1210,1944,0,98117,47.6949,-122.389,2340,7500,5080,5160,86.66,0.07540327868852459,Very Cheap
20140709T000000,420000.0,3,1.75,1510,6360,1.0,0,0,4,7,1510,0,1954,0,98133,47.7321,-122.353,1480,7260,4850,5780,66.0377358490566,0.04524590163934426,Very Cheap
20141215T000000,319990.0,4,2.5,2120,5293,2.0,0,0,3,7,2120,0,2003,0,98031,47.4217,-122.201,1990,5313,3173,3323,60.455318344983944,0.03212983606557377,Very Cheap
20140812T000000,265000.0,3,2.0,1850,16535,1.0,0,0,3,7,1850,0,1992,0,98014,47.6565,-121.912,1528,13295,14685,11767,16.026610220743876,0.024918032786885248,Very Cheap
20150223T000000,482000.0,3,1.75,2300,16474,1.0,0,0,3,7,1220,1080,1984,0,98072,47.7609,-122.144,1940,15601,14174,13661,29.258225081947312,0.05337704918032787,Very Cheap
20140805T000000,452000.0,3,2.25,2600,14810,1.0,0,2,4,8,1490,1110,1956,0,98166,47.4326,-122.341,2450,16715,12210,14265,30.519918973666442,0.04944262295081967,Very Cheap
20140718T000000,1488000.0,4,4.25,5180,13077,2.0,0,3,3,12,4280,900,1998,0,98006,47.5513,-122.109,5030,15069,7897,10039,113.78756595549437,0.18531147540983606,Cheap
20140821T000000,375000.0,2,1.0,1810,8527,1.5,0,0,4,7,1810,0,1943,0,98133,47.7275,-122.336,1490,6800,6717,5310,43.977952386536884,0.03934426229508197,Very Cheap
20140703T000000,588000.0,5,3.0,2190,4900,2.0,0,0,5,7,1490,700,1940,0,98117,47.6892,-122.386,1370,4606,2710,3236,120.0,0.06727868852459017,Very Cheap
20150424T000000,635000.0,4,2.5,2500,10215,2.0,0,0,3,9,2500,0,1998,0,98075,47.5912,-121.986,2890,10240,7715,7350,62.163485070974055,0.07344262295081967,Very Cheap
20140703T000000,280500.0,4,2.5,1890,6962,2.0,0,0,3,8,1890,0,1997,0,98092,47.3328,-122.187,2170,6803,5072,4633,40.290146509623675,0.026950819672131147,Very Cheap
20140925T000000,210500.0,2,1.75,2040,8600,1.0,0,0,4,6,1430,610,1985,0,98003,47.2755,-122.308,1310,7859,6560,6549,24.476744186046513,0.01777049180327869,Very Cheap
20140926T000000,196500.0,3,2.0,1310,7000,1.0,0,0,4,7,1310,0,1979,0,98023,47.303,-122.383,1390,7500,5690,6110,28.071428571428573,0.015934426229508195,Very Cheap
20140505T000000,1395000.0,5,3.5,4010,8510,2.0,0,1,5,9,2850,1160,1971,0,98105,47.6578,-122.286,2610,6128,4500,3518,163.92479435957696,0.17311475409836066,Cheap
20150206T000000,475000.0,3,1.75,1780,8033,1.0,0,0,2,7,1210,570,1977,0,98034,47.7275,-122.219,1630,7508,6253,5878,59.13108427735591,0.05245901639344262,Very Cheap
20150504T000000,550000.0,3,2.5,1980,9061,2.0,0,0,4,8,1980,0,1987,0,98074,47.6366,-122.029,1930,8869,7081,6939,60.69970201964463,0.06229508196721312,Very Cheap
20140521T000000,1580000.0,3,3.25,3690,7200,2.0,0,0,3,11,3690,0,2007,0,98033,47.6815,-122.2,1880,7200,3510,5320,219.44444444444446,0.19737704918032786,Cheap
20150422T000000,240000.0,3,1.75,1540,6687,1.0,0,0,3,7,1200,340,1991,0,98022,47.1938,-121.981,1540,7242,5147,5702,35.89053387169134,0.021639344262295083,Very Cheap
20150429T000000,272000.0,3,1.0,1130,8100,1.5,0,0,3,6,1130,0,1934,0,98168,47.4935,-122.306,1080,8100,6970,7020,33.58024691358025,0.02583606557377049,Very Cheap
20150324T000000,408506.0,3,2.75,2480,209199,1.5,0,0,3,8,1870,610,2000,0,98010,47.3085,-121.888,2040,219229,206719,217189,1.9527148791342215,0.04373849180327869,Very Cheap
20140818T000000,640000.0,3,2.5,2580,7500,2.0,0,0,3,9,2580,0,1991,0,98116,47.5577,-122.396,910,6500,4920,5590,85.33333333333333,0.0740983606557377,Very Cheap
20140514T000000,316000.0,4,2.5,2010,7226,2.0,0,0,3,8,2010,0,1995,0,98092,47.2588,-122.21,2160,7696,5216,5536,43.73097149183504,0.03160655737704918,Very Cheap
20140820T000000,299000.0,4,2.0,2320,12000,1.0,0,0,3,7,1720,600,1943,2014,98108,47.5246,-122.325,1390,6000,9680,4610,24.916666666666668,0.02937704918032787,Very Cheap
20150305T000000,447500.0,2,2.25,1180,2090,2.0,0,0,3,7,1180,0,2004,0,98122,47.6032,-122.31,1550,2812,910,1262,214.11483253588517,0.04885245901639344,Very Cheap
20140505T000000,736500.0,4,2.5,3180,21904,2.0,0,3,3,9,3180,0,2000,0,98059,47.515,-122.117,3715,29170,18724,25455,33.62399561723886,0.08675409836065574,Very Cheap
20140728T000000,665000.0,4,2.0,2970,52567,2.0,0,0,3,8,2970,0,1924,1985,98072,47.7333,-122.128,3280,46676,49597,43396,12.650522190728024,0.07737704918032787,Very Cheap
20150424T000000,707000.0,5,2.5,3050,13212,1.0,0,0,4,8,1590,1460,1975,0,98006,47.5596,-122.142,2550,10826,10162,8276,53.51195882531032,0.08288524590163934,Very Cheap
20140829T000000,215000.0,4,1.75,1630,8000,1.0,0,0,3,7,1630,0,1959,0,98031,47.3948,-122.201,1630,7700,6370,6070,26.875,0.018360655737704918,Very Cheap
20141211T000000,275000.0,3,2.25,1620,6415,2.0,0,0,4,7,1620,0,1989,0,98038,47.3577,-122.038,1640,7253,4795,5613,42.868277474668744,0.02622950819672131,Very Cheap
20150325T000000,648000.0,4,2.25,2170,8240,2.0,0,1,4,8,2170,0,1983,0,98006,47.5634,-122.128,2600,9898,6070,7298,78.64077669902913,0.07514754098360656,Very Cheap
20141028T000000,415000.0,4,2.5,2150,8173,2.0,0,0,3,8,2150,0,1987,0,98059,47.511,-122.153,2080,7620,6023,5540,50.776948488926955,0.04459016393442623,Very Cheap
20141119T000000,690000.0,3,2.0,1770,1800,3.0,0,0,3,8,1770,0,1999,0,98122,47.6102,-122.314,1890,3200,30,1310,383.3333333333333,0.08065573770491803,Very Cheap
20140924T000000,320000.0,4,2.75,2110,13260,1.0,0,0,4,7,1290,820,1979,0,98058,47.4513,-122.16,1980,11016,11150,9036,24.132730015082956,0.032131147540983604,Very Cheap
20140902T000000,750000.0,3,1.75,1590,8285,1.0,0,0,4,8,1590,0,1956,0,98004,47.5855,-122.194,1970,8970,6695,7000,90.52504526252262,0.08852459016393442,Very Cheap
20140630T000000,355000.0,3,2.25,1370,1524,3.0,0,0,3,8,1370,0,2005,0,98103,47.6982,-122.347,1370,1418,154,48,232.93963254593177,0.036721311475409836,Very Cheap
20140508T000000,246000.0,3,1.75,1390,7399,1.0,0,0,4,7,1390,0,1975,0,98031,47.4183,-122.182,1460,7800,6009,6340,33.24773618056494,0.02242622950819672,Very Cheap
20141001T000000,1155000.0,3,1.75,1640,10464,1.0,0,2,4,8,1640,0,1968,0,98004,47.5873,-122.205,2630,18872,8824,16242,110.37844036697248,0.14163934426229507,Cheap
20140606T000000,744000.0,3,2.5,2670,12187,2.0,0,0,3,8,2670,0,1986,0,98052,47.6677,-122.15,2400,8999,9517,6599,61.04865840649873,0.08773770491803279,Very Cheap
20140911T000000,1210000.0,3,3.75,5400,24740,2.0,0,0,3,11,5400,0,1997,0,98053,47.6426,-121.955,1690,20000,19340,18310,48.90864995957963,0.14885245901639343,Cheap
20141210T000000,217000.0,3,2.0,1690,6750,1.0,0,0,3,7,1210,480,1977,0,98023,47.3021,-122.375,1930,7350,5060,5420,32.148148148148145,0.01862295081967213,Very Cheap
20140709T000000,583000.0,3,2.5,2600,5100,2.0,0,1,3,8,2600,0,1998,0,98056,47.5175,-122.205,2270,5400,2500,3130,114.31372549019608,0.06662295081967214,Very Cheap
20141111T000000,515000.0,2,1.5,1400,5000,1.0,0,0,4,7,1150,250,1904,0,98107,47.6681,-122.362,1530,4200,3600,2670,103.0,0.057704918032786885,Very Cheap
20150319T000000,594000.0,4,1.75,2140,8000,1.0,0,0,4,8,1410,730,1965,0,98007,47.622,-122.139,2080,8000,5860,5920,74.25,0.0680655737704918,Very Cheap
20141022T000000,303100.0,3,1.5,1640,5650,1.0,0,0,3,8,1640,0,1952,0,98178,47.509,-122.251,1640,5650,4010,4010,53.64601769911504,0.029914754098360655,Very Cheap
20141010T000000,430000.0,3,1.75,1720,15225,1.0,0,0,4,7,1020,700,1970,0,98075,47.579,-122.051,1860,13588,13505,11728,28.24302134646962,0.04655737704918033,Very Cheap
20141208T000000,708000.0,5,3.25,3060,11778,2.0,0,0,3,8,3060,0,2004,0,98034,47.7212,-122.222,1840,10403,8718,8563,60.11207335710647,0.08301639344262295,Very Cheap
20140813T000000,221000.0,3,1.0,1150,7260,1.0,0,0,3,7,1150,0,1959,0,98133,47.7344,-122.333,1200,7888,6110,6688,30.44077134986226,0.01914754098360656,Very Cheap
20150324T000000,325000.0,3,2.5,2000,7205,2.0,0,0,3,8,2000,0,1998,0,98003,47.3499,-122.302,2180,7611,5205,5431,45.107564191533655,0.03278688524590164,Very Cheap
20140624T000000,1295650.0,0,0.0,4810,28008,2.0,0,0,3,12,4810,0,1990,0,98053,47.6642,-122.069,4740,35061,23198,30321,46.25999714367324,0.16008524590163933,Cheap
20150219T000000,385000.0,3,1.75,1560,5950,1.0,0,0,4,6,780,780,1944,0,98125,47.719,-122.307,1320,7830,4390,6510,64.70588235294117,0.04065573770491803,Very Cheap
20150327T000000,359500.0,3,2.5,2070,4689,2.0,0,0,3,8,2070,0,2013,0,98038,47.3545,-122.056,1880,4593,2619,2713,76.66879931755172,0.037311475409836065,Very Cheap
20140807T000000,433000.0,3,2.0,1920,7200,1.0,0,0,3,7,1300,620,1984,0,98028,47.7703,-122.265,2010,7200,5280,5190,60.138888888888886,0.04695081967213115,Very Cheap
20150323T000000,525000.0,2,1.0,1000,4950,1.0,0,0,3,7,800,200,1948,0,98116,47.5671,-122.394,1060,5500,3950,4440,106.06060606060606,0.05901639344262295,Very Cheap
20140722T000000,356200.0,3,2.0,1690,10062,1.0,0,2,5,7,940,750,1928,0,98178,47.5102,-122.241,2390,6650,8372,4260,35.400516795865634,0.03687868852459016,Very Cheap
20140729T000000,595000.0,4,2.0,3090,87120,1.0,0,0,4,7,1590,1500,1974,0,98072,47.7275,-122.122,2560,88426,84030,85866,6.829660238751148,0.06819672131147542,Very Cheap
20140915T000000,560000.0,4,1.5,1790,3420,1.0,0,0,4,7,1020,770,1923,0,98103,47.6489,-122.337,1680,3420,1630,1740,163.74269005847952,0.06360655737704918,Very Cheap
20141208T000000,2175000.0,4,3.0,4750,21701,1.5,0,0,5,11,4750,0,1976,0,98004,47.6454,-122.218,3120,18551,16951,15431,100.22579604626515,0.2754098360655738,Cheap
20141027T000000,513000.0,4,2.0,2090,4000,1.0,0,0,3,7,1480,610,1951,0,98107,47.6751,-122.379,1510,5000,1910,3490,128.25,0.05744262295081967,Very Cheap
20140721T000000,365000.0,2,1.0,680,2550,1.0,0,0,4,5,680,0,1901,0,98117,47.6767,-122.388,1120,5100,1870,3980,143.13725490196077,0.0380327868852459,Very Cheap
20140708T000000,368000.0,4,1.75,2100,11942,1.0,0,0,3,7,1030,1070,1964,0,98106,47.55,-122.356,1170,6986,9842,5816,30.815608775749457,0.03842622950819672,Very Cheap
20140625T000000,870000.0,4,2.75,2840,4000,1.5,0,0,5,8,1960,880,1912,0,98144,47.5846,-122.291,2750,4000,1160,1250,217.5,0.10426229508196722,Cheap
20140724T000000,225000.0,3,2.25,1470,6808,1.0,0,0,3,7,1160,310,1984,0,98023,47.2884,-122.365,1570,7881,5338,6311,33.049353701527615,0.019672131147540985,Very Cheap
20150421T000000,1387000.0,4,4.5,4490,24767,2.0,0,2,3,11,3800,690,1998,0,98006,47.5544,-122.147,3370,32700,20277,29330,56.001938062744784,0.1720655737704918,Cheap
20140619T000000,177000.0,3,1.75,1150,8079,1.0,0,0,4,7,1150,0,1983,0,98030,47.3766,-122.18,1540,7399,6929,5859,21.908652060898625,0.01337704918032787,Very Cheap
20150127T000000,465000.0,3,1.5,1460,9879,1.0,0,0,3,7,1460,0,1956,0,98008,47.6346,-122.127,1610,10050,8419,8440,47.06954145156392,0.051147540983606556,Very Cheap
20140927T000000,750000.0,4,2.75,3150,6343,1.0,0,3,3,8,1810,1340,1976,0,98126,47.5424,-122.381,2250,6343,3193,4093,118.24058016711335,0.08852459016393442,Very Cheap
20140922T000000,149000.0,3,1.0,1090,2800,1.0,0,0,3,6,1090,0,1969,0,98092,47.3162,-122.183,1040,2960,1710,1920,53.214285714285715,0.009704918032786886,Very Cheap
20140609T000000,605000.0,3,2.5,2670,47480,2.0,0,3,3,9,2670,0,1981,0,98072,47.7443,-122.114,2760,42800,44810,40040,12.742207245155855,0.06950819672131148,Very Cheap
20141024T000000,725000.0,3,2.0,2110,5800,1.5,0,0,4,7,1990,120,1927,0,98103,47.6645,-122.342,1620,4300,3690,2680,125.0,0.08524590163934426,Very Cheap
20140922T000000,413900.0,4,2.25,1770,5236,2.0,0,0,3,7,1770,0,2007,0,98056,47.5137,-122.189,2470,5064,3466,2594,79.04889228418641,0.04444590163934426,Very Cheap
20140731T000000,199950.0,3,1.5,1510,6600,1.0,0,0,3,6,1510,0,1938,0,98168,47.4821,-122.331,990,6600,5090,5610,30.295454545454547,0.01638688524590164,Very Cheap
20140924T000000,400000.0,1,1.0,530,13679,1.0,0,0,4,6,530,0,1949,0,98053,47.6422,-121.954,1930,20624,13149,18694,29.24190364792748,0.04262295081967213,Very Cheap
20140812T000000,870000.0,3,1.5,2420,5000,2.0,0,0,4,8,2200,220,1925,0,98103,47.6744,-122.353,2070,5000,2580,2930,174.0,0.10426229508196722,Cheap
20140605T000000,292000.0,5,2.5,2490,7666,1.0,0,0,4,7,1490,1000,1989,0,98031,47.4022,-122.171,1930,7415,5176,5485,38.09026871901904,0.028459016393442622,Very Cheap
20140512T000000,225000.0,3,1.0,990,8012,1.0,0,0,4,7,990,0,1966,0,98058,47.4557,-122.181,1260,9060,7022,7800,28.082875686470295,0.019672131147540985,Very Cheap
20150316T000000,466750.0,4,2.0,1730,9139,2.0,0,0,3,8,1730,0,1957,0,98125,47.7181,-122.316,1410,7311,7409,5901,51.07232738811686,0.05137704918032787,Very Cheap
20150323T000000,330000.0,2,1.5,1440,11954,1.0,0,0,4,8,1440,0,1978,0,98002,47.2909,-122.219,1460,9730,10514,8270,27.605822318889075,0.03344262295081967,Very Cheap
20141002T000000,770000.0,7,2.25,3260,8145,2.0,0,0,5,8,3260,0,1967,0,98008,47.6336,-122.115,2340,8145,4885,5805,94.536525475752,0.09114754098360656,Very Cheap
20150213T000000,802500.0,4,2.25,1950,7000,1.0,0,1,3,8,1450,500,1957,0,98118,47.5426,-122.262,1840,6440,5050,4600,114.64285714285714,0.09540983606557377,Very Cheap
20140718T000000,378800.0,5,2.5,2740,5400,2.0,0,0,3,8,2740,0,2005,0,98031,47.4036,-122.205,2900,5476,2660,2576,70.14814814814815,0.039842622950819674,Very Cheap
20150501T000000,795000.0,3,2.75,2940,12487,2.0,0,0,3,10,2940,0,1997,0,98075,47.5879,-121.973,3110,10837,9547,7727,63.66621286137583,0.09442622950819672,Very Cheap
20150422T000000,460000.0,3,2.0,1200,7320,1.0,0,0,3,7,1200,0,1955,0,98115,47.6986,-122.286,1750,8220,6120,6470,62.84153005464481,0.050491803278688525,Very Cheap
20141219T000000,567000.0,3,2.5,2070,10908,2.0,0,0,3,8,2070,0,1986,0,98029,47.5665,-122.023,2220,10975,8838,8755,51.98019801980198,0.06452459016393443,Very Cheap
20140722T000000,209950.0,3,1.75,1570,15570,1.0,0,0,3,7,1570,0,1981,0,98023,47.3207,-122.362,2000,28200,14000,26200,13.484264611432241,0.017698360655737704,Very Cheap
20140520T000000,415000.0,2,1.0,1050,60113,1.0,0,0,4,7,1050,0,1943,0,98001,47.3226,-122.287,1380,27442,59063,26062,6.903664764693161,0.04459016393442623,Very Cheap
20141215T000000,424500.0,4,1.5,1830,6985,1.0,0,0,3,7,1080,750,1967,0,98028,47.7494,-122.236,1650,9501,5155,7851,60.773085182534004,0.04583606557377049,Very Cheap
20150505T000000,261000.0,2,1.0,970,12500,1.0,0,0,3,6,970,0,1941,0,98168,47.5102,-122.33,1280,6250,11530,4970,20.88,0.02439344262295082,Very Cheap
20140827T000000,365000.0,3,2.5,2200,9696,2.0,0,0,3,8,2200,0,1987,0,98031,47.4197,-122.205,2200,9915,7496,7715,37.6443894389439,0.0380327868852459,Very Cheap
20150408T000000,631000.0,4,2.0,1930,3240,1.5,0,0,4,7,1930,0,1911,0,98122,47.6156,-122.299,1480,3600,1310,2120,194.7530864197531,0.07291803278688525,Very Cheap
20140701T000000,3800000.0,5,5.5,7050,42840,1.0,0,2,4,13,4320,2730,1978,0,98004,47.6229,-122.22,5070,20570,35790,15500,88.70214752567693,0.4885245901639344,High
20141008T000000,584000.0,3,2.5,1790,3962,2.0,0,0,3,8,1790,0,1992,0,98117,47.6894,-122.391,1340,3960,2172,2620,147.40030287733467,0.06675409836065574,Very Cheap
20140729T000000,310000.0,3,1.75,1560,82328,1.0,0,0,3,7,1560,0,1974,0,98070,47.3674,-122.503,2100,205603,80768,203503,3.765426100476144,0.03081967213114754,Very Cheap
20150312T000000,717000.0,4,2.5,2780,7985,2.0,0,0,4,10,2780,0,1992,0,98029,47.5608,-122.016,2650,8094,5205,5444,89.79336255479024,0.0841967213114754,Very Cheap
20140616T000000,667000.0,3,1.5,1720,8100,2.0,0,0,3,8,1720,0,1907,0,98107,47.6746,-122.4,2210,8100,6380,5890,82.34567901234568,0.07763934426229509,Very Cheap
20141230T000000,190000.0,3,1.0,1640,8100,1.0,0,0,3,6,1040,600,1939,0,98146,47.482,-122.34,1600,8100,6460,6500,23.45679012345679,0.015081967213114755,Very Cheap
20140617T000000,430000.0,3,2.0,1730,9000,1.0,0,0,3,8,1370,360,1978,0,98027,47.5202,-122.047,2390,10000,7270,7610,47.77777777777778,0.04655737704918033,Very Cheap
20150424T000000,213000.0,2,1.0,740,7380,1.0,0,0,4,6,740,0,1951,0,98188,47.4481,-122.278,1500,10075,6640,8575,28.86178861788618,0.018098360655737705,Very Cheap
20141007T000000,475000.0,3,2.5,2280,3710,1.0,0,0,3,8,1550,730,1990,0,98072,47.735,-122.159,2030,3710,1430,1680,128.03234501347708,0.05245901639344262,Very Cheap
20150309T000000,649000.0,2,2.75,2090,23962,2.0,0,3,4,8,2090,0,1988,0,98070,47.4145,-122.44,1820,32340,21872,30520,27.084550538352392,0.07527868852459016,Very Cheap
20140606T000000,715000.0,3,2.5,2550,13458,2.0,0,0,3,9,2550,0,1990,0,98006,47.5586,-122.121,3180,13458,10908,10278,53.12825085451033,0.0839344262295082,Very Cheap
20150318T000000,845000.0,4,3.5,3350,19487,1.0,0,0,3,11,2460,890,1992,0,98075,47.5796,-121.998,3360,19460,16137,16100,43.36224149432955,0.10098360655737705,Cheap
20141110T000000,390000.0,3,2.5,2770,8820,1.0,0,0,3,7,1900,870,1980,2004,98038,47.3685,-122.048,1850,10920,6050,9070,44.21768707482993,0.04131147540983607,Very Cheap
20140924T000000,390000.0,4,3.0,2860,5724,1.0,0,0,3,7,1730,1130,1983,0,98108,47.5427,-122.302,2340,7200,2864,4860,68.13417190775681,0.04131147540983607,Very Cheap
20140729T000000,328000.0,4,1.75,1990,7194,1.0,0,0,4,8,1400,590,1978,0,98058,47.4417,-122.135,1820,7400,5204,5580,45.593550180706146,0.03318032786885246,Very Cheap
20141205T000000,239999.0,3,2.75,1740,8436,1.0,0,0,3,7,1140,600,1967,0,98003,47.3456,-122.305,1550,8436,6696,6886,28.449383594120437,0.0216392131147541,Very Cheap
20141021T000000,225000.0,3,2.0,1460,7740,1.0,0,0,3,7,1460,0,1968,0,98003,47.3467,-122.306,1540,7644,6280,6104,29.069767441860463,0.019672131147540985,Very Cheap
20141016T000000,920000.0,3,1.75,3670,11884,1.0,0,2,4,9,1950,1720,1979,0,98006,47.5604,-122.133,3020,9747,8214,6727,77.41501178054527,0.11081967213114755,Cheap
20150317T000000,940000.0,4,2.75,3270,9231,2.0,0,0,3,10,3270,0,1995,0,98052,47.6539,-122.121,3380,10154,5961,6774,101.83078756364424,0.11344262295081967,Cheap
20150501T000000,465000.0,3,1.0,1210,4872,1.0,0,0,4,6,1210,0,1949,0,98118,47.5551,-122.273,1070,4872,3662,3802,95.44334975369458,0.051147540983606556,Very Cheap
20140701T000000,241000.0,3,2.0,1770,7000,1.0,0,0,3,7,1770,0,1986,0,98001,47.3321,-122.261,1510,10462,5230,8952,34.42857142857143,0.02177049180327869,Very Cheap
20140609T000000,307550.0,4,2.5,1980,5909,2.0,0,0,3,8,1980,0,2003,0,98031,47.3913,-122.185,2550,5487,3929,2937,52.047723811135555,0.030498360655737706,Very Cheap
20141031T000000,490000.0,4,2.5,2650,9627,1.0,0,3,4,8,1610,1040,1976,0,98028,47.7684,-122.254,2650,9221,6977,6571,50.89851459437,0.05442622950819672,Very Cheap
20140512T000000,647000.0,4,2.5,3040,6887,2.0,0,0,3,8,3040,0,1999,0,98074,47.6073,-122.015,2790,7196,3847,4406,93.94511398286627,0.07501639344262295,Very Cheap
20140827T000000,780000.0,4,2.75,3640,231739,1.5,0,0,3,10,3640,0,1999,0,98027,47.5078,-122.018,2670,91040,228099,88370,3.3658555530143826,0.09245901639344262,Very Cheap
20141114T000000,517500.0,3,2.5,1810,4332,2.0,0,0,3,8,1810,0,1992,0,98029,47.5776,-121.996,1740,4332,2522,2592,119.45983379501385,0.0580327868852459,Very Cheap
20140618T000000,295000.0,3,2.0,1380,8682,1.0,0,0,4,7,1380,0,1966,0,98148,47.4238,-122.322,1410,10594,7302,9184,33.97834600322506,0.028852459016393443,Very Cheap
20141204T000000,560000.0,4,1.5,1810,3400,2.0,0,0,3,8,1810,0,1926,0,98112,47.6264,-122.302,1770,3600,1590,1830,164.7058823529412,0.06360655737704918,Very Cheap
20141105T000000,319450.0,5,2.0,2250,5472,1.5,0,0,5,7,1750,500,1930,0,98002,47.3065,-122.219,1540,5472,3222,3932,58.379020467836256,0.03205901639344262,Very Cheap
20141212T000000,1500000.0,4,3.25,3860,7199,2.0,0,1,3,9,2870,990,2005,0,98115,47.6855,-122.269,2940,9600,3339,6660,208.36227253785248,0.18688524590163935,Cheap
20140919T000000,340000.0,4,3.0,2380,20277,1.0,0,0,3,8,1500,880,1999,0,98023,47.3046,-122.392,2370,15440,17897,13070,16.767766434876954,0.03475409836065574,Very Cheap
20140815T000000,249950.0,3,1.0,1370,11658,1.0,0,0,4,6,1370,0,1958,0,98058,47.4576,-122.182,1080,9198,10288,8118,21.440212729456167,0.022944262295081966,Very Cheap
20140613T000000,499950.0,3,1.0,1830,3000,1.5,0,0,3,7,1430,400,1926,0,98103,47.6619,-122.351,1510,2500,1170,990,166.65,0.05573114754098361,Very Cheap
20140702T000000,1038000.0,4,1.75,1440,13296,1.0,0,0,4,8,1440,0,1967,0,98004,47.634,-122.204,3520,10802,11856,7282,78.06859205776173,0.12629508196721312,Cheap
20150216T000000,750000.0,4,2.5,2510,17200,1.0,0,2,4,9,1540,970,1977,0,98052,47.6287,-122.089,2370,14621,14690,12251,43.604651162790695,0.08852459016393442,Very Cheap
20150323T000000,875000.0,4,2.5,3230,256132,2.0,0,0,3,9,3230,0,2006,0,98053,47.6544,-121.998,3080,217800,252902,214720,3.416207268127372,0.10491803278688525,Cheap
20150414T000000,678000.0,3,1.75,1670,7210,1.0,0,0,5,8,1670,0,1967,0,98008,47.6344,-122.116,2200,7210,5540,5010,94.03606102635229,0.07908196721311475,Very Cheap
20140729T000000,360000.0,2,1.0,780,4200,1.0,0,0,3,6,780,0,1920,0,98118,47.5381,-122.267,1620,6000,3420,4380,85.71428571428571,0.037377049180327866,Very Cheap
20140923T000000,354900.0,3,1.0,1720,16552,1.0,0,0,4,7,1720,0,1971,0,98059,47.4772,-122.153,1550,15457,14832,13907,21.441517641372645,0.036708196721311474,Very Cheap
20140827T000000,632000.0,5,2.5,2260,10087,1.0,0,0,3,8,1520,740,1967,0,98008,47.5982,-122.128,2500,9440,7827,6940,62.65490234955884,0.07304918032786885,Very Cheap
20141218T000000,350000.0,3,1.75,1480,9375,1.0,0,0,4,7,1480,0,1957,0,98146,47.5076,-122.366,1370,9000,7895,7630,37.333333333333336,0.036065573770491806,Very Cheap
20140730T000000,990000.0,3,4.0,2550,3900,2.0,0,2,3,8,2050,500,1940,2003,98199,47.6415,-122.392,2340,6400,1350,4060,253.84615384615384,0.12,Cheap
20150105T000000,1650000.0,4,3.25,3920,881654,3.0,0,3,3,11,3920,0,2002,0,98024,47.5385,-121.896,2970,112384,877734,109414,1.8714824636421998,0.20655737704918034,Cheap
20140707T000000,481000.0,4,2.5,2286,8269,2.0,0,0,3,8,2286,0,2002,0,98056,47.5174,-122.194,2110,4711,5983,2601,58.169065183214414,0.05324590163934426,Very Cheap
20140624T000000,485000.0,3,2.5,1500,5412,1.0,0,0,5,7,900,600,1920,0,98136,47.5499,-122.394,1090,5412,3912,4322,89.61566888396156,0.05377049180327869,Very Cheap
20150413T000000,477000.0,3,2.5,1740,4960,2.0,0,0,3,8,1740,0,1992,0,98029,47.5772,-121.998,1740,5021,3220,3281,96.16935483870968,0.052721311475409836,Very Cheap
20140729T000000,560000.0,5,2.5,2880,9000,1.0,0,0,5,8,1440,1440,1966,0,98006,47.5456,-122.179,2010,9000,6120,6990,62.22222222222222,0.06360655737704918,Very Cheap
20141117T000000,600000.0,6,3.0,2600,9350,1.0,0,0,4,8,1340,1260,1963,0,98008,47.6198,-122.105,2090,9102,6750,7012,64.1711229946524,0.06885245901639345,Very Cheap
20140613T000000,622500.0,5,2.75,3320,23760,2.0,0,0,4,8,2190,1130,1975,0,98072,47.7498,-122.146,2520,36720,20440,34200,26.199494949494948,0.0718032786885246,Very Cheap
20150429T000000,410000.0,2,2.25,1660,2128,2.0,0,0,4,8,1660,0,1974,0,98028,47.7528,-122.252,1640,2128,468,488,192.66917293233084,0.043934426229508196,Very Cheap
20150402T000000,318200.0,3,2.5,1990,3644,2.0,0,0,3,7,1990,0,2010,0,98038,47.3531,-122.017,2580,3800,1654,1220,87.32162458836443,0.031895081967213114,Very Cheap
20140605T000000,289000.0,3,2.0,1680,8424,1.0,0,0,3,7,1680,0,1993,0,98022,47.1969,-122.011,1990,8545,6744,6555,34.306742640075974,0.028065573770491802,Very Cheap
20140520T000000,263000.0,3,1.75,1570,7775,2.0,0,0,3,7,1570,0,1982,0,98031,47.3876,-122.216,1580,8622,6205,7042,33.82636655948553,0.024655737704918034,Very Cheap
20140605T000000,240000.0,3,1.0,1150,4825,1.0,0,0,4,6,1150,0,1957,0,98027,47.5321,-122.029,1760,7121,3675,5361,49.740932642487046,0.021639344262295083,Very Cheap
20150407T000000,281500.0,3,1.0,1270,7500,1.0,0,0,3,7,1270,0,1953,0,98146,47.4921,-122.339,1340,3000,6230,1660,37.53333333333333,0.027081967213114753,Very Cheap
20140620T000000,587206.0,3,3.5,1890,1710,2.0,0,0,3,8,1640,250,1999,0,98103,47.6592,-122.349,1680,1562,-180,-118,343.3953216374269,0.06717455737704918,Very Cheap
20140730T000000,482000.0,2,2.25,1350,1248,2.0,0,0,3,7,1180,170,2000,0,98102,47.6399,-122.32,1760,3360,-102,1600,386.21794871794873,0.05337704918032787,Very Cheap
20150310T000000,485000.0,3,1.75,1650,9500,1.0,0,0,3,8,1650,0,1967,0,98052,47.631,-122.098,1880,9375,7850,7495,51.05263157894737,0.05377049180327869,Very Cheap
20150212T000000,309000.0,3,2.5,1450,11480,2.0,0,0,3,7,1450,0,1990,0,98014,47.672,-121.864,2080,87991,10030,85911,26.916376306620208,0.030688524590163933,Very Cheap
20140619T000000,221000.0,3,2.25,1640,7350,1.0,0,0,3,7,1140,500,1984,0,98003,47.2625,-122.3,1480,8041,5710,6561,30.068027210884352,0.01914754098360656,Very Cheap
20140513T000000,700000.0,3,2.5,2030,8398,2.0,0,0,4,9,2030,0,1975,0,98008,47.6272,-122.095,2450,8104,6368,5654,83.35317932841153,0.08196721311475409,Very Cheap
20140929T000000,411500.0,5,3.0,2420,7740,1.0,0,0,5,7,1360,1060,1929,1969,98106,47.536,-122.358,1840,6780,5320,4940,53.16537467700258,0.04413114754098361,Very Cheap
20141028T000000,285000.0,4,3.5,2770,10505,2.0,0,0,3,8,2770,0,1940,2015,98133,47.7412,-122.355,1760,10505,7735,8745,27.129938124702523,0.02754098360655738,Very Cheap
20140605T000000,395000.0,4,3.0,1980,7931,1.0,0,0,4,7,1160,820,1983,0,98133,47.7513,-122.334,1910,7931,5951,6021,49.80456436767116,0.0419672131147541,Very Cheap
20140709T000000,237950.0,2,1.75,1460,7926,1.0,0,0,4,7,1460,0,1987,0,98042,47.3665,-122.092,1680,8206,6466,6526,30.021448397678526,0.02137049180327869,Very Cheap
20150310T000000,680000.0,3,2.5,1610,8064,1.0,0,2,4,7,1160,450,1981,0,98033,47.6818,-122.189,2260,8328,6454,6068,84.32539682539682,0.07934426229508197,Very Cheap
20141226T000000,199950.0,2,1.0,1010,10057,1.0,0,0,3,6,1010,0,1961,0,98023,47.3286,-122.336,1040,8591,9047,7551,19.88167445560306,0.01638688524590164,Very Cheap
20141212T000000,765000.0,4,3.5,2760,4000,2.0,0,2,3,8,2000,760,1926,2014,98126,47.5687,-122.374,1690,4000,1240,2310,191.25,0.09049180327868853,Very Cheap
20140508T000000,515000.0,2,1.0,1060,4960,1.0,0,0,3,7,1060,0,1926,0,98103,47.6896,-122.331,1420,4960,3900,3540,103.83064516129032,0.057704918032786885,Very Cheap
20140616T000000,470000.0,3,1.5,1510,8000,1.0,0,0,4,7,1510,0,1956,0,98007,47.5865,-122.135,1430,8000,6490,6570,58.75,0.05180327868852459,Very Cheap
20140820T000000,330000.0,2,1.0,880,4000,1.0,0,0,3,6,780,100,1937,0,98117,47.6931,-122.379,950,4000,3120,3050,82.5,0.03344262295081967,Very Cheap
20150226T000000,284000.0,3,2.5,2150,9375,1.0,0,0,3,8,1550,600,1968,0,98188,47.4578,-122.274,1950,9100,7225,7150,30.293333333333333,0.027409836065573772,Very Cheap
20140912T000000,295000.0,3,2.5,1660,8125,1.0,0,0,3,7,1150,510,1999,0,98148,47.4373,-122.333,1250,8125,6465,6875,36.30769230769231,0.028852459016393443,Very Cheap
20150330T000000,555000.0,4,2.5,2160,10987,1.0,0,0,4,8,1440,720,1981,2003,98074,47.6333,-122.034,1280,11617,8827,10337,50.51424410667152,0.06295081967213115,Very Cheap
20140806T000000,350000.0,3,1.0,1370,8162,1.5,0,0,3,6,1370,0,1949,0,98125,47.7263,-122.289,1560,8250,6792,6690,42.88164665523156,0.036065573770491806,Very Cheap
20141203T000000,240000.0,3,2.25,1460,5818,1.0,0,0,3,7,1140,320,1986,0,98023,47.3113,-122.358,1490,6031,4358,4541,41.25128910278446,0.021639344262295083,Very Cheap
20150204T000000,419900.0,3,1.5,1450,7000,1.0,0,0,3,7,1450,0,1955,0,98007,47.5983,-122.15,1490,7245,5550,5755,59.98571428571429,0.0452327868852459,Very Cheap
20150430T000000,528000.0,3,2.0,1560,6300,1.0,0,0,3,7,1560,0,1924,0,98126,47.5407,-122.379,1620,6300,4740,4680,83.80952380952381,0.05940983606557377,Very Cheap
20150311T000000,481000.0,4,2.5,2480,9869,1.0,0,0,4,8,1240,1240,1963,0,98028,47.7612,-122.229,2230,10310,7389,8080,48.73847400952477,0.05324590163934426,Very Cheap
20140609T000000,304700.0,2,1.0,740,5995,1.0,0,0,4,7,740,0,1949,0,98133,47.7291,-122.337,1140,5995,5255,4855,50.825688073394495,0.030124590163934425,Very Cheap
20150204T000000,715000.0,4,2.5,2927,12171,2.0,0,0,3,10,2927,0,1998,0,98075,47.5948,-121.983,2967,12166,9244,9199,58.74619998356749,0.0839344262295082,Very Cheap
20140820T000000,738950.0,4,2.75,2260,12005,1.0,0,0,4,8,2260,0,1956,1989,98005,47.6342,-122.171,1870,10800,9745,8930,61.553519366930445,0.08707540983606557,Very Cheap
20141022T000000,215000.0,3,1.5,1240,9405,1.0,0,0,4,7,1240,0,1966,0,98042,47.3727,-122.162,2260,7611,8165,5351,22.860180754917597,0.018360655737704918,Very Cheap
20140522T000000,300000.0,6,2.0,2040,10812,1.0,0,0,4,5,2040,0,1943,0,98056,47.4919,-122.181,1440,10200,8772,8760,27.74694783573807,0.029508196721311476,Very Cheap
20140623T000000,346000.0,3,1.75,1270,8100,1.0,0,0,3,6,880,390,1950,0,98146,47.4828,-122.344,1650,8173,6830,6523,42.71604938271605,0.03554098360655738,Very Cheap
20150327T000000,473000.0,4,3.5,4370,37193,2.0,0,3,3,8,2780,1590,1996,0,98022,47.241,-121.979,2860,39356,32823,36496,12.717446831393005,0.05219672131147541,Very Cheap
20150105T000000,500000.0,3,1.75,1700,6120,1.0,0,0,3,7,1700,0,1952,0,98116,47.5807,-122.397,1330,6120,4420,4790,81.69934640522875,0.05573770491803279,Very Cheap
20140925T000000,750000.0,2,1.5,1300,7632,1.0,0,2,3,7,1300,0,1943,0,98122,47.6134,-122.308,1420,1676,6332,256,98.27044025157232,0.08852459016393442,Very Cheap
20140520T000000,519900.0,4,2.0,1820,9350,1.0,0,0,4,8,1820,0,1967,0,98052,47.6288,-122.098,2260,9299,7530,7039,55.60427807486631,0.05834754098360656,Very Cheap
20140819T000000,378500.0,2,1.0,880,6171,1.0,0,0,4,7,880,0,1949,0,98125,47.7262,-122.285,2260,12769,5291,10509,61.33527791281802,0.03980327868852459,Very Cheap
20140507T000000,314500.0,3,1.75,1870,12381,1.0,0,0,4,8,1870,0,1957,0,98003,47.3358,-122.32,1950,12667,10511,10717,25.4018253775947,0.03140983606557377,Very Cheap
20150429T000000,499950.0,3,1.5,1350,9315,1.0,0,0,3,7,1350,0,1968,0,98052,47.6587,-122.124,1840,9920,7965,8080,53.671497584541065,0.05573114754098361,Very Cheap
20141203T000000,1735000.0,5,3.5,4870,7700,2.5,0,3,5,10,3650,1220,1929,0,98144,47.5832,-122.29,3220,7700,2830,4480,225.32467532467533,0.21770491803278688,Cheap
20150422T000000,630000.0,3,2.5,2460,38794,2.0,0,0,3,9,2460,0,1999,0,98077,47.7602,-122.022,2470,51400,36334,48930,16.23962468422952,0.07278688524590164,Very Cheap
20140623T000000,360000.0,4,1.5,1720,6417,1.0,0,0,3,7,1720,0,1953,0,98125,47.7268,-122.311,1430,6240,4697,4810,56.100981767180926,0.037377049180327866,Very Cheap
20140526T000000,460000.0,2,1.5,2730,19877,1.0,0,0,4,8,1570,1160,1976,0,98019,47.7698,-121.898,1450,19509,17147,18059,23.14232530059868,0.050491803278688525,Very Cheap
20140522T000000,361000.0,3,1.0,1100,4046,1.5,0,4,4,6,1100,0,1922,0,98198,47.344,-122.331,2550,7847,2946,5297,89.22392486406328,0.037508196721311476,Very Cheap
20140710T000000,713400.0,3,2.25,1810,9845,1.0,0,0,4,8,1810,0,1959,1991,98040,47.5505,-122.221,1900,10083,8035,8183,72.46317927882174,0.08372459016393442,Very Cheap
20141028T000000,445000.0,2,1.0,930,3150,1.0,0,0,5,6,930,0,1918,0,98115,47.6783,-122.298,1900,5000,2220,3100,141.26984126984127,0.04852459016393443,Very Cheap
20140514T000000,305000.0,4,1.5,1590,131551,1.0,0,3,4,7,1590,0,1966,0,98022,47.2558,-122.024,2280,108028,129961,105748,2.318492447795912,0.03016393442622951,Very Cheap
20150304T000000,1430000.0,3,2.75,2710,9204,1.5,0,4,3,9,1480,1230,1975,0,98177,47.7039,-122.385,2960,10080,6494,7120,155.36723163841808,0.17770491803278687,Cheap
20150424T000000,222000.0,3,1.0,1460,8400,1.0,0,0,4,6,1460,0,1962,0,98023,47.3086,-122.365,1060,8563,6940,7503,26.428571428571427,0.019278688524590165,Very Cheap
20150216T000000,510000.0,5,3.25,3400,4499,2.0,0,0,3,8,2740,660,2005,0,98065,47.5385,-121.88,3400,6163,1099,2763,113.35852411647032,0.057049180327868855,Very Cheap
20140604T000000,500000.0,5,3.0,2920,11440,2.0,0,0,3,8,2920,0,2003,0,98133,47.7607,-122.354,1720,9348,8520,7628,43.70629370629371,0.05573770491803279,Very Cheap
20140516T000000,605000.0,2,1.0,910,3600,1.0,0,0,4,7,910,0,1909,0,98119,47.6341,-122.361,1720,3600,2690,1880,168.05555555555554,0.06950819672131148,Very Cheap
20140820T000000,393000.0,3,2.0,1320,10720,2.0,0,0,3,8,1320,0,1981,0,98074,47.6203,-122.037,1910,13639,9400,11729,36.66044776119403,0.041704918032786885,Very Cheap
20140625T000000,725000.0,4,2.5,2490,5170,2.0,0,0,4,9,2490,0,2000,0,98052,47.6836,-122.162,2490,5170,2680,2680,140.2321083172147,0.08524590163934426,Very Cheap
20140707T000000,320000.0,3,1.75,2220,11646,1.0,0,0,3,7,1270,950,1950,0,98028,47.7762,-122.27,1490,10003,9426,8513,27.477245406148032,0.032131147540983604,Very Cheap
20140612T000000,210000.0,4,1.5,1130,7840,1.0,0,0,4,7,1130,0,1970,0,98023,47.2986,-122.377,1690,7840,6710,6150,26.785714285714285,0.017704918032786884,Very Cheap
20140729T000000,419900.0,4,2.5,2750,5767,2.0,0,0,3,9,2750,0,2005,0,98038,47.3595,-122.038,2800,5376,3017,2576,72.81082018380441,0.0452327868852459,Very Cheap
20150302T000000,410000.0,4,2.5,2240,4447,2.0,0,0,3,7,2240,0,2006,0,98059,47.4868,-122.159,2000,3800,2207,1800,92.19698673262874,0.043934426229508196,Very Cheap
20141216T000000,721000.0,3,2.25,2680,10440,1.0,0,1,3,8,1540,1140,1963,0,98116,47.561,-122.398,2140,7560,7760,5420,69.06130268199233,0.08472131147540983,Very Cheap
20140714T000000,605000.0,2,2.0,1270,5500,1.5,0,0,4,8,1270,0,1921,0,98122,47.6121,-122.294,1870,4400,4230,2530,110.0,0.06950819672131148,Very Cheap
20141203T000000,738000.0,3,1.75,1520,5500,1.5,0,0,5,7,1520,0,1936,0,98116,47.5839,-122.383,2310,5500,3980,3190,134.1818181818182,0.08695081967213114,Very Cheap
20150402T000000,725000.0,6,3.0,2480,12000,2.0,0,0,3,8,2480,0,1972,0,98007,47.6131,-122.145,2220,8580,9520,6360,60.416666666666664,0.08524590163934426,Very Cheap
20140819T000000,255000.0,2,1.0,960,20954,1.0,0,0,3,7,960,0,1977,0,98045,47.4485,-121.774,1240,9752,19994,8512,12.169514173904744,0.02360655737704918,Very Cheap
20150320T000000,303000.0,3,2.25,1340,873,3.0,0,0,3,8,1340,0,2009,0,98133,47.7325,-122.343,1340,1186,-467,-154,347.0790378006873,0.029901639344262296,Very Cheap
20140723T000000,394950.0,3,2.5,1090,7700,1.0,0,0,4,7,1090,0,1957,0,98008,47.607,-122.12,1740,7700,6610,5960,51.29220779220779,0.04196065573770492,Very Cheap
20140902T000000,530000.0,4,3.0,2240,5580,2.0,0,0,5,7,1830,410,1949,0,98118,47.5598,-122.27,1530,4800,3340,3270,94.9820788530466,0.05967213114754098,Very Cheap
20140513T000000,475000.0,4,2.5,3740,8700,1.0,0,0,3,10,2260,1480,2004,0,98058,47.4587,-122.117,2650,6333,4960,3683,54.59770114942529,0.05245901639344262,Very Cheap
20140617T000000,250000.0,4,2.5,1800,8100,2.0,0,0,3,7,1800,0,1998,0,98038,47.3611,-122.047,1590,8100,6300,6510,30.864197530864196,0.022950819672131147,Very Cheap
20141208T000000,180000.0,3,1.0,780,3540,1.0,0,0,2,6,780,0,1920,0,98118,47.565,-122.291,1260,3540,2760,2280,50.847457627118644,0.01377049180327869,Very Cheap
20140804T000000,443500.0,2,1.0,1330,4140,1.0,0,0,4,7,930,400,1919,1940,98115,47.6802,-122.306,1410,5100,2810,3690,107.1256038647343,0.048327868852459016,Very Cheap
20140703T000000,390000.0,4,2.0,1900,76877,1.0,0,0,3,8,1900,0,2004,0,98042,47.3491,-122.113,1740,34848,74977,33108,5.073038750211377,0.04131147540983607,Very Cheap
20150220T000000,430000.0,4,1.75,1570,7650,1.0,0,0,3,7,1100,470,1975,0,98052,47.6801,-122.106,1580,7650,6080,6070,56.209150326797385,0.04655737704918033,Very Cheap
20150225T000000,460000.0,5,4.5,3100,7260,2.0,0,0,3,8,3100,0,1963,2000,98059,47.5004,-122.162,1650,7700,4160,6050,63.36088154269972,0.050491803278688525,Very Cheap
20150312T000000,660000.0,3,3.5,2740,3785,2.0,0,0,3,9,2190,550,2001,0,98034,47.7195,-122.182,2060,3457,1045,1397,174.37252311756936,0.07672131147540984,Very Cheap
20140729T000000,515000.0,3,1.75,1570,10939,1.0,0,0,3,8,1200,370,1974,0,98052,47.6389,-122.102,1760,10200,9369,8440,47.0792577018009,0.057704918032786885,Very Cheap
20150421T000000,482500.0,3,2.0,1330,6490,1.0,0,0,4,7,1330,0,1954,0,98125,47.7181,-122.308,1580,7202,5160,5622,74.34514637904468,0.053442622950819675,Very Cheap
20140602T000000,305000.0,2,1.5,1140,2980,2.0,0,0,3,7,1140,0,1988,0,98029,47.5707,-122.018,1150,2981,1840,1831,102.3489932885906,0.03016393442622951,Very Cheap
20140603T000000,835000.0,4,2.75,1550,4000,1.5,0,0,3,9,1550,0,1930,0,98105,47.6596,-122.28,2120,4000,2450,1880,208.75,0.09967213114754099,Very Cheap
20141204T000000,237000.0,3,2.0,1290,7952,1.0,0,0,3,7,1290,0,1998,0,98030,47.3867,-122.19,1670,7280,6662,5610,29.803822937625753,0.021245901639344263,Very Cheap
20141126T000000,445000.0,2,1.5,1510,2001,2.0,0,0,4,8,1510,0,1985,0,98007,47.6211,-122.153,1510,2055,491,545,222.3888055972014,0.04852459016393443,Very Cheap
20150406T000000,710000.0,4,2.5,2720,8000,1.0,0,0,4,7,1360,1360,1955,0,98136,47.5237,-122.391,1790,8000,5280,6210,88.75,0.08327868852459017,Very Cheap
20140821T000000,180000.0,3,1.0,840,5700,1.0,0,0,4,5,840,0,1945,0,98038,47.3948,-122.028,1430,12600,4860,11170,31.57894736842105,0.01377049180327869,Very Cheap
20141023T000000,280017.0,3,2.5,1850,8770,2.0,0,0,3,8,1850,0,1996,0,98022,47.2091,-122.009,2350,8606,6920,6256,31.928962371721777,0.026887475409836065,Very Cheap
20140630T000000,436500.0,4,2.5,2290,11173,2.0,0,0,4,8,2290,0,1988,0,98058,47.4314,-122.164,2290,10404,8883,8114,39.0673946120111,0.04740983606557377,Very Cheap
20140515T000000,1255000.0,4,2.5,3200,7535,2.0,0,0,3,9,3200,0,2006,0,98105,47.666,-122.276,1650,6850,4335,5200,166.55607166556072,0.15475409836065573,Cheap
20141218T000000,420000.0,3,2.25,1800,9800,1.0,0,0,4,7,1300,500,1959,0,98028,47.7393,-122.244,1680,9545,8000,7865,42.857142857142854,0.04524590163934426,Very Cheap
20140719T000000,205000.0,3,1.0,860,7467,1.0,0,0,3,6,860,0,1944,0,98178,47.4947,-122.237,1280,7467,6607,6187,27.454131511986073,0.017049180327868854,Very Cheap
20140902T000000,570000.0,3,1.5,1980,10203,1.0,0,0,4,7,1680,300,1946,0,98010,47.3402,-122.046,1980,13664,8223,11684,55.865921787709496,0.06491803278688525,Very Cheap
20140711T000000,565000.0,4,1.75,2140,7102,1.0,0,0,4,7,1070,1070,1948,0,98177,47.7042,-122.37,1950,7102,4962,5152,79.5550549141087,0.06426229508196721,Very Cheap
20141211T000000,287000.0,2,2.5,2410,7500,1.0,0,0,3,7,1550,860,1978,0,98023,47.3078,-122.374,1840,8800,5090,6960,38.266666666666666,0.02780327868852459,Very Cheap
20140923T000000,260000.0,4,1.75,1650,7276,1.0,0,0,3,7,1010,640,1977,0,98011,47.7721,-122.206,1840,8550,5626,6710,35.73391973611874,0.024262295081967214,Very Cheap
20150206T000000,470000.0,4,1.75,1650,7276,1.0,0,0,3,7,1010,640,1977,0,98011,47.7721,-122.206,1840,8550,5626,6710,64.5959318306762,0.05180327868852459,Very Cheap
20140905T000000,700000.0,3,2.5,2410,9916,2.0,0,0,4,10,2410,0,1989,0,98052,47.6911,-122.103,2310,8212,7506,5902,70.59298104074223,0.08196721311475409,Very Cheap
20150225T000000,249000.0,3,1.75,1520,7500,1.0,0,0,3,8,1520,0,1985,0,98092,47.2646,-122.219,2180,7506,5980,5326,33.2,0.02281967213114754,Very Cheap
20140609T000000,568000.0,3,1.75,2050,3520,1.0,0,0,4,7,1070,980,1977,0,98136,47.5536,-122.399,2050,16083,1470,14033,161.36363636363637,0.06465573770491803,Very Cheap
20140606T000000,500000.0,4,1.0,1720,4011,1.5,0,0,4,7,1720,0,1904,0,98107,47.6719,-122.396,1580,3784,2291,2204,124.65719272001995,0.05573770491803279,Very Cheap
20141126T000000,358000.0,5,2.5,2390,8775,1.0,0,0,4,7,1270,1120,1980,0,98058,47.4639,-122.17,1800,8000,6385,6200,40.7977207977208,0.03711475409836065,Very Cheap
20140528T000000,225000.0,3,2.5,1680,6755,2.0,0,0,3,8,1680,0,1994,0,98092,47.3293,-122.17,1860,7257,5075,5397,33.30866025166543,0.019672131147540985,Very Cheap
20150226T000000,275500.0,3,1.0,1060,7246,1.0,0,0,4,6,1060,0,1981,0,98056,47.4936,-122.165,1090,6694,6186,5604,38.02097709080872,0.026295081967213113,Very Cheap
20150202T000000,495000.0,3,2.5,1860,3150,2.0,0,0,3,8,1860,0,2001,0,98034,47.719,-122.182,2050,3375,1290,1325,157.14285714285714,0.05508196721311476,Very Cheap
20150326T000000,758800.0,5,2.25,1750,5000,1.0,0,0,3,8,960,790,1940,0,98105,47.6589,-122.276,2580,5000,3250,2420,151.76,0.08967868852459017,Very Cheap
20150403T000000,280000.0,3,1.75,1480,8165,1.0,0,0,4,7,1480,0,1985,0,98042,47.3624,-122.079,1450,7939,6685,6489,34.29271279853031,0.026885245901639345,Very Cheap
20150225T000000,380500.0,3,2.5,1900,7361,2.0,0,0,3,8,1900,0,1994,0,98055,47.4324,-122.191,2100,7361,5461,5261,51.69134628447222,0.0400655737704918,Very Cheap
20140507T000000,3200000.0,7,4.5,6210,8856,2.5,0,2,5,11,4760,1450,1910,0,98109,47.6307,-122.354,2940,5400,2646,2460,361.3369467028004,0.4098360655737705,High
20140617T000000,260000.0,3,1.75,1440,12888,1.0,0,2,3,7,1090,350,1958,0,98168,47.471,-122.262,1710,12888,11448,11178,20.17380509000621,0.024262295081967214,Very Cheap
20140805T000000,630000.0,4,2.5,1910,1502,3.0,0,0,3,8,1910,0,2014,0,98107,47.6747,-122.393,1520,3888,-408,2368,419.4407456724368,0.07278688524590164,Very Cheap
20140820T000000,875000.0,3,2.0,2010,4000,1.0,0,0,5,7,1210,800,1915,0,98103,47.6638,-122.329,1770,4000,1990,2230,218.75,0.10491803278688525,Cheap
20150403T000000,457500.0,3,1.0,960,4600,1.5,0,0,4,6,960,0,1927,0,98118,47.5553,-122.286,1380,5175,3640,3795,99.45652173913044,0.05016393442622951,Very Cheap
20141119T000000,900000.0,2,1.0,1240,5500,1.0,0,0,3,7,1240,0,1954,0,98102,47.6461,-122.317,2080,4400,4260,2320,163.63636363636363,0.10819672131147541,Cheap
20141028T000000,235000.0,2,2.0,870,6450,1.0,0,0,4,6,740,130,1954,0,98118,47.5354,-122.278,1640,5775,5580,4135,36.434108527131784,0.02098360655737705,Very Cheap
20140627T000000,410000.0,3,2.0,1400,45738,2.0,0,0,4,8,1400,0,1981,0,98070,47.3624,-122.455,2390,56628,44338,54238,8.964099873190783,0.043934426229508196,Very Cheap
20140827T000000,355000.0,3,3.0,1850,9600,1.0,0,0,3,7,1230,620,1981,0,98028,47.7717,-122.25,1970,10000,7750,8030,36.979166666666664,0.036721311475409836,Very Cheap
20140606T000000,1300000.0,4,4.0,4270,6002,2.0,0,3,3,10,3180,1090,2004,0,98029,47.5443,-121.994,4280,5942,1732,1662,216.5944685104965,0.16065573770491803,Cheap
20140929T000000,467500.0,3,1.75,2260,8512,1.0,0,0,3,7,1130,1130,1948,0,98125,47.7129,-122.304,2240,8040,6252,5800,54.922462406015036,0.05147540983606557,Very Cheap
20141125T000000,500000.0,4,4.5,2690,7350,1.5,0,0,5,7,2690,0,1949,0,98125,47.7062,-122.311,1660,9000,4660,7340,68.02721088435374,0.05573770491803279,Very Cheap
20150416T000000,995000.0,4,3.5,2780,9550,2.0,0,4,5,10,2530,250,1978,0,98166,47.454,-122.373,2724,10634,6770,7910,104.18848167539267,0.12065573770491804,Cheap
20140827T000000,277000.0,3,1.0,1140,8144,1.0,0,0,3,7,1140,0,1956,0,98155,47.7464,-122.317,1150,8144,7004,6994,34.012770137524555,0.026491803278688525,Very Cheap
20141217T000000,630000.0,4,2.25,2900,9680,2.0,0,0,3,7,1990,910,1947,0,98125,47.7037,-122.308,1850,7540,6780,5690,65.08264462809917,0.07278688524590164,Very Cheap
20141121T000000,628000.0,5,2.75,2830,11795,1.0,0,0,4,7,1710,1120,1960,0,98008,47.5828,-122.118,2460,10880,8965,8420,53.24289953370072,0.07252459016393442,Very Cheap
20140814T000000,655000.0,5,2.5,2560,46786,2.0,0,0,3,8,2560,0,1995,0,98019,47.7125,-121.915,2430,46929,44226,44499,13.999914504338905,0.0760655737704918,Very Cheap
20150122T000000,170000.0,2,1.0,1240,9900,1.0,0,0,3,7,940,300,1950,0,98168,47.4862,-122.326,1050,9375,8660,8325,17.171717171717173,0.012459016393442624,Very Cheap
20141217T000000,352500.0,4,2.5,2100,10750,1.0,0,2,4,8,2100,0,1967,0,98023,47.3338,-122.337,2310,10425,8650,8115,32.7906976744186,0.03639344262295082,Very Cheap
20150219T000000,615000.0,4,2.75,3120,34040,2.0,0,0,3,9,3120,0,1997,0,98010,47.3431,-122.03,2420,25201,30920,22781,18.066980023501763,0.07081967213114754,Very Cheap
20140610T000000,165000.0,3,1.0,970,6600,1.0,0,0,3,7,970,0,1965,0,98168,47.4836,-122.332,1200,6600,5630,5400,25.0,0.01180327868852459,Very Cheap
20140923T000000,243500.0,4,2.5,2300,15188,2.0,0,0,4,7,2300,0,1966,0,98042,47.3683,-122.164,1820,10125,12888,8305,16.032393995259415,0.022098360655737705,Very Cheap
20140806T000000,304000.0,2,1.5,950,676,2.0,0,0,3,7,850,100,2003,0,98144,47.6005,-122.306,950,1280,-274,330,449.70414201183434,0.030032786885245903,Very Cheap
20141016T000000,369000.0,3,1.5,2110,5195,1.0,0,0,3,7,1210,900,1959,0,98118,47.5283,-122.286,1950,5195,3085,3245,71.02983638113571,0.03855737704918033,Very Cheap
20141007T000000,779950.0,4,2.75,2990,4298,2.0,0,0,3,9,2990,0,2014,0,98052,47.7101,-122.108,2990,4837,1308,1847,181.46812470916706,0.09245245901639344,Very Cheap
20140702T000000,605000.0,4,2.25,2940,48788,1.0,0,0,5,7,1520,1420,1961,0,98028,47.7422,-122.245,2470,14900,45848,12430,12.400590309092399,0.06950819672131148,Very Cheap
20141223T000000,292500.0,4,2.5,1860,8709,2.0,0,0,3,8,1860,0,1994,0,98092,47.3289,-122.17,1990,6825,6849,4835,33.585945573544606,0.028524590163934428,Very Cheap
20150323T000000,500007.0,2,1.75,1820,6050,1.0,0,0,3,7,910,910,1950,0,98115,47.6928,-122.323,1730,6050,4230,4320,82.64578512396695,0.055738622950819675,Very Cheap
20150429T000000,449999.0,4,2.5,1950,4947,2.0,0,0,3,8,1950,0,2000,0,98056,47.5042,-122.193,1760,5611,2997,3851,90.96401859712957,0.04918019672131148,Very Cheap
20140627T000000,355000.0,4,2.5,1890,7867,2.0,0,0,3,8,1890,0,1996,0,98038,47.3788,-122.031,2250,7867,5977,5617,45.12520655904411,0.036721311475409836,Very Cheap
20141125T000000,258000.0,4,3.0,2710,7199,1.0,0,0,4,7,1710,1000,1967,0,98030,47.3789,-122.213,2070,9271,4489,7201,35.838310876510626,0.024,Very Cheap
20140619T000000,380000.0,4,2.25,2150,20181,1.0,0,0,3,7,1090,1060,1963,0,98028,47.7627,-122.245,2150,10480,18031,8330,18.829592190674397,0.04,Very Cheap
20140708T000000,650000.0,4,3.0,3720,57499,1.0,0,0,3,9,1880,1840,2003,0,98014,47.6469,-121.897,2560,26372,53779,23812,11.304544426859598,0.07540983606557378,Very Cheap
20150514T000000,456500.0,4,2.5,2580,11780,2.0,0,0,3,9,2580,0,2003,0,98038,47.3658,-122.04,2410,8403,9200,5993,38.75212224108659,0.0500327868852459,Very Cheap
20140825T000000,259950.0,4,2.0,1540,10212,1.5,0,0,5,7,1540,0,1948,0,98022,47.2056,-121.999,1480,10212,8672,8732,25.455346650998823,0.024255737704918033,Very Cheap
20140702T000000,123000.0,2,1.0,1050,6600,1.5,0,0,3,6,1050,0,1964,0,98168,47.4828,-122.324,1330,6600,5550,5270,18.636363636363637,0.006295081967213114,Very Cheap
20140730T000000,520000.0,3,2.25,1210,1250,3.0,0,0,3,8,1210,0,2014,0,98107,47.6722,-122.384,1780,5000,40,3220,416.0,0.058360655737704915,Very Cheap
20150416T000000,506000.0,4,2.25,2040,12000,1.0,0,0,4,7,1300,740,1963,0,98028,47.7362,-122.241,1930,12000,9960,10070,42.166666666666664,0.05652459016393443,Very Cheap
20140730T000000,425000.0,3,1.0,980,4800,1.5,0,0,3,7,980,0,1926,0,98118,47.5663,-122.274,2030,7200,3820,5170,88.54166666666667,0.04590163934426229,Very Cheap
20141205T000000,438000.0,5,2.5,1990,6840,2.0,0,0,4,7,1990,0,1974,0,98034,47.7162,-122.166,1990,7150,4850,5160,64.03508771929825,0.04760655737704918,Very Cheap
20150129T000000,1490000.0,4,2.5,2420,18480,1.0,0,0,4,9,2420,0,1967,0,98004,47.6214,-122.227,3330,19910,16060,16580,80.62770562770562,0.1855737704918033,Cheap
20140616T000000,375000.0,4,2.0,1240,3000,1.0,0,0,3,7,1040,200,1908,0,98122,47.6076,-122.298,1480,3500,1760,2020,125.0,0.03934426229508197,Very Cheap
20150429T000000,337500.0,3,2.25,1530,6600,1.0,0,0,4,7,1240,290,1968,0,98055,47.462,-122.188,1500,7700,5070,6200,51.13636363636363,0.03442622950819672,Very Cheap
20140930T000000,300000.0,4,2.25,2080,7700,1.0,0,0,3,7,1450,630,1968,0,98058,47.4349,-122.17,1900,7980,5620,6080,38.96103896103896,0.029508196721311476,Very Cheap
20140728T000000,627000.0,5,3.25,3570,5425,2.0,0,0,3,7,3570,0,2005,0,98075,47.5933,-122.007,2690,5347,1855,2657,115.57603686635944,0.07239344262295082,Very Cheap
20141022T000000,1400000.0,5,4.25,4230,6907,2.0,0,0,3,10,3450,780,2008,0,98033,47.6866,-122.205,2650,8076,2677,5426,202.69292022585782,0.1737704918032787,Cheap
20150512T000000,674725.0,4,2.5,2700,10160,2.0,0,0,3,9,2700,0,1988,0,98029,47.5685,-122.012,2760,9219,7460,6459,66.4099409448819,0.07865245901639344,Very Cheap
20140618T000000,325000.0,3,2.75,2200,7000,1.0,0,0,4,7,1280,920,1977,0,98058,47.4574,-122.169,1670,7000,4800,5330,46.42857142857143,0.03278688524590164,Very Cheap
20150402T000000,230000.0,5,2.0,1210,12538,2.0,0,0,3,7,1210,0,1982,0,98023,47.2848,-122.361,1510,7700,11328,6190,18.344233530068593,0.020327868852459016,Very Cheap
20140729T000000,485000.0,5,1.75,2140,43124,1.0,0,2,4,7,1220,920,1962,0,98027,47.5516,-122.085,2520,14677,40984,12157,11.246637603190798,0.05377049180327869,Very Cheap
20140923T000000,315000.0,4,2.5,2740,8400,1.5,0,2,3,8,2740,0,1993,0,98022,47.1947,-122.008,2030,8638,5660,6608,37.5,0.031475409836065574,Very Cheap
20150403T000000,560000.0,3,2.75,1370,1193,3.0,0,0,3,8,1370,0,2003,0,98107,47.67,-122.392,1320,1180,-177,-140,469.4048616932104,0.06360655737704918,Very Cheap
20140812T000000,444000.0,4,3.0,2800,7198,2.0,0,0,3,8,2800,0,2002,0,98038,47.3538,-122.013,3610,7845,4398,4235,61.683801055848846,0.04839344262295082,Very Cheap
20150507T000000,325000.0,3,1.5,1060,7488,1.0,0,0,5,7,1060,0,1977,0,98106,47.5549,-122.356,1300,6780,6428,5480,43.40277777777778,0.03278688524590164,Very Cheap
20140916T000000,118125.0,2,1.0,790,7153,1.0,0,0,4,6,790,0,1944,0,98168,47.4869,-122.324,810,7128,6363,6318,16.514050048930518,0.005655737704918033,Very Cheap
20150114T000000,212000.0,2,1.0,790,7153,1.0,0,0,4,6,790,0,1944,0,98168,47.4869,-122.324,810,7128,6363,6318,29.637914161890116,0.017967213114754098,Very Cheap
20150309T000000,428900.0,4,2.5,2820,5056,2.0,0,0,3,9,2820,0,2006,0,98038,47.3591,-122.038,2820,5150,2236,2330,84.82990506329114,0.04641311475409836,Very Cheap
20150123T000000,510000.0,3,2.0,1850,9600,1.0,0,0,3,7,1850,0,1968,1998,98011,47.7671,-122.225,1770,9600,7750,7830,53.125,0.057049180327868855,Very Cheap
20140523T000000,416000.0,3,1.5,1110,9762,1.0,0,0,4,7,1110,0,1963,0,98052,47.676,-122.15,1900,9720,8652,7820,42.61421839786929,0.044721311475409836,Very Cheap
20141009T000000,950000.0,4,3.0,3230,438213,2.0,0,0,3,9,3230,0,1999,0,98070,47.4141,-122.47,1600,144619,434983,143019,2.1678955211278534,0.11475409836065574,Cheap
20150227T000000,204000.0,3,1.5,1460,7140,1.0,0,0,4,7,980,480,1980,0,98031,47.3954,-122.191,1400,8572,5680,7172,28.571428571428573,0.016918032786885247,Very Cheap
20141013T000000,7700000.0,6,8.0,12050,27600,2.5,0,3,4,13,8570,3480,1910,1987,98102,47.6298,-122.323,3940,8800,15550,4860,278.9855072463768,1.0,Very High
20141007T000000,878000.0,4,2.5,3480,13421,2.0,0,0,3,11,3480,0,1995,0,98027,47.5504,-122.097,3290,9642,9941,6352,65.41986439162507,0.10531147540983607,Cheap
20140826T000000,1045000.0,4,3.0,3560,4000,3.0,0,2,3,9,2970,590,1996,0,98112,47.6265,-122.3,1190,4000,440,2810,261.25,0.12721311475409836,Cheap
20150130T000000,350000.0,2,1.0,840,5551,1.0,0,0,3,6,840,0,1952,0,98118,47.5354,-122.28,1270,4652,4711,3382,63.05170239596469,0.036065573770491806,Very Cheap
20140610T000000,659500.0,3,1.75,1820,5500,1.0,0,0,4,8,1620,200,1957,0,98115,47.6737,-122.283,2330,6050,3680,3720,119.9090909090909,0.07665573770491803,Very Cheap
20150313T000000,395000.0,3,2.5,1630,15200,1.0,0,0,3,7,1120,510,1988,0,98072,47.7454,-122.103,2050,15200,13570,13150,25.986842105263158,0.0419672131147541,Very Cheap
20140708T000000,308950.0,4,2.5,1920,8562,2.0,0,2,4,7,1920,0,1994,0,98022,47.1932,-122.008,1820,8628,6642,6808,36.083858911469285,0.030681967213114753,Very Cheap
20150501T000000,410000.0,3,2.0,1750,2550,1.0,0,0,3,7,1750,0,1955,0,98133,47.7329,-122.343,1370,1533,800,163,160.7843137254902,0.043934426229508196,Very Cheap
20141016T000000,710000.0,4,3.0,2750,7500,1.0,0,0,5,8,1630,1120,1966,0,98177,47.7134,-122.361,2440,7500,4750,5060,94.66666666666667,0.08327868852459017,Very Cheap
20150428T000000,175000.0,1,1.0,620,8685,1.0,0,0,4,5,620,0,1976,0,98198,47.4095,-122.29,1300,12150,8065,10850,20.149683362118594,0.013114754098360656,Very Cheap
20150327T000000,508800.0,3,2.0,1720,10098,1.0,0,0,4,8,1140,580,1981,0,98074,47.6231,-122.043,1840,10098,8378,8258,50.386215092097444,0.05689180327868852,Very Cheap
20141009T000000,606400.0,3,3.0,1800,5000,1.5,0,2,3,8,1500,300,1929,0,98119,47.6475,-122.371,1670,5000,3200,3330,121.28,0.06969180327868853,Very Cheap
20140528T000000,245100.0,3,1.75,1300,7958,1.0,0,0,3,7,1300,0,1996,0,98092,47.3162,-122.194,1640,8698,6658,7058,30.799195777833628,0.022308196721311475,Very Cheap
20150501T000000,540000.0,3,2.5,1970,14876,1.0,0,0,3,7,1320,650,1981,0,98146,47.5031,-122.372,2030,8008,12906,5978,36.30008066684593,0.06098360655737705,Very Cheap
20150507T000000,415000.0,3,1.5,1740,9046,1.0,0,0,3,7,1740,0,1956,0,98028,47.7402,-122.255,1830,9513,7306,7683,45.87663055494141,0.04459016393442623,Very Cheap
20150105T000000,469500.0,4,2.75,1930,13041,1.0,0,0,4,8,1180,750,1980,0,98072,47.7502,-122.085,1880,10234,11111,8354,36.00184034966644,0.051737704918032784,Very Cheap
20141106T000000,195000.0,3,1.75,1190,14777,1.0,0,0,4,7,1190,0,1965,0,98023,47.2933,-122.377,2240,8325,13587,6085,13.196183257765446,0.015737704918032787,Very Cheap
20141006T000000,1615000.0,4,3.25,4250,12281,2.0,0,4,3,12,3020,1230,1996,0,98006,47.5507,-122.113,4940,12941,8031,8001,131.50394918980538,0.2019672131147541,Cheap
20141013T000000,1450000.0,4,3.5,4360,24603,2.0,0,0,3,12,4360,0,1998,0,98074,47.6035,-122.005,4770,27521,20243,22751,58.935902125757025,0.18032786885245902,Cheap
20141030T000000,1200000.0,3,2.5,3420,16622,1.0,0,4,3,10,2410,1010,1991,0,98006,47.5638,-122.105,3460,14566,13202,11106,72.19347852244015,0.14754098360655737,Cheap
20140709T000000,1065000.0,4,3.75,4260,9800,2.0,0,0,3,10,4260,0,2008,0,98033,47.6739,-122.172,1950,8970,5540,7020,108.6734693877551,0.1298360655737705,Cheap
20150507T000000,555500.0,2,1.0,920,10000,1.0,0,0,4,7,920,0,1981,0,98033,47.6938,-122.21,1340,10000,9080,8660,55.55,0.06301639344262296,Very Cheap
20150512T000000,440000.0,3,1.0,1040,4000,1.0,0,0,3,7,1040,0,1950,0,98122,47.6178,-122.292,1170,4000,2960,2830,110.0,0.04786885245901639,Very Cheap
20150423T000000,485000.0,3,1.0,1260,7250,1.0,0,2,3,7,960,300,1940,0,98115,47.6947,-122.311,1540,7250,5990,5710,66.89655172413794,0.05377049180327869,Very Cheap
20140531T000000,693000.0,3,2.5,2460,12028,2.0,0,0,3,9,2460,0,1996,0,98052,47.691,-122.095,2540,12229,9568,9689,57.61556368473562,0.08104918032786886,Very Cheap
20140724T000000,295000.0,3,1.0,830,3386,1.0,0,0,3,6,830,0,1942,1989,98133,47.7027,-122.355,1300,3844,2556,2544,87.12344949793267,0.028852459016393443,Very Cheap
20150330T000000,700000.0,3,2.5,2060,10650,1.0,0,0,5,8,1050,1010,1976,0,98006,47.5627,-122.137,2690,8850,8590,6160,65.72769953051643,0.08196721311475409,Very Cheap
20141216T000000,767500.0,2,1.75,2210,9374,1.0,0,3,4,8,1560,650,1951,0,98107,47.6634,-122.359,2140,5640,7164,3500,81.87540004267122,0.09081967213114754,Very Cheap
20141201T000000,800000.0,6,4.25,5480,189050,2.0,0,0,4,10,5140,340,1991,0,98031,47.412,-122.168,2470,10429,183570,7959,4.231684739486909,0.09508196721311475,Very Cheap
20140708T000000,440000.0,3,2.0,1860,217800,2.0,0,2,3,8,1860,0,1998,0,98059,47.5157,-122.107,2500,217800,215940,215300,2.0202020202020203,0.04786885245901639,Very Cheap
20141029T000000,600000.0,3,2.5,1350,187313,1.0,0,0,4,7,1350,0,1997,0,98077,47.7369,-122.049,2310,49222,185963,46912,3.2031946528003927,0.06885245901639345,Very Cheap
20140917T000000,1160000.0,4,2.5,2790,5450,2.0,0,0,3,10,1930,860,1925,2000,98112,47.6453,-122.303,2320,5450,2660,3130,212.8440366972477,0.1422950819672131,Cheap
20140619T000000,506000.0,2,1.0,1570,8210,1.0,0,0,4,8,1150,420,1952,0,98177,47.7221,-122.371,1680,8196,6640,6516,61.63215590742996,0.05652459016393443,Very Cheap
20150311T000000,474950.0,4,1.75,2030,15400,1.0,0,1,3,9,1130,900,1975,0,98166,47.4603,-122.365,2040,12425,13370,10385,30.84090909090909,0.05245245901639344,Very Cheap
20141211T000000,654000.0,3,2.5,2570,5500,1.0,0,0,4,7,1320,1250,1961,0,98199,47.6417,-122.397,1460,6250,2930,4790,118.9090909090909,0.0759344262295082,Very Cheap
20140911T000000,710000.0,2,1.0,1210,6000,1.0,0,0,4,7,1000,210,1942,0,98199,47.6482,-122.402,1840,6000,4790,4160,118.33333333333333,0.08327868852459017,Very Cheap
20140811T000000,620000.0,4,2.25,1530,7845,1.0,0,0,4,7,1030,500,1981,0,98027,47.5589,-122.082,1710,7627,6315,5917,79.03123008285532,0.07147540983606557,Very Cheap
20141028T000000,390000.0,3,2.0,1510,10827,2.0,0,0,3,7,1510,0,1984,0,98052,47.654,-122.127,1900,10908,9317,9008,36.02105846494874,0.04131147540983607,Very Cheap
20140630T000000,550000.0,3,2.25,1720,9600,1.0,0,0,4,7,1220,500,1967,0,98052,47.6581,-122.126,1720,9600,7880,7880,57.291666666666664,0.06229508196721312,Very Cheap
20141002T000000,353000.0,3,1.75,2190,7021,1.0,0,2,4,7,1390,800,1953,0,98178,47.5033,-122.232,2180,7155,4831,4975,50.27773821392964,0.03645901639344262,Very Cheap
20140827T000000,465000.0,4,2.5,3030,47958,1.0,0,0,3,8,1660,1370,1980,0,98027,47.4598,-122.004,2740,36017,44928,33277,9.69598398598774,0.051147540983606556,Very Cheap
20150128T000000,279900.0,3,2.0,1410,6600,1.0,0,0,4,7,1410,0,1990,0,98042,47.3596,-122.089,1750,7150,5190,5400,42.40909090909091,0.026872131147540983,Very Cheap
20141120T000000,700000.0,2,1.75,1679,577605,2.0,0,0,3,9,1679,0,2001,0,98070,47.463,-122.475,1850,358934,575926,357084,1.2119008665091195,0.08196721311475409,Very Cheap
20140619T000000,395000.0,4,1.0,1980,10350,1.0,0,0,4,7,1430,550,1968,0,98027,47.5226,-122.045,1890,13140,8370,11250,38.16425120772947,0.0419672131147541,Very Cheap
20140910T000000,375000.0,4,2.5,1900,9428,2.0,0,0,3,8,1900,0,1978,0,98028,47.7628,-122.244,1830,10480,7528,8650,39.77513788714467,0.03934426229508197,Very Cheap
20140617T000000,547000.0,4,1.0,1720,2800,1.5,0,0,4,7,1200,520,1926,0,98115,47.6743,-122.299,1530,3500,1080,1970,195.35714285714286,0.061901639344262294,Very Cheap
20150403T000000,525000.0,5,3.25,2480,10277,2.0,0,0,5,8,1640,840,1993,0,98155,47.7726,-122.286,2270,10277,7797,8007,51.08494696895981,0.05901639344262295,Very Cheap
20140619T000000,285000.0,3,1.0,1210,4731,1.5,0,0,3,7,1210,0,1901,0,98117,47.6865,-122.397,1450,5264,3521,3814,60.24096385542169,0.02754098360655738,Very Cheap
20140520T000000,570000.0,2,1.75,1540,4025,1.0,0,0,4,7,1190,350,1908,0,98116,47.5876,-122.391,1950,4420,2485,2470,141.61490683229815,0.06491803278688525,Very Cheap
20150324T000000,409000.0,3,2.5,2740,9168,2.0,0,0,3,9,2740,0,1991,0,98042,47.3835,-122.148,2690,10554,6428,7864,44.61169284467714,0.04380327868852459,Very Cheap
20140608T000000,260000.0,4,2.5,1811,4381,2.0,0,0,3,8,1811,0,2007,0,98055,47.454,-122.19,1811,4150,2570,2339,59.347181008902076,0.024262295081967214,Very Cheap
20140916T000000,348000.0,4,2.5,2720,7697,1.0,0,0,4,8,2120,600,1987,0,98058,47.4391,-122.161,2340,7700,4977,5360,45.21242042354164,0.03580327868852459,Very Cheap
20140806T000000,389000.0,4,1.0,1520,9800,1.5,0,0,4,7,1520,0,1971,0,98034,47.7303,-122.236,1540,7700,8280,6160,39.69387755102041,0.04118032786885246,Very Cheap
20141217T000000,445000.0,4,2.75,2160,7200,1.0,0,0,4,7,1220,940,1976,0,98034,47.7177,-122.224,1790,7614,5040,5824,61.80555555555556,0.04852459016393443,Very Cheap
20140721T000000,400000.0,3,1.75,1390,4602,1.0,0,0,3,7,930,460,1981,0,98117,47.6944,-122.366,1230,4800,3212,3570,86.91873098652759,0.04262295081967213,Very Cheap
20140915T000000,302000.0,4,2.5,1740,7895,2.0,0,0,3,7,1740,0,1999,0,98001,47.3401,-122.282,1720,6813,6155,5093,38.25205826472451,0.02977049180327869,Very Cheap
20141021T000000,798000.0,3,2.5,2849,9588,2.0,0,0,3,10,2849,0,2001,0,98074,47.6487,-122.079,3190,8897,6739,5707,83.22903629536921,0.09481967213114754,Very Cheap
20140724T000000,335000.0,2,1.0,1440,8842,1.0,0,0,3,7,840,600,1950,0,98155,47.7443,-122.325,1650,8461,7402,6811,37.88735580185478,0.03409836065573771,Very Cheap
20150107T000000,585000.0,4,2.5,3000,6892,2.0,0,0,3,8,3000,0,2005,0,98072,47.7623,-122.165,3000,6589,3892,3589,84.88102147417295,0.06688524590163934,Very Cheap
20150428T000000,2500000.0,4,4.0,3330,24354,1.0,0,0,4,10,3330,0,1961,0,98006,47.5708,-122.192,3880,25493,21024,21613,102.65254167693192,0.3180327868852459,Medium
20141201T000000,555000.0,4,2.25,1720,2300,1.0,0,0,3,7,860,860,1940,2014,98116,47.5762,-122.412,1720,4680,580,2960,241.30434782608697,0.06295081967213115,Very Cheap
20140825T000000,3100000.0,3,3.0,3920,13085,2.0,1,4,4,11,3920,0,1996,0,98040,47.5716,-122.204,3450,13287,9165,9837,236.9124952235384,0.39672131147540984,Medium
20150218T000000,295000.0,3,2.5,1500,3060,2.0,0,0,3,7,1500,0,1994,0,98006,47.5605,-122.117,2700,7734,1560,5034,96.40522875816994,0.028852459016393443,Very Cheap
20140618T000000,265000.0,4,1.5,2050,7100,1.0,0,0,3,7,1050,1000,1963,0,98001,47.3395,-122.28,1950,7350,5050,5400,37.32394366197183,0.024918032786885248,Very Cheap
20150105T000000,330000.0,4,2.0,1180,7275,1.0,0,0,3,7,1180,0,1965,0,98034,47.7301,-122.2,1210,7275,6095,6065,45.36082474226804,0.03344262295081967,Very Cheap
20150218T000000,286000.0,4,1.5,1600,5750,2.0,0,0,4,6,1600,0,1902,0,98118,47.5437,-122.28,1690,5750,4150,4060,49.73913043478261,0.027672131147540982,Very Cheap
20150331T000000,305000.0,3,2.5,1260,895,3.0,0,0,3,7,1160,100,2009,0,98133,47.7072,-122.336,1190,1095,-365,-95,340.78212290502796,0.03016393442622951,Very Cheap
20150403T000000,970000.0,2,1.0,1290,5376,1.0,0,0,3,6,1290,0,1945,0,98115,47.6966,-122.315,1180,5376,4086,4196,180.43154761904762,0.11737704918032787,Cheap
20150414T000000,525000.0,4,2.0,2680,14157,1.0,0,0,3,8,1460,1220,1966,0,98188,47.4286,-122.292,2100,9199,11477,7099,37.0841279932189,0.05901639344262295,Very Cheap
20141202T000000,355000.0,3,1.75,2370,9750,1.0,0,0,4,7,1280,1090,1979,0,98045,47.4459,-121.773,1230,9775,7380,8545,36.41025641025641,0.036721311475409836,Very Cheap
20141010T000000,469950.0,5,2.5,2310,8303,1.0,0,0,3,7,1300,1010,1975,0,98034,47.7212,-122.211,1930,8303,5993,6373,56.60002408767915,0.05179672131147541,Very Cheap
20140502T000000,435000.0,4,1.0,1450,8800,1.0,0,0,4,7,1450,0,1954,0,98006,47.5746,-122.135,1260,8942,7350,7682,49.43181818181818,0.04721311475409836,Very Cheap
20140922T000000,363500.0,4,2.5,2680,7700,2.0,0,0,4,8,2680,0,1990,0,98031,47.4094,-122.17,2400,7700,5020,5300,47.20779220779221,0.03783606557377049,Very Cheap
20140523T000000,595000.0,2,1.5,1030,4500,1.0,0,0,3,7,830,200,1924,0,98109,47.6455,-122.352,1250,4000,3470,2750,132.22222222222223,0.06819672131147542,Very Cheap
20141112T000000,275000.0,3,1.0,1320,11090,1.0,0,0,3,7,1320,0,1955,0,98155,47.7748,-122.304,1320,8319,9770,6999,24.79711451758341,0.02622950819672131,Very Cheap
20150408T000000,295000.0,2,1.0,670,7952,1.0,0,0,4,6,670,0,1942,0,98146,47.5124,-122.372,1080,9525,7282,8445,37.09758551307847,0.028852459016393443,Very Cheap
20150116T000000,345000.0,3,2.25,2670,37089,2.0,0,0,3,9,2670,0,1990,0,98042,47.3347,-122.077,2290,36284,34419,33994,9.301949365040848,0.03540983606557377,Very Cheap
20140701T000000,485000.0,3,2.25,2440,47916,2.0,0,0,3,8,2090,350,1991,0,98053,47.6347,-121.958,2150,24000,45476,21850,10.1218799565907,0.05377049180327869,Very Cheap
20141215T000000,1245000.0,5,2.5,3370,8113,2.0,0,0,3,9,3370,0,2005,0,98004,47.5812,-122.196,2470,8113,4743,5643,153.45741402687045,0.15344262295081967,Cheap
20150129T000000,340500.0,2,1.0,940,5413,1.0,0,0,3,7,940,0,1923,0,98115,47.6956,-122.304,1340,5296,4473,3956,62.90411971180492,0.03481967213114754,Very Cheap
20141010T000000,280000.0,3,1.0,1100,5132,1.0,0,0,3,6,840,260,1948,0,98103,47.7011,-122.336,1280,5132,4032,3852,54.55962587685113,0.026885245901639345,Very Cheap
20141211T000000,449888.0,3,2.25,2520,78408,2.0,0,0,3,9,2520,0,1988,0,98001,47.3514,-122.279,1490,29972,75888,28482,5.73778185899398,0.049165639344262296,Very Cheap
20141028T000000,483000.0,2,1.75,1400,4720,1.0,0,0,4,7,820,580,1927,0,98116,47.5705,-122.392,1330,6786,3320,5456,102.33050847457628,0.05350819672131148,Very Cheap
20141120T000000,445500.0,3,1.75,1880,9360,1.0,0,0,4,7,940,940,1941,0,98125,47.7131,-122.283,1390,7200,7480,5810,47.59615384615385,0.04859016393442623,Very Cheap
20140617T000000,379900.0,5,3.5,2800,7350,2.0,0,0,3,7,2800,0,1995,0,98106,47.5273,-122.345,2190,7620,4550,5430,51.68707482993197,0.03998688524590164,Very Cheap
20140702T000000,599950.0,4,3.5,2500,3080,2.0,0,0,3,8,1810,690,2008,0,98052,47.6749,-122.14,2060,3295,580,1235,194.78896103896105,0.06884590163934426,Very Cheap
20141009T000000,215000.0,3,1.0,810,5240,1.0,0,0,3,6,810,0,1942,0,98166,47.4734,-122.35,1700,5245,4430,3545,41.030534351145036,0.018360655737704918,Very Cheap
20140718T000000,263000.0,3,2.5,1720,6847,2.0,0,0,3,7,1720,0,1987,0,98001,47.3266,-122.272,1610,7790,5127,6180,38.410982912224334,0.024655737704918034,Very Cheap
20150209T000000,565000.0,4,1.0,2170,12100,1.0,0,0,5,7,2170,0,1961,0,98033,47.6893,-122.164,1270,12844,9930,11574,46.69421487603306,0.06426229508196721,Very Cheap
20140512T000000,950000.0,5,3.0,4530,258746,1.5,0,0,4,9,3200,1330,2003,0,98077,47.7702,-122.066,3430,83199,254216,79769,3.6715543428690687,0.11475409836065574,Cheap
20140909T000000,395000.0,4,1.0,1440,8320,1.5,0,0,3,7,1440,0,1946,0,98155,47.7529,-122.318,1440,9230,6880,7790,47.47596153846154,0.0419672131147541,Very Cheap
20141230T000000,1535000.0,4,3.25,2850,4100,2.0,0,3,3,10,1820,1030,1908,2003,98122,47.6147,-122.285,2130,4200,1250,2070,374.390243902439,0.19147540983606556,Cheap
20141029T000000,922000.0,4,2.5,2620,14126,1.0,0,4,4,8,1620,1000,1941,0,98117,47.6983,-122.397,2620,8905,11506,6285,65.26971541837746,0.11108196721311475,Cheap
20141212T000000,330000.0,3,2.5,1676,18778,2.0,0,0,3,7,1676,0,1997,0,98014,47.6521,-121.905,1410,18778,17102,17368,17.573756523591438,0.03344262295081967,Very Cheap
20150210T000000,1525000.0,4,3.75,5850,35070,2.0,0,0,4,12,4410,1440,1990,0,98006,47.5485,-122.124,4830,36200,29220,31370,43.48445965212432,0.1901639344262295,Cheap
20141209T000000,323000.0,3,1.75,1910,8329,1.0,0,0,3,8,1910,0,2004,0,98022,47.19,-122.016,2510,9259,6419,6749,38.7801656861568,0.03252459016393443,Very Cheap
20140710T000000,554000.0,2,2.0,1670,4996,1.0,0,0,3,8,1670,0,2004,0,98053,47.7141,-122.031,1670,4996,3326,3326,110.88871096877502,0.06281967213114754,Very Cheap
20150410T000000,500000.0,3,2.0,2050,11454,1.0,0,0,3,8,2050,0,1987,0,98052,47.6389,-122.11,1980,11424,9404,9444,43.65287235900122,0.05573770491803279,Very Cheap
20150513T000000,775000.0,5,3.5,3730,16679,1.0,0,0,3,10,2760,970,1990,0,98075,47.5987,-122.029,3280,16679,12949,13399,46.465615444571014,0.09180327868852459,Very Cheap
20140715T000000,340000.0,4,1.75,1800,5210,1.0,0,0,5,7,1080,720,1979,0,98118,47.5298,-122.28,1870,5365,3410,3495,65.25911708253359,0.03475409836065574,Very Cheap
20150406T000000,560000.0,4,1.75,2230,6838,1.0,0,0,3,7,1320,910,1985,0,98008,47.5742,-122.118,1580,7500,4608,5920,81.89529102076631,0.06360655737704918,Very Cheap
20150406T000000,304000.0,3,2.5,1670,5298,2.0,0,0,3,8,1670,0,2002,0,98042,47.3925,-122.165,1920,5298,3628,3378,57.380143450358624,0.030032786885245903,Very Cheap
20141107T000000,279900.0,3,1.0,1400,10800,1.0,0,0,3,6,1400,0,1962,0,98034,47.719,-122.202,1430,10000,9400,8570,25.916666666666668,0.026872131147540983,Very Cheap
20150304T000000,315000.0,5,3.0,2110,10766,2.0,0,0,3,7,2110,0,2005,0,98030,47.3599,-122.176,1460,10400,8656,8940,29.258777633289988,0.031475409836065574,Very Cheap
20140621T000000,849000.0,4,2.0,2160,6300,1.5,0,1,4,8,2160,0,1928,0,98116,47.5662,-122.404,1980,5152,4140,3172,134.76190476190476,0.10150819672131148,Cheap
20150210T000000,325000.0,3,1.75,2420,14862,1.0,0,0,3,8,1380,1040,1977,0,98023,47.3301,-122.365,2550,14675,12442,12125,21.867850894899743,0.03278688524590164,Very Cheap
20140926T000000,786000.0,4,3.5,3320,8808,2.0,0,0,3,9,3320,0,2005,0,98075,47.592,-121.989,3160,9226,5488,6066,89.23705722070845,0.09324590163934426,Very Cheap
20140915T000000,384000.0,5,2.75,3220,8160,2.0,0,0,3,9,3220,0,1999,0,98001,47.3154,-122.254,2876,11521,4940,8645,47.05882352941177,0.04052459016393443,Very Cheap
20141124T000000,907000.0,3,1.5,1340,6000,1.5,0,1,3,9,1340,0,1927,0,98105,47.66,-122.282,2600,6000,4660,3400,151.16666666666666,0.10911475409836066,Cheap
20140702T000000,700000.0,3,2.5,2490,23891,2.0,0,0,3,9,2490,0,1993,0,98053,47.6716,-122.029,2900,34705,21401,31805,29.29973630237328,0.08196721311475409,Very Cheap
20140826T000000,269500.0,3,2.0,1640,8395,1.0,0,0,4,7,1640,0,1991,0,98038,47.348,-122.035,1510,7180,6755,5670,32.10244192972007,0.025508196721311476,Very Cheap
20150222T000000,269000.0,3,2.25,1420,7297,1.0,0,0,3,7,1130,290,1984,0,98031,47.4046,-122.194,1730,7419,5877,5689,36.864464848567906,0.02544262295081967,Very Cheap
20141111T000000,749950.0,4,2.5,3340,123600,2.0,0,0,3,10,3340,0,2005,0,98053,47.6101,-121.955,3730,123600,120260,119870,6.067556634304207,0.08851803278688525,Very Cheap
20150316T000000,325000.0,3,2.75,1580,4007,2.0,0,0,3,7,1580,0,2001,0,98019,47.7367,-121.969,1770,3799,2427,2029,81.10806089343649,0.03278688524590164,Very Cheap
20140606T000000,1150000.0,3,1.5,2170,16600,1.0,1,2,3,10,1130,1040,1979,0,98052,47.6307,-122.088,3130,13875,14430,10745,69.27710843373494,0.14098360655737704,Cheap
20141216T000000,406000.0,3,1.5,1370,7853,1.0,0,0,4,7,1370,0,1962,0,98056,47.5409,-122.18,1730,9465,6483,7735,51.69998726601299,0.04340983606557377,Very Cheap
20140606T000000,650000.0,4,2.5,2840,9354,2.0,0,0,3,10,2840,0,1990,0,98074,47.6274,-122.04,2540,10200,6514,7660,69.48898866794954,0.07540983606557378,Very Cheap
20140707T000000,295000.0,3,1.75,1940,7500,1.5,0,0,4,8,1940,0,1918,1985,98022,47.2062,-121.993,1650,7500,5560,5850,39.333333333333336,0.028852459016393443,Very Cheap
20141009T000000,375000.0,4,2.0,1757,19370,1.0,0,2,5,7,1757,0,1955,0,98198,47.3974,-122.312,1850,11125,17613,9275,19.359834796076406,0.03934426229508197,Very Cheap
20150227T000000,395000.0,2,1.0,980,5100,1.0,0,0,4,6,980,0,1907,0,98117,47.6824,-122.38,1190,5100,4120,3910,77.45098039215686,0.0419672131147541,Very Cheap
20141231T000000,609000.0,6,3.0,2470,9267,2.0,0,0,3,8,2470,0,1982,0,98007,47.6025,-122.152,2470,9151,6797,6681,65.71706053739074,0.0700327868852459,Very Cheap
20140910T000000,510000.0,3,1.75,1610,11950,1.0,0,2,3,7,1210,400,1984,0,98052,47.6705,-122.138,1610,9363,10340,7753,42.67782426778243,0.057049180327868855,Very Cheap
20140530T000000,190000.0,3,2.25,1590,11745,1.0,0,0,3,7,1090,500,1978,0,98001,47.3553,-122.28,1540,12530,10155,10990,16.17709663686675,0.015081967213114755,Very Cheap
20140805T000000,250000.0,1,1.0,780,1033,1.0,0,0,3,7,780,0,1922,1985,98122,47.6155,-122.306,1040,1319,253,279,242.0135527589545,0.022950819672131147,Very Cheap
20141107T000000,295000.0,3,1.5,720,7450,1.0,0,1,1,5,720,0,1924,0,98126,47.584,-122.375,2600,7360,6730,4760,39.59731543624161,0.028852459016393443,Very Cheap
20150421T000000,740000.0,3,1.5,1630,4080,1.5,0,0,4,8,1630,0,1927,0,98115,47.6756,-122.308,1950,4080,2450,2130,181.37254901960785,0.08721311475409836,Very Cheap
20150217T000000,323000.0,3,1.0,1590,7759,2.0,0,0,4,7,1590,0,1912,1984,98065,47.5217,-121.819,1600,7200,6169,5600,41.62907591184431,0.03252459016393443,Very Cheap
20150303T000000,713000.0,3,2.75,2310,1850,2.0,0,0,3,10,2020,290,2011,0,98027,47.5304,-122.073,2340,2155,-460,-185,385.4054054054054,0.08367213114754099,Very Cheap
20141105T000000,1070000.0,3,1.75,2320,6090,2.0,0,3,3,8,2040,280,1939,0,98199,47.643,-122.412,3110,7052,3770,3942,175.69786535303777,0.13049180327868853,Cheap
20141027T000000,460000.0,3,1.75,1660,9900,2.0,0,0,3,8,1660,0,1978,0,98033,47.6704,-122.184,1720,6600,8240,4880,46.464646464646464,0.050491803278688525,Very Cheap
20150407T000000,880000.0,3,1.75,2070,5000,1.5,0,0,3,8,2070,0,1920,0,98144,47.5828,-122.291,2630,5000,2930,2370,176.0,0.10557377049180328,Cheap
20150302T000000,585000.0,4,1.75,2500,7000,1.0,0,0,3,7,1250,1250,1947,0,98199,47.648,-122.386,1680,7000,4500,5320,83.57142857142857,0.06688524590163934,Very Cheap
20140522T000000,249950.0,2,1.0,940,8532,1.0,0,0,4,7,940,0,1959,0,98166,47.4814,-122.343,1050,8100,7592,7050,29.295593061415847,0.022944262295081966,Very Cheap
20141107T000000,450000.0,3,2.5,1990,3478,2.0,0,0,3,10,1520,470,1990,0,98199,47.6361,-122.399,1710,6157,1488,4447,129.38470385278896,0.04918032786885246,Very Cheap
20140926T000000,450000.0,3,2.5,2620,14096,2.0,0,0,4,9,2620,0,1989,0,98042,47.3513,-122.1,3010,14096,11476,11086,31.92395005675369,0.04918032786885246,Very Cheap
20150107T000000,1775000.0,4,3.25,3730,7071,3.0,0,2,3,11,3730,0,1985,0,98109,47.6292,-122.355,3730,7680,3341,3950,251.0253146655353,0.22295081967213115,Cheap
20140923T000000,350000.0,3,3.25,1600,1298,3.0,0,0,3,8,1600,0,1999,0,98117,47.6954,-122.375,1600,1348,-302,-252,269.6456086286595,0.036065573770491806,Very Cheap
20150325T000000,292500.0,3,2.5,2095,3438,2.0,0,0,3,7,2095,0,2008,0,98002,47.3523,-122.213,1805,3402,1343,1597,85.07853403141361,0.028524590163934428,Very Cheap
20140626T000000,879000.0,4,2.75,4230,31747,2.0,0,0,4,10,4230,0,1985,0,98072,47.731,-122.132,4080,35576,27517,31496,27.687655526506443,0.10544262295081967,Cheap
20140612T000000,1184000.0,4,2.5,3200,7500,1.5,0,1,5,8,1860,1340,1948,0,98115,47.6826,-122.274,2500,6500,4300,4000,157.86666666666667,0.14544262295081967,Cheap
20150213T000000,584999.0,4,2.75,2050,17859,1.0,0,0,4,7,1300,750,1967,0,98075,47.5945,-122.056,2960,20908,15809,17948,32.75653732011871,0.06688511475409836,Very Cheap
20141120T000000,366000.0,4,2.75,2020,8093,1.0,0,0,5,7,1300,720,1961,0,98133,47.7685,-122.332,1920,8089,6073,6169,45.22426788582726,0.03816393442622951,Very Cheap
20150108T000000,987500.0,4,2.25,3270,15760,1.0,0,0,4,10,2000,1270,1974,0,98040,47.5295,-122.229,4100,15760,12490,11660,62.65862944162436,0.11967213114754098,Cheap
20150323T000000,300000.0,3,1.0,1320,7200,1.0,0,0,4,7,1320,0,1959,0,98056,47.5048,-122.19,1720,7249,5880,5529,41.666666666666664,0.029508196721311476,Very Cheap
20150408T000000,299000.0,2,1.75,1270,7800,1.0,0,0,4,7,890,380,1981,0,98058,47.4438,-122.134,2020,8025,6530,6005,38.333333333333336,0.02937704918032787,Very Cheap
20140714T000000,560000.0,4,1.75,1980,2700,1.5,0,0,3,8,1210,770,1931,0,98115,47.6865,-122.32,1720,2910,720,1190,207.40740740740742,0.06360655737704918,Very Cheap
20140701T000000,695000.0,3,2.5,2620,51354,2.0,0,0,3,9,2620,0,1998,0,98077,47.7211,-122.028,2620,37042,48734,34422,13.53351248198777,0.08131147540983606,Very Cheap
20141205T000000,360000.0,4,1.75,1750,18810,1.0,0,0,3,7,1220,530,1977,0,98059,47.4719,-122.074,1840,17424,17060,15584,19.138755980861244,0.037377049180327866,Very Cheap
20140708T000000,183500.0,3,1.0,1040,8892,1.0,0,0,4,6,800,240,1958,0,98023,47.3273,-122.349,820,9000,7852,8180,20.636527215474583,0.014229508196721311,Very Cheap
20140619T000000,311000.0,3,1.75,1900,3000,1.5,0,0,5,7,1070,830,1903,0,98118,47.5255,-122.265,1130,6000,1100,4870,103.66666666666667,0.030950819672131147,Very Cheap
20141021T000000,263000.0,3,1.75,1660,7210,1.0,0,0,4,7,1660,0,1977,0,98032,47.3609,-122.274,2150,7350,5550,5200,36.47711511789182,0.024655737704918034,Very Cheap
20150224T000000,269000.0,3,1.75,1530,7930,1.0,0,0,5,7,1530,0,1986,0,98038,47.3609,-122.05,1610,7930,6400,6320,33.921815889029006,0.02544262295081967,Very Cheap
20140606T000000,1600000.0,4,3.5,4280,9583,2.0,0,0,3,11,4280,0,2005,0,98004,47.5979,-122.197,2360,10031,5303,7671,166.96232912449128,0.2,Cheap
20150303T000000,564000.0,4,2.5,2870,6658,2.0,0,0,3,8,2870,0,2004,0,98065,47.5394,-121.878,2770,6658,3788,3888,84.71012316010814,0.0641311475409836,Very Cheap
20140620T000000,425000.0,3,2.5,2540,5612,2.0,0,0,3,9,2540,0,1999,0,98059,47.4965,-122.157,2380,6303,3072,3923,75.73057733428368,0.04590163934426229,Very Cheap
20140709T000000,679000.0,4,2.75,2100,4480,1.5,0,0,4,7,1780,320,1928,0,98105,47.6691,-122.294,2050,4480,2380,2430,151.5625,0.07921311475409835,Very Cheap
20140826T000000,410000.0,3,2.0,1740,9300,1.0,0,0,4,7,1740,0,1952,0,98166,47.4526,-122.357,1540,9638,7560,8098,44.086021505376344,0.043934426229508196,Very Cheap
20141020T000000,340000.0,4,2.5,2441,7316,2.0,0,0,3,8,2441,0,2007,0,98023,47.3237,-122.337,2724,7357,4875,4633,46.47348277747403,0.03475409836065574,Very Cheap
20150511T000000,360000.0,3,1.75,1810,7200,1.0,0,0,5,7,1030,780,1959,0,98146,47.4993,-122.364,1950,8384,5390,6434,50.0,0.037377049180327866,Very Cheap
20140520T000000,450000.0,3,1.5,2060,44866,1.0,0,0,3,8,2060,0,1953,0,98077,47.7503,-122.051,2320,43995,42806,41675,10.029866714215665,0.04918032786885246,Very Cheap
20150326T000000,552000.0,4,2.75,3160,8429,1.0,0,3,4,7,1620,1540,1982,0,98178,47.511,-122.251,1760,6780,5269,5020,65.48819551548226,0.06255737704918032,Very Cheap
20140805T000000,294000.0,4,2.0,2930,12840,1.5,0,0,4,8,2930,0,1965,0,98092,47.2957,-122.187,1960,10920,9910,8960,22.897196261682243,0.028721311475409836,Very Cheap
20150313T000000,663500.0,2,1.0,1310,5200,1.0,0,0,3,7,910,400,1946,0,98115,47.6784,-122.304,1320,4794,3890,3474,127.59615384615384,0.07718032786885246,Very Cheap
20140710T000000,1975000.0,6,4.5,4800,9097,2.0,0,0,3,10,3580,1220,2007,0,98112,47.6259,-122.291,2180,6037,4297,3857,217.10453995822797,0.24918032786885247,Cheap
20141008T000000,175409.0,4,1.5,1450,5530,1.0,0,0,4,6,1450,0,1969,0,98042,47.3613,-122.087,1060,5200,4080,4140,31.719529837251358,0.013168393442622951,Very Cheap
20150123T000000,459000.0,4,3.0,1900,9077,2.0,0,0,3,7,1900,0,1954,2015,98155,47.7684,-122.304,1900,12868,7177,10968,50.567368073151926,0.050360655737704915,Very Cheap
20140514T000000,339950.0,3,1.0,1050,5402,1.5,0,0,4,7,1050,0,1906,0,98144,47.5867,-122.311,1510,4685,4352,3175,62.93039614957423,0.03474754098360656,Very Cheap
20141029T000000,393000.0,5,1.75,1610,15246,1.0,0,0,3,6,1610,0,1936,0,98024,47.5654,-121.894,1410,10500,13636,9090,25.777253049980324,0.041704918032786885,Very Cheap
20140627T000000,275500.0,2,1.0,720,11400,1.0,0,0,5,6,720,0,1951,0,98133,47.7641,-122.341,1690,8075,10680,6385,24.166666666666668,0.026295081967213113,Very Cheap
20150413T000000,485000.0,3,1.0,1020,9835,1.0,0,0,5,7,1020,0,1955,0,98006,47.5728,-122.179,1210,9622,8815,8412,49.31367564819522,0.05377049180327869,Very Cheap
20140722T000000,250000.0,3,1.0,1250,7920,1.0,0,0,4,7,1250,0,1960,0,98059,47.4853,-122.126,1440,9648,6670,8208,31.565656565656564,0.022950819672131147,Very Cheap
20141030T000000,935100.0,4,3.5,3200,8049,1.0,0,0,3,8,2700,500,1980,0,98005,47.5841,-122.172,1640,8506,4849,6866,116.1759224748416,0.1128,Cheap
20150414T000000,245000.0,3,1.0,990,9599,1.0,0,0,4,6,990,0,1959,0,98002,47.2934,-122.215,1216,10364,8609,9148,25.523492030419835,0.022295081967213116,Very Cheap
20150429T000000,670000.0,4,2.5,2850,25993,2.0,0,0,4,9,2850,0,1989,0,98056,47.5318,-122.17,2480,12672,23143,10192,25.776170507444313,0.0780327868852459,Very Cheap
20141212T000000,1393000.0,3,3.5,4240,21578,2.0,0,0,3,10,3500,740,1994,0,98040,47.5614,-122.215,3120,16440,17338,13320,64.55649272407081,0.17285245901639346,Cheap
20140820T000000,440000.0,4,1.75,2800,49149,1.0,0,0,4,7,1400,1400,1978,0,98027,47.4649,-122.034,2560,61419,46349,58859,8.952369325927283,0.04786885245901639,Very Cheap
20141008T000000,1248000.0,2,2.5,2310,3313,2.0,0,0,3,9,2310,0,2006,0,98119,47.6318,-122.365,2700,5670,1003,2970,376.6978569272563,0.1538360655737705,Cheap
20140827T000000,203000.0,3,1.75,1490,8000,1.0,0,0,4,7,1200,290,1978,0,98092,47.3187,-122.18,1540,8000,6510,6460,25.375,0.01678688524590164,Very Cheap
20140901T000000,583000.0,4,2.5,1840,4011,2.0,0,0,3,9,1840,0,2005,0,98052,47.6662,-122.083,2120,4011,2171,1891,145.35028671154325,0.06662295081967214,Very Cheap
20150402T000000,575000.0,3,1.0,1740,9163,1.0,0,0,3,7,1740,0,1954,0,98125,47.705,-122.299,1490,6509,7423,5019,62.752373676743424,0.06557377049180328,Very Cheap
20140922T000000,2575000.0,4,3.5,3280,3800,2.0,0,0,3,11,2880,400,2011,0,98112,47.6299,-122.28,2050,3800,520,1750,677.6315789473684,0.32786885245901637,Medium
20150316T000000,1600000.0,5,3.5,4050,20925,2.0,0,3,3,10,3020,1030,1973,2005,98040,47.5348,-122.241,3880,18321,16875,14441,76.46356033452808,0.2,Cheap
20150416T000000,312500.0,4,2.5,2160,8755,2.0,0,0,3,7,2160,0,1993,0,98030,47.3585,-122.195,1990,7971,6595,5981,35.6938892061679,0.03114754098360656,Very Cheap
20140811T000000,455000.0,3,2.75,2720,31314,3.0,0,2,3,8,2720,0,1986,0,98042,47.3689,-122.163,2290,15188,28594,12898,14.53024206425241,0.049836065573770495,Very Cheap
20141125T000000,1310000.0,5,3.0,3650,16600,1.0,0,3,4,9,1860,1790,1978,0,98006,47.56,-122.144,3150,10400,12950,7250,78.91566265060241,0.1619672131147541,Cheap
20150316T000000,605000.0,4,2.25,1750,6120,1.0,0,0,3,7,1150,600,1962,0,98115,47.6958,-122.29,1350,6120,4370,4770,98.85620915032679,0.06950819672131148,Very Cheap
20140718T000000,325000.0,3,2.25,2450,49658,1.0,0,0,3,7,1770,680,1978,0,98045,47.486,-121.726,1340,121097,47208,119757,6.544766200813565,0.03278688524590164,Very Cheap
20150427T000000,630000.0,3,1.75,1940,7306,1.0,0,0,3,8,1470,470,1982,0,98052,47.6632,-122.153,2360,8865,5366,6505,86.23049548316452,0.07278688524590164,Very Cheap
20150109T000000,928950.0,4,3.75,3280,6000,2.0,0,0,3,9,3280,0,2014,0,98006,47.554,-122.19,2900,10108,2720,7208,154.825,0.11199344262295081,Cheap
20141010T000000,489950.0,3,1.75,2480,10804,1.0,0,0,3,8,1800,680,1976,0,98177,47.7721,-122.367,2480,10400,8324,7920,45.34894483524621,0.05441967213114754,Very Cheap
20150415T000000,550000.0,3,2.25,2120,18255,1.0,0,0,3,8,1590,530,1984,0,98074,47.6279,-122.037,2120,12997,16135,10877,30.128731854286496,0.06229508196721312,Very Cheap
20140805T000000,237000.0,3,2.0,1710,7920,1.0,0,0,3,8,1260,450,1968,0,98003,47.3473,-122.305,1760,8120,6210,6360,29.924242424242426,0.021245901639344263,Very Cheap
20140807T000000,390000.0,3,2.5,1690,10113,1.0,0,0,3,7,1310,380,1991,0,98028,47.7381,-122.223,1690,10113,8423,8423,38.5642242657965,0.04131147540983607,Very Cheap
20140528T000000,665000.0,3,2.5,2190,10370,2.0,0,0,3,9,2190,0,1987,0,98074,47.6218,-122.03,2470,10472,8180,8002,64.12729026036644,0.07737704918032787,Very Cheap
20150210T000000,277000.0,4,3.0,1960,5160,1.0,0,0,3,7,1170,790,2001,0,98106,47.5313,-122.36,1960,5160,3200,3200,53.68217054263566,0.026491803278688525,Very Cheap
20140612T000000,545000.0,3,1.0,1510,5000,1.5,0,0,3,7,1510,0,1909,0,98105,47.6708,-122.297,1680,4000,3490,2320,109.0,0.06163934426229508,Very Cheap
20150407T000000,615000.0,3,2.5,1490,1410,2.0,0,0,3,10,1300,190,2008,0,98199,47.6478,-122.383,1490,1715,-80,225,436.17021276595744,0.07081967213114754,Very Cheap
20150415T000000,343000.0,3,1.75,2210,7920,1.0,0,0,3,7,1400,810,1966,0,98178,47.4968,-122.237,2220,7920,5710,5700,43.30808080808081,0.035147540983606555,Very Cheap
20140730T000000,597000.0,4,2.5,2340,7877,2.0,0,0,3,9,2340,0,2004,0,98125,47.73,-122.315,1920,9116,5537,7196,75.79027548559097,0.06845901639344262,Very Cheap
20140715T000000,600000.0,3,1.0,940,19000,1.0,0,0,3,6,940,0,1945,0,98004,47.5828,-122.19,2280,19000,18060,16720,31.57894736842105,0.06885245901639345,Very Cheap
20150313T000000,479000.0,3,1.75,1470,6018,1.0,0,0,3,8,1470,0,1987,0,98074,47.6171,-122.044,1720,6584,4548,4864,79.5945496842805,0.05298360655737705,Very Cheap
20141216T000000,292000.0,3,1.75,1650,14633,1.0,0,0,4,7,1650,0,1958,0,98056,47.4984,-122.176,1370,12495,12983,11125,19.954896466889906,0.028459016393442622,Very Cheap
20140912T000000,265000.0,3,1.5,1400,6527,1.0,0,0,3,7,1110,290,1957,0,98166,47.4535,-122.358,1690,7597,5127,5907,40.600582197027734,0.024918032786885248,Very Cheap
20150420T000000,623000.0,4,2.5,2710,49044,2.0,0,0,3,9,2710,0,1988,0,98077,47.774,-122.08,2560,38190,46334,35630,12.702879047386022,0.07186885245901639,Very Cheap
20140514T000000,486000.0,4,2.5,2150,39449,1.0,0,0,3,7,1420,730,1978,0,98024,47.5531,-121.892,2010,35717,37299,33707,12.319703921518924,0.053901639344262293,Very Cheap
20140615T000000,520500.0,3,2.0,1900,8100,1.0,0,0,4,7,950,950,1940,0,98115,47.6997,-122.319,1400,6380,6200,4980,64.25925925925925,0.058426229508196724,Very Cheap
20140520T000000,1300000.0,4,3.5,4380,74052,1.0,0,0,3,11,4380,0,2001,0,98053,47.6587,-122.009,5170,62291,69672,57121,17.555231458974774,0.16065573770491803,Cheap
20140924T000000,825000.0,4,1.0,2290,6300,1.5,0,4,4,7,2150,140,1921,0,98144,47.5917,-122.29,2390,6300,4010,3910,130.95238095238096,0.09836065573770492,Very Cheap
20140928T000000,259900.0,3,1.75,1690,7953,1.0,0,0,3,7,1690,0,1986,0,98030,47.3556,-122.175,1680,7425,6263,5745,32.6794920155916,0.024249180327868852,Very Cheap
20150402T000000,1170000.0,5,2.75,3090,12031,1.0,0,0,5,9,1600,1490,1968,0,98040,47.5342,-122.226,2280,10800,8941,8520,97.24877400049871,0.1436065573770492,Cheap
20140923T000000,245000.0,2,1.0,1120,5650,1.0,0,1,3,6,720,400,1904,0,98118,47.5155,-122.255,2160,6480,4530,4320,43.36283185840708,0.022295081967213116,Very Cheap
20150320T000000,830200.0,3,2.5,2680,4990,1.0,0,0,5,8,1440,1240,1951,0,98199,47.6538,-122.393,2320,6000,2310,3680,166.37274549098197,0.09904262295081967,Very Cheap
20140623T000000,650000.0,4,2.5,2400,7351,2.0,0,0,3,9,2400,0,1990,0,98029,47.5707,-122.022,2330,7756,4951,5426,88.42334376275336,0.07540983606557378,Very Cheap
20150122T000000,305000.0,4,2.0,1610,6250,1.0,0,0,4,7,1610,0,1952,0,98118,47.5293,-122.271,1310,6000,4640,4690,48.8,0.03016393442622951,Very Cheap
20150305T000000,599000.0,5,2.5,3470,12003,2.0,0,0,3,8,3470,0,1978,0,98074,47.624,-122.048,2220,12283,8533,10063,49.904190619011914,0.06872131147540983,Very Cheap
20140926T000000,272000.0,4,2.5,2070,6175,2.0,0,0,3,8,2070,0,1993,0,98092,47.3262,-122.174,1940,6175,4105,4235,44.04858299595141,0.02583606557377049,Very Cheap
20141113T000000,415000.0,3,2.5,2420,10733,2.0,0,0,3,8,2420,0,1996,0,98038,47.3835,-122.035,1950,8534,8313,6584,38.665797074443304,0.04459016393442623,Very Cheap
20141121T000000,319000.0,4,2.25,2380,7400,1.0,0,0,4,8,1760,620,1979,0,98042,47.3555,-122.149,1940,7400,5020,5460,43.108108108108105,0.032,Very Cheap
20140724T000000,425000.0,4,1.75,2120,15920,1.0,0,0,4,7,1060,1060,1960,0,98028,47.771,-122.258,2200,12580,13800,10380,26.695979899497488,0.04590163934426229,Very Cheap
20150428T000000,297500.0,4,2.5,2190,8100,1.0,0,0,4,8,1250,940,1978,0,98023,47.3131,-122.392,2100,8840,5910,6740,36.72839506172839,0.029180327868852458,Very Cheap
20140527T000000,725000.0,4,2.5,2740,12899,2.0,0,0,4,10,2740,0,1990,0,98075,47.5811,-122.028,2830,9453,10159,6623,56.20590743468486,0.08524590163934426,Very Cheap
20150107T000000,325000.0,3,2.5,1830,7585,2.0,0,0,4,8,1830,0,1995,0,98042,47.3893,-122.154,2070,7585,5755,5515,42.847725774555045,0.03278688524590164,Very Cheap
20140805T000000,460000.0,3,1.75,1370,8467,1.0,0,0,4,7,970,400,1972,0,98052,47.6644,-122.145,1650,8472,7097,6822,54.328569741348765,0.050491803278688525,Very Cheap
20150217T000000,396480.0,3,1.0,1000,10800,1.0,0,0,3,7,1000,0,1959,0,98027,47.52,-122.03,1140,16846,9800,15706,36.71111111111111,0.042161311475409836,Very Cheap
20150305T000000,1025000.0,3,1.0,2050,4800,2.0,0,0,3,8,1950,100,1922,0,98112,47.6315,-122.311,2220,4800,2750,2580,213.54166666666666,0.12459016393442623,Cheap
20141120T000000,370000.0,3,2.75,1750,9166,1.0,0,0,4,7,1170,580,1979,0,98155,47.7696,-122.325,1810,8760,7416,6950,40.36657211433559,0.038688524590163934,Very Cheap
20150416T000000,260656.0,3,1.0,1620,13803,1.0,0,0,4,6,1620,0,1969,0,98038,47.3631,-122.028,1260,10370,12183,9110,18.884010722306744,0.024348327868852458,Very Cheap
20140715T000000,431000.0,3,2.5,1710,12677,2.0,0,0,3,8,1710,0,1996,0,98028,47.75,-122.234,1610,12160,10967,10550,33.99858010570324,0.046688524590163934,Very Cheap
20150113T000000,320000.0,3,1.0,1060,5000,1.0,0,0,3,7,1060,0,1958,0,98106,47.5294,-122.354,1220,4600,3940,3380,64.0,0.032131147540983604,Very Cheap
20140519T000000,296500.0,3,2.75,2170,7900,1.0,0,0,4,8,1380,790,1978,0,98032,47.362,-122.277,2170,7700,5730,5530,37.53164556962025,0.02904918032786885,Very Cheap
20150309T000000,679000.0,4,2.5,3080,8451,1.0,0,0,3,7,1540,1540,1969,0,98052,47.674,-122.154,1550,8125,5371,6575,80.34552124008994,0.07921311475409835,Very Cheap
20140801T000000,359000.0,3,3.0,1320,1071,2.0,0,0,3,7,1080,240,2003,0,98144,47.5942,-122.296,1780,7715,-249,5935,335.2007469654528,0.03724590163934426,Very Cheap
20150402T000000,330000.0,4,3.0,1920,12040,1.0,0,0,3,7,1920,0,1962,0,98168,47.4805,-122.301,1530,10230,10120,8700,27.408637873754152,0.03344262295081967,Very Cheap
20140516T000000,350000.0,4,2.5,2440,4000,2.0,0,0,3,7,2440,0,2009,0,98038,47.3841,-122.036,2410,4502,1560,2092,87.5,0.036065573770491806,Very Cheap
20141022T000000,242000.0,3,1.5,1640,8922,1.0,0,0,4,7,1640,0,1963,0,98146,47.495,-122.342,1540,9040,7282,7500,27.12396323694239,0.021901639344262296,Very Cheap
20150326T000000,692500.0,3,2.5,2420,198198,2.0,0,0,3,9,2420,0,1997,0,98077,47.772,-122.022,2780,179467,195778,176687,3.4939807667080394,0.08098360655737705,Very Cheap
20140630T000000,441000.0,2,1.5,1190,3400,1.0,0,0,3,7,990,200,1919,0,98115,47.6726,-122.32,1410,3150,2210,1740,129.7058823529412,0.048,Very Cheap
20141212T000000,765000.0,4,2.5,2910,15016,2.0,0,0,3,10,2910,0,1990,0,98052,47.69,-122.097,2870,13992,12106,11122,50.94565796483751,0.09049180327868853,Very Cheap
20140903T000000,375000.0,2,1.0,1010,4050,1.0,0,0,3,7,1010,0,1950,0,98116,47.5838,-122.382,2310,5000,3040,2690,92.5925925925926,0.03934426229508197,Very Cheap
20150326T000000,365000.0,3,1.75,2080,7800,1.0,0,0,5,7,1220,860,1955,0,98166,47.4536,-122.355,1770,7860,5720,6090,46.794871794871796,0.0380327868852459,Very Cheap
20140908T000000,580000.0,2,1.5,1990,6000,1.0,0,0,3,6,1430,560,1944,0,98199,47.6521,-122.398,1350,6000,4010,4650,96.66666666666667,0.06622950819672131,Very Cheap
20150410T000000,1605000.0,4,3.5,3920,19088,1.0,0,1,3,10,2240,1680,2005,0,98040,47.576,-122.214,3800,13749,15168,9949,84.08424140821458,0.20065573770491804,Cheap
20150219T000000,841000.0,4,2.5,3080,13870,2.0,0,0,4,9,3080,0,1981,0,98007,47.6197,-122.149,2920,12221,10790,9301,60.63446286950252,0.10045901639344262,Cheap
20150421T000000,515000.0,5,3.0,2670,11761,1.0,0,0,3,7,1370,1300,1981,0,98052,47.6895,-122.129,2580,10703,9091,8123,43.78879346994303,0.057704918032786885,Very Cheap
20141024T000000,565000.0,5,2.5,4320,107157,1.0,0,0,4,8,2160,2160,1967,0,98038,47.4009,-122.059,2480,107157,102837,104677,5.2726373452037665,0.06426229508196721,Very Cheap
20141215T000000,365000.0,2,1.5,1200,6380,1.0,0,0,3,7,1200,0,1929,0,98115,47.697,-122.319,1290,6598,5180,5308,57.210031347962385,0.0380327868852459,Very Cheap
20140707T000000,295000.0,3,1.5,1640,7222,2.0,0,0,4,7,1640,0,1908,0,98108,47.5215,-122.33,1240,5100,5582,3860,40.84741068955968,0.028852459016393443,Very Cheap
20140630T000000,406500.0,2,1.0,870,5750,1.0,0,0,4,7,870,0,1947,0,98116,47.5637,-122.395,1100,5750,4880,4650,70.69565217391305,0.04347540983606557,Very Cheap
20150212T000000,614905.0,3,2.5,2410,7225,2.0,0,0,3,8,2410,0,1991,0,98125,47.7211,-122.31,1940,8347,4815,6407,85.10795847750865,0.0708072131147541,Very Cheap
20150402T000000,1398000.0,5,2.25,2640,14959,1.0,0,0,4,7,1770,870,1929,0,98039,47.6191,-122.234,3240,17904,12319,14664,93.45544488267933,0.1735081967213115,Cheap
20140716T000000,250000.0,2,1.0,990,10556,2.0,0,0,3,7,990,0,1981,0,98056,47.5118,-122.188,1350,7295,9566,5945,23.68321333838575,0.022950819672131147,Very Cheap
20141112T000000,549000.0,5,1.0,1500,3978,2.0,0,0,3,7,1500,0,1929,0,98117,47.6811,-122.383,1350,4080,2478,2730,138.00904977375566,0.06216393442622951,Very Cheap
20140820T000000,397000.0,4,2.5,1790,6590,2.0,0,0,3,7,1790,0,2005,0,98059,47.4829,-122.128,1950,5180,4800,3230,60.24279210925645,0.04222950819672131,Very Cheap
20140505T000000,184000.0,3,1.75,1490,10125,1.0,0,0,4,7,1490,0,1962,0,98001,47.3075,-122.284,2488,4981,8635,2493,18.17283950617284,0.014295081967213115,Very Cheap
20150505T000000,2500000.0,4,3.25,3960,16224,2.0,0,2,3,12,3100,860,1938,0,98105,47.6701,-122.259,3960,15050,12264,11090,154.09270216962526,0.3180327868852459,Medium
20140728T000000,499100.0,3,1.5,1620,5108,1.0,0,0,3,7,1620,0,1954,0,98115,47.6978,-122.316,1380,6130,3488,4750,97.70947533281128,0.05561967213114754,Very Cheap
20140925T000000,676101.0,4,1.5,2270,6010,1.0,0,0,3,8,1290,980,1954,0,98115,47.6743,-122.269,2120,5987,3740,3867,112.49600665557405,0.07883291803278689,Very Cheap
20140623T000000,290000.0,3,1.0,1150,8145,1.0,0,0,4,6,990,160,1932,0,98155,47.7471,-122.317,1200,8145,6995,6945,35.60466543891958,0.02819672131147541,Very Cheap
20150304T000000,390000.0,4,1.75,2180,7560,1.0,0,0,4,7,1560,620,1962,0,98133,47.757,-122.336,1810,7352,5380,5542,51.58730158730159,0.04131147540983607,Very Cheap
20140604T000000,465000.0,3,1.0,910,4500,1.0,0,0,3,7,910,0,1948,0,98117,47.6828,-122.395,1370,5000,3590,3630,103.33333333333333,0.051147540983606556,Very Cheap
20140926T000000,470000.0,3,2.75,2770,54707,1.5,0,0,3,8,2370,400,1938,0,98155,47.7555,-122.289,1640,54707,51937,53067,8.59122232986638,0.05180327868852459,Very Cheap
20150219T000000,435000.0,3,1.0,940,7590,1.0,0,0,4,6,940,0,1959,0,98008,47.6231,-122.12,1250,7590,6650,6340,57.312252964426875,0.04721311475409836,Very Cheap
20140627T000000,415000.0,3,1.75,2410,8944,1.0,0,0,4,8,1860,550,1967,0,98058,47.4494,-122.139,2750,9600,6534,6850,46.39982110912344,0.04459016393442623,Very Cheap
20150225T000000,450000.0,3,2.0,1010,2820,1.5,0,0,3,7,1010,0,1905,0,98122,47.6066,-122.304,1330,3000,1810,1670,159.5744680851064,0.04918032786885246,Very Cheap
20150327T000000,645000.0,3,2.5,2120,196995,1.0,0,1,3,9,2120,0,1997,0,98070,47.4089,-122.459,1304,92423,194875,91119,3.2741947765171706,0.07475409836065573,Very Cheap
20140529T000000,231000.0,4,2.0,1530,6375,2.0,0,0,3,7,1530,0,1942,1983,98058,47.4692,-122.162,1500,8712,4845,7212,36.23529411764706,0.020459016393442622,Very Cheap
20140624T000000,358000.0,3,1.5,1810,100188,1.0,0,0,5,7,1810,0,1969,0,98022,47.2175,-121.995,1540,40415,98378,38875,3.5732822294087114,0.03711475409836065,Very Cheap
20140815T000000,330000.0,3,1.0,1040,11900,1.0,0,0,5,6,1040,0,1972,0,98070,47.4332,-122.446,1250,9600,10860,8350,27.73109243697479,0.03344262295081967,Very Cheap
20141120T000000,229950.0,2,1.5,1160,1848,2.0,0,0,3,7,1160,0,1972,0,98034,47.7366,-122.176,1160,1566,688,406,124.43181818181819,0.020321311475409835,Very Cheap
20141016T000000,403250.0,2,1.5,1430,8137,1.0,0,0,3,7,1130,300,1934,0,98125,47.7307,-122.29,1430,8137,6707,6707,49.55757650239646,0.04304918032786885,Very Cheap
20140912T000000,470000.0,3,2.5,2280,6134,2.0,0,0,3,8,2280,0,2004,0,98065,47.5335,-121.854,2640,6167,3854,3527,76.62210629279426,0.05180327868852459,Very Cheap
20150425T000000,239000.0,3,1.0,1200,7810,1.0,0,0,4,7,1200,0,1967,0,98038,47.3631,-122.05,1590,7800,6610,6210,30.60179257362356,0.021508196721311476,Very Cheap
20150327T000000,579000.0,4,1.5,2480,6000,1.0,0,0,3,8,1520,960,1955,0,98136,47.5233,-122.386,1810,6000,3520,4190,96.5,0.06609836065573771,Very Cheap
20150318T000000,380500.0,3,2.0,1270,1348,3.0,0,0,3,8,1270,0,2003,0,98103,47.6929,-122.342,1180,1360,78,180,282.2700296735905,0.0400655737704918,Very Cheap
20141231T000000,614285.0,5,2.75,2730,6401,2.0,0,0,3,8,2730,0,2015,0,98072,47.7685,-122.16,2520,6126,3671,3606,95.9670364005624,0.07072590163934427,Very Cheap
20150407T000000,376000.0,2,2.0,1340,1635,2.0,0,0,3,8,1340,0,2003,0,98029,47.5476,-122.005,1410,1375,295,-35,229.96941896024464,0.039475409836065574,Very Cheap
20150217T000000,290000.0,3,1.0,1240,9300,1.0,0,0,3,7,1240,0,1954,0,98148,47.4363,-122.333,1250,9300,8060,8050,31.182795698924732,0.02819672131147541,Very Cheap
20150129T000000,487000.0,4,2.25,2400,7000,1.0,0,0,4,8,1800,600,1965,0,98034,47.7207,-122.184,2210,7210,4600,5000,69.57142857142857,0.054032786885245904,Very Cheap
20150219T000000,935000.0,4,2.0,1220,7489,2.0,0,0,3,7,1220,0,1903,0,98122,47.6133,-122.306,1220,3750,6269,2530,124.8497796768594,0.11278688524590164,Cheap
20150327T000000,255000.0,4,2.5,2163,5882,2.0,0,0,3,7,2163,0,2006,0,98001,47.2736,-122.251,1760,9600,3719,7840,43.35260115606936,0.02360655737704918,Very Cheap
20140826T000000,380000.0,2,2.5,1860,3504,2.0,0,0,3,7,1860,0,2000,0,98028,47.776,-122.239,1860,4246,1644,2386,108.44748858447488,0.04,Very Cheap
20150424T000000,450000.0,2,1.0,810,4368,1.0,0,0,3,6,810,0,1958,0,98115,47.6915,-122.312,1890,5253,3558,3363,103.02197802197803,0.04918032786885246,Very Cheap
20141010T000000,622000.0,3,2.5,1950,7481,2.0,0,0,3,8,1950,0,1987,0,98027,47.564,-122.091,1980,8479,5531,6499,83.14396471060019,0.07173770491803279,Very Cheap
20150323T000000,292500.0,3,2.25,1390,6004,2.0,0,0,3,8,1390,0,1993,0,98038,47.3536,-122.047,1630,6397,4614,4767,48.717521652231845,0.028524590163934428,Very Cheap
20141220T000000,1320000.0,4,3.0,2120,3600,2.0,0,3,4,8,1830,290,1908,1996,98119,47.6344,-122.369,2120,3600,1480,1480,366.6666666666667,0.16327868852459015,Cheap
20150206T000000,410000.0,4,2.0,1510,3240,1.0,0,0,5,7,870,640,1901,0,98144,47.5972,-122.296,1420,5160,1730,3740,126.54320987654322,0.043934426229508196,Very Cheap
20141024T000000,160000.0,3,1.75,1010,5355,1.0,0,0,3,6,1010,0,1950,0,98106,47.5202,-122.351,750,4515,4345,3765,29.878618113912232,0.011147540983606558,Very Cheap
20140602T000000,809000.0,4,1.5,1840,4337,2.0,0,0,4,8,1840,0,1917,0,98112,47.6312,-122.307,2250,4337,2497,2087,186.53447083237262,0.09626229508196721,Very Cheap
20150312T000000,183750.0,5,2.75,1650,5453,1.0,0,0,3,7,1650,0,1970,0,98118,47.5293,-122.285,1670,5885,3803,4215,33.69704749679076,0.014262295081967214,Very Cheap
20141013T000000,411000.0,5,1.75,2860,12293,1.0,0,0,4,8,1430,1430,1947,0,98133,47.7385,-122.348,1920,18110,9433,16190,33.43366143333604,0.044065573770491806,Very Cheap
20150209T000000,1050000.0,3,1.75,2650,5512,2.0,0,0,3,9,2250,400,1984,0,98112,47.6265,-122.295,1440,5100,2862,3660,190.4934687953556,0.12786885245901639,Cheap
20140822T000000,625000.0,2,1.0,1100,4160,1.0,0,0,3,7,1100,0,1919,0,98109,47.6352,-122.352,1900,4000,3060,2100,150.2403846153846,0.07213114754098361,Very Cheap
20140819T000000,305000.0,3,2.25,1646,9519,2.0,0,0,3,7,1646,0,1994,0,98038,47.3646,-122.036,1975,8889,7873,6914,32.041180796302136,0.03016393442622951,Very Cheap
20150423T000000,915000.0,4,4.5,5250,48352,2.0,0,0,3,10,5250,0,1998,0,98059,47.4858,-122.111,2500,48352,43102,45852,18.923726009265387,0.11016393442622952,Cheap
20150311T000000,317000.0,3,1.5,1390,8300,1.0,0,0,4,7,1390,0,1974,0,98019,47.7383,-121.983,1470,7500,6910,6030,38.19277108433735,0.03173770491803279,Very Cheap
20150120T000000,165000.0,2,1.0,780,6380,1.0,0,0,3,6,780,0,1947,0,98106,47.5423,-122.351,1270,6960,5600,5690,25.862068965517242,0.01180327868852459,Very Cheap
20140515T000000,575000.0,2,1.0,1490,6000,1.0,0,0,3,7,1090,400,1946,0,98112,47.6296,-122.3,1590,6000,4510,4410,95.83333333333333,0.06557377049180328,Very Cheap
20140610T000000,219900.0,3,1.0,970,7742,1.0,0,0,4,6,970,0,1967,0,98003,47.3173,-122.327,970,7650,6772,6680,28.4035133040558,0.01900327868852459,Very Cheap
20141001T000000,1485000.0,4,3.25,3730,7200,2.0,0,0,3,10,2810,920,2006,0,98033,47.6824,-122.199,2490,7200,3470,4710,206.25,0.18491803278688523,Cheap
20140520T000000,300000.0,3,1.0,1090,9900,1.0,0,0,4,7,1090,0,1955,0,98052,47.6755,-122.16,1720,10419,8810,8699,30.303030303030305,0.029508196721311476,Very Cheap
20140619T000000,520000.0,3,1.75,1940,219527,1.0,0,0,3,7,1940,0,1991,0,98038,47.4214,-122.02,2060,108900,217587,106840,2.368729131268591,0.058360655737704915,Very Cheap
20150507T000000,310000.0,4,2.25,1780,8820,1.0,0,0,4,8,1480,300,1966,0,98032,47.3618,-122.289,1780,8625,7040,6845,35.147392290249435,0.03081967213114754,Very Cheap
20150223T000000,322500.0,3,2.0,1190,6445,1.0,0,0,3,7,1190,0,1996,0,98056,47.5057,-122.172,1920,8195,5255,6275,50.038789759503494,0.032459016393442626,Very Cheap
20150417T000000,320000.0,4,2.25,2000,10374,2.0,0,1,4,7,2000,0,1967,0,98023,47.3342,-122.34,2170,10374,8374,8204,30.84634663582032,0.032131147540983604,Very Cheap
20150403T000000,440000.0,3,2.5,1390,4997,2.0,0,0,3,7,1390,0,2004,0,98065,47.5303,-121.855,2340,4125,3607,1785,88.0528316990194,0.04786885245901639,Very Cheap
20140818T000000,578000.0,3,1.0,1500,4500,1.0,0,0,3,7,1120,380,1938,0,98117,47.6873,-122.385,1440,4500,3000,3060,128.44444444444446,0.06596721311475409,Very Cheap
20141119T000000,382000.0,2,1.5,1070,877,3.0,0,0,3,8,1070,0,2005,0,98107,47.6699,-122.393,1320,1193,-193,-127,435.57582668187,0.040262295081967214,Very Cheap
20140528T000000,535000.0,3,2.5,1720,4006,2.0,0,0,3,8,1720,0,1994,0,98029,47.569,-122.007,1780,3974,2286,2194,133.54967548676984,0.06032786885245902,Very Cheap
20150508T000000,679000.0,4,2.5,3680,7236,2.0,0,0,3,10,3680,0,2006,0,98038,47.3543,-122.005,3310,7180,3556,3870,93.83637368711996,0.07921311475409835,Very Cheap
20141201T000000,258900.0,3,2.25,1400,10436,1.0,0,0,4,7,1040,360,1985,0,98058,47.4261,-122.144,1860,9318,9036,7458,24.808355691835953,0.024118032786885246,Very Cheap
20150316T000000,563000.0,3,1.5,1730,9509,2.0,0,0,3,8,1270,460,1955,0,98125,47.7067,-122.282,1810,8795,7779,6985,59.207066989168155,0.064,Very Cheap
20140618T000000,562000.0,5,3.0,2795,15101,2.0,0,0,3,8,2795,0,1996,0,98019,47.7301,-121.972,2750,14567,12306,11817,37.216078405403614,0.0638688524590164,Very Cheap
20150105T000000,725000.0,4,1.75,2000,3750,1.0,0,0,5,8,1120,880,1950,0,98117,47.6816,-122.374,1370,5000,1750,3630,193.33333333333334,0.08524590163934426,Very Cheap
20150220T000000,236775.0,3,2.5,1830,8372,2.0,0,0,3,8,1830,0,1987,0,98023,47.3116,-122.4,1770,8372,6542,6602,28.281772575250837,0.021216393442622952,Very Cheap
20140911T000000,860000.0,4,3.5,3380,8098,1.0,0,1,5,9,1690,1690,1952,0,98033,47.6839,-122.19,1890,8400,4718,6510,106.19906149666585,0.10295081967213114,Cheap
20140509T000000,270000.0,3,1.5,1500,6337,1.0,0,0,5,7,1500,0,1953,0,98125,47.7276,-122.312,1420,6337,4837,4917,42.60691178791226,0.025573770491803278,Very Cheap
20141230T000000,621000.0,4,2.75,1950,6930,1.0,0,2,4,7,1250,700,1960,0,98008,47.616,-122.113,1950,8560,4980,6610,89.6103896103896,0.07160655737704918,Very Cheap
20150327T000000,527900.0,3,2.5,2490,5928,2.0,0,2,3,8,2490,0,1998,0,98065,47.5385,-121.87,2420,6381,3438,3961,89.0519568151147,0.05939672131147541,Very Cheap
20150108T000000,395000.0,4,2.25,1780,10748,2.0,0,0,4,8,1780,0,1964,0,98072,47.762,-122.11,2070,37680,8968,35610,36.751023446222554,0.0419672131147541,Very Cheap
20140522T000000,320000.0,3,2.0,1110,10500,1.0,0,0,5,7,1110,0,1978,0,98045,47.4456,-121.773,1230,10395,9390,9165,30.476190476190474,0.032131147540983604,Very Cheap
20150416T000000,300000.0,4,2.5,2500,4750,2.0,0,0,3,8,2500,0,2003,0,98042,47.3666,-122.122,2690,4750,2250,2060,63.1578947368421,0.029508196721311476,Very Cheap
20140520T000000,320000.0,3,1.75,1480,7225,1.0,0,0,4,7,1480,0,1965,0,98056,47.513,-122.185,1430,7201,5745,5771,44.29065743944636,0.032131147540983604,Very Cheap
20150507T000000,625000.0,3,2.25,2570,47480,1.0,0,0,3,9,2570,0,1979,0,98053,47.6854,-122.079,2570,106722,44910,104152,13.163437236731255,0.07213114754098361,Very Cheap
20150410T000000,505000.0,2,1.0,810,5060,1.0,0,0,3,6,810,0,1941,0,98116,47.5635,-122.394,900,5060,4250,4160,99.80237154150197,0.05639344262295082,Very Cheap
20140613T000000,300000.0,4,2.5,2700,10814,1.0,0,0,4,8,1560,1140,1966,0,98030,47.369,-122.177,2460,6310,8114,3850,27.74181616423155,0.029508196721311476,Very Cheap
20150212T000000,363000.0,4,2.5,2180,9281,2.0,0,0,3,8,2180,0,2004,0,98042,47.3673,-122.072,2520,9520,7101,7000,39.11216463743131,0.03777049180327869,Very Cheap
20140808T000000,1700000.0,4,3.5,4330,15335,2.0,0,0,4,11,3230,1100,1988,0,98040,47.5315,-122.231,3840,14311,11005,10471,110.85751548744702,0.21311475409836064,Cheap
20140515T000000,1146800.0,4,3.5,4210,10308,2.0,0,0,3,10,4210,0,2006,0,98008,47.5905,-122.117,3860,10200,6098,6340,111.25339542103221,0.1405639344262295,Cheap
20150317T000000,680000.0,4,2.5,2880,9202,1.0,0,0,3,8,1780,1100,1977,0,98052,47.6658,-122.139,2500,10265,6322,7765,73.8969789176266,0.07934426229508197,Very Cheap
20141209T000000,678940.0,5,2.25,2610,4080,2.0,0,0,5,7,1750,860,1909,0,98115,47.6757,-122.309,2160,4080,1470,1920,166.40686274509804,0.07920524590163934,Very Cheap
20150120T000000,299000.0,3,1.75,2010,8065,1.0,0,0,4,7,1090,920,1984,0,98031,47.4171,-122.202,1560,8065,6055,6505,37.07377557346559,0.02937704918032787,Very Cheap
20140506T000000,379900.0,4,1.75,1500,11600,1.0,0,0,4,7,1000,500,1955,0,98028,47.7373,-122.241,1740,11600,10100,9860,32.75,0.03998688524590164,Very Cheap
20140613T000000,205000.0,3,1.0,1290,6566,1.0,0,0,5,7,1290,0,1976,0,98023,47.3004,-122.377,1690,6860,5276,5170,31.221443801401158,0.017049180327868854,Very Cheap
20140520T000000,387500.0,4,1.0,1320,4440,1.5,0,0,3,7,1320,0,1929,0,98122,47.6145,-122.295,1260,4440,3120,3180,87.27477477477477,0.040983606557377046,Very Cheap
20150204T000000,256000.0,3,1.0,1290,4720,1.0,0,0,3,6,790,500,1948,0,98106,47.5186,-122.358,1110,4720,3430,3610,54.23728813559322,0.023737704918032787,Very Cheap
20140701T000000,548000.0,4,2.5,2440,11005,2.0,0,0,3,9,2440,0,1994,0,98056,47.5318,-122.176,2590,14754,8565,12164,49.795547478418904,0.062032786885245904,Very Cheap
20150224T000000,163000.0,3,1.75,1290,4811,1.0,0,0,3,7,1290,0,1996,0,98032,47.3912,-122.234,1310,4811,3521,3501,33.88069008522137,0.011540983606557377,Very Cheap
20150122T000000,367500.0,2,2.0,1030,600,2.0,0,0,3,8,680,350,2004,0,98116,47.5788,-122.41,1120,1267,-430,147,612.5,0.03836065573770492,Very Cheap
20140714T000000,390000.0,3,2.25,1640,2875,2.0,0,0,3,6,1240,400,1983,0,98118,47.5686,-122.286,1500,3960,1235,2460,135.65217391304347,0.04131147540983607,Very Cheap
20140801T000000,415000.0,4,2.5,1160,16008,1.0,0,0,4,7,1160,0,1989,0,98155,47.7643,-122.295,1570,12645,14848,11075,25.924537731134432,0.04459016393442623,Very Cheap
20141022T000000,449000.0,4,2.25,2230,8440,2.0,0,0,4,8,2230,0,1968,0,98011,47.7558,-122.217,2160,9412,6210,7252,53.199052132701425,0.049049180327868855,Very Cheap
20140716T000000,460000.0,5,2.0,1910,12264,1.0,0,0,4,7,1010,900,1963,0,98007,47.601,-122.134,1700,9179,10354,7479,37.50815394651011,0.050491803278688525,Very Cheap
20141223T000000,395000.0,4,2.0,1980,15354,1.0,0,0,3,7,1980,0,1977,0,98053,47.638,-121.968,1420,12300,13374,10880,25.726195128305328,0.0419672131147541,Very Cheap
20150120T000000,300000.0,3,2.0,1470,16500,1.0,0,0,3,7,1470,0,1961,0,98042,47.3617,-122.061,1720,14406,15030,12686,18.181818181818183,0.029508196721311476,Very Cheap
20150311T000000,345000.0,3,1.75,1520,7439,1.0,0,0,4,7,1520,0,1969,0,98055,47.457,-122.208,1650,7500,5919,5850,46.37720123672537,0.03540983606557377,Very Cheap
20150102T000000,825000.0,3,1.75,1930,8442,1.0,0,0,4,7,1930,0,1953,0,98004,47.6313,-122.204,1790,8442,6512,6652,97.72565742714997,0.09836065573770492,Very Cheap
20150327T000000,539950.0,3,2.5,1330,2180,3.0,0,0,3,8,1330,0,2014,0,98117,47.6987,-122.365,1330,5000,850,3670,247.6834862385321,0.06097704918032787,Very Cheap
20140616T000000,410000.0,4,2.0,1580,9581,1.0,0,0,3,7,1580,0,1953,0,98033,47.692,-122.165,1580,10552,8001,8972,42.793027867654736,0.043934426229508196,Very Cheap
20140801T000000,245000.0,3,1.0,1370,6000,1.0,0,0,3,7,1370,0,1955,0,98146,47.4879,-122.339,1370,9520,4630,8150,40.833333333333336,0.022295081967213116,Very Cheap
20140819T000000,482000.0,4,2.75,3010,15750,1.0,0,0,4,8,1560,1450,1973,0,98034,47.7336,-122.183,2110,9450,12740,7340,30.603174603174605,0.05337704918032787,Very Cheap
20140811T000000,270000.0,3,1.75,1390,9000,1.0,0,0,4,7,1390,0,1978,0,98045,47.4469,-121.772,1400,9697,7610,8297,30.0,0.025573770491803278,Very Cheap
20141226T000000,475000.0,3,1.75,1330,14560,1.0,0,0,3,7,1330,0,1983,0,98052,47.6599,-122.135,1510,9890,13230,8380,32.62362637362637,0.05245901639344262,Very Cheap
20141014T000000,445800.0,3,2.0,1320,6500,1.0,0,0,3,7,1320,0,1947,0,98125,47.7119,-122.319,1110,6592,5180,5482,68.58461538461539,0.048629508196721315,Very Cheap
20150219T000000,518000.0,4,3.0,2430,11670,1.0,0,0,4,7,1330,1100,1978,0,98034,47.7307,-122.228,1580,10464,9240,8884,44.38731790916881,0.0580983606557377,Very Cheap
20140812T000000,785000.0,2,0.75,1260,4800,1.5,0,2,4,6,1080,180,1942,0,98033,47.6843,-122.212,2660,7200,3540,4540,163.54166666666666,0.09311475409836066,Very Cheap
20150226T000000,430000.0,3,2.5,1690,1310,2.0,0,0,3,8,1140,550,2004,0,98136,47.5404,-122.387,1640,1321,-380,-319,328.2442748091603,0.04655737704918033,Very Cheap
20140530T000000,715000.0,4,1.75,3420,7200,1.0,0,3,5,8,1770,1650,1947,0,98125,47.7081,-122.277,2450,6200,3780,3750,99.30555555555556,0.0839344262295082,Very Cheap
20141009T000000,560000.0,3,1.5,2790,6900,1.0,0,2,3,8,1700,1090,1955,0,98125,47.7328,-122.288,2410,8100,4110,5690,81.15942028985508,0.06360655737704918,Very Cheap
20141107T000000,449000.0,3,1.75,1270,6600,1.5,0,0,5,7,1270,0,1903,0,98144,47.5976,-122.295,1490,3600,5330,2110,68.03030303030303,0.049049180327868855,Very Cheap
20141008T000000,805000.0,4,2.5,2910,9000,2.0,0,0,3,9,2910,0,1989,0,98006,47.5451,-122.142,2530,9000,6090,6470,89.44444444444444,0.09573770491803278,Very Cheap
20140924T000000,296000.0,3,2.5,1560,5845,2.0,0,0,3,7,1560,0,2003,0,98038,47.3851,-122.029,1860,5752,4285,3892,50.64157399486741,0.02898360655737705,Very Cheap
20140625T000000,275000.0,2,1.0,770,4840,1.0,0,0,4,7,770,0,1927,0,98126,47.551,-122.376,930,4840,4070,3910,56.81818181818182,0.02622950819672131,Very Cheap
20150112T000000,419950.0,3,1.75,1770,16909,1.0,0,0,5,8,1770,0,1977,0,98058,47.4458,-122.134,1960,9100,15139,7140,24.835886214442013,0.04523934426229508,Very Cheap
20141002T000000,285000.0,3,1.75,1100,1307,2.0,0,0,3,7,780,320,2008,0,98106,47.5601,-122.363,1170,4800,207,3630,218.0566182096404,0.02754098360655738,Very Cheap
20140721T000000,775000.0,3,2.5,2890,8470,2.0,0,0,3,10,2890,0,1996,0,98075,47.5785,-122.054,3000,8879,5580,5879,91.49940968122786,0.09180327868852459,Very Cheap
20150428T000000,288250.0,3,1.75,2110,15400,1.0,0,0,3,7,1380,730,1963,0,98178,47.4861,-122.226,2110,9800,13290,7690,18.717532467532468,0.0279672131147541,Very Cheap
20150427T000000,257000.0,2,1.75,1220,2268,1.0,0,0,4,6,610,610,1909,0,98144,47.592,-122.295,1240,1675,1048,435,113.31569664902999,0.023868852459016394,Very Cheap
20140825T000000,377000.0,1,1.0,950,10585,1.5,0,0,3,6,950,0,1929,0,98115,47.6968,-122.297,1400,7056,9635,5656,35.61643835616438,0.03960655737704918,Very Cheap
20150512T000000,550000.0,2,1.0,1420,3100,1.0,0,0,3,7,820,600,1924,0,98107,47.6737,-122.365,1420,3915,1680,2495,177.41935483870967,0.06229508196721312,Very Cheap
20140624T000000,339000.0,3,1.0,1100,4128,1.0,0,0,4,7,720,380,1942,0,98126,47.5296,-122.379,1510,4538,3028,3028,82.12209302325581,0.03462295081967213,Very Cheap
20141106T000000,481500.0,3,1.75,2140,6000,1.0,0,0,3,7,1070,1070,1948,0,98117,47.6913,-122.366,1240,4650,3860,3410,80.25,0.053311475409836065,Very Cheap
20141107T000000,224500.0,3,1.75,1300,7735,1.0,0,0,4,7,1300,0,1980,0,98022,47.1983,-122.0,1300,8941,6435,7641,29.023917259211377,0.01960655737704918,Very Cheap
20140826T000000,260000.0,3,1.0,1790,11884,1.0,0,0,3,7,1790,0,1951,0,98031,47.3887,-122.22,1660,11513,10094,9853,21.878155503197576,0.024262295081967214,Very Cheap
20150423T000000,865000.0,2,1.0,1470,5400,1.5,0,0,3,8,1470,0,1912,0,98119,47.6391,-122.36,1760,3573,3930,1813,160.1851851851852,0.10360655737704919,Cheap
20150505T000000,730000.0,5,3.0,2500,11779,1.0,0,0,4,8,1550,950,1971,0,98006,47.5696,-122.127,2580,12055,9279,9475,61.9747007386026,0.0859016393442623,Very Cheap
20150326T000000,550000.0,2,1.0,980,3080,1.5,0,0,3,7,980,0,1910,1946,98103,47.6646,-122.339,1450,3333,2100,1883,178.57142857142858,0.06229508196721312,Very Cheap
20140820T000000,645000.0,3,2.0,2130,4000,2.0,0,0,3,7,2130,0,1908,0,98115,47.6741,-122.323,2010,4000,1870,1990,161.25,0.07475409836065573,Very Cheap
20141008T000000,250000.0,3,1.75,1360,16000,1.0,0,0,3,7,1360,0,1978,0,98155,47.7583,-122.306,1360,12939,14640,11579,15.625,0.022950819672131147,Very Cheap
20150122T000000,507200.0,3,3.5,1630,1329,2.0,0,0,3,9,1360,270,2000,0,98122,47.6159,-122.306,1580,1319,-301,-261,381.640331075997,0.056681967213114755,Very Cheap
20140812T000000,380000.0,4,2.5,2500,11070,1.0,0,2,4,8,1300,1200,1964,0,98003,47.336,-122.334,2500,11070,8570,8570,34.32700993676603,0.04,Very Cheap
20140814T000000,540000.0,4,1.75,2260,19500,1.0,0,2,3,8,1450,810,1971,0,98074,47.6555,-122.086,2980,19500,17240,16520,27.692307692307693,0.06098360655737705,Very Cheap
20140617T000000,738500.0,3,2.5,2300,6009,1.0,0,0,3,8,2300,0,2005,0,98053,47.7067,-122.013,1640,5931,3709,4291,122.89898485604925,0.08701639344262295,Very Cheap
20150129T000000,206000.0,3,1.0,1060,10350,1.0,0,0,4,7,1060,0,1980,0,98038,47.365,-122.028,1500,9660,9290,8160,19.903381642512077,0.017180327868852457,Very Cheap
20150317T000000,265000.0,2,1.0,940,9458,1.0,0,0,3,6,940,0,1948,0,98155,47.7523,-122.311,1450,9458,8518,8008,28.018608585324593,0.024918032786885248,Very Cheap
20150120T000000,190000.0,1,0.75,780,77603,1.0,0,0,1,5,780,0,1945,0,98058,47.4396,-122.104,1750,30847,76823,29097,2.4483589551950313,0.015081967213114755,Very Cheap
20140628T000000,339900.0,3,1.0,1200,9087,1.0,0,0,5,7,1200,0,1969,0,98056,47.5234,-122.177,1250,11826,7887,10576,37.405084186200064,0.03474098360655738,Very Cheap
20141226T000000,250000.0,6,2.5,2590,10890,1.0,0,0,4,7,1340,1250,1970,0,98042,47.4126,-122.165,2474,10454,8300,7980,22.95684113865932,0.022950819672131147,Very Cheap
20140801T000000,416500.0,3,1.0,1100,4184,1.0,0,0,4,7,1100,0,1965,0,98136,47.5309,-122.382,1630,4366,3084,2736,99.54588910133843,0.04478688524590164,Very Cheap
20150407T000000,575000.0,4,2.5,2890,9775,2.0,0,2,3,8,2890,0,2004,0,98065,47.5339,-121.854,2640,7184,6885,4544,58.8235294117647,0.06557377049180328,Very Cheap
20140609T000000,385000.0,3,1.75,1230,7500,1.0,0,0,3,7,1230,0,1987,0,98034,47.7316,-122.224,1930,8747,6270,6817,51.333333333333336,0.04065573770491803,Very Cheap
20141009T000000,253000.0,3,1.0,1030,6250,1.0,0,0,3,7,1030,0,1960,1997,98056,47.4988,-122.168,1160,7250,5220,6090,40.48,0.023344262295081967,Very Cheap
20140902T000000,460000.0,3,1.0,1140,4600,1.0,0,0,3,7,1140,0,1942,0,98103,47.6897,-122.337,1370,5000,3460,3630,100.0,0.050491803278688525,Very Cheap
20140807T000000,1445000.0,4,2.5,3200,3600,3.0,0,3,4,9,2600,600,1997,0,98119,47.632,-122.369,2490,4080,400,1590,401.3888888888889,0.179672131147541,Cheap
20150304T000000,492000.0,2,1.0,950,6000,1.0,0,0,3,7,950,0,1942,0,98115,47.6897,-122.294,1440,6000,5050,4560,82.0,0.054688524590163934,Very Cheap
20141016T000000,275000.0,4,2.0,1960,30480,1.0,0,2,4,7,1060,900,1972,0,98022,47.1924,-121.988,1460,8914,28520,7454,9.02230971128609,0.02622950819672131,Very Cheap
20140521T000000,542500.0,5,3.25,3010,1074218,1.5,0,0,5,8,2010,1000,1931,0,98027,47.4564,-122.004,2450,68825,1071208,66375,0.5050185344129404,0.061311475409836065,Very Cheap
20140701T000000,345000.0,2,1.0,1080,7775,1.0,0,0,3,6,1080,0,1955,0,98136,47.5447,-122.394,1730,7350,6695,5620,44.37299035369775,0.03540983606557377,Very Cheap
20150421T000000,575000.0,4,2.75,2730,35075,1.0,0,0,3,8,1530,1200,1979,0,98072,47.7726,-122.139,2310,35000,32345,32690,16.39344262295082,0.06557377049180328,Very Cheap
20150504T000000,275000.0,5,2.5,2570,17234,1.0,0,0,3,7,1300,1270,1959,0,98133,47.7753,-122.355,1760,7969,14664,6209,15.956829523035859,0.02622950819672131,Very Cheap
20140722T000000,510000.0,6,4.5,3300,7561,2.0,0,0,3,8,3300,0,1980,0,98052,47.6795,-122.104,2470,7561,4261,5091,67.45139531807962,0.057049180327868855,Very Cheap
20150401T000000,2538000.0,4,3.5,4350,6000,2.0,0,0,5,10,2970,1380,1908,0,98112,47.6277,-122.286,4190,7200,1650,3010,423.0,0.32301639344262295,Medium
20140909T000000,830000.0,3,3.5,3820,145054,2.0,0,3,3,9,2870,950,1999,0,98045,47.4419,-121.736,2500,95950,141234,93450,5.722006976712121,0.09901639344262295,Very Cheap
20141121T000000,640000.0,4,2.5,2260,5172,2.0,0,0,3,9,2260,0,2004,0,98052,47.7047,-122.128,2680,5172,2912,2492,123.74323279195669,0.0740983606557377,Very Cheap
20141014T000000,702000.0,4,2.75,3880,15025,2.0,0,0,3,7,3880,0,2004,0,98053,47.6777,-122.035,2620,5300,11145,2680,46.722129783693845,0.08222950819672131,Very Cheap
20141119T000000,960000.0,3,2.5,2010,6857,1.0,0,0,4,9,1450,560,1955,0,98102,47.6402,-122.314,2380,6370,4847,3990,140.00291672743182,0.1160655737704918,Cheap
20150429T000000,190000.0,3,1.0,950,7610,1.0,0,0,3,7,950,0,1983,0,98092,47.3188,-122.174,1360,7938,6660,6578,24.967148488830485,0.015081967213114755,Very Cheap
20141009T000000,500000.0,3,2.25,1730,13040,1.0,0,0,4,8,1290,440,1988,0,98052,47.6809,-122.119,1730,11016,11310,9286,38.34355828220859,0.05573770491803279,Very Cheap
20140714T000000,529000.0,3,2.5,3070,22098,2.0,0,0,3,9,3070,0,1995,0,98059,47.4724,-122.147,3070,21803,19028,18733,23.938817992578514,0.05954098360655738,Very Cheap
20140613T000000,435000.0,3,1.75,1500,8173,1.0,0,0,3,7,1500,0,1997,0,98034,47.7293,-122.227,1970,8173,6673,6203,53.224030343815,0.04721311475409836,Very Cheap
20150303T000000,670000.0,3,1.75,2160,5760,1.0,0,0,4,8,1260,900,1954,0,98136,47.5346,-122.391,2090,5760,3600,3670,116.31944444444444,0.0780327868852459,Very Cheap
20150507T000000,365000.0,3,2.25,1960,1985,2.0,0,0,3,7,1750,210,2003,0,98118,47.5419,-122.289,1760,1985,25,225,183.87909319899245,0.0380327868852459,Very Cheap
20141204T000000,1270000.0,5,3.0,3950,9520,1.0,0,0,3,9,2250,1700,1953,2002,98004,47.6363,-122.207,1890,9520,5570,7630,133.4033613445378,0.15672131147540982,Cheap
20140925T000000,465000.0,3,1.0,1100,145490,1.5,0,0,4,6,1100,0,1915,0,98024,47.5697,-121.898,1100,11610,144390,10510,3.196095951611795,0.051147540983606556,Very Cheap
20150107T000000,285000.0,3,1.5,1400,7582,1.0,0,0,3,7,1400,0,1956,0,98148,47.4536,-122.33,1280,7872,6182,6592,37.58902664204695,0.02754098360655738,Very Cheap
20150205T000000,219950.0,3,1.0,1020,4960,1.5,0,0,3,6,920,100,1926,0,98118,47.5328,-122.275,1230,7335,3940,6105,44.34475806451613,0.01900983606557377,Very Cheap
20141117T000000,220000.0,3,1.5,1600,10548,1.0,0,0,4,7,1600,0,1962,0,98001,47.2925,-122.284,2880,13609,8948,10729,20.857034508911642,0.01901639344262295,Very Cheap
20140709T000000,1465000.0,6,4.5,4230,6420,2.0,0,3,4,8,2360,1870,1916,0,98119,47.6301,-122.369,3450,4085,2190,635,228.1931464174455,0.1822950819672131,Cheap
20141020T000000,1112750.0,5,3.5,3090,3600,2.0,0,0,3,9,2060,1030,2000,0,98112,47.6217,-122.309,2240,3904,510,1664,309.09722222222223,0.13609836065573772,Cheap
20150417T000000,694000.0,2,2.5,2320,9311,1.0,0,0,3,8,2320,0,2007,0,98053,47.7226,-122.03,1680,4765,6991,3085,74.53549565030609,0.08118032786885246,Very Cheap
20150403T000000,620000.0,3,2.5,2440,10363,2.0,0,0,3,9,2440,0,1988,0,98029,47.5634,-122.016,2500,10728,7923,8228,59.82823506706552,0.07147540983606557,Very Cheap
20140821T000000,415000.0,3,1.0,2020,19210,1.0,0,0,3,6,1760,260,1949,0,98028,47.7552,-122.229,1780,14469,17190,12689,21.603331598125976,0.04459016393442623,Very Cheap
20150223T000000,765000.0,3,3.0,3270,38088,2.0,0,0,3,10,3270,0,1992,0,98053,47.6692,-122.028,1870,37457,34818,35587,20.08506616257089,0.09049180327868853,Very Cheap
20140715T000000,864000.0,4,1.75,2260,6600,1.0,0,0,5,8,1220,1040,1948,0,98115,47.6753,-122.278,2240,6600,4340,4360,130.9090909090909,0.10347540983606557,Cheap
20141204T000000,385000.0,5,2.0,2020,4000,2.0,0,0,3,7,2020,0,1950,0,98144,47.5799,-122.305,1960,4000,1980,2040,96.25,0.04065573770491803,Very Cheap
20150113T000000,725000.0,3,1.0,1000,19969,1.0,0,0,3,7,1000,0,1951,0,98033,47.6745,-122.197,1370,7962,18969,6592,36.30627472582503,0.08524590163934426,Very Cheap
20140617T000000,545000.0,4,2.25,2030,11585,1.0,0,0,4,7,1590,440,1967,0,98052,47.6561,-122.13,1960,8977,9555,7017,47.04359085023738,0.06163934426229508,Very Cheap
20150411T000000,299900.0,3,1.75,1730,9893,1.0,0,0,4,9,1730,0,1988,0,98042,47.3747,-122.164,2120,9108,8163,6988,30.31436369149904,0.029495081967213115,Very Cheap
20150507T000000,639500.0,3,1.75,2010,8072,1.0,0,0,4,8,2010,0,1974,0,98052,47.6327,-122.097,2030,8055,6062,6025,79.22447968285431,0.07403278688524591,Very Cheap
20150317T000000,345000.0,4,1.5,1540,7168,1.0,0,0,3,7,1160,380,1964,0,98055,47.455,-122.198,1540,7176,5628,5636,48.130580357142854,0.03540983606557377,Very Cheap
20150330T000000,1125000.0,6,4.0,5330,18116,2.0,0,0,3,11,3950,1380,2000,0,98006,47.5503,-122.137,4590,16900,12786,12310,62.0998012806359,0.1377049180327869,Cheap
20150316T000000,345000.0,2,1.0,960,2700,1.0,0,0,3,6,780,180,1904,0,98144,47.6013,-122.299,1400,3000,1740,1600,127.77777777777777,0.03540983606557377,Very Cheap
20150421T000000,600000.0,3,2.0,1460,2800,1.0,0,0,4,7,730,730,1921,0,98105,47.67,-122.295,1780,4560,1340,2780,214.28571428571428,0.06885245901639345,Very Cheap
20141104T000000,355000.0,4,1.75,2160,7417,1.0,0,0,4,7,1360,800,1983,0,98056,47.5122,-122.181,1880,8022,5257,6142,47.86301739247674,0.036721311475409836,Very Cheap
20140909T000000,698000.0,3,2.75,2640,11957,1.5,0,0,3,9,2260,380,1978,0,98052,47.6491,-122.12,2640,12641,9317,10001,58.37584678431045,0.08170491803278689,Very Cheap
20140616T000000,566000.0,4,2.25,2170,7737,2.0,0,0,3,8,2170,0,1987,0,98074,47.637,-122.029,1850,8869,5567,7019,73.1549696264702,0.06439344262295082,Very Cheap
20140723T000000,449950.0,3,2.5,1530,3840,2.0,0,0,3,8,1530,0,1994,0,98029,47.5691,-122.007,1720,3985,2310,2265,117.17447916666667,0.04917377049180328,Very Cheap
20150116T000000,404600.0,3,1.0,1570,7727,1.0,0,2,4,8,1270,300,1958,0,98056,47.4821,-122.192,2440,7727,6157,5287,52.36184806522583,0.04322622950819672,Very Cheap
20140624T000000,258000.0,3,1.0,1490,7435,1.0,0,0,3,7,1120,370,1969,0,98198,47.368,-122.314,1490,7530,5945,6040,34.700739744451916,0.024,Very Cheap
20150429T000000,415000.0,4,2.0,1960,10559,2.0,0,0,4,7,1960,0,1955,0,98133,47.7494,-122.337,1580,7769,8599,6189,39.30296429586135,0.04459016393442623,Very Cheap
20140812T000000,320000.0,4,2.25,2190,9020,2.0,0,0,3,8,2190,0,1978,0,98032,47.3742,-122.284,2170,8400,6830,6230,35.47671840354767,0.032131147540983604,Very Cheap
20141126T000000,295000.0,3,2.5,1690,4102,2.0,0,0,3,7,1690,0,2003,0,98038,47.3552,-122.015,1830,4733,2412,2903,71.9161384690395,0.028852459016393443,Very Cheap
20140527T000000,389000.0,5,2.0,2330,10750,1.0,0,0,4,7,1190,1140,1962,0,98028,47.7325,-122.245,1830,10180,8420,8350,36.18604651162791,0.04118032786885246,Very Cheap
20140821T000000,299900.0,3,1.75,1470,27000,1.0,0,0,3,7,1470,0,1958,0,98198,47.3943,-122.311,2230,14186,25530,11956,11.107407407407408,0.029495081967213115,Very Cheap
20150415T000000,394000.0,3,2.5,2550,5349,2.0,0,0,3,7,2550,0,2004,0,98038,47.3504,-122.026,2640,5400,2799,2760,73.65862778089362,0.041836065573770495,Very Cheap
20150202T000000,762000.0,4,2.0,2130,5500,1.5,0,0,5,7,2130,0,1939,0,98033,47.6807,-122.199,1490,6000,3370,4510,138.54545454545453,0.0900983606557377,Very Cheap
20140613T000000,697000.0,4,2.75,3650,48351,1.5,0,0,4,8,3650,0,1978,0,98077,47.7632,-122.089,2820,53143,44701,50323,14.415420570412195,0.08157377049180328,Very Cheap
20150330T000000,485000.0,3,2.5,3340,70131,2.0,0,0,3,9,2420,920,1994,0,98022,47.2666,-122.015,2760,116740,66791,113980,6.915629322268327,0.05377049180327869,Very Cheap
20141008T000000,189900.0,2,1.0,800,5600,1.0,0,0,5,6,800,0,1955,0,98056,47.4959,-122.172,1100,6000,4800,4900,33.910714285714285,0.015068852459016393,Very Cheap
20150105T000000,2150000.0,3,2.75,3470,9610,3.0,1,4,3,11,3470,0,1989,2000,98034,47.7205,-122.26,4130,11875,6140,7745,223.72528616024974,0.2721311475409836,Cheap
20141118T000000,345000.0,3,1.5,1030,6969,1.0,0,0,4,6,1030,0,1921,0,98108,47.5492,-122.3,1420,6000,5939,4580,49.504950495049506,0.03540983606557377,Very Cheap
20140729T000000,376500.0,3,2.0,1630,7800,1.0,0,0,5,7,1630,0,1950,0,98125,47.7326,-122.307,1470,7800,6170,6330,48.26923076923077,0.039540983606557376,Very Cheap
20141024T000000,775000.0,3,2.0,2010,7017,2.0,0,3,3,7,2010,0,1951,1988,98115,47.6828,-122.267,2450,6045,5007,3595,110.44605956961665,0.09180327868852459,Very Cheap
20141016T000000,450000.0,3,1.0,1360,3737,1.5,0,0,4,6,1360,0,1910,0,98107,47.6751,-122.362,1820,4500,2377,2680,120.41744715012042,0.04918032786885246,Very Cheap
20141210T000000,760000.0,4,2.25,2040,8315,1.0,0,0,4,8,1480,560,1958,0,98177,47.7077,-122.371,2330,8940,6275,6610,91.40108238123872,0.0898360655737705,Very Cheap
20141007T000000,569000.0,4,2.5,2830,10954,2.0,0,0,3,8,2830,0,2003,0,98065,47.5396,-121.882,2470,10443,8124,7973,51.94449516158481,0.06478688524590163,Very Cheap
20140917T000000,500000.0,3,1.5,2040,6750,1.0,0,0,3,7,1280,760,1950,0,98117,47.7013,-122.369,1970,6750,4710,4780,74.07407407407408,0.05573770491803279,Very Cheap
20141211T000000,592500.0,2,2.0,1340,5350,1.5,0,0,3,8,1340,0,1941,0,98199,47.6384,-122.403,2210,5350,4010,3140,110.74766355140187,0.06786885245901639,Very Cheap
20150304T000000,620000.0,4,2.5,2130,9139,2.0,0,0,3,9,2130,0,1988,0,98029,47.5648,-122.01,2150,8178,7009,6028,67.84112047269942,0.07147540983606557,Very Cheap
20140515T000000,1000000.0,5,4.25,3920,16258,2.0,0,0,3,9,2900,1020,1990,0,98004,47.5871,-122.192,2540,12131,12338,9591,61.508180588018206,0.12131147540983607,Cheap
20150319T000000,815000.0,3,2.5,2415,2186,2.0,0,1,3,9,2415,0,1981,0,98033,47.6506,-122.202,2660,2165,-229,-495,372.82708142726443,0.09704918032786886,Very Cheap
20150323T000000,775000.0,5,2.75,3750,12077,2.0,0,4,3,10,3750,0,2005,0,98038,47.3525,-122.002,3120,7255,8327,4135,64.17156578620518,0.09180327868852459,Very Cheap
20140716T000000,340000.0,3,1.0,1010,7500,1.0,0,0,4,7,1010,0,1975,0,98074,47.6169,-122.062,1230,7500,6490,6270,45.333333333333336,0.03475409836065574,Very Cheap
20140915T000000,458000.0,2,1.75,990,5850,1.0,0,0,4,6,990,0,1942,0,98125,47.7132,-122.321,840,6110,4860,5270,78.2905982905983,0.05022950819672131,Very Cheap
20140917T000000,250000.0,2,1.5,1200,5773,2.0,0,0,3,7,1200,0,1985,0,98055,47.4723,-122.19,1530,4576,4573,3046,43.30504070673827,0.022950819672131147,Very Cheap
20141009T000000,151600.0,2,1.0,1060,16988,1.0,0,0,3,6,1060,0,1954,0,98058,47.4305,-122.157,2320,10580,15928,8260,8.923946315045916,0.010045901639344263,Very Cheap
20140527T000000,515000.0,4,2.5,3200,6473,2.0,0,0,3,7,3200,0,2005,0,98059,47.5012,-122.15,2480,6140,3273,3660,79.56125444152634,0.057704918032786885,Very Cheap
20150327T000000,216000.0,2,1.0,1810,10360,1.0,0,0,3,6,1010,800,1946,0,98178,47.5039,-122.266,1810,10360,8550,8550,20.84942084942085,0.018491803278688525,Very Cheap
20150309T000000,245000.0,3,1.75,1670,24650,1.0,0,0,4,7,1670,0,1974,0,98022,47.1764,-122.026,1810,19465,22980,17655,9.939148073022313,0.022295081967213116,Very Cheap
20140625T000000,645000.0,3,2.75,1850,16960,1.0,0,2,4,8,1850,0,1953,0,98177,47.7128,-122.365,2470,13761,15110,11291,38.030660377358494,0.07475409836065573,Very Cheap
20140903T000000,249900.0,3,1.0,1100,5000,1.0,0,0,3,7,1100,0,1960,0,98118,47.5433,-122.283,1020,5000,3900,3980,49.98,0.02293770491803279,Very Cheap
20140709T000000,410000.0,3,1.75,1660,6250,1.0,0,0,3,7,830,830,1980,0,98116,47.5859,-122.385,1660,5750,4590,4090,65.6,0.043934426229508196,Very Cheap
20150313T000000,499000.0,6,1.75,2400,7500,1.5,0,0,3,7,1400,1000,1975,0,98155,47.7661,-122.313,1980,7500,5100,5520,66.53333333333333,0.05560655737704918,Very Cheap
20140529T000000,790000.0,5,3.25,2900,12160,1.0,0,0,4,8,1890,1010,1967,0,98005,47.6154,-122.168,2590,12160,9260,9570,64.96710526315789,0.09377049180327869,Very Cheap
20140520T000000,458000.0,1,2.25,2140,10350,1.0,0,0,3,7,1470,670,1976,0,98072,47.7352,-122.17,1980,8400,8210,6420,44.2512077294686,0.05022950819672131,Very Cheap
20140805T000000,925000.0,4,2.5,2670,5100,2.0,0,0,3,8,1940,730,1929,2010,98117,47.6768,-122.39,1470,4080,2430,2610,181.37254901960785,0.11147540983606558,Cheap
20140625T000000,152000.0,3,1.0,1090,3264,1.0,0,0,4,6,1090,0,1969,0,98092,47.3155,-122.182,1090,3330,2174,2240,46.568627450980394,0.010098360655737704,Very Cheap
20140923T000000,402000.0,3,2.5,1970,12205,2.0,0,0,4,8,1970,0,1990,0,98011,47.7397,-122.209,2640,9636,10235,6996,32.93732077017616,0.04288524590163934,Very Cheap
20150326T000000,340000.0,2,2.0,1250,1178,2.0,0,0,3,7,980,270,1996,0,98136,47.5426,-122.387,1270,1242,-72,-28,288.6247877758913,0.03475409836065574,Very Cheap
20150326T000000,1250000.0,4,2.5,4040,11350,2.0,0,2,4,10,3690,350,1984,0,98006,47.559,-122.162,3770,12382,7310,8612,110.13215859030836,0.1540983606557377,Cheap
20141117T000000,775000.0,4,2.5,3220,38448,2.0,0,0,3,10,3220,0,1993,0,98053,47.6854,-122.053,3090,38448,35228,35358,20.157095297544736,0.09180327868852459,Very Cheap
20150319T000000,299800.0,2,1.0,1310,2814,1.0,0,0,3,6,810,500,1944,0,98126,47.5185,-122.376,1300,1344,1504,44,106.53873489694385,0.029481967213114753,Very Cheap
20140908T000000,340000.0,4,2.25,2060,8400,1.0,0,0,3,7,1300,760,1960,0,98178,47.4984,-122.23,1990,7383,6340,5393,40.476190476190474,0.03475409836065574,Very Cheap
20140502T000000,626000.0,3,2.25,1750,1572,2.5,0,0,3,9,1470,280,2005,0,98102,47.6498,-122.321,2410,3050,-178,640,398.2188295165394,0.07226229508196721,Very Cheap
20141007T000000,324950.0,2,1.0,1150,9186,1.0,0,0,3,7,1150,0,1946,0,98168,47.5081,-122.33,1390,10690,8036,9300,35.37448290877422,0.03278032786885246,Very Cheap
20150223T000000,535500.0,3,2.5,2050,4976,2.0,0,0,3,8,2050,0,1994,0,98029,47.5689,-121.995,2050,5153,2926,3103,107.61655948553054,0.06039344262295082,Very Cheap
20140905T000000,817500.0,3,3.25,3230,7639,2.0,0,0,3,10,3230,0,1999,0,98074,47.6338,-122.063,3230,7772,4409,4542,107.01662521272418,0.09737704918032787,Very Cheap
20140812T000000,810000.0,4,3.5,4170,4322,2.0,0,0,3,9,2940,1230,2005,0,98074,47.6136,-122.041,2970,4922,152,1952,187.4132346136048,0.09639344262295083,Very Cheap
20150408T000000,565000.0,5,1.5,1940,3430,1.5,0,0,4,6,1220,720,1926,0,98117,47.6853,-122.362,1830,4120,1490,2290,164.72303206997086,0.06426229508196721,Very Cheap
20141125T000000,978000.0,3,1.5,2390,4000,1.5,0,0,3,9,1690,700,1936,0,98105,47.6604,-122.28,2350,4000,1610,1650,244.5,0.11842622950819671,Cheap
20150112T000000,530000.0,3,1.0,1440,27505,1.0,0,0,3,8,1440,0,1951,0,98177,47.7553,-122.37,2430,16400,26065,13970,19.269223777495,0.05967213114754098,Very Cheap
20141007T000000,305000.0,4,2.5,2230,6487,2.0,0,0,3,7,2230,0,2003,0,98092,47.3287,-122.169,2230,6882,4257,4652,47.01711114536766,0.03016393442622951,Very Cheap
20140609T000000,345000.0,3,2.5,1210,1420,3.0,0,0,3,8,1210,0,2008,0,98103,47.6977,-122.349,1190,1407,210,217,242.95774647887325,0.03540983606557377,Very Cheap
20150219T000000,258000.0,2,2.0,750,6553,1.5,0,2,3,7,750,0,1945,0,98178,47.4982,-122.221,1140,7500,5803,6360,39.37128032962002,0.024,Very Cheap
20150330T000000,275000.0,4,1.0,1770,7345,1.5,0,0,3,7,1770,0,1966,0,98106,47.5393,-122.351,1580,7345,5575,5765,37.44043567052417,0.02622950819672131,Very Cheap
20150324T000000,310000.0,3,1.0,1020,55756,1.0,0,0,3,7,1020,0,1961,0,98042,47.3836,-122.082,1490,12745,54736,11255,5.559939737427362,0.03081967213114754,Very Cheap
20140603T000000,713250.0,3,2.0,2050,9000,1.0,0,0,4,7,2050,0,1951,0,98040,47.5885,-122.245,2910,8856,6950,5946,79.25,0.08370491803278689,Very Cheap
20150508T000000,500000.0,3,1.0,2000,21780,1.0,0,0,3,8,1480,520,1978,0,98074,47.6064,-122.039,2000,45738,19780,43738,22.95684113865932,0.05573770491803279,Very Cheap
20140911T000000,472000.0,3,1.75,2180,7200,1.0,0,3,4,8,1090,1090,1954,0,98178,47.5044,-122.235,2180,7140,5020,4960,65.55555555555556,0.052065573770491806,Very Cheap
20140711T000000,250000.0,3,1.0,920,4429,1.0,0,0,3,7,920,0,1952,0,98118,47.5369,-122.291,1320,7860,3509,6540,56.446150372544594,0.022950819672131147,Very Cheap
20141002T000000,725000.0,4,2.25,3440,14237,2.0,0,0,3,9,3440,0,1982,0,98077,47.7241,-122.065,3250,18365,10797,15115,50.92364964529044,0.08524590163934426,Very Cheap
20140629T000000,345000.0,3,2.0,1610,15005,1.0,0,0,4,7,1610,0,1986,0,98014,47.6886,-121.911,1610,15479,13395,13869,22.99233588803732,0.03540983606557377,Very Cheap
20150115T000000,460000.0,3,1.5,1870,15685,1.0,0,0,3,7,1470,400,1936,0,98133,47.723,-122.353,1340,7620,13815,6280,29.32738284985655,0.050491803278688525,Very Cheap
20140602T000000,440150.0,2,1.0,1110,6800,1.0,0,0,5,7,1000,110,1947,0,98133,47.7184,-122.355,1410,6963,5690,5553,64.7279411764706,0.04788852459016393,Very Cheap
20141104T000000,390000.0,3,1.75,2200,8036,1.0,0,0,3,7,1270,930,1978,0,98011,47.7763,-122.209,1850,7563,5836,5713,48.531607765057245,0.04131147540983607,Very Cheap
20150504T000000,375000.0,2,1.0,790,5120,1.0,0,0,3,6,790,0,1950,0,98136,47.557,-122.395,1250,5120,4330,3870,73.2421875,0.03934426229508197,Very Cheap
20141211T000000,224950.0,3,1.5,1630,9282,1.0,0,0,4,7,1630,0,1963,0,98022,47.2021,-122.002,1420,9282,7652,7862,24.235078646843352,0.019665573770491804,Very Cheap
20140829T000000,480000.0,3,1.5,2100,67269,1.0,0,0,4,7,1220,880,1949,0,98028,47.7592,-122.23,1610,15999,65169,14389,7.135530482094278,0.05311475409836065,Very Cheap
20150326T000000,721000.0,4,2.75,2690,5400,2.0,0,0,3,7,2210,480,1940,2009,98117,47.6963,-122.367,1620,5400,2710,3780,133.5185185185185,0.08472131147540983,Very Cheap
20140826T000000,174000.0,2,1.0,600,4854,1.0,0,0,5,6,600,0,1922,0,98168,47.4927,-122.28,1470,5000,4254,3530,35.84672435105068,0.012983606557377049,Very Cheap
20141119T000000,170000.0,2,1.0,810,9882,1.0,0,0,3,6,810,0,1944,0,98178,47.4925,-122.239,950,7200,9072,6250,17.202995345071848,0.012459016393442624,Very Cheap
20150115T000000,658000.0,3,1.5,1660,3190,1.5,0,0,3,7,1660,0,1919,0,98109,47.6368,-122.351,2200,3240,1530,1040,206.26959247648904,0.07645901639344262,Very Cheap
20150327T000000,860000.0,3,2.0,1880,8494,1.0,0,0,4,7,1200,680,1968,0,98004,47.6217,-122.192,1290,9128,6614,7838,101.24793972215681,0.10295081967213114,Cheap
20140618T000000,407450.0,4,1.5,2310,68824,2.0,0,0,4,7,2310,0,1968,0,98010,47.3354,-122.031,2020,39900,66514,37880,5.920173195396955,0.0436,Very Cheap
20150130T000000,615000.0,4,1.5,2650,34000,2.0,0,0,4,7,2650,0,1930,0,98028,47.7516,-122.237,1960,34000,31350,32040,18.08823529411765,0.07081967213114754,Very Cheap
20150407T000000,920000.0,4,3.0,3130,12381,2.0,0,0,3,9,3130,0,1995,0,98006,47.5599,-122.118,3250,10049,9251,6799,74.30740650997497,0.11081967213114755,Cheap
20140710T000000,195000.0,2,1.0,860,10400,1.0,0,0,4,6,860,0,1983,0,98042,47.3682,-122.096,1390,9086,9540,7696,18.75,0.015737704918032787,Very Cheap
20140718T000000,269950.0,3,1.0,990,9950,1.0,0,0,5,7,990,0,1961,0,98056,47.5104,-122.171,1370,9260,8960,7890,27.13065326633166,0.025567213114754097,Very Cheap
20150119T000000,855000.0,4,3.5,4030,1024068,2.0,0,0,3,10,4030,0,2006,0,98045,47.4619,-121.744,1830,11700,1020038,9870,0.834905494557002,0.10229508196721311,Cheap
20140910T000000,620000.0,3,2.25,1780,1429,3.0,0,0,3,8,1570,210,2007,0,98109,47.6413,-122.346,1470,1799,-351,329,433.86983904828554,0.07147540983606557,Very Cheap
20141209T000000,276000.0,2,2.0,1480,6075,1.0,0,0,5,7,740,740,1919,0,98118,47.5317,-122.276,1230,6053,4595,4823,45.4320987654321,0.026360655737704918,Very Cheap
20140806T000000,329000.0,3,1.0,1140,5258,1.5,0,0,3,6,1140,0,1911,0,98146,47.5122,-122.383,1140,5280,4118,4140,62.57131989349563,0.03331147540983607,Very Cheap
20141007T000000,270000.0,3,1.5,1230,7500,1.0,0,0,3,7,1230,0,1962,0,98198,47.4202,-122.331,1260,7800,6270,6540,36.0,0.025573770491803278,Very Cheap
20141113T000000,440000.0,4,2.5,3080,10646,2.0,0,0,3,9,3080,0,1993,0,98042,47.3828,-122.148,2740,9994,7566,7254,41.330077024234456,0.04786885245901639,Very Cheap
20141003T000000,639000.0,4,2.5,1990,8034,2.0,0,0,4,10,1990,0,1989,0,98029,47.561,-122.018,2580,8034,6044,5454,79.53696788648244,0.0739672131147541,Very Cheap
20141010T000000,403500.0,1,1.0,700,5621,1.0,0,0,4,6,700,0,1945,0,98133,47.734,-122.353,1020,5621,4921,4601,71.78438000355808,0.043081967213114754,Very Cheap
20141001T000000,585000.0,3,2.5,1700,1156,2.0,0,2,3,9,1320,380,2002,0,98119,47.6373,-122.369,1710,1686,-544,-24,506.0553633217993,0.06688524590163934,Very Cheap
20140826T000000,216000.0,2,1.0,860,9000,1.0,0,0,4,6,860,0,1942,0,98168,47.4801,-122.315,990,9975,8140,8985,24.0,0.018491803278688525,Very Cheap
20140911T000000,1150000.0,3,2.5,3160,24437,1.0,0,3,3,11,2160,1000,1991,0,98006,47.5531,-122.131,3990,11977,21277,7987,47.05978638949134,0.14098360655737704,Cheap
20150416T000000,575000.0,3,2.0,2500,30056,1.0,0,0,5,8,1840,660,1954,0,98166,47.4468,-122.337,2500,30000,27556,27500,19.13095554964067,0.06557377049180328,Very Cheap
20141114T000000,430000.0,4,2.5,3000,9460,2.0,0,0,3,9,3000,0,2001,0,98031,47.3959,-122.211,3000,8450,6460,5450,45.45454545454545,0.04655737704918033,Very Cheap
20150324T000000,660000.0,2,1.0,1670,8195,1.0,0,0,3,7,1670,0,1954,1975,98033,47.6627,-122.192,1980,7500,6525,5520,80.53691275167785,0.07672131147540984,Very Cheap
20150413T000000,338000.0,2,1.0,690,6400,1.0,0,0,3,6,690,0,1943,0,98126,47.5287,-122.367,1000,6400,5710,5400,52.8125,0.034491803278688525,Very Cheap
20140529T000000,400000.0,4,2.75,1240,3867,1.0,0,0,3,7,800,440,1987,0,98125,47.7157,-122.284,1150,7733,2627,6583,103.43935867597621,0.04262295081967213,Very Cheap
20150220T000000,210000.0,2,1.0,900,5000,1.0,0,0,5,6,900,0,1930,1990,98022,47.2008,-121.995,1150,5000,4100,3850,42.0,0.017704918032786884,Very Cheap
20140522T000000,305000.0,4,1.75,2200,8100,1.5,0,0,5,6,1400,800,1942,0,98168,47.4945,-122.303,1520,8100,5900,6580,37.65432098765432,0.03016393442622951,Very Cheap
20140820T000000,365000.0,2,1.0,960,223898,1.0,0,0,3,6,960,0,1985,0,98014,47.6668,-121.892,1830,230868,222938,229038,1.6302066119393652,0.0380327868852459,Very Cheap
20140629T000000,325000.0,5,2.75,2130,6222,1.0,0,0,3,7,1300,830,1991,0,98118,47.5272,-122.276,2130,6222,4092,4092,52.23400835744134,0.03278688524590164,Very Cheap
20141210T000000,245000.0,4,1.75,2020,8800,1.0,0,0,4,8,2020,0,1969,0,98023,47.3202,-122.384,2320,8000,6780,5680,27.84090909090909,0.022295081967213116,Very Cheap
20140926T000000,182000.0,3,1.0,1060,7350,1.0,0,0,4,7,1060,0,1959,0,98032,47.3809,-122.287,1060,7350,6290,6290,24.761904761904763,0.014032786885245901,Very Cheap
20140603T000000,440000.0,2,1.0,1230,6600,1.0,0,0,3,7,1130,100,1906,0,98118,47.5573,-122.282,1260,5060,5370,3800,66.66666666666667,0.04786885245901639,Very Cheap
20140731T000000,225000.0,3,2.25,2510,12013,2.0,0,0,3,8,2510,0,1988,0,98003,47.3473,-122.314,1870,8017,9503,6147,18.729709481395155,0.019672131147540985,Very Cheap
20150114T000000,358000.0,3,2.25,2510,12013,2.0,0,0,3,8,2510,0,1988,0,98003,47.3473,-122.314,1870,8017,9503,6147,29.80104886373096,0.03711475409836065,Very Cheap
20141202T000000,580000.0,5,2.5,2720,5000,1.5,0,0,4,7,1530,1190,1939,0,98117,47.6827,-122.376,1210,5000,2280,3790,116.0,0.06622950819672131,Very Cheap
20150422T000000,240000.0,3,1.5,1070,8886,1.0,0,0,4,7,1070,0,1984,0,98030,47.3516,-122.166,1730,9461,7816,7731,27.00877785280216,0.021639344262295083,Very Cheap
20150413T000000,700000.0,4,3.25,3580,43093,1.0,0,0,4,8,3580,0,1990,0,98024,47.5595,-121.901,2070,43093,39513,41023,16.243937530457384,0.08196721311475409,Very Cheap
20140729T000000,325000.0,4,2.5,2230,8500,2.0,0,0,3,8,2230,0,1994,0,98022,47.2082,-122.009,2270,8770,6270,6500,38.23529411764706,0.03278688524590164,Very Cheap
20141114T000000,488000.0,4,2.25,2500,10890,1.0,0,0,5,7,1800,700,1978,0,98034,47.7318,-122.239,2500,7467,8390,4967,44.81175390266299,0.05416393442622951,Very Cheap
20140910T000000,875000.0,4,1.0,1670,4600,1.5,0,0,5,8,1670,0,1906,0,98103,47.6838,-122.332,1820,4600,2930,2780,190.2173913043478,0.10491803278688525,Cheap
20140602T000000,615000.0,4,2.5,2150,9070,2.0,0,0,4,8,2150,0,1985,0,98052,47.7279,-122.107,2230,8995,6920,6765,67.80595369349504,0.07081967213114754,Very Cheap
20141120T000000,321000.0,3,2.5,2020,4183,2.0,0,0,3,7,2020,0,2012,0,98038,47.3658,-122.017,2030,4140,2163,2110,76.73918240497251,0.032262295081967214,Very Cheap
20140602T000000,1035000.0,3,2.5,2230,5750,2.0,0,0,3,9,2230,0,2003,0,98033,47.6938,-122.213,1900,8238,3520,6338,180.0,0.1259016393442623,Cheap
20150424T000000,299500.0,2,1.0,740,6300,1.0,0,0,3,6,740,0,1942,0,98126,47.5158,-122.376,740,6300,5560,5560,47.53968253968254,0.02944262295081967,Very Cheap
20150414T000000,459000.0,4,1.5,2020,9583,2.0,0,0,4,7,2020,0,1963,0,98034,47.7283,-122.238,1770,8625,7563,6855,47.89731816758844,0.050360655737704915,Very Cheap
20140912T000000,435000.0,3,2.5,1730,4065,2.0,0,0,3,8,1730,0,1996,0,98029,47.5668,-122.005,1730,4094,2335,2364,107.01107011070111,0.04721311475409836,Very Cheap
20141010T000000,222000.0,3,1.75,1370,8280,1.0,0,0,4,7,1370,0,1980,0,98031,47.4096,-122.172,1850,7820,6910,5970,26.81159420289855,0.019278688524590165,Very Cheap
20141027T000000,485000.0,4,1.0,1210,6380,1.5,0,0,3,7,1210,0,1936,0,98115,47.6924,-122.321,1340,6380,5170,5040,76.01880877742947,0.05377049180327869,Very Cheap
20150429T000000,750000.0,5,3.5,2160,2323,3.0,0,0,3,9,2160,0,2007,0,98107,47.6726,-122.39,1750,4650,163,2900,322.8583727938011,0.08852459016393442,Very Cheap
20141222T000000,266000.0,3,2.25,1550,6022,2.0,0,0,3,8,1550,0,1989,0,98003,47.3525,-122.304,1650,5627,4472,3977,44.17137163732979,0.02504918032786885,Very Cheap
20140602T000000,455000.0,2,1.0,1170,6000,1.0,0,0,4,7,970,200,1941,0,98103,47.6994,-122.354,2130,6002,4830,3872,75.83333333333333,0.049836065573770495,Very Cheap
20150508T000000,490000.0,3,1.75,2020,215622,2.0,0,0,4,7,2020,0,1975,0,98070,47.4189,-122.499,1810,215622,213602,213812,2.272495385443044,0.05442622950819672,Very Cheap
20150430T000000,280000.0,3,1.75,1740,8625,1.0,0,0,4,7,1240,500,1978,0,98023,47.3054,-122.38,1980,8625,6885,6645,32.46376811594203,0.026885245901639345,Very Cheap
20140805T000000,1450000.0,4,3.25,3100,3900,2.0,0,2,5,9,2090,1010,1923,0,98109,47.6385,-122.348,2110,3900,800,1790,371.79487179487177,0.18032786885245902,Cheap
20141217T000000,291000.0,4,1.0,1590,24330,1.5,0,0,3,6,1140,450,1942,0,98168,47.4906,-122.309,1000,16228,22740,15228,11.960542540073982,0.028327868852459016,Very Cheap
20150417T000000,745000.0,5,3.0,2400,10126,2.0,0,3,3,8,2400,0,1981,0,98126,47.5726,-122.373,2250,3946,7726,1696,73.57298044637567,0.08786885245901639,Very Cheap
20140807T000000,685900.0,3,2.5,2290,9142,1.0,0,0,3,8,2290,0,1972,0,98117,47.691,-122.387,1770,8035,6852,6265,75.0273463137169,0.08011803278688524,Very Cheap
20140801T000000,160000.0,3,1.75,1610,7392,1.0,0,0,4,7,1610,0,1964,0,98001,47.3413,-122.28,1450,7392,5782,5942,21.645021645021647,0.011147540983606558,Very Cheap
20150429T000000,650000.0,4,2.5,2240,9934,1.0,0,0,4,8,1490,750,1968,0,98005,47.6147,-122.166,2640,11622,7694,8982,65.43185021139521,0.07540983606557378,Very Cheap
20150219T000000,250000.0,2,1.0,850,6370,1.0,0,0,3,6,850,0,1951,0,98126,47.5198,-122.373,850,5170,5520,4320,39.24646781789639,0.022950819672131147,Very Cheap
20150218T000000,265000.0,2,1.5,920,1458,2.0,0,0,3,7,920,0,1995,0,98133,47.7081,-122.342,1110,1598,538,488,181.75582990397805,0.024918032786885248,Very Cheap
20141105T000000,599000.0,5,3.25,2590,6180,1.0,0,0,3,7,1330,1260,1960,0,98118,47.551,-122.272,1560,6180,3590,4620,96.92556634304208,0.06872131147540983,Very Cheap
20141105T000000,199950.0,3,1.0,1340,7260,1.5,0,0,3,6,1340,0,1944,0,98178,47.4934,-122.237,1210,7260,5920,6050,27.541322314049587,0.01638688524590164,Very Cheap
20150428T000000,712500.0,4,2.75,2420,11201,1.0,0,1,3,8,1420,1000,1948,1999,98118,47.5459,-122.265,3170,9385,8781,6215,63.61039192929203,0.08360655737704918,Very Cheap
20141022T000000,490000.0,2,1.0,1420,4305,1.0,0,0,4,7,920,500,1941,0,98115,47.6864,-122.311,1420,4305,2885,2885,113.82113821138212,0.05442622950819672,Very Cheap
20140620T000000,511500.0,4,1.0,1360,6000,1.5,0,0,3,7,1360,0,1917,0,98115,47.6854,-122.288,1710,6000,4640,4290,85.25,0.05724590163934426,Very Cheap
20150319T000000,299000.0,3,1.0,1510,6200,1.0,0,0,3,6,1010,500,1955,0,98118,47.5293,-122.274,1710,8623,4690,6913,48.225806451612904,0.02937704918032787,Very Cheap
20140814T000000,685000.0,4,2.5,2650,25248,1.0,0,2,3,9,2330,320,1954,0,98177,47.7537,-122.373,3020,23135,22598,20115,27.1308618504436,0.08,Very Cheap
20140825T000000,597000.0,4,2.0,2120,4000,1.5,0,0,4,7,1720,400,1927,0,98117,47.688,-122.383,1760,4000,1880,2240,149.25,0.06845901639344262,Very Cheap
20140908T000000,210000.0,3,1.0,1200,7200,1.0,0,0,3,6,1200,0,1977,0,98030,47.3746,-122.183,1200,7420,6000,6220,29.166666666666668,0.017704918032786884,Very Cheap
20140530T000000,659000.0,4,2.5,3190,11375,1.0,0,0,5,8,2210,980,1946,0,98125,47.704,-122.3,1100,8500,8185,7400,57.934065934065934,0.07659016393442623,Very Cheap
20140604T000000,540000.0,3,1.0,1050,4160,1.0,0,0,4,7,1050,0,1925,0,98115,47.6756,-122.3,1580,3680,3110,2100,129.80769230769232,0.06098360655737705,Very Cheap
20150330T000000,469000.0,3,2.0,1300,22605,1.0,0,0,3,7,1300,0,1998,0,98056,47.5337,-122.187,2250,10215,21305,7965,20.747622207476223,0.05167213114754098,Very Cheap
20150430T000000,1065000.0,3,2.5,3970,263538,1.5,0,0,3,9,3970,0,1991,0,98024,47.6067,-121.952,3970,194676,259568,190706,4.041162944243335,0.1298360655737705,Cheap
20140714T000000,575000.0,5,2.5,2990,7500,1.0,0,2,3,9,1800,1190,1972,0,98177,47.7707,-122.369,2800,9860,4510,7060,76.66666666666667,0.06557377049180328,Very Cheap
20140731T000000,725000.0,4,2.75,2440,7042,1.5,0,2,4,7,1640,800,1941,0,98116,47.5731,-122.408,2170,7900,4602,5730,102.953706333428,0.08524590163934426,Very Cheap
20140917T000000,299950.0,4,1.0,1170,5400,1.0,0,0,5,6,1170,0,1953,0,98056,47.492,-122.172,1100,5400,4230,4300,55.5462962962963,0.029501639344262295,Very Cheap
20150421T000000,375000.0,4,2.0,2270,18450,1.0,0,0,3,7,2270,0,1961,0,98001,47.3264,-122.262,2150,18450,16180,16300,20.32520325203252,0.03934426229508197,Very Cheap
20141118T000000,342450.0,3,1.5,1280,5525,1.0,0,0,3,7,1280,0,1962,0,98133,47.7339,-122.336,1330,5286,4245,3956,61.98190045248869,0.03507540983606557,Very Cheap
20141029T000000,315000.0,4,2.5,1950,3225,2.0,0,0,3,7,1950,0,2002,0,98178,47.5014,-122.226,1980,3225,1275,1245,97.67441860465117,0.031475409836065574,Very Cheap
20141222T000000,328000.0,4,2.75,1930,3840,1.0,0,0,3,7,1170,760,1997,0,98106,47.5303,-122.346,1610,3840,1910,2230,85.41666666666667,0.03318032786885246,Very Cheap
20140509T000000,323000.0,4,2.75,1970,7213,1.0,0,0,3,8,1170,800,1977,0,98058,47.4424,-122.126,1980,7045,5243,5065,44.780257867738804,0.03252459016393443,Very Cheap
20141022T000000,320000.0,4,3.0,1820,3120,1.0,0,0,3,7,1000,820,1997,0,98118,47.5468,-122.274,1600,5001,1300,3401,102.56410256410257,0.032131147540983604,Very Cheap
20141229T000000,550000.0,2,1.0,950,4080,1.0,0,0,4,7,950,0,1924,0,98117,47.6765,-122.384,1120,4080,3130,2960,134.80392156862746,0.06229508196721312,Very Cheap
20141121T000000,1646000.0,6,3.5,4010,16200,1.0,0,0,3,8,2090,1920,1955,1990,98004,47.6322,-122.216,3560,16200,12190,12640,101.60493827160494,0.2060327868852459,Cheap
20140520T000000,1212500.0,4,3.5,4560,16643,1.0,0,3,3,12,2230,2330,1995,0,98006,47.5521,-122.115,4060,15177,12083,11117,72.85345190170041,0.14918032786885246,Cheap
20140827T000000,1200000.0,4,3.5,4560,16643,1.0,0,3,3,12,2230,2330,1995,0,98006,47.5521,-122.115,4060,15177,12083,11117,72.1023853872499,0.14754098360655737,Cheap
20150121T000000,120000.0,3,1.0,1150,8924,1.0,0,0,3,6,1150,0,1943,0,98030,47.3865,-122.217,1492,8924,7774,7432,13.44688480502017,0.005901639344262295,Very Cheap
20150430T000000,175000.0,3,1.0,1150,8924,1.0,0,0,3,6,1150,0,1943,0,98030,47.3865,-122.217,1492,8924,7774,7432,19.610040340654415,0.013114754098360656,Very Cheap
20140916T000000,169900.0,3,1.0,910,5800,1.5,0,0,4,5,910,0,1900,0,98022,47.2068,-121.992,1400,6766,4890,5366,29.29310344827586,0.012445901639344262,Very Cheap
20140811T000000,508000.0,6,2.75,2890,7500,1.0,0,0,4,8,1830,1060,1976,0,98034,47.7099,-122.23,1880,7500,4610,5620,67.73333333333333,0.05678688524590164,Very Cheap
20141211T000000,335000.0,2,1.0,1070,6678,1.0,0,0,4,7,1070,0,1951,0,98133,47.7315,-122.357,1680,7788,5608,6108,50.16471997604073,0.03409836065573771,Very Cheap
20140910T000000,613200.0,3,2.75,2050,3320,1.5,0,0,4,7,1580,470,1927,0,98105,47.6719,-122.301,1760,4150,1270,2390,184.6987951807229,0.07058360655737705,Very Cheap
20140507T000000,420000.0,2,1.5,1040,3500,1.5,0,0,4,6,1040,0,1904,0,98144,47.588,-122.304,1340,1213,2460,-127,120.0,0.04524590163934426,Very Cheap
20140825T000000,1000000.0,4,3.25,3320,8587,3.0,0,0,3,11,2950,370,2008,0,98103,47.691,-122.337,1860,5668,5267,3808,116.45510655642249,0.12131147540983607,Cheap
20140617T000000,342000.0,2,1.0,740,6180,1.0,0,0,3,6,740,0,1948,0,98118,47.5517,-122.272,1330,4635,5440,3305,55.33980582524272,0.03501639344262295,Very Cheap
20140723T000000,850000.0,4,2.0,3380,90968,1.0,0,0,4,9,1690,1690,1979,0,98075,47.5936,-122.077,3380,42740,87588,39360,9.343945123559934,0.10163934426229508,Cheap
20141218T000000,582000.0,2,1.75,1210,4141,1.0,0,0,4,7,910,300,1942,0,98117,47.686,-122.382,1310,4141,2931,2831,140.5457618932625,0.06649180327868852,Very Cheap
20141031T000000,475000.0,3,2.5,2480,6031,2.0,0,0,3,8,2480,0,2001,0,98155,47.772,-122.297,1850,7704,3551,5854,78.75974133642845,0.05245901639344262,Very Cheap
20140505T000000,570000.0,3,2.25,2010,6000,1.0,0,0,3,8,1330,680,1975,0,98052,47.6912,-122.115,2080,8260,3990,6180,95.0,0.06491803278688525,Very Cheap
20150324T000000,826600.0,4,3.25,3230,5000,1.5,0,0,4,7,1750,1480,1916,0,98105,47.6702,-122.3,1730,4000,1770,2270,165.32,0.09857049180327869,Very Cheap
20141021T000000,387000.0,2,2.5,1170,1394,2.0,0,0,3,8,1170,0,2001,0,98122,47.6131,-122.297,1250,3136,224,1886,277.6183644189383,0.040918032786885244,Very Cheap
20140521T000000,330000.0,3,1.0,1250,9126,1.0,0,0,3,7,1250,0,1969,0,98077,47.7554,-122.076,1440,10620,7876,9180,36.16042077580539,0.03344262295081967,Very Cheap
20140725T000000,653450.0,3,2.5,2070,49658,1.0,0,0,4,8,1540,530,1980,0,98075,47.5936,-122.013,2620,35160,47588,32540,13.159007612066535,0.07586229508196721,Very Cheap
20140911T000000,285000.0,2,1.0,1050,3088,1.0,0,0,3,7,1050,0,2005,0,98029,47.5471,-121.996,1890,2772,2038,882,92.29274611398964,0.02754098360655738,Very Cheap
20140814T000000,217000.0,3,1.0,1400,7800,1.0,0,0,3,7,1400,0,1962,0,98059,47.4789,-122.159,1400,7800,6400,6400,27.82051282051282,0.01862295081967213,Very Cheap
20150223T000000,615000.0,3,1.0,1120,12500,1.0,0,0,4,7,1120,0,1977,0,98033,47.6842,-122.2,2380,10000,11380,7620,49.2,0.07081967213114754,Very Cheap
20140603T000000,580135.0,4,2.5,3150,5886,2.0,0,0,3,8,3150,0,2014,0,98059,47.4787,-122.122,2650,5886,2736,3236,98.56184165817193,0.0662472131147541,Very Cheap
20140730T000000,1150000.0,4,3.5,4540,19767,2.0,0,0,3,11,4200,340,1998,0,98006,47.5445,-122.137,3990,12881,15227,8891,58.17777103252896,0.14098360655737704,Cheap
20141029T000000,231200.0,3,2.0,1400,8821,1.0,0,0,3,7,1400,0,1991,0,98022,47.1949,-121.989,1450,8721,7421,7271,26.210180251672146,0.020485245901639346,Very Cheap
20140616T000000,680000.0,4,2.75,2500,4950,2.0,0,0,3,8,2500,0,2010,0,98053,47.6964,-122.017,2500,4950,2450,2450,137.37373737373738,0.07934426229508197,Very Cheap
20140725T000000,267500.0,3,1.5,1390,2153,2.0,0,0,3,7,1390,0,2001,0,98118,47.5506,-122.29,1100,2617,763,1517,124.24523920111473,0.025245901639344263,Very Cheap
20140804T000000,942000.0,4,2.75,3160,37200,2.0,0,3,3,8,2310,850,1939,0,98125,47.7214,-122.285,3130,20000,34040,16870,25.322580645161292,0.11370491803278689,Cheap
20140619T000000,435000.0,3,1.75,1310,8065,1.0,0,0,4,6,1310,0,1948,0,98117,47.701,-122.368,1420,8100,6755,6680,53.93676379417235,0.04721311475409836,Very Cheap
20140610T000000,315000.0,2,1.0,1740,3622,1.0,0,0,4,7,950,790,1924,0,98118,47.5541,-122.29,1270,3800,1882,2530,86.96852567642186,0.031475409836065574,Very Cheap
20140513T000000,354901.0,3,2.5,1490,1709,3.0,0,0,3,8,1490,0,2004,0,98125,47.7173,-122.299,1364,1709,219,345,207.6658864833236,0.03670832786885246,Very Cheap
20141014T000000,439888.0,2,2.0,1300,6515,1.0,0,0,3,8,1300,0,2005,0,98053,47.7078,-122.013,1640,6009,5215,4369,67.51926323867997,0.04785416393442623,Very Cheap
20150122T000000,360000.0,4,1.0,1460,3840,1.5,0,0,3,8,1340,120,1928,0,98106,47.533,-122.347,990,4200,2380,3210,93.75,0.037377049180327866,Very Cheap
20141231T000000,205000.0,4,1.0,1030,6621,1.0,0,0,4,6,1030,0,1955,0,98055,47.4857,-122.221,1420,6631,5591,5211,30.96209031868298,0.017049180327868854,Very Cheap
20140612T000000,299995.0,3,2.5,1970,7500,2.0,0,0,3,8,1970,0,1988,0,98092,47.2658,-122.218,1950,8220,5530,6270,39.99933333333333,0.029507540983606556,Very Cheap
20140923T000000,150000.0,2,1.0,790,7275,1.0,0,0,4,6,790,0,1944,0,98058,47.4771,-122.174,850,7399,6485,6549,20.61855670103093,0.009836065573770493,Very Cheap
20140603T000000,575000.0,3,2.25,3800,33825,1.0,0,0,4,10,3330,470,1976,0,98042,47.3797,-122.152,3470,14484,30025,11014,16.999260901699927,0.06557377049180328,Very Cheap
20150505T000000,625000.0,3,2.0,2168,12616,2.0,0,1,4,7,2168,0,1950,0,98146,47.4933,-122.367,2168,9750,10448,7582,49.54026632847178,0.07213114754098361,Very Cheap
20140529T000000,950000.0,4,3.5,4140,13392,2.0,0,0,3,11,4140,0,2000,0,98059,47.5261,-122.144,4140,11529,9252,7389,70.9378733572282,0.11475409836065574,Cheap
20150210T000000,278800.0,4,2.5,2440,7797,1.0,0,0,3,8,1560,880,1965,0,98031,47.3895,-122.222,2090,8100,5357,6010,35.75734256765423,0.026727868852459015,Very Cheap
20141110T000000,713500.0,3,2.0,1720,4200,2.0,0,0,3,8,1720,0,1908,1992,98112,47.6285,-122.301,1720,4200,2480,2480,169.88095238095238,0.08373770491803278,Very Cheap
20150325T000000,1900000.0,4,2.25,3020,11489,1.5,1,3,5,10,2110,910,1916,1988,98040,47.5395,-122.21,3890,11489,8469,7599,165.3755766385238,0.23934426229508196,Cheap
20141028T000000,439000.0,5,2.0,2610,5009,1.0,0,0,3,7,1710,900,1988,0,98117,47.6969,-122.366,1600,5040,2399,3440,87.64224396087043,0.04773770491803279,Very Cheap
20140926T000000,425000.0,3,2.0,1500,8086,1.0,0,0,3,7,1060,440,1981,0,98027,47.5584,-122.081,1550,8086,6586,6536,52.559980212713334,0.04590163934426229,Very Cheap
20140825T000000,252500.0,4,2.5,2600,11280,1.5,0,0,3,7,1570,1030,1961,0,98003,47.336,-122.304,1660,11200,8680,9540,22.384751773049647,0.023278688524590165,Very Cheap
20140512T000000,185000.0,3,1.5,1370,8470,1.0,0,0,4,7,1370,0,1961,0,98092,47.2874,-122.192,1710,8800,7100,7090,21.841794569067297,0.014426229508196721,Very Cheap
20140923T000000,406550.0,5,2.75,2400,15781,1.0,0,0,4,7,1200,1200,1974,0,98074,47.622,-122.059,2390,7500,13381,5110,25.76199226918446,0.04348196721311475,Very Cheap
20140630T000000,243000.0,2,1.5,1068,1758,2.0,0,0,3,7,1068,0,1990,0,98028,47.7527,-122.244,1078,1315,690,237,138.22525597269623,0.022032786885245903,Very Cheap
20141201T000000,500000.0,3,1.5,2220,8994,1.0,0,0,4,8,1110,1110,1962,0,98006,47.5473,-122.172,2220,8994,6774,6774,55.5926173004225,0.05573770491803279,Very Cheap
20150513T000000,204750.0,2,1.0,880,7575,1.0,0,0,4,7,880,0,1942,0,98198,47.3757,-122.304,1800,7575,6695,5775,27.02970297029703,0.01701639344262295,Very Cheap
20140909T000000,222000.0,3,1.5,1310,9273,1.0,0,0,4,7,1310,0,1968,0,98042,47.3683,-122.147,1710,9600,7963,7890,23.940472339048853,0.019278688524590165,Very Cheap
20140523T000000,200000.0,4,1.0,1350,11507,1.0,0,0,3,7,1350,0,1966,0,98055,47.4269,-122.197,1320,25675,10157,24355,17.38072477622317,0.01639344262295082,Very Cheap
20141021T000000,367000.0,3,2.25,1400,1320,3.0,0,2,3,8,1400,0,2006,0,98133,47.7147,-122.356,1490,1449,-80,-41,278.030303030303,0.03829508196721312,Very Cheap
20150514T000000,183000.0,3,1.0,1170,7320,1.0,0,0,3,7,1170,0,1962,0,98188,47.4685,-122.282,2040,7320,6150,5280,25.0,0.014163934426229508,Very Cheap
20141210T000000,300000.0,3,2.5,1020,1570,2.0,0,0,3,7,720,300,2004,0,98144,47.5871,-122.317,1470,1249,550,-221,191.0828025477707,0.029508196721311476,Very Cheap
20140819T000000,369000.0,3,1.75,1300,3844,1.0,0,0,3,7,1300,0,1985,0,98133,47.7024,-122.355,1290,3844,2544,2554,95.99375650364205,0.03855737704918033,Very Cheap
20140731T000000,380000.0,3,2.0,2010,16736,2.0,0,0,4,6,2010,0,1929,0,98133,47.7643,-122.352,1890,11477,14726,9587,22.705544933078393,0.04,Very Cheap
20150203T000000,463000.0,3,2.0,1590,5009,2.0,0,0,4,6,1590,0,1985,0,98125,47.7012,-122.322,1730,6380,3419,4650,92.43361948492714,0.05088524590163934,Very Cheap
20141208T000000,475000.0,3,1.0,1470,9750,1.0,0,0,3,7,1470,0,1963,0,98034,47.7155,-122.194,1300,9750,8280,8450,48.717948717948715,0.05245901639344262,Very Cheap
20150324T000000,225000.0,3,1.75,1580,14400,1.0,0,0,4,7,1580,0,1981,0,98001,47.2598,-122.281,1480,9600,12820,8120,15.625,0.019672131147540985,Very Cheap
20150511T000000,371000.0,3,1.75,1970,9512,1.0,0,0,3,8,1970,0,1968,0,98058,47.4545,-122.146,2250,10573,7542,8323,39.00336417157275,0.038819672131147544,Very Cheap
20140827T000000,625000.0,3,2.5,2330,3141,2.0,0,0,3,8,2330,0,2003,0,98116,47.5622,-122.392,1980,5265,811,3285,198.98121617319325,0.07213114754098361,Very Cheap
20140923T000000,3200000.0,6,5.0,7100,18200,2.5,0,0,3,13,5240,1860,1933,2002,98199,47.6427,-122.408,3130,6477,11100,3347,175.82417582417582,0.4098360655737705,High
20150129T000000,329000.0,3,1.75,1230,10725,1.0,0,0,3,7,1230,0,1980,0,98045,47.4431,-121.772,1250,10170,9495,8920,30.675990675990676,0.03331147540983607,Very Cheap
20150210T000000,634000.0,3,1.75,2570,13000,2.0,0,0,4,7,2570,0,1962,0,98177,47.7705,-122.371,2570,8521,10430,5951,48.76923076923077,0.07331147540983607,Very Cheap
20141107T000000,616000.0,4,2.5,3440,6915,2.0,0,0,3,10,3440,0,2006,0,98038,47.3538,-122.004,3200,6915,3475,3715,89.08170643528561,0.07095081967213114,Very Cheap
20150424T000000,1824100.0,3,2.25,3330,20053,2.0,0,0,3,9,3330,0,1968,1998,98004,47.6395,-122.214,2870,20053,16723,17183,90.96394554430759,0.22939016393442624,Cheap
20150319T000000,435000.0,4,2.25,1780,2684,2.0,0,0,3,7,1780,0,2002,0,98072,47.7642,-122.149,1670,2426,904,756,162.07153502235468,0.04721311475409836,Very Cheap
20150415T000000,320000.0,4,2.5,2110,6295,2.0,0,0,3,8,2110,0,2000,0,98030,47.3641,-122.193,2720,6311,4185,3591,50.833995234312944,0.032131147540983604,Very Cheap
20150114T000000,820000.0,4,3.5,2770,8049,2.0,0,0,3,9,2770,0,2002,0,98074,47.6469,-122.081,3410,7447,5279,4037,101.87600944216673,0.09770491803278689,Very Cheap
20140822T000000,310000.0,3,2.5,1590,3359,2.0,0,0,3,7,1590,0,2000,0,98019,47.7349,-121.986,1820,3383,1769,1563,92.2893718368562,0.03081967213114754,Very Cheap
20141202T000000,443750.0,3,2.25,1460,968,2.0,0,0,3,7,1140,320,2003,0,98199,47.6601,-122.4,1460,1531,-492,71,458.4194214876033,0.04836065573770492,Very Cheap
20140605T000000,795000.0,4,2.25,2070,13084,1.0,0,0,4,8,1700,370,1967,0,98040,47.5606,-122.222,2520,10180,11014,7660,60.76123509630082,0.09442622950819672,Very Cheap
20141104T000000,475000.0,3,2.5,2420,36862,1.0,0,0,4,8,1530,890,1957,0,98003,47.3264,-122.308,1670,9046,34442,7376,12.885898757528079,0.05245901639344262,Very Cheap
20140515T000000,585000.0,5,1.75,2000,3750,2.0,0,0,4,7,2000,0,1921,0,98103,47.6618,-122.355,1520,3750,1750,2230,156.0,0.06688524590163934,Very Cheap
20140729T000000,315000.0,2,1.0,1010,7338,2.0,0,0,4,7,1010,0,1981,0,98056,47.5123,-122.19,1220,7719,6328,6499,42.92722812755519,0.031475409836065574,Very Cheap
20140917T000000,635000.0,4,2.5,3050,7238,2.0,0,0,3,8,3050,0,1989,0,98029,47.5772,-122.013,2580,7228,4188,4648,87.73141751865155,0.07344262295081967,Very Cheap
20140528T000000,305000.0,3,1.0,1160,11776,1.0,0,0,3,7,1160,0,1968,0,98077,47.7427,-122.074,1160,10050,10616,8890,25.90013586956522,0.03016393442622951,Very Cheap
20140516T000000,785000.0,3,2.0,2180,5440,1.0,0,0,5,7,1100,1080,1904,0,98103,47.657,-122.345,1470,4109,3260,2639,144.3014705882353,0.09311475409836066,Very Cheap
20141024T000000,525000.0,3,1.75,1560,6000,1.0,0,0,3,6,780,780,1944,0,98199,47.6501,-122.384,1560,1734,4440,174,87.5,0.05901639344262295,Very Cheap
20150120T000000,537000.0,4,1.75,1580,3635,1.0,0,0,4,7,790,790,1910,0,98117,47.6795,-122.371,1190,3638,2055,2448,147.73039889958736,0.060590163934426226,Very Cheap
20150217T000000,279950.0,3,1.75,1660,8303,1.0,0,0,3,7,1380,280,1974,0,98058,47.4366,-122.171,1740,8320,6643,6580,33.716728893171144,0.026878688524590164,Very Cheap
20141208T000000,659000.0,4,2.0,2350,9329,2.0,0,0,3,8,2350,0,1977,0,98005,47.583,-122.17,1640,9403,6979,7763,70.63993997212992,0.07659016393442623,Very Cheap
20140821T000000,203000.0,2,1.0,1440,6650,1.0,0,0,3,7,970,470,1980,0,98023,47.2896,-122.369,1600,6847,5210,5247,30.526315789473685,0.01678688524590164,Very Cheap
20140909T000000,782500.0,4,2.5,2930,7806,2.0,0,0,3,9,2930,0,2005,0,98074,47.6219,-122.024,2600,6051,4876,3451,100.24340251088906,0.09278688524590165,Very Cheap
20140610T000000,250000.0,3,1.75,1590,7560,1.0,0,0,3,7,1130,460,1984,0,98031,47.4016,-122.18,1500,7560,5970,6060,33.06878306878307,0.022950819672131147,Very Cheap
20140805T000000,279000.0,3,1.0,1400,9450,1.0,0,0,4,7,1060,340,1955,0,98056,47.5051,-122.194,1400,8108,8050,6708,29.523809523809526,0.02675409836065574,Very Cheap
20141125T000000,664000.0,6,2.5,3190,12196,2.0,0,0,4,8,3190,0,1979,0,98052,47.6309,-122.103,2790,13068,9006,10278,54.44408002623811,0.07724590163934426,Very Cheap
20140917T000000,2900000.0,4,3.25,4580,4838,2.0,0,3,4,11,3080,1500,1991,0,98109,47.6305,-122.354,3540,6483,258,2943,599.4212484497726,0.3704918032786885,Medium
20150330T000000,378500.0,4,2.0,1830,6000,1.0,0,0,5,7,1070,760,1953,0,98118,47.5453,-122.279,1830,5500,4170,3670,63.083333333333336,0.03980327868852459,Very Cheap
20140507T000000,535000.0,3,1.75,2720,149410,1.5,0,0,3,9,2720,0,1988,0,98014,47.7092,-121.892,2560,149410,146690,146850,3.5807509537514224,0.06032786885245902,Very Cheap
20140716T000000,520000.0,2,1.0,1360,22508,1.0,0,0,3,7,1360,0,1932,0,98034,47.7101,-122.226,2830,12600,21148,9770,23.102896747822996,0.058360655737704915,Very Cheap
20150504T000000,369950.0,3,2.0,1520,4000,1.0,0,0,5,6,800,720,1943,0,98106,47.531,-122.351,1430,4000,2480,2570,92.4875,0.03868196721311475,Very Cheap
20140924T000000,545000.0,3,2.25,2290,14585,2.0,0,0,3,8,2290,0,1981,0,98075,47.5874,-122.074,1660,36961,12295,35301,37.36715803908125,0.06163934426229508,Very Cheap
20150504T000000,360000.0,3,2.5,2150,14092,2.0,0,0,3,8,2150,0,1991,0,98058,47.4621,-122.129,2400,10699,11942,8299,25.546409310246947,0.037377049180327866,Very Cheap
20140805T000000,760000.0,3,1.5,1170,7645,1.0,0,0,4,7,1170,0,1955,0,98004,47.6077,-122.194,1870,7678,6475,5808,99.41137998691956,0.0898360655737705,Very Cheap
20140916T000000,450000.0,3,1.75,1830,5488,1.0,0,2,4,7,1010,820,1939,0,98115,47.6914,-122.309,1200,5488,3658,4288,81.99708454810495,0.04918032786885246,Very Cheap
20140502T000000,612500.0,4,2.5,2730,12261,2.0,0,0,3,9,2730,0,1991,0,98011,47.7419,-122.205,2730,10872,9531,8142,49.95514232118098,0.07049180327868852,Very Cheap
20140701T000000,280000.0,3,1.0,1090,10710,1.0,0,0,4,7,1090,0,1962,0,98056,47.5,-122.169,1090,10440,9620,9350,26.143790849673202,0.026885245901639345,Very Cheap
20150414T000000,750000.0,3,2.5,2560,9182,2.0,0,0,3,9,2560,0,1993,0,98027,47.5361,-122.051,2800,8784,6622,5984,81.681550860379,0.08852459016393442,Very Cheap
20140715T000000,237000.0,3,1.0,1160,6132,1.0,0,0,4,7,1160,0,1958,0,98056,47.5015,-122.173,1280,6132,4972,4852,38.64970645792564,0.021245901639344263,Very Cheap
20141014T000000,441500.0,2,1.75,1010,4000,1.5,0,0,5,7,1010,0,1919,0,98105,47.6665,-122.287,1470,4000,2990,2530,110.375,0.0480655737704918,Very Cheap
20150126T000000,251000.0,3,2.0,1650,7930,1.0,0,0,4,7,1650,0,1989,0,98038,47.3617,-122.05,1510,7930,6280,6420,31.651954602774275,0.023081967213114753,Very Cheap
20141229T000000,200000.0,3,1.0,2120,31564,1.0,0,0,3,7,1220,900,1942,0,98168,47.4938,-122.298,1790,11571,29444,9781,6.336332530731212,0.01639344262295082,Very Cheap
20140616T000000,332000.0,1,1.0,960,2640,1.0,0,0,3,7,760,200,1908,0,98112,47.6223,-122.294,1620,3759,1680,2139,125.75757575757575,0.033704918032786885,Very Cheap
20140826T000000,401500.0,3,2.5,1509,1114,3.0,0,0,3,8,1509,0,2014,0,98133,47.7048,-122.34,1509,2431,-395,922,360.4129263913824,0.04281967213114754,Very Cheap
20140926T000000,585000.0,4,1.75,2270,27122,1.0,0,0,5,8,1300,970,1957,0,98155,47.7637,-122.281,2380,11822,24852,9442,21.569205810780915,0.06688524590163934,Very Cheap
20140702T000000,340000.0,4,2.5,1954,4805,2.0,0,0,3,8,1954,0,2005,0,98055,47.4297,-122.19,1714,3259,2851,1545,70.75962539021852,0.03475409836065574,Very Cheap
20150112T000000,920000.0,3,3.5,2800,7694,1.0,0,0,3,9,2800,0,2005,0,98053,47.7095,-122.022,2420,7694,4894,5274,119.57369378736678,0.11081967213114755,Cheap
20140613T000000,153000.0,3,1.0,1270,6405,1.5,0,0,3,6,1270,0,1944,0,98178,47.4959,-122.241,1110,6405,5135,5295,23.88758782201405,0.010229508196721311,Very Cheap
20150105T000000,299950.0,4,2.25,1810,7601,1.0,0,0,3,7,1080,730,1986,0,98023,47.2857,-122.358,1570,7601,5791,6031,39.46191290619655,0.029501639344262295,Very Cheap
20150512T000000,440000.0,4,2.5,2410,7517,2.0,0,0,3,8,2410,0,1983,0,98058,47.4388,-122.142,2420,8095,5107,5675,58.53398962352002,0.04786885245901639,Very Cheap
20140915T000000,293000.0,3,2.5,1690,17383,2.0,0,0,3,7,1690,0,2003,0,98038,47.3691,-122.031,2610,7999,15693,5389,16.85554852442041,0.02859016393442623,Very Cheap
20150329T000000,203000.0,3,1.75,1190,6000,1.0,0,0,3,7,1190,0,1952,2015,98178,47.5026,-122.236,1200,6000,4810,4800,33.833333333333336,0.01678688524590164,Very Cheap
20150320T000000,193000.0,2,1.75,1280,6774,1.0,0,0,3,7,1280,0,1991,0,98002,47.2925,-122.219,1450,7810,5494,6360,28.491290227339828,0.015475409836065573,Very Cheap
20150316T000000,305000.0,3,1.75,1460,7862,1.0,0,0,3,7,1460,0,1965,0,98155,47.7755,-122.299,2200,9293,6402,7093,38.79419994912236,0.03016393442622951,Very Cheap
20140502T000000,495000.0,4,1.75,1600,6380,1.0,0,0,3,8,1130,470,1959,0,98125,47.701,-122.306,1090,6380,4780,5290,77.58620689655173,0.05508196721311476,Very Cheap
20140902T000000,420000.0,3,1.75,1770,6000,1.0,0,0,3,7,1130,640,1952,0,98125,47.7135,-122.315,1900,7200,4230,5300,70.0,0.04524590163934426,Very Cheap
20140905T000000,569500.0,4,2.5,2800,8190,1.0,0,0,3,8,1700,1100,1971,0,98177,47.7695,-122.368,2460,8165,5390,5705,69.53601953601954,0.06485245901639344,Very Cheap
20140515T000000,620000.0,4,2.5,2680,9185,2.0,0,0,3,9,2680,0,1989,0,98029,47.5738,-121.992,2810,8505,6505,5695,67.50136091453457,0.07147540983606557,Very Cheap
20141211T000000,466000.0,3,1.75,1680,9460,1.0,0,0,4,7,1680,0,1959,0,98006,47.5525,-122.182,1690,9448,7780,7758,49.2600422832981,0.051278688524590166,Very Cheap
20150324T000000,355500.0,3,1.0,1120,10032,1.0,0,0,3,7,1120,0,1962,0,98034,47.7182,-122.194,1210,9918,8912,8708,35.436602870813395,0.03678688524590164,Very Cheap
20150508T000000,687500.0,2,1.0,1040,7200,1.0,0,0,4,6,1040,0,1955,0,98033,47.6823,-122.203,1640,7200,6160,5560,95.48611111111111,0.08032786885245902,Very Cheap
20150411T000000,432100.0,3,2.25,1790,2240,2.0,0,0,4,8,1790,0,1975,0,98052,47.6343,-122.106,1780,2560,450,780,192.90178571428572,0.0468327868852459,Very Cheap
20140721T000000,500000.0,3,2.5,2410,34848,1.5,0,0,3,8,2410,0,1976,0,98006,47.5694,-122.12,2420,16424,32438,14004,14.348025711662075,0.05573770491803279,Very Cheap
20141010T000000,690000.0,5,3.25,3370,7313,2.0,0,0,4,8,2140,1230,1988,0,98029,47.5632,-122.015,2990,7806,3943,4816,94.35252290441679,0.08065573770491803,Very Cheap
20150102T000000,350000.0,2,1.0,800,5150,1.0,0,0,4,6,800,0,1949,0,98118,47.5525,-122.274,1280,5150,4350,3870,67.96116504854369,0.036065573770491806,Very Cheap
20140610T000000,268000.0,2,1.0,1380,5000,1.0,0,0,3,7,870,510,1943,0,98108,47.5339,-122.293,1450,5000,3620,3550,53.6,0.025311475409836064,Very Cheap
20140619T000000,120000.0,2,1.0,990,39964,1.0,0,0,2,4,990,0,1945,0,98042,47.3577,-122.085,1560,8990,38974,7430,3.00270243218897,0.005901639344262295,Very Cheap
20150218T000000,285000.0,4,2.5,1800,9229,2.0,0,0,3,7,1800,0,1994,0,98022,47.1927,-122.015,1970,9231,7429,7261,30.8809188427782,0.02754098360655738,Very Cheap
20141008T000000,365000.0,4,1.5,1820,12327,1.0,0,0,4,7,1380,440,1955,0,98006,47.5767,-122.144,1450,9256,10507,7806,29.6097996268354,0.0380327868852459,Very Cheap
20150408T000000,635000.0,3,2.5,2620,6842,2.0,0,0,3,7,2620,0,2002,0,98053,47.6846,-122.037,2280,4800,4222,2520,92.80912014030986,0.07344262295081967,Very Cheap
20140708T000000,630000.0,2,2.5,2290,3507,2.0,0,0,3,9,2290,0,2005,0,98029,47.5545,-122.002,2290,3640,1217,1350,179.64071856287424,0.07278688524590164,Very Cheap
20150305T000000,450000.0,4,3.0,2200,4466,2.0,0,0,3,7,2200,0,1968,0,98103,47.7005,-122.339,1780,2250,2266,470,100.76130765785938,0.04918032786885246,Very Cheap
20150304T000000,590000.0,4,2.5,2940,12600,1.0,0,0,4,8,1850,1090,1974,0,98074,47.6294,-122.062,2030,11770,9660,9740,46.82539682539682,0.06754098360655737,Very Cheap
20140909T000000,895000.0,2,1.75,1700,3618,1.0,0,1,3,8,1260,440,1950,0,98199,47.6336,-122.397,2200,5000,1918,2800,247.37423991155333,0.10754098360655738,Cheap
20140514T000000,160000.0,3,1.0,860,11900,1.0,0,0,4,6,860,0,1963,0,98030,47.3574,-122.186,1660,10248,11040,8588,13.445378151260504,0.011147540983606558,Very Cheap
20140930T000000,520000.0,2,1.0,910,5000,1.0,0,0,3,7,910,0,1924,0,98107,47.6733,-122.37,1050,5000,4090,3950,104.0,0.058360655737704915,Very Cheap
20140806T000000,432000.0,4,3.25,2820,13059,2.0,0,0,4,8,2820,0,1976,0,98058,47.4508,-122.132,2360,8600,10239,6240,33.08063404548587,0.046819672131147544,Very Cheap
20140519T000000,141800.0,2,1.0,930,4743,1.0,0,0,4,5,930,0,1942,0,98056,47.4966,-122.187,930,4779,3813,3849,29.896689858739194,0.008760655737704919,Very Cheap
20140714T000000,980000.0,4,2.0,2190,4560,2.5,0,0,5,8,2190,0,1910,0,98103,47.662,-122.329,2190,4560,2370,2370,214.91228070175438,0.11868852459016394,Cheap
20150416T000000,1290000.0,4,2.5,3430,7200,2.0,0,0,3,9,3430,0,2014,0,98033,47.6842,-122.196,1530,7800,3770,6270,179.16666666666666,0.15934426229508197,Cheap
20141117T000000,740000.0,4,2.75,2560,6900,1.0,0,0,3,8,1480,1080,1959,0,98115,47.686,-122.297,2600,7200,4340,4600,107.2463768115942,0.08721311475409836,Very Cheap
20141010T000000,230000.0,2,1.0,770,6450,1.0,0,0,4,6,770,0,1948,0,98106,47.531,-122.358,780,6063,5680,5283,35.65891472868217,0.020327868852459016,Very Cheap
20140623T000000,3400000.0,3,4.5,5230,17826,2.0,1,4,3,10,3740,1490,2005,0,98040,47.5348,-122.243,3670,17826,12596,14156,190.732637720184,0.4360655737704918,High
20150408T000000,954500.0,3,2.25,2440,9689,1.0,0,2,4,8,1830,610,1974,0,98008,47.6141,-122.111,2730,9689,7249,6959,98.51377851171432,0.11534426229508196,Cheap
20150316T000000,622000.0,3,1.5,1650,3150,1.5,0,0,4,8,1650,0,1929,0,98122,47.6156,-122.297,1650,4500,1500,2850,197.46031746031747,0.07173770491803279,Very Cheap
20150303T000000,90000.0,1,1.0,780,4000,1.0,0,0,3,5,780,0,1905,0,98108,47.5424,-122.321,1150,4000,3220,2850,22.5,0.0019672131147540984,Very Cheap
20141029T000000,342000.0,3,3.0,1260,1634,3.0,0,0,3,8,1260,0,1998,0,98103,47.697,-122.349,1260,1135,374,-125,209.30232558139534,0.03501639344262295,Very Cheap
20140729T000000,305000.0,4,2.5,2320,4683,2.0,0,0,3,7,2320,0,2007,0,98042,47.3349,-122.059,2230,5750,2363,3520,65.1291906897288,0.03016393442622951,Very Cheap
20140820T000000,259900.0,4,2.75,1560,8820,1.0,0,3,3,7,1060,500,1979,0,98001,47.3382,-122.257,2140,7800,7260,5660,29.467120181405896,0.024249180327868852,Very Cheap
20140827T000000,420000.0,3,2.0,2330,6346,1.5,0,0,3,6,1600,730,1934,2014,98146,47.5135,-122.38,1380,8400,4016,7020,66.18342262842735,0.04524590163934426,Very Cheap
20150304T000000,250000.0,2,1.0,1400,19570,1.5,0,0,3,6,1100,300,1929,0,98168,47.4724,-122.271,2250,6500,18170,4250,12.774655084312723,0.022950819672131147,Very Cheap
20150323T000000,249950.0,3,1.5,1450,6875,1.0,0,0,4,7,1450,0,1961,0,98198,47.4205,-122.316,1270,8000,5425,6730,36.35636363636364,0.022944262295081966,Very Cheap
20150217T000000,199000.0,2,1.0,1140,15120,1.0,0,0,4,6,990,150,1932,0,98055,47.4521,-122.196,2320,11250,13980,8930,13.161375661375661,0.016262295081967214,Very Cheap
20150407T000000,355200.0,3,1.0,1120,7320,1.0,0,0,4,7,1120,0,1954,0,98146,47.5103,-122.382,1410,6328,6200,4918,48.52459016393443,0.03674754098360656,Very Cheap
20140909T000000,425000.0,3,1.5,1970,13709,1.0,0,0,4,7,1680,290,1955,0,98155,47.7562,-122.277,2200,16536,11739,14336,31.00153184039682,0.04590163934426229,Very Cheap
20141112T000000,379500.0,3,1.0,1110,7128,1.0,0,0,3,7,1110,0,1980,0,98052,47.6968,-122.124,1510,7107,6018,5597,53.24074074074074,0.0399344262295082,Very Cheap
20140819T000000,860000.0,4,2.5,3070,6923,2.0,0,0,3,9,3070,0,2009,0,98033,47.669,-122.172,2190,9218,3853,7028,124.22360248447205,0.10295081967213114,Cheap
20140512T000000,335000.0,3,2.5,1940,4927,2.0,0,0,3,8,1940,0,2004,0,98058,47.4479,-122.12,2070,4892,2987,2822,67.99269332250863,0.03409836065573771,Very Cheap
20141105T000000,865000.0,3,2.5,3050,12558,2.0,0,0,3,10,3050,0,1997,0,98074,47.6549,-122.089,3543,12558,9508,9015,68.88039496735149,0.10360655737704919,Cheap
20150408T000000,390000.0,3,1.0,1240,3600,1.5,0,0,3,7,1240,0,1902,0,98144,47.5986,-122.298,1680,3600,2360,1920,108.33333333333333,0.04131147540983607,Very Cheap
20140909T000000,569950.0,5,4.25,3380,7805,2.0,0,0,3,8,3380,0,2014,0,98148,47.4349,-122.328,2790,7805,4425,5015,73.02370275464446,0.06491147540983606,Very Cheap
20150205T000000,495500.0,3,2.5,3190,7828,2.0,0,0,3,9,3190,0,2006,0,98059,47.5047,-122.144,2970,7828,4638,4858,63.298415942769545,0.05514754098360656,Very Cheap
20141211T000000,476500.0,4,1.75,1670,10200,1.0,0,0,3,7,1390,280,1953,0,98118,47.5524,-122.267,1720,6860,8530,5140,46.71568627450981,0.052655737704918035,Very Cheap
20140812T000000,261000.0,3,1.0,1660,11200,1.0,0,0,3,7,1660,0,1957,0,98056,47.5121,-122.168,1380,10875,9540,9495,23.303571428571427,0.02439344262295082,Very Cheap
20140822T000000,375000.0,4,2.0,2070,9822,1.0,0,0,5,7,2070,0,1955,0,98006,47.566,-122.14,1300,9572,7752,8272,38.179596823457544,0.03934426229508197,Very Cheap
20150422T000000,550000.0,4,2.0,2070,9822,1.0,0,0,5,7,2070,0,1955,0,98006,47.566,-122.14,1300,9572,7752,8272,55.99674200773773,0.06229508196721312,Very Cheap
20140723T000000,230000.0,2,1.0,1430,4000,1.0,0,0,3,7,930,500,1949,0,98118,47.5233,-122.284,1110,4000,2570,2890,57.5,0.020327868852459016,Very Cheap
20150204T000000,526750.0,5,2.5,2270,10700,1.0,0,0,4,8,1570,700,1963,0,98028,47.741,-122.256,2020,10230,8430,8210,49.228971962616825,0.05924590163934426,Very Cheap
20150304T000000,606000.0,3,2.0,1980,7680,1.5,0,0,4,6,1070,910,1911,0,98033,47.6839,-122.195,1330,8704,5700,7374,78.90625,0.06963934426229508,Very Cheap
20150424T000000,368500.0,4,2.75,2500,26400,1.0,0,0,3,8,1780,720,1977,0,98031,47.3444,-122.084,2180,31900,23900,29720,13.958333333333334,0.03849180327868852,Very Cheap
20140929T000000,275000.0,3,1.0,1230,171190,1.0,0,0,3,7,1230,0,1973,0,98070,47.4397,-122.46,1550,15450,169960,13900,1.6064022431216776,0.02622950819672131,Very Cheap
20150422T000000,342000.0,4,1.0,1390,9023,1.5,0,0,3,7,1390,0,1955,0,98155,47.7754,-122.296,1760,9023,7633,7263,37.90313642912557,0.03501639344262295,Very Cheap
20150327T000000,278100.0,4,1.75,2120,8520,1.0,0,0,3,7,1600,520,1978,0,98023,47.302,-122.373,2160,8400,6400,6240,32.640845070422536,0.026636065573770493,Very Cheap
20141028T000000,450000.0,4,2.75,1540,4840,1.0,0,2,4,7,850,690,1929,0,98126,47.5491,-122.375,1180,4840,3300,3660,92.97520661157024,0.04918032786885246,Very Cheap
20140825T000000,349950.0,4,2.5,2000,5006,2.0,0,0,3,7,2000,0,2005,0,98058,47.466,-122.147,2410,4889,3006,2479,69.90611266480224,0.036059016393442625,Very Cheap
20150410T000000,425000.0,4,2.5,2400,6053,2.0,0,0,3,8,2400,0,2001,0,98038,47.3869,-122.033,2460,6519,3653,4059,70.21311746241533,0.04590163934426229,Very Cheap
20140626T000000,435000.0,4,2.75,2110,8751,1.0,0,0,3,7,1510,600,1962,0,98011,47.7617,-122.215,1660,10295,6641,8635,49.7086047308879,0.04721311475409836,Very Cheap
20140626T000000,460000.0,4,2.5,2550,19017,1.0,0,0,4,7,1300,1250,1961,0,98155,47.7682,-122.284,2080,21100,16467,19020,24.188883630435924,0.050491803278688525,Very Cheap
20141222T000000,323000.0,4,1.75,1440,8114,1.0,0,0,4,7,1440,0,1963,0,98155,47.7639,-122.332,1940,7208,6674,5268,39.80773970914469,0.03252459016393443,Very Cheap
20150430T000000,325000.0,2,1.0,810,6827,1.0,0,0,3,6,810,0,1944,0,98106,47.5495,-122.357,990,6827,6017,5837,47.605097407353156,0.03278688524590164,Very Cheap
20140813T000000,480000.0,2,1.75,1170,4635,1.0,0,0,4,6,690,480,1924,0,98117,47.6842,-122.359,1240,4120,3465,2880,103.55987055016182,0.05311475409836065,Very Cheap
20150430T000000,1325000.0,3,2.5,3590,8400,1.0,0,0,3,9,2950,640,1958,2007,98005,47.595,-122.173,1620,7875,4810,6255,157.73809523809524,0.16393442622950818,Cheap
20150427T000000,210000.0,4,1.75,2090,6485,1.0,0,0,3,7,1280,810,1956,0,98178,47.4958,-122.265,2190,9600,4395,7410,32.38242097147263,0.017704918032786884,Very Cheap
20150401T000000,920000.0,5,4.5,3820,5750,2.0,0,3,3,9,2830,990,2000,0,98116,47.5581,-122.385,1750,5750,1930,4000,160.0,0.11081967213114755,Cheap
20141202T000000,399000.0,3,1.0,1460,8290,1.0,0,0,3,8,1460,0,1959,0,98125,47.7246,-122.3,1470,8290,6830,6820,48.13027744270205,0.042491803278688525,Very Cheap
20140818T000000,631750.0,3,1.75,2360,4063,1.0,0,0,5,7,1180,1180,1940,0,98117,47.6902,-122.382,1660,4063,1703,2403,155.4885552547379,0.07301639344262295,Very Cheap
20150326T000000,184000.0,3,1.0,1100,8680,1.0,0,0,3,6,1100,0,1962,0,98023,47.3072,-122.363,1100,9220,7580,8120,21.19815668202765,0.014295081967213115,Very Cheap
20150416T000000,333000.0,4,2.5,2100,7208,2.0,0,0,3,8,2100,0,1974,0,98058,47.4478,-122.128,2060,7480,5108,5420,46.198668146503884,0.033836065573770495,Very Cheap
20140620T000000,218000.0,2,2.0,1310,2841,2.0,0,0,3,6,1310,0,2004,0,98038,47.3502,-122.022,1360,2550,1531,1190,76.73354452657514,0.018754098360655738,Very Cheap
20150224T000000,258305.0,2,1.5,750,2964,1.0,0,0,5,5,750,0,1919,0,98118,47.5518,-122.277,1350,3090,2214,1740,87.1474358974359,0.02404,Very Cheap
20140715T000000,775000.0,5,1.5,1720,5000,1.5,0,0,3,8,1720,0,1915,0,98103,47.6627,-122.355,1720,5000,3280,3280,155.0,0.09180327868852459,Very Cheap
20140611T000000,515000.0,3,2.5,3370,19585,2.0,0,0,3,7,3200,170,1951,0,98133,47.7388,-122.339,1730,9430,16215,7700,26.29563441409242,0.057704918032786885,Very Cheap
20140624T000000,455000.0,2,1.5,1200,1259,2.0,0,0,3,8,1000,200,2015,0,98144,47.6001,-122.298,1320,1852,59,532,361.3979348689436,0.049836065573770495,Very Cheap
20150218T000000,440000.0,3,2.5,1830,6807,2.5,0,0,5,7,1830,0,1954,0,98155,47.7613,-122.322,1340,6807,4977,5467,64.63934185397385,0.04786885245901639,Very Cheap
20140619T000000,1440000.0,3,3.5,3870,3819,2.0,0,0,3,11,2760,1110,2002,0,98102,47.6452,-122.317,2530,5500,-51,2970,377.0620581304006,0.17901639344262296,Cheap
20140714T000000,850000.0,3,2.25,2220,3707,2.0,0,0,4,8,1620,600,1919,0,98122,47.617,-122.286,2030,4850,1487,2820,229.29592662530348,0.10163934426229508,Cheap
20150501T000000,480000.0,3,1.75,2920,21375,1.0,0,0,3,8,1850,1070,1961,0,98028,47.7666,-122.265,1540,8482,18455,6942,22.45614035087719,0.05311475409836065,Very Cheap
20141126T000000,420000.0,5,2.75,2540,27007,1.0,0,0,3,8,1520,1020,1980,2014,98058,47.4326,-122.155,1800,26572,24467,24772,15.551523679046173,0.04524590163934426,Very Cheap
20140912T000000,408000.0,3,1.75,1970,7100,1.0,0,0,3,7,1590,380,1976,0,98072,47.7353,-122.172,1790,7455,5130,5665,57.46478873239437,0.04367213114754098,Very Cheap
20140820T000000,278000.0,5,1.75,2170,9752,1.0,0,0,3,7,1100,1070,1962,0,98003,47.3355,-122.331,1810,10609,7582,8799,28.506972928630024,0.02662295081967213,Very Cheap
20150122T000000,1195000.0,3,3.0,2350,1620,2.0,0,0,3,9,1560,790,2001,0,98112,47.6308,-122.279,2000,4380,-730,2380,737.6543209876543,0.14688524590163934,Cheap
20140613T000000,454000.0,4,2.25,2630,39000,2.0,0,0,3,9,2630,0,1979,0,98042,47.4089,-122.149,2270,66647,36370,64377,11.64102564102564,0.049704918032786885,Very Cheap
20150417T000000,1851000.0,4,2.5,4120,14866,1.0,1,4,3,8,2070,2050,1965,0,98006,47.5571,-122.193,3620,19729,10746,16109,124.51230996905691,0.23291803278688525,Cheap
20150505T000000,499000.0,4,2.25,2440,5000,2.0,0,0,3,7,2440,0,2007,0,98065,47.5407,-121.89,2440,5212,2560,2772,99.8,0.05560655737704918,Very Cheap
20150218T000000,590000.0,5,3.0,3480,6625,2.0,0,0,3,8,3480,0,2012,0,98059,47.4815,-122.153,2800,9400,3145,6600,89.05660377358491,0.06754098360655737,Very Cheap
20140730T000000,385000.0,3,3.5,1900,4805,2.0,0,0,3,8,1560,340,1999,0,98108,47.5686,-122.315,1360,4800,2905,3440,80.12486992715921,0.04065573770491803,Very Cheap
20140924T000000,1250000.0,4,3.25,3160,10043,2.0,0,2,3,9,3160,0,2011,0,98034,47.7001,-122.238,3450,10043,6883,6593,124.46480135417704,0.1540983606557377,Cheap
20140924T000000,202200.0,2,1.75,1330,2159,1.0,0,0,4,8,1330,0,1979,0,98198,47.3822,-122.32,1220,3679,829,2459,93.6544696618805,0.016681967213114754,Very Cheap
20150311T000000,450000.0,3,2.25,1420,13468,1.0,0,0,3,7,960,460,1976,0,98033,47.6693,-122.176,1480,10980,12048,9500,33.41253341253341,0.04918032786885246,Very Cheap
20150508T000000,435000.0,3,2.0,2570,233481,1.5,0,0,4,8,2570,0,1986,0,98038,47.4199,-122.034,2280,157687,230911,155407,1.863106633944518,0.04721311475409836,Very Cheap
20150204T000000,550000.0,2,1.0,1270,43560,1.0,0,0,4,5,1270,0,1908,0,98042,47.3651,-122.165,1870,6960,42290,5090,12.626262626262626,0.06229508196721312,Very Cheap
20150504T000000,361000.0,3,2.25,2470,5650,1.0,0,2,3,7,1550,920,1973,0,98178,47.5072,-122.252,1660,5650,3180,3990,63.89380530973451,0.037508196721311476,Very Cheap
20150120T000000,760000.0,4,2.25,2590,12600,2.0,0,0,3,9,2590,0,1979,0,98006,47.5566,-122.162,2620,11050,10010,8430,60.317460317460316,0.0898360655737705,Very Cheap
20140616T000000,902000.0,4,2.5,3030,8507,2.0,0,0,3,9,3030,0,2003,0,98033,47.6675,-122.176,2570,8830,5477,6260,106.03032796520513,0.10845901639344262,Cheap
20150411T000000,505000.0,3,1.75,1240,4550,1.5,0,0,4,7,1240,0,1951,0,98116,47.5803,-122.398,2110,5700,3310,3590,110.98901098901099,0.05639344262295082,Very Cheap
20150225T000000,200000.0,3,1.0,1040,8925,1.0,0,0,4,6,1040,0,1961,0,98023,47.3265,-122.335,1040,8925,7885,7885,22.408963585434172,0.01639344262295082,Very Cheap
20150204T000000,260000.0,5,2.25,2320,6375,1.0,0,0,4,7,1270,1050,1967,0,98001,47.3351,-122.282,1760,7600,4055,5840,40.78431372549019,0.024262295081967214,Very Cheap
20140925T000000,417000.0,2,1.0,1190,5100,1.5,0,0,2,7,1190,0,1928,0,98117,47.6773,-122.382,1920,5100,3910,3180,81.76470588235294,0.04485245901639344,Very Cheap
20150202T000000,287500.0,3,2.25,2030,8690,1.0,0,0,4,8,1360,670,1986,0,98023,47.3185,-122.391,1720,8800,6660,7080,33.084004602991946,0.027868852459016394,Very Cheap
20150407T000000,450000.0,3,1.5,1390,10530,1.0,0,0,3,7,1390,0,1961,0,98033,47.7025,-122.196,1750,10530,9140,8780,42.73504273504273,0.04918032786885246,Very Cheap
20150130T000000,825000.0,2,1.75,2050,4000,1.5,0,2,3,8,2050,0,1979,0,98119,47.6415,-122.373,1940,4000,1950,2060,206.25,0.09836065573770492,Very Cheap
20140827T000000,1475000.0,4,3.0,3050,6179,2.0,0,0,4,9,2330,720,1926,0,98112,47.6253,-122.284,3020,6505,3129,3485,238.71176565787343,0.18360655737704917,Cheap
20150225T000000,319950.0,2,1.0,1240,5500,1.5,0,0,3,6,1240,0,1921,0,98118,47.5257,-122.263,1520,5500,4260,3980,58.17272727272727,0.03212459016393442,Very Cheap
20140828T000000,682000.0,4,2.5,3030,30000,2.0,0,0,4,9,3030,0,1981,0,98072,47.7468,-122.112,2600,34932,26970,32332,22.733333333333334,0.07960655737704918,Very Cheap
20150506T000000,560000.0,3,1.75,1930,6000,1.0,0,0,3,8,1130,800,1956,0,98119,47.6516,-122.375,1870,6000,4070,4130,93.33333333333333,0.06360655737704918,Very Cheap
20141230T000000,350000.0,3,1.75,1490,10344,1.0,0,0,3,7,1490,0,1985,0,98155,47.7517,-122.326,1450,8632,8854,7182,33.83604021655066,0.036065573770491806,Very Cheap
20141028T000000,270000.0,3,2.0,1510,10215,1.0,0,0,4,7,1510,0,1995,0,98022,47.2078,-122.003,1370,8902,8705,7532,26.431718061674008,0.025573770491803278,Very Cheap
20150305T000000,284000.0,3,1.75,1320,35100,1.0,0,0,3,7,1320,0,1990,0,98092,47.312,-122.129,1660,35100,33780,33440,8.091168091168091,0.027409836065573772,Very Cheap
20140714T000000,308000.0,4,2.5,2330,4606,2.0,0,0,3,8,2330,0,2004,0,98031,47.3934,-122.184,2330,5783,2276,3453,66.8693009118541,0.030557377049180327,Very Cheap
20140529T000000,450000.0,4,2.0,2240,7725,1.0,0,0,5,7,1120,1120,1956,0,98106,47.5331,-122.365,1340,6300,5485,4960,58.25242718446602,0.04918032786885246,Very Cheap
20140618T000000,540000.0,4,2.5,2050,34222,2.0,0,0,4,8,2050,0,1989,0,98077,47.7572,-122.022,2240,51400,32172,49160,15.779323242358716,0.06098360655737705,Very Cheap
20140610T000000,380000.0,4,1.5,1680,11123,1.0,0,0,3,7,1130,550,1959,0,98177,47.7565,-122.361,1770,10103,9443,8333,34.16344511372831,0.04,Very Cheap
20150224T000000,522500.0,4,2.75,2200,122403,1.5,0,0,3,7,2200,0,1971,0,98014,47.6301,-121.911,1710,74487,120203,72777,4.268686225010825,0.05868852459016394,Very Cheap
20141021T000000,118000.0,1,1.0,670,7957,1.0,0,0,4,6,670,0,1978,0,98038,47.3594,-122.056,1600,7957,7287,6357,14.8297096895815,0.005639344262295082,Very Cheap
20150423T000000,280400.0,4,1.75,1730,7210,1.0,0,0,4,7,1010,720,1968,0,98003,47.354,-122.315,1620,7210,5480,5590,38.890429958391124,0.02693770491803279,Very Cheap
20140903T000000,710000.0,4,2.75,2710,41811,1.5,0,0,4,8,1690,1020,1995,0,98075,47.5836,-122.046,2110,35656,39101,33546,16.981177202171676,0.08327868852459017,Very Cheap
20140910T000000,720000.0,3,3.25,3410,25741,2.0,0,0,4,8,3410,0,1993,0,98014,47.6929,-121.868,1660,25865,22331,24205,27.9709412998718,0.08459016393442623,Very Cheap
20140505T000000,787000.0,3,1.75,1330,7500,1.0,0,0,3,8,1330,0,1961,0,98004,47.6074,-122.195,1690,7800,6170,6110,104.93333333333334,0.09337704918032787,Very Cheap
20150330T000000,537000.0,4,2.5,1990,2660,2.0,0,0,3,8,1990,0,2012,0,98034,47.732,-122.178,1990,2665,670,675,201.8796992481203,0.060590163934426226,Very Cheap
20141103T000000,650000.0,2,1.5,1900,4450,1.0,0,0,5,7,1500,400,1916,0,98144,47.5834,-122.293,2130,5000,2550,2870,146.06741573033707,0.07540983606557378,Very Cheap
20150106T000000,154200.0,4,1.0,1310,8640,1.0,0,0,3,6,910,400,1948,0,98146,47.5104,-122.342,1310,8640,7330,7330,17.84722222222222,0.01038688524590164,Very Cheap
20150115T000000,238000.0,4,2.5,1690,7260,1.0,0,0,3,7,1080,610,1979,0,98023,47.3001,-122.368,1690,7700,5570,6010,32.78236914600551,0.02137704918032787,Very Cheap
20140804T000000,285650.0,3,1.0,1040,8199,1.0,0,0,3,7,1040,0,1953,0,98155,47.7348,-122.302,1420,8200,7159,6780,34.83961458714477,0.027626229508196723,Very Cheap
20140807T000000,485500.0,2,1.5,1340,1286,2.0,0,0,3,8,1190,150,2006,0,98122,47.617,-122.309,1460,1245,-54,-215,377.52721617418354,0.05383606557377049,Very Cheap
20150126T000000,315000.0,2,1.0,1120,7350,1.0,0,0,3,7,1120,0,1942,0,98155,47.7648,-122.31,1320,7545,6230,6225,42.857142857142854,0.031475409836065574,Very Cheap
20140617T000000,4668000.0,5,6.75,9640,13068,1.0,1,4,3,12,4820,4820,1983,2009,98040,47.557,-122.21,3270,10454,3428,7184,357.20844811753904,0.6023606557377049,Very High
20141117T000000,627000.0,3,2.0,2310,10525,2.0,0,0,5,7,2310,0,1965,0,98033,47.6727,-122.174,1430,10523,8215,9093,59.572446555819475,0.07239344262295082,Very Cheap
20150410T000000,525000.0,3,2.5,2190,34528,2.0,0,0,3,8,2190,0,1994,0,98027,47.4594,-121.986,2460,37901,32338,35441,15.205050973123262,0.05901639344262295,Very Cheap
20140919T000000,526000.0,3,3.25,1220,1281,2.0,0,0,3,8,930,290,2014,0,98105,47.67,-122.317,1303,3810,61,2507,410.6167056986729,0.059147540983606556,Very Cheap
20150327T000000,480000.0,3,1.5,1200,3060,1.0,0,0,4,7,1060,140,1910,0,98115,47.679,-122.315,1410,3060,1860,1650,156.86274509803923,0.05311475409836065,Very Cheap
20141008T000000,970000.0,3,3.5,3840,53696,2.0,0,0,3,9,3840,0,1996,0,98077,47.7322,-122.035,3810,35181,49856,31371,18.06466030989273,0.11737704918032787,Cheap
20140811T000000,640000.0,4,2.5,2460,9973,1.0,0,0,4,8,1560,900,1965,0,98177,47.7133,-122.361,1830,7200,7513,5370,64.17326782312243,0.0740983606557377,Very Cheap
20140627T000000,279000.0,3,2.5,1630,7950,1.0,0,0,3,8,1320,310,1985,0,98042,47.4224,-122.159,1650,7952,6320,6302,35.094339622641506,0.02675409836065574,Very Cheap
20140710T000000,303000.0,2,2.0,970,9750,1.0,0,0,5,6,970,0,1940,0,98146,47.5073,-122.372,1850,9000,8780,7150,31.076923076923077,0.029901639344262296,Very Cheap
20140625T000000,315000.0,4,2.0,1780,5336,1.5,0,0,5,6,930,850,1918,0,98178,47.5094,-122.263,1910,10304,3556,8394,59.03298350824588,0.031475409836065574,Very Cheap
20150325T000000,336500.0,4,1.75,1760,7268,1.0,0,0,4,7,1080,680,1979,0,98058,47.4267,-122.148,1830,8786,5508,6956,46.2988442487617,0.03429508196721311,Very Cheap
20141113T000000,163250.0,2,1.0,770,8150,1.0,0,0,3,6,770,0,1951,0,98118,47.5324,-122.275,1140,8550,7380,7410,20.030674846625768,0.01157377049180328,Very Cheap
20150218T000000,444950.0,3,1.0,1760,6927,1.0,0,0,3,7,1050,710,1962,0,98011,47.7623,-122.2,2060,9120,5167,7060,64.23415620037534,0.04851803278688525,Very Cheap
20140801T000000,285000.0,2,1.0,990,2446,2.0,0,0,3,7,990,0,1998,0,98144,47.5919,-122.297,1260,2805,1456,1545,116.51676206050695,0.02754098360655738,Very Cheap
20150317T000000,370000.0,2,1.0,1250,4960,1.0,0,0,3,7,940,310,1938,0,98115,47.6893,-122.325,2030,7440,3710,5410,74.59677419354838,0.038688524590163934,Very Cheap
20141215T000000,330000.0,3,2.25,1440,5150,2.0,0,0,3,7,1440,0,1997,0,98106,47.5456,-122.356,1530,5238,3710,3708,64.07766990291262,0.03344262295081967,Very Cheap
20140820T000000,395000.0,2,2.0,1960,4018,1.0,0,0,5,7,980,980,1950,0,98108,47.5629,-122.32,1240,4641,2058,3401,98.30761572921851,0.0419672131147541,Very Cheap
20150416T000000,440000.0,6,3.0,2510,5310,1.0,0,0,4,7,1460,1050,1944,0,98108,47.5533,-122.304,1390,5407,2800,4017,82.86252354048965,0.04786885245901639,Very Cheap
20140503T000000,625000.0,4,2.75,2920,6605,2.0,0,0,3,8,2920,0,2012,0,98059,47.4909,-122.144,3030,6605,3685,3575,94.62528387585162,0.07213114754098361,Very Cheap
20140929T000000,435000.0,3,2.5,1730,46638,2.0,0,0,3,8,1730,0,1991,0,98045,47.4614,-121.709,1750,35508,44908,33758,9.327158111411295,0.04721311475409836,Very Cheap
20141118T000000,299950.0,3,2.5,1570,2577,2.0,0,0,3,7,1570,0,2005,0,98019,47.7456,-121.984,1970,2952,1007,982,116.39503298409002,0.029501639344262295,Very Cheap
20140929T000000,560000.0,2,1.75,970,4233,1.0,0,0,4,7,970,0,1944,0,98199,47.6384,-122.4,1340,4233,3263,2893,132.29388140798488,0.06360655737704918,Very Cheap
20140520T000000,380000.0,4,3.0,2800,9764,2.0,0,0,3,8,2800,0,2002,0,98038,47.3543,-122.012,3610,8194,6964,4584,38.91847603441212,0.04,Very Cheap
20140519T000000,333000.0,4,2.0,1580,7800,2.0,0,0,2,6,1580,0,1906,0,98144,47.5848,-122.302,1190,4440,6220,3250,42.69230769230769,0.033836065573770495,Very Cheap
20140610T000000,499000.0,2,1.0,1220,3000,1.0,0,0,3,7,920,300,1926,0,98117,47.6823,-122.365,1270,3000,1780,1730,166.33333333333334,0.05560655737704918,Very Cheap
20150224T000000,386000.0,3,1.5,1550,8000,1.0,0,0,3,6,1330,220,1980,0,98118,47.5536,-122.286,1150,5150,6450,4000,48.25,0.04078688524590164,Very Cheap
20140922T000000,320600.0,3,2.0,1220,7620,1.0,0,0,3,6,720,500,1947,2014,98166,47.4564,-122.352,1640,7620,6400,5980,42.07349081364829,0.03220983606557377,Very Cheap
20140610T000000,285000.0,2,2.0,1651,18200,1.0,0,0,3,6,1651,0,1946,0,98070,47.4621,-122.461,1510,89595,16549,88085,15.659340659340659,0.02754098360655738,Very Cheap
20140909T000000,450000.0,7,4.0,3150,7800,2.0,0,0,3,8,3150,0,2013,0,98118,47.5259,-122.279,1880,6000,4650,4120,57.69230769230769,0.04918032786885246,Very Cheap
20141218T000000,175000.0,2,1.0,800,7150,1.0,0,0,3,5,800,0,1933,0,98030,47.3788,-122.224,1220,8019,6350,6799,24.475524475524477,0.013114754098360656,Very Cheap
20150421T000000,544800.0,5,2.75,3190,5857,2.0,0,0,3,9,3190,0,2004,0,98058,47.4575,-122.119,3100,5857,2667,2757,93.01690285128906,0.061613114754098364,Very Cheap
20150121T000000,220000.0,3,1.75,1720,7587,1.0,0,0,4,7,1140,580,1981,0,98092,47.3175,-122.182,1120,7287,5867,6167,28.996968498747858,0.01901639344262295,Very Cheap
20140905T000000,374000.0,2,2.25,1100,1695,2.0,0,0,3,9,1100,0,2009,0,98118,47.5663,-122.289,1100,3082,595,1982,220.6489675516224,0.03921311475409836,Very Cheap
20150227T000000,200000.0,3,2.0,1010,7896,1.0,0,0,3,7,1010,0,1984,0,98031,47.4046,-122.181,1540,7896,6886,6356,25.329280648429584,0.01639344262295082,Very Cheap
20150506T000000,259950.0,3,2.0,1010,7896,1.0,0,0,3,7,1010,0,1984,0,98031,47.4046,-122.181,1540,7896,6886,6356,32.921732522796354,0.024255737704918033,Very Cheap
20140722T000000,255000.0,4,2.75,1760,9222,1.0,0,0,3,7,1140,620,1971,0,98023,47.3099,-122.362,1800,9222,7462,7422,27.651268705270006,0.02360655737704918,Very Cheap
20150323T000000,447000.0,3,1.75,1400,6750,1.0,0,0,3,7,1040,360,1975,0,98034,47.717,-122.226,1860,7480,5350,5620,66.22222222222223,0.04878688524590164,Very Cheap
20150319T000000,287000.0,3,2.5,1820,8722,1.5,0,0,3,7,1820,0,1926,2008,98022,47.2137,-121.989,1480,12285,6902,10805,32.90529695024077,0.02780327868852459,Very Cheap
20140930T000000,344950.0,3,2.0,1470,6950,1.0,0,0,5,6,1470,0,1932,0,98133,47.7619,-122.343,1660,5065,5480,3405,49.63309352517986,0.03540327868852459,Very Cheap
20141010T000000,212000.0,2,1.0,770,7000,1.0,0,0,3,6,770,0,1921,0,98024,47.5654,-121.89,1100,8777,6230,7677,30.285714285714285,0.017967213114754098,Very Cheap
20140723T000000,425000.0,5,2.75,1340,11583,1.0,0,0,3,7,1190,150,1962,0,98034,47.709,-122.214,1950,10514,10243,8564,36.69170335837003,0.04590163934426229,Very Cheap
20140904T000000,170000.0,1,1.0,480,4560,1.0,0,0,3,5,480,0,1922,0,98065,47.5253,-121.826,890,4803,4080,3913,37.280701754385966,0.012459016393442624,Very Cheap
20150212T000000,565000.0,3,1.0,1260,4080,1.5,0,0,4,7,1260,0,1928,0,98103,47.6893,-122.354,1130,3876,2820,2746,138.48039215686273,0.06426229508196721,Very Cheap
20140623T000000,234000.0,2,1.0,870,11100,1.0,0,0,3,6,870,0,1940,0,98146,47.5038,-122.364,1370,10404,10230,9034,21.08108108108108,0.020852459016393442,Very Cheap
20141009T000000,1511250.0,3,2.5,4010,12105,1.0,0,3,5,11,2600,1410,1983,0,98006,47.554,-122.151,4010,15081,8095,11071,124.8451053283767,0.1883606557377049,Cheap
20150126T000000,345000.0,3,2.5,2340,8414,1.0,0,0,3,7,1280,1060,1993,0,98188,47.4685,-122.265,2340,7268,6074,4928,41.00309008794866,0.03540983606557377,Very Cheap
20150427T000000,415000.0,3,2.75,1770,3172,2.0,0,0,3,8,1770,0,2009,0,98065,47.5164,-121.878,1760,2891,1402,1131,130.83228247162674,0.04459016393442623,Very Cheap
20141010T000000,760000.0,5,1.75,2660,10637,1.5,0,0,5,7,1670,990,1922,0,98115,47.6945,-122.292,1570,6825,7977,5255,71.4487167434427,0.0898360655737705,Very Cheap
20150226T000000,484000.0,5,2.5,3600,20001,2.0,0,0,4,9,3600,0,1976,0,98166,47.4484,-122.339,2860,21780,16401,18920,24.198790060496975,0.05363934426229508,Very Cheap
20140926T000000,360000.0,2,1.75,1230,1107,2.0,0,0,3,8,1230,0,2006,0,98029,47.5475,-121.999,1380,1107,-123,-273,325.2032520325203,0.037377049180327866,Very Cheap
20150224T000000,875000.0,3,2.75,3270,39586,1.5,0,0,3,11,3270,0,1988,0,98077,47.731,-122.078,3480,35998,36316,32518,22.103774061536907,0.10491803278688525,Cheap
20140514T000000,930000.0,3,2.5,3100,20553,1.0,0,0,3,10,3100,0,1954,0,98177,47.7635,-122.377,3000,22302,17453,19302,45.248868778280546,0.1121311475409836,Cheap
20140516T000000,250000.0,3,2.0,1900,6660,1.0,0,0,5,7,950,950,1966,0,98038,47.3594,-122.054,1690,8111,4760,6421,37.53753753753754,0.022950819672131147,Very Cheap
20150421T000000,394000.0,2,2.0,1750,2731,2.0,0,0,3,8,1750,0,2012,0,98065,47.5169,-121.878,1650,2731,981,1081,144.26949835225193,0.041836065573770495,Very Cheap
20150122T000000,865000.0,4,3.5,3380,11270,2.0,0,1,3,9,2160,1220,2007,0,98074,47.6124,-122.06,2910,11214,7890,8304,76.75244010647738,0.10360655737704919,Cheap
20140912T000000,477500.0,2,2.0,2090,6000,2.0,0,1,3,7,2090,0,1918,1985,98116,47.5732,-122.413,1600,5400,3910,3800,79.58333333333333,0.05278688524590164,Very Cheap
20141217T000000,1250000.0,4,2.75,4120,12500,1.0,0,4,4,8,2060,2060,1947,0,98116,47.5914,-122.385,3680,5000,8380,1320,100.0,0.1540983606557377,Cheap
20140827T000000,270000.0,3,1.75,1260,7500,1.0,0,0,3,6,840,420,1947,0,98155,47.772,-122.323,1340,7500,6240,6160,36.0,0.025573770491803278,Very Cheap
20150428T000000,567000.0,3,2.25,1800,6875,1.0,0,0,4,8,1230,570,1974,0,98052,47.6773,-122.11,1800,8749,5075,6949,82.47272727272727,0.06452459016393443,Very Cheap
20140602T000000,635000.0,3,2.5,1960,7200,1.0,0,0,4,8,980,980,1940,0,98118,47.5655,-122.27,1440,7200,5240,5760,88.19444444444444,0.07344262295081967,Very Cheap
20140911T000000,1865000.0,6,2.75,4460,6952,2.5,0,2,4,10,3460,1000,1930,0,98105,47.6626,-122.269,2750,4769,2492,2019,268.2681242807825,0.23475409836065575,Cheap
20140610T000000,183000.0,3,1.75,1330,9200,1.0,0,0,4,7,1330,0,1973,0,98092,47.2916,-122.185,1590,9200,7870,7610,19.891304347826086,0.014163934426229508,Very Cheap
20150429T000000,309933.0,3,1.75,1820,78408,1.0,0,0,3,6,1220,600,1950,0,98042,47.3364,-122.128,1340,78408,76588,77068,3.952823691460055,0.03081088524590164,Very Cheap
20150325T000000,945800.0,4,2.75,3360,9100,1.0,0,0,4,8,1760,1600,1973,0,98006,47.5641,-122.149,2620,8925,5740,6305,103.93406593406593,0.11420327868852459,Cheap
20140522T000000,503000.0,2,1.75,2860,59612,1.0,1,4,3,8,1510,1350,1948,2003,98023,47.3276,-122.389,2720,59612,56752,56892,8.437898409716164,0.056131147540983604,Very Cheap
20140814T000000,220000.0,3,1.0,1460,10200,1.0,0,0,4,7,1460,0,1957,0,98055,47.4238,-122.197,1460,8500,8740,7040,21.568627450980394,0.01901639344262295,Very Cheap
20150401T000000,335000.0,3,1.75,1900,36769,1.0,0,0,3,8,1900,0,1987,0,98092,47.3041,-122.066,1950,35847,34869,33897,9.110935842693573,0.03409836065573771,Very Cheap
20150422T000000,650000.0,3,2.25,1790,9927,1.0,0,2,4,7,1240,550,1969,0,98075,47.5822,-122.077,2610,10700,8137,8090,65.47798932205097,0.07540983606557378,Very Cheap
20150203T000000,511000.0,4,3.5,3100,7600,2.0,0,0,3,10,3100,0,2005,0,98031,47.3892,-122.215,3350,7638,4500,4288,67.23684210526316,0.05718032786885246,Very Cheap
20141217T000000,275000.0,2,1.0,900,57063,1.0,0,0,4,6,900,0,1938,0,98045,47.4735,-121.786,1440,268765,56163,267325,4.819234880745842,0.02622950819672131,Very Cheap
20150403T000000,576250.0,2,1.75,1530,5000,2.0,0,0,4,7,1260,270,1989,0,98107,47.6755,-122.37,1470,5000,3470,3530,115.25,0.06573770491803278,Very Cheap
20150319T000000,1452000.0,2,3.25,2070,3128,2.0,1,3,3,9,1760,310,1988,0,98075,47.5686,-122.06,2740,3568,1058,828,464.1943734015345,0.18059016393442623,Cheap
20140619T000000,186000.0,3,2.0,1340,4320,1.0,0,0,3,5,920,420,1912,1993,98002,47.299,-122.228,980,6480,2980,5500,43.05555555555556,0.014557377049180328,Very Cheap
20150505T000000,655100.0,1,1.0,1220,4160,1.0,0,0,3,7,1220,0,1922,0,98115,47.6746,-122.315,1970,4200,2940,2230,157.47596153846155,0.07607868852459017,Very Cheap
20140505T000000,328000.0,4,2.5,2370,6500,2.0,0,0,3,9,2370,0,1998,0,98092,47.3328,-122.173,2590,6137,4130,3547,50.46153846153846,0.03318032786885246,Very Cheap
20150310T000000,441000.0,3,2.5,1890,11036,1.0,0,0,3,8,1460,430,1973,0,98133,47.7426,-122.354,2040,7524,9146,5484,39.960130482058716,0.048,Very Cheap
20150414T000000,370000.0,3,1.75,1480,7725,1.5,0,0,4,7,1480,0,1981,0,98059,47.483,-122.163,1720,8379,6245,6659,47.896440129449836,0.038688524590163934,Very Cheap
20150413T000000,630000.0,2,1.0,1050,8382,1.0,0,0,3,7,1050,0,1959,0,98040,47.5627,-122.221,2400,9525,7332,7125,75.16105941302791,0.07278688524590164,Very Cheap
20150414T000000,470500.0,4,2.25,2070,14000,1.0,0,0,3,7,1720,350,1958,0,98028,47.7484,-122.237,1690,14444,11930,12754,33.607142857142854,0.051868852459016394,Very Cheap
20150413T000000,285950.0,2,1.0,1170,6000,1.0,0,0,3,6,1170,0,1948,0,98168,47.5033,-122.331,1130,7500,4830,6370,47.65833333333333,0.027665573770491805,Very Cheap
20150324T000000,698000.0,3,1.5,1090,7200,1.0,0,0,4,7,1090,0,1958,0,98040,47.5817,-122.241,2010,8982,6110,6972,96.94444444444444,0.08170491803278689,Very Cheap
20140626T000000,268000.0,3,2.5,1650,6684,2.0,0,0,3,7,1650,0,1991,0,98031,47.4051,-122.184,1850,7048,5034,5198,40.095751047277076,0.025311475409836064,Very Cheap
20150212T000000,1625000.0,4,3.75,4410,8112,3.0,0,4,3,11,3570,840,2003,0,98116,47.5888,-122.392,2770,5750,3702,2980,200.32051282051282,0.20327868852459016,Cheap
20150330T000000,355000.0,4,2.5,1780,15000,2.0,0,0,2,7,1780,0,1993,0,98058,47.4239,-122.153,2005,9680,13220,7675,23.666666666666668,0.036721311475409836,Very Cheap
20140917T000000,299000.0,3,1.0,1550,8778,1.0,0,0,3,7,1250,300,1952,0,98118,47.5413,-122.281,2120,7268,7228,5148,34.062428799270904,0.02937704918032787,Very Cheap
20140521T000000,1003000.0,4,2.75,2290,6120,2.0,0,0,4,7,2170,120,1926,0,98115,47.6746,-122.327,1910,4590,3830,2680,163.88888888888889,0.12170491803278688,Cheap
20150420T000000,275000.0,4,2.0,2220,8229,1.5,0,0,4,7,2220,0,1958,0,98030,47.3722,-122.22,1660,8396,6009,6736,33.4183983473083,0.02622950819672131,Very Cheap
20150503T000000,475000.0,3,1.75,1150,10240,1.0,0,0,3,6,1030,120,1918,0,98106,47.5222,-122.357,1270,2566,9090,1296,46.38671875,0.05245901639344262,Very Cheap
20140623T000000,260000.0,4,2.5,2000,37045,2.0,0,0,3,8,2000,0,1989,0,98042,47.3398,-122.071,2390,36868,35045,34478,7.018491024429748,0.024262295081967214,Very Cheap
20140718T000000,416000.0,2,1.75,1270,7560,1.5,0,0,4,7,1270,0,1932,0,98133,47.7083,-122.357,1480,7560,6290,6080,55.026455026455025,0.044721311475409836,Very Cheap
20141119T000000,495000.0,5,1.0,1810,11205,1.5,0,2,3,7,1810,0,1915,0,98178,47.5099,-122.262,1860,7965,9395,6105,44.17670682730924,0.05508196721311476,Very Cheap
20150114T000000,357500.0,3,1.0,1450,8100,1.0,0,0,3,6,1450,0,1952,0,98125,47.7027,-122.289,1450,7800,6650,6350,44.135802469135804,0.03704918032786885,Very Cheap
20140825T000000,459500.0,2,1.5,1170,1079,3.0,0,0,3,7,1170,0,2003,0,98103,47.6607,-122.333,1170,1116,-91,-54,425.8572752548656,0.050426229508196724,Very Cheap
20140903T000000,258000.0,3,2.5,1730,6930,2.0,0,0,3,8,1730,0,1994,0,98003,47.2621,-122.308,1780,6930,5200,5150,37.22943722943723,0.024,Very Cheap
20150411T000000,600000.0,3,2.25,2680,98445,1.0,0,0,5,8,2680,0,1962,0,98059,47.5015,-122.108,2340,98445,95765,96105,6.094773731525217,0.06885245901639345,Very Cheap
20140919T000000,665000.0,3,1.0,1260,24550,1.5,0,2,4,7,1260,0,1937,0,98136,47.5442,-122.396,2500,12320,23290,9820,27.087576374745417,0.07737704918032787,Very Cheap
20141003T000000,165000.0,3,1.5,1020,10152,1.0,0,0,5,6,1020,0,1959,0,98056,47.4971,-122.168,1320,8892,9132,7572,16.252955082742318,0.01180327868852459,Very Cheap
20140518T000000,297000.0,5,2.5,1970,8605,2.0,0,0,4,7,1970,0,1994,0,98022,47.1944,-122.013,1970,8460,6635,6490,34.51481696687972,0.029114754098360656,Very Cheap
20141023T000000,350000.0,2,1.0,830,5100,1.0,0,0,4,7,830,0,1942,0,98126,47.5259,-122.379,1220,5100,4270,3880,68.62745098039215,0.036065573770491806,Very Cheap
20140513T000000,2450000.0,4,4.5,5030,11023,2.0,0,2,3,11,3250,1780,2008,0,98040,47.5722,-122.236,3640,11490,5993,7850,222.26254195772475,0.3114754098360656,Medium
20150513T000000,180000.0,2,1.0,800,9450,1.0,0,0,3,6,800,0,1958,0,98058,47.4563,-122.184,1090,9450,8650,8360,19.047619047619047,0.01377049180327869,Very Cheap
20150407T000000,339950.0,3,1.75,1330,12092,1.0,0,0,4,6,720,610,1981,0,98168,47.5102,-122.324,1770,11770,10762,10000,28.1136288455177,0.03474754098360656,Very Cheap
20150127T000000,365000.0,3,1.0,1030,4700,1.0,0,0,3,7,1030,0,1952,0,98146,47.5118,-122.377,1030,4700,3670,3670,77.65957446808511,0.0380327868852459,Very Cheap
20140605T000000,955000.0,4,4.25,5660,193593,2.0,0,0,3,10,4100,1560,2001,0,98019,47.7064,-121.981,3620,207141,187933,203521,4.933029603343096,0.11540983606557377,Cheap
20140527T000000,732000.0,3,2.5,2330,1987,2.0,0,4,3,9,1410,920,2004,0,98107,47.6735,-122.405,2640,5250,-343,2610,368.39456467035734,0.08616393442622951,Very Cheap
20140616T000000,500000.0,3,1.75,1540,10800,1.0,0,0,5,6,770,770,1947,0,98040,47.5763,-122.222,2020,10800,9260,8780,46.2962962962963,0.05573770491803279,Very Cheap
20150213T000000,610000.0,6,2.75,2040,8560,1.0,0,2,4,7,1100,940,1961,0,98008,47.616,-122.115,2230,8560,6520,6330,71.26168224299066,0.07016393442622951,Very Cheap
20140604T000000,525000.0,3,2.0,1540,7800,1.0,0,0,3,8,1540,0,2004,0,98125,47.7041,-122.288,1510,7800,6260,6290,67.3076923076923,0.05901639344262295,Very Cheap
20140617T000000,170000.0,4,1.0,1920,13787,1.0,0,0,4,7,1220,700,1966,0,98188,47.4502,-122.277,1490,11200,11867,9710,12.330456226880395,0.012459016393442624,Very Cheap
20140713T000000,300000.0,3,2.5,1870,3439,2.0,0,0,3,7,1870,0,2005,0,98042,47.3992,-122.163,2190,4029,1569,1839,87.23466123873219,0.029508196721311476,Very Cheap
20141029T000000,389500.0,5,3.5,2960,12527,2.0,0,0,3,9,1940,1020,1986,0,98023,47.3134,-122.35,2210,10952,9567,8742,31.092839466751816,0.04124590163934426,Very Cheap
20150219T000000,330000.0,3,1.5,1690,10250,1.0,0,0,4,7,1690,0,1955,0,98166,47.4531,-122.344,1990,11084,8560,9094,32.19512195121951,0.03344262295081967,Very Cheap
20141114T000000,269950.0,3,2.25,1610,7187,2.0,0,0,3,7,1610,0,1988,0,98042,47.3764,-122.117,1640,7194,5577,5554,37.560873799916514,0.025567213114754097,Very Cheap
20140828T000000,107000.0,2,1.0,670,4720,1.0,0,0,4,6,670,0,1948,0,98106,47.5243,-122.358,1480,4720,4050,3240,22.66949152542373,0.00419672131147541,Very Cheap
20141202T000000,249000.0,3,1.0,1752,14626,2.0,0,2,3,8,1752,0,2005,0,98032,47.3755,-122.278,1800,9000,12874,7200,17.02447695884042,0.02281967213114754,Very Cheap
20140818T000000,442500.0,4,2.0,1540,5920,1.5,0,0,5,7,1540,0,1935,0,98125,47.7148,-122.301,1630,6216,4380,4586,74.74662162162163,0.04819672131147541,Very Cheap
20150417T000000,579000.0,3,2.5,3160,286181,2.0,0,3,3,9,3160,0,2002,0,98010,47.3401,-121.946,2110,94663,283021,92553,2.02319511078653,0.06609836065573771,Very Cheap
20150121T000000,621500.0,3,1.75,2570,39634,2.0,0,0,3,8,2570,0,1984,0,98075,47.596,-122.08,2990,39634,37064,36644,15.680980975929756,0.07167213114754098,Very Cheap
20141119T000000,203000.0,3,1.5,1370,7500,1.0,0,0,3,7,1080,290,1958,0,98198,47.4167,-122.322,1400,7500,6130,6100,27.066666666666666,0.01678688524590164,Very Cheap
20140909T000000,222900.0,2,1.0,860,5800,1.0,0,0,5,5,860,0,1942,0,98056,47.4979,-122.183,900,6000,4940,5100,38.43103448275862,0.01939672131147541,Very Cheap
20150409T000000,453000.0,2,1.5,1680,17400,1.5,0,0,3,7,1680,0,1991,0,98038,47.3836,-122.006,1610,27600,15720,25990,26.03448275862069,0.04957377049180328,Very Cheap
20140625T000000,190000.0,1,0.75,930,29258,1.0,0,0,3,6,930,0,1941,0,98178,47.4837,-122.236,2000,18321,28328,16321,6.49395037254768,0.015081967213114755,Very Cheap
20150406T000000,320000.0,4,1.75,1820,7381,1.0,0,0,5,7,1150,670,1962,0,98058,47.4567,-122.171,1610,8462,5561,6852,43.35455900284514,0.032131147540983604,Very Cheap
20141210T000000,733500.0,3,1.5,2120,4370,1.5,0,0,3,8,2120,0,1904,0,98122,47.606,-122.307,1960,5120,2250,3160,167.84897025171625,0.08636065573770492,Very Cheap
20150218T000000,555000.0,4,2.25,3330,21785,2.0,0,0,3,9,3330,0,1994,0,98059,47.4725,-122.136,3330,21796,18455,18466,25.47624512279091,0.06295081967213115,Very Cheap
20141215T000000,364950.0,3,2.25,2520,6170,2.0,0,0,3,7,1850,670,2003,0,98038,47.3522,-122.042,2260,6967,3650,4707,59.149108589951375,0.03802622950819672,Very Cheap
20141120T000000,490000.0,3,1.75,1560,9247,1.0,0,0,3,7,1160,400,1989,0,98033,47.6954,-122.174,1690,8772,7687,7082,52.99015897047691,0.05442622950819672,Very Cheap
20150427T000000,688000.0,5,1.75,2250,13526,1.0,0,1,3,8,1350,900,1957,0,98125,47.7108,-122.279,2580,10078,11276,7498,50.86500073931687,0.08039344262295083,Very Cheap
20140711T000000,165000.0,2,1.0,640,7768,1.0,0,0,3,6,640,0,1942,0,98106,47.515,-122.359,840,7424,7128,6584,21.24098867147271,0.01180327868852459,Very Cheap
20141113T000000,506000.0,5,3.75,3880,8370,2.0,0,0,4,7,3880,0,2004,0,98056,47.4811,-122.179,2160,4651,4490,2491,60.45400238948626,0.05652459016393443,Very Cheap
20141209T000000,2193000.0,3,2.25,3360,7108,2.0,0,0,3,10,2770,590,1905,2004,98112,47.6187,-122.284,3450,8558,3748,5108,308.5256049521666,0.2777704918032787,Cheap
20150429T000000,754000.0,5,1.75,2350,7800,1.0,0,0,4,8,1510,840,1968,0,98008,47.6225,-122.107,2220,8400,5450,6180,96.66666666666667,0.08904918032786885,Very Cheap
20150417T000000,949950.0,5,2.5,2340,1989,2.0,1,4,3,8,2340,0,1959,0,98118,47.5193,-122.257,2200,3230,-351,1030,477.6018099547511,0.11474754098360655,Cheap
20140822T000000,443600.0,3,2.5,1430,1056,3.0,0,0,3,8,1430,0,2003,0,98117,47.684,-122.388,1310,2135,-374,825,420.07575757575756,0.04834098360655738,Very Cheap
20140814T000000,380600.0,3,2.5,1920,12244,2.0,0,0,3,7,1920,0,1998,0,98019,47.7256,-121.97,1920,11859,10324,9939,31.084612871610585,0.040078688524590164,Very Cheap
20150126T000000,722800.0,3,3.25,4330,14600,2.0,0,0,3,10,3630,700,1985,0,98074,47.6341,-122.044,3220,12672,10270,9452,49.50684931506849,0.08495737704918033,Very Cheap
20150210T000000,342888.0,2,1.0,790,5150,1.0,0,0,4,6,790,0,1948,0,98118,47.5528,-122.272,1460,5150,4360,3690,66.58019417475728,0.035132852459016393,Very Cheap
20140916T000000,555000.0,4,1.75,2350,5946,1.0,0,2,3,8,1350,1000,1957,0,98115,47.6879,-122.298,2060,6000,3596,3940,93.34006054490413,0.06295081967213115,Very Cheap
20140603T000000,613000.0,3,2.5,1350,3068,2.0,0,0,3,7,1350,0,1991,0,98122,47.6099,-122.293,1900,4000,1718,2100,199.8044328552803,0.07055737704918033,Very Cheap
20140702T000000,480000.0,3,2.0,1470,10052,1.0,0,0,4,8,1470,0,1956,0,98125,47.726,-122.316,1480,9780,8582,8300,47.751691205730204,0.05311475409836065,Very Cheap
20150316T000000,619500.0,6,1.5,1680,5202,1.5,0,0,2,7,1680,0,1911,0,98033,47.6798,-122.206,1890,5500,3522,3610,119.0888119953864,0.07140983606557377,Very Cheap
20140624T000000,437000.0,4,2.5,1890,8505,1.0,0,0,3,8,1290,600,1980,0,98052,47.6796,-122.115,1720,9600,6615,7880,51.38154027042916,0.047475409836065574,Very Cheap
20150408T000000,621000.0,4,2.5,2030,9905,1.0,0,0,4,8,2030,0,1959,0,98006,47.5518,-122.184,2130,10008,7875,7878,62.69560827864715,0.07160655737704918,Very Cheap
20140714T000000,810000.0,4,1.75,1760,4080,1.5,0,0,4,8,1760,0,1906,0,98103,47.675,-122.331,1760,6120,2320,4360,198.52941176470588,0.09639344262295083,Very Cheap
20140527T000000,415000.0,3,2.25,1950,8868,1.0,0,0,3,7,1350,600,1964,0,98155,47.7538,-122.312,1300,8880,6918,7580,46.79747406405052,0.04459016393442623,Very Cheap
20141113T000000,250000.0,4,1.0,1440,7404,1.0,0,0,3,6,1080,360,1918,0,98126,47.5328,-122.379,1620,7436,5964,5816,33.765532144786604,0.022950819672131147,Very Cheap
20150413T000000,585000.0,3,1.5,2230,6000,1.0,0,1,3,8,1260,970,1968,0,98136,47.5373,-122.395,2120,7200,3770,5080,97.5,0.06688524590163934,Very Cheap
20140528T000000,220000.0,3,1.0,1180,5002,1.5,0,0,3,7,1180,0,1946,0,98155,47.7529,-122.324,1470,8410,3822,6940,43.982407037185126,0.01901639344262295,Very Cheap
20150422T000000,580000.0,5,2.5,2500,11900,1.0,0,0,3,7,1400,1100,1963,0,98007,47.5915,-122.132,2820,11900,9400,9080,48.739495798319325,0.06622950819672131,Very Cheap
20140725T000000,1320000.0,3,2.75,2680,20104,1.0,0,0,5,9,1820,860,1964,0,98039,47.6304,-122.234,3060,19837,17424,16777,65.65857540787903,0.16327868852459015,Cheap
20140801T000000,675000.0,4,2.5,2040,9225,1.0,0,0,5,8,1610,430,1968,0,98052,47.636,-122.097,1730,9225,7185,7495,73.17073170731707,0.07868852459016394,Very Cheap
20141029T000000,695000.0,4,2.75,2660,7389,2.0,0,0,3,9,2660,0,2002,0,98075,47.5993,-121.977,2820,7388,4729,4568,94.05873595885777,0.08131147540983606,Very Cheap
20141209T000000,915000.0,5,2.75,2580,7630,1.0,0,0,4,7,1730,850,1954,0,98004,47.6226,-122.205,2040,7717,5050,5677,119.92136304062909,0.11016393442622952,Cheap
20141121T000000,375000.0,3,1.0,1000,6947,1.0,0,0,4,7,1000,0,1947,0,98125,47.7142,-122.319,1000,6947,5947,5947,53.980135310205846,0.03934426229508197,Very Cheap
20150407T000000,500000.0,3,1.5,1330,1265,2.0,0,0,3,8,1140,190,2008,0,98116,47.5773,-122.409,1330,1264,-65,-66,395.25691699604744,0.05573770491803279,Very Cheap
20141226T000000,335000.0,2,2.0,1420,5185,1.0,0,0,3,7,1420,0,2004,0,98038,47.3543,-122.022,2140,4890,3765,2750,64.60945033751206,0.03409836065573771,Very Cheap
20140718T000000,170000.0,2,1.0,1280,21750,1.5,0,0,5,6,1280,0,1912,0,98001,47.3096,-122.241,1520,21750,20470,20230,7.816091954022989,0.012459016393442624,Very Cheap
20150429T000000,320900.0,5,2.5,2200,8500,1.0,0,0,4,7,1400,800,1971,0,98010,47.3073,-122.006,1360,8855,6300,7495,37.752941176470586,0.03224918032786885,Very Cheap
20150306T000000,508000.0,3,1.75,1800,8462,1.0,0,0,3,8,1440,360,1978,0,98052,47.6623,-122.141,2210,8436,6662,6226,60.033089104230676,0.05678688524590164,Very Cheap
20140708T000000,228950.0,3,1.75,1200,9085,1.0,0,0,4,7,1200,0,1968,0,98023,47.2795,-122.353,1200,9085,7885,7885,25.200880572372043,0.020190163934426228,Very Cheap
20150507T000000,433000.0,4,2.0,1840,4760,1.5,0,0,4,6,1080,760,1929,0,98106,47.5297,-122.349,1170,5950,2920,4780,90.96638655462185,0.04695081967213115,Very Cheap
20140908T000000,267500.0,2,1.0,960,5150,1.0,0,0,5,6,960,0,1951,0,98126,47.5201,-122.372,1010,5000,4190,3990,51.94174757281554,0.025245901639344263,Very Cheap
20141008T000000,910000.0,4,1.5,2890,9000,2.0,0,4,3,8,2090,800,1939,0,98118,47.5682,-122.274,2550,8400,6110,5850,101.11111111111111,0.10950819672131147,Cheap
20150303T000000,370000.0,3,1.75,1290,10117,1.0,0,0,3,7,1290,0,1984,0,98072,47.7598,-122.146,1770,11839,8827,10069,36.57210635563902,0.038688524590163934,Very Cheap
20141206T000000,320000.0,2,1.0,1140,3834,1.5,0,0,3,6,1140,0,1911,0,98126,47.5642,-122.378,1190,5750,2694,4560,83.46374543557643,0.032131147540983604,Very Cheap
20141001T000000,660000.0,3,1.75,1750,5200,1.0,0,1,4,8,1750,0,1956,0,98117,47.6995,-122.383,2060,5200,3450,3140,126.92307692307692,0.07672131147540984,Very Cheap
20140826T000000,787888.0,4,2.25,2580,21115,2.0,0,0,4,9,2580,0,1977,0,98040,47.5566,-122.219,2690,10165,18535,7475,37.314136869524035,0.09349350819672131,Very Cheap
20141218T000000,329000.0,4,2.5,2650,5880,2.0,0,0,3,9,2650,0,2005,0,98042,47.3509,-122.165,2610,6490,3230,3880,55.95238095238095,0.03331147540983607,Very Cheap
20141203T000000,602000.0,2,1.0,1470,6398,1.0,0,0,4,7,970,500,1941,0,98105,47.6716,-122.279,1950,6398,4928,4448,94.09190371991247,0.06911475409836065,Very Cheap
20141106T000000,375000.0,3,2.0,1640,9750,1.0,0,0,3,7,1640,0,1959,0,98028,47.7425,-122.241,1340,9750,8110,8410,38.46153846153846,0.03934426229508197,Very Cheap
20150505T000000,212000.0,1,1.0,620,7620,1.0,0,0,3,6,620,0,1926,0,98166,47.4697,-122.349,1160,7620,7000,6460,27.821522309711288,0.017967213114754098,Very Cheap
20140822T000000,224000.0,3,1.5,1440,8370,1.0,0,0,3,7,1440,0,1977,0,98118,47.5418,-122.275,1440,8370,6930,6930,26.76224611708483,0.01954098360655738,Very Cheap
20150310T000000,315500.0,3,2.0,1160,10079,1.0,0,0,3,7,1160,0,1986,0,98019,47.7341,-121.976,1130,10087,8919,8957,31.302708602043854,0.031540983606557375,Very Cheap
20150128T000000,350000.0,2,1.0,1070,2880,1.0,0,0,3,7,1070,0,1902,0,98102,47.6261,-122.324,2030,2880,1810,850,121.52777777777777,0.036065573770491806,Very Cheap
20150506T000000,389000.0,6,4.5,3560,14010,2.0,0,0,3,7,3560,0,1989,0,98002,47.3244,-122.217,1710,11116,10450,9406,27.765881513204853,0.04118032786885246,Very Cheap
20140713T000000,285000.0,3,1.75,1720,13104,1.0,0,0,4,7,1720,0,1962,0,98168,47.4709,-122.26,1840,13104,11384,11264,21.749084249084248,0.02754098360655738,Very Cheap
20141201T000000,425000.0,3,1.75,1530,9800,1.0,0,0,5,8,1530,0,1958,0,98133,47.7655,-122.336,1660,9800,8270,8140,43.36734693877551,0.04590163934426229,Very Cheap
20150309T000000,190000.0,3,1.75,1270,7875,1.0,0,0,4,7,1270,0,1980,0,98030,47.3696,-122.17,1830,7210,6605,5380,24.126984126984127,0.015081967213114755,Very Cheap
20150505T000000,374000.0,3,1.75,1510,18439,1.0,0,0,3,7,1510,0,1971,0,98027,47.5491,-122.046,1600,34326,16929,32726,20.283095612560334,0.03921311475409836,Very Cheap
20140807T000000,292000.0,2,1.0,880,5500,1.0,0,0,3,6,880,0,1904,0,98118,47.5573,-122.289,1080,5500,4620,4420,53.09090909090909,0.028459016393442622,Very Cheap
20150511T000000,475000.0,5,1.75,2020,5100,1.5,0,0,5,7,1320,700,1911,0,98103,47.6915,-122.345,1130,5100,3080,3970,93.13725490196079,0.05245901639344262,Very Cheap
20150330T000000,546500.0,3,2.5,1410,2675,1.0,0,0,3,7,820,590,1985,0,98117,47.6786,-122.371,1410,4013,1265,2603,204.29906542056074,0.06183606557377049,Very Cheap
20141105T000000,82000.0,3,1.0,860,10426,1.0,0,0,3,6,860,0,1954,0,98146,47.4987,-122.341,1140,11250,9566,10110,7.864953002110109,0.0009180327868852459,Very Cheap
20150408T000000,219900.0,3,1.0,860,10426,1.0,0,0,3,6,860,0,1954,0,98146,47.4987,-122.341,1140,11250,9566,10110,21.09150201419528,0.01900327868852459,Very Cheap
20140612T000000,440000.0,3,1.0,1210,5750,1.5,0,0,4,7,1210,0,1910,0,98136,47.5403,-122.391,1160,5000,4540,3840,76.52173913043478,0.04786885245901639,Very Cheap
20150428T000000,400000.0,3,2.5,2090,32718,2.0,1,4,3,7,1550,540,1919,1983,98070,47.3338,-122.511,1200,192268,30628,191068,12.225686166636102,0.04262295081967213,Very Cheap
20141117T000000,453000.0,3,1.75,1430,20193,1.0,0,0,3,7,1430,0,1955,0,98006,47.5619,-122.183,2140,18364,18763,16224,22.433516565146338,0.04957377049180328,Very Cheap
20140812T000000,330000.0,6,3.25,2120,6893,1.0,0,0,4,7,1060,1060,1983,0,98106,47.5508,-122.355,1380,6986,4773,5606,47.87465544755549,0.03344262295081967,Very Cheap
20140721T000000,359950.0,3,2.75,2540,8604,2.0,0,0,3,8,2540,0,1991,0,98092,47.3209,-122.185,2260,7438,6064,5178,41.835192933519295,0.037370491803278685,Very Cheap
20140617T000000,616000.0,4,2.5,2490,12929,2.0,0,0,3,9,2490,0,1983,0,98074,47.6161,-122.021,2440,12929,10439,10489,47.6448294531673,0.07095081967213114,Very Cheap
20141107T000000,245000.0,2,1.0,670,2356,1.0,0,0,5,6,670,0,1960,0,98144,47.5918,-122.295,1220,1740,1686,520,103.98981324278438,0.022295081967213116,Very Cheap
20141103T000000,296000.0,2,2.0,1320,2040,3.0,0,0,3,7,1320,0,1997,0,98125,47.7224,-122.291,1430,2040,720,610,145.09803921568627,0.02898360655737705,Very Cheap
20141106T000000,193000.0,2,1.0,950,9000,1.0,0,0,3,6,950,0,1924,0,98106,47.5219,-122.361,1000,8280,8050,7280,21.444444444444443,0.015475409836065573,Very Cheap
20140828T000000,456000.0,3,2.0,1870,8442,1.5,0,0,5,7,1060,810,1927,0,98117,47.6964,-122.365,1640,6174,6572,4534,54.01563610518834,0.0499672131147541,Very Cheap
20150427T000000,480000.0,4,1.75,1840,9250,1.0,0,0,4,7,980,860,1956,0,98133,47.708,-122.337,1520,9250,7410,7730,51.891891891891895,0.05311475409836065,Very Cheap
20140509T000000,382000.0,3,3.25,1410,1253,3.0,0,0,3,8,1410,0,2005,0,98103,47.6981,-122.34,1410,1253,-157,-157,304.8683160415004,0.040262295081967214,Very Cheap
20140628T000000,650000.0,2,1.0,1050,2542,1.0,0,0,3,7,880,170,1904,0,98122,47.6172,-122.298,1620,1809,1492,189,255.70416994492527,0.07540983606557378,Very Cheap
20141125T000000,431750.0,2,2.0,1400,10052,1.0,0,0,3,8,1400,0,1957,0,98125,47.7262,-122.316,1400,8785,8652,7385,42.9516514126542,0.04678688524590164,Very Cheap
20150511T000000,419900.0,3,2.5,1630,1755,2.0,0,0,3,8,1320,310,1997,0,98033,47.691,-122.176,1920,14550,125,12630,239.25925925925927,0.0452327868852459,Very Cheap
20141229T000000,315000.0,3,2.0,1900,9513,1.0,0,0,3,8,1900,0,1995,0,98023,47.2843,-122.357,1790,8028,7613,6238,33.11258278145695,0.031475409836065574,Very Cheap
20150420T000000,597500.0,4,3.0,1890,35280,1.0,0,0,3,9,1510,380,1979,0,98052,47.7112,-122.099,2730,34525,33390,31795,16.9359410430839,0.06852459016393443,Very Cheap
20150306T000000,615000.0,3,2.5,2980,43301,1.0,0,0,4,8,1930,1050,1978,0,98077,47.7631,-122.093,2890,35915,40321,33025,14.20290524468257,0.07081967213114754,Very Cheap
20141031T000000,605000.0,4,3.25,2885,33671,2.0,0,0,4,8,2885,0,1984,0,98027,47.5174,-122.046,1910,16000,30786,14090,17.96798431885005,0.06950819672131148,Very Cheap
20150401T000000,220000.0,3,2.5,1980,11900,2.0,0,0,3,8,1980,0,1990,0,98092,47.2656,-122.217,2130,9933,9920,7803,18.48739495798319,0.01901639344262295,Very Cheap
20150413T000000,340000.0,4,2.5,3020,8750,1.0,0,0,3,8,1710,1310,1960,0,98188,47.4298,-122.29,1900,8750,5730,6850,38.857142857142854,0.03475409836065574,Very Cheap
20141015T000000,620000.0,4,2.5,2980,210395,2.0,0,0,3,9,2980,0,2001,0,98045,47.4575,-121.707,2530,45596,207415,43066,2.9468380902587987,0.07147540983606557,Very Cheap
20140519T000000,602000.0,5,1.75,3290,11900,1.5,0,0,3,8,3290,0,1973,0,98052,47.6626,-122.141,2210,8549,8610,6339,50.588235294117645,0.06911475409836065,Very Cheap
20140513T000000,575000.0,3,1.75,1580,11750,1.0,0,0,4,7,1180,400,1951,0,98118,47.5368,-122.265,2150,11750,10170,9600,48.93617021276596,0.06557377049180328,Very Cheap
20140502T000000,285000.0,3,2.5,2090,10834,1.0,0,0,4,8,1360,730,1987,0,98003,47.3537,-122.303,1750,8595,8744,6845,26.3060734724017,0.02754098360655738,Very Cheap
20150220T000000,306500.0,3,1.5,1100,8140,1.0,0,0,4,7,1100,0,1965,0,98059,47.5004,-122.162,1430,7700,7040,6270,37.65356265356265,0.03036065573770492,Very Cheap
20150102T000000,325000.0,3,2.5,1870,3480,2.0,0,0,3,7,1870,0,2002,0,98056,47.4831,-122.183,2160,3480,1610,1320,93.39080459770115,0.03278688524590164,Very Cheap
20150319T000000,623000.0,3,2.75,2390,21804,1.0,0,0,3,8,1450,940,1973,0,98034,47.7339,-122.183,2390,10136,19414,7746,28.572738946982206,0.07186885245901639,Very Cheap
20150311T000000,256500.0,3,2.0,1320,8568,1.0,0,0,3,7,1320,0,1993,0,98042,47.3904,-122.164,1600,8463,7248,6863,29.936974789915965,0.02380327868852459,Very Cheap
20141117T000000,473000.0,5,3.5,3430,6872,2.0,0,0,3,10,2830,600,2002,0,98031,47.4065,-122.207,3650,6600,3442,2950,68.83003492433062,0.05219672131147541,Very Cheap
20141029T000000,549000.0,3,2.5,2250,9235,2.0,0,0,3,8,2250,0,1985,0,98052,47.7268,-122.105,2290,8187,6985,5897,59.44775311315647,0.06216393442622951,Very Cheap
20150317T000000,305000.0,3,1.0,1710,19115,1.0,0,0,3,6,1710,0,1986,0,98014,47.656,-121.913,1650,15144,17405,13494,15.95605545383207,0.03016393442622951,Very Cheap
20150204T000000,317000.0,4,2.5,2160,8049,2.0,0,0,3,9,2160,0,1988,0,98001,47.3337,-122.26,2490,8995,5889,6505,39.3837743819108,0.03173770491803279,Very Cheap
20140701T000000,450000.0,3,1.75,1400,13775,1.0,0,0,3,8,1400,0,1963,0,98028,47.7413,-122.259,2200,10450,12375,8250,32.66787658802178,0.04918032786885246,Very Cheap
20150409T000000,225000.0,2,2.5,1560,5333,1.0,0,0,3,5,780,780,1947,0,98055,47.4749,-122.213,1010,4800,3773,3790,42.19013688355522,0.019672131147540985,Very Cheap
20150212T000000,500000.0,5,2.0,2300,7897,2.5,0,0,4,8,2300,0,1956,0,98133,47.7556,-122.356,2030,7902,5597,5872,63.31518298087882,0.05573770491803279,Very Cheap
20140812T000000,207000.0,2,1.0,820,4860,1.0,0,0,5,6,820,0,1955,0,98118,47.5298,-122.271,1240,6000,4040,4760,42.592592592592595,0.017311475409836064,Very Cheap
20140818T000000,474900.0,3,1.0,1630,8308,1.5,0,0,3,7,1630,0,1948,0,98146,47.5075,-122.378,1170,8308,6678,7138,57.16177178623014,0.05244590163934426,Very Cheap
20140701T000000,515000.0,3,2.5,2010,7200,2.0,0,0,3,8,2010,0,1994,0,98028,47.7372,-122.223,1970,7202,5190,5232,71.52777777777777,0.057704918032786885,Very Cheap
20150212T000000,542000.0,4,1.0,1540,5000,1.5,0,0,4,7,1090,450,1922,0,98115,47.6754,-122.294,1590,5000,3460,3410,108.4,0.06124590163934426,Very Cheap
20140605T000000,725000.0,4,2.75,2420,10962,1.0,0,0,3,8,1530,890,1977,0,98007,47.6218,-122.152,2620,13200,8542,10580,66.13756613756614,0.08524590163934426,Very Cheap
20150309T000000,314950.0,3,2.5,1690,4533,2.0,0,0,3,7,1690,0,2003,0,98038,47.3575,-122.016,1830,5175,2843,3345,69.47937348334436,0.03146885245901639,Very Cheap
20141106T000000,375000.0,3,2.0,1410,10078,1.0,0,0,4,6,1410,0,1983,0,98072,47.7587,-122.144,2090,9202,8668,7112,37.209763842032146,0.03934426229508197,Very Cheap
20140710T000000,500000.0,3,1.75,1640,47044,1.0,0,0,3,7,1640,0,1989,0,98014,47.654,-121.94,2280,200811,45404,198531,10.628347929597822,0.05573770491803279,Very Cheap
20140624T000000,689000.0,3,1.75,2200,9840,1.0,0,0,5,8,1500,700,1978,0,98006,47.559,-122.136,2410,9623,7640,7213,70.02032520325203,0.08052459016393443,Very Cheap
20141209T000000,525000.0,3,2.25,1290,1182,2.0,0,0,3,8,1000,290,2006,0,98102,47.637,-122.327,1300,1169,-108,-131,444.16243654822335,0.05901639344262295,Very Cheap
20150504T000000,360000.0,3,1.5,1060,6232,1.0,0,0,4,7,1060,0,1968,0,98118,47.5329,-122.271,1120,5379,5172,4259,57.76636713735559,0.037377049180327866,Very Cheap
20140820T000000,425000.0,3,1.0,1240,5750,1.0,0,0,4,6,1240,0,1948,0,98116,47.564,-122.398,1240,5750,4510,4510,73.91304347826087,0.04590163934426229,Very Cheap
20150304T000000,239950.0,2,1.0,1280,5500,1.0,0,0,3,7,1280,0,1949,0,98118,47.5179,-122.264,1270,5500,4220,4230,43.627272727272725,0.021632786885245902,Very Cheap
20150402T000000,577500.0,2,2.5,2330,3000,2.0,0,3,3,8,2330,0,1915,1994,98144,47.5953,-122.294,1760,4000,670,2240,192.5,0.0659016393442623,Very Cheap
20140502T000000,615000.0,3,1.75,2360,7291,1.0,0,0,4,8,1360,1000,1948,0,98136,47.5274,-122.384,1860,5499,4931,3639,84.35056919489782,0.07081967213114754,Very Cheap
20140827T000000,516000.0,4,2.75,2210,10800,1.0,0,0,4,8,1170,1040,1997,0,98074,47.6086,-122.059,2210,10800,8590,8590,47.77777777777778,0.05783606557377049,Very Cheap
20140813T000000,1218000.0,4,2.75,3670,15400,2.0,0,3,4,10,3670,0,1986,0,98006,47.5581,-122.156,3370,13300,11730,9930,79.0909090909091,0.1499016393442623,Cheap
20140527T000000,1655000.0,4,3.5,3080,4815,2.0,0,3,3,10,2300,780,1937,2009,98199,47.6417,-122.411,2910,5350,1735,2440,343.71754932502597,0.20721311475409837,Cheap
20150501T000000,315000.0,2,1.0,770,6731,1.0,0,0,4,6,770,0,1943,0,98155,47.7505,-122.312,1120,9212,5961,8092,46.79839548358342,0.031475409836065574,Very Cheap
20141021T000000,250000.0,4,2.0,2600,9000,1.0,0,0,3,8,1410,1190,1959,0,98032,47.381,-122.299,2600,7200,6400,4600,27.77777777777778,0.022950819672131147,Very Cheap
20141113T000000,250000.0,4,1.5,1220,4900,1.0,0,0,3,6,1220,0,1942,0,98118,47.5292,-122.269,1410,3000,3680,1590,51.02040816326531,0.022950819672131147,Very Cheap
20150410T000000,925000.0,4,2.5,2910,48351,1.0,0,0,4,8,1910,1000,1967,0,98005,47.6495,-122.164,2760,43560,45441,40800,19.130938346673286,0.11147540983606558,Cheap
20140825T000000,358000.0,3,1.0,1150,4681,1.0,0,0,3,7,1150,0,1955,0,98133,47.7284,-122.336,1150,6800,3531,5650,76.47938474684896,0.03711475409836065,Very Cheap
20140926T000000,262000.0,3,2.5,1700,6200,2.0,0,0,3,8,1700,0,1997,0,98092,47.2621,-122.221,1720,6205,4500,4485,42.25806451612903,0.024524590163934427,Very Cheap
20141015T000000,500000.0,3,1.75,1220,7370,1.0,0,0,4,7,1220,0,1964,0,98008,47.6334,-122.12,1580,8213,6150,6633,67.84260515603799,0.05573770491803279,Very Cheap
20140715T000000,1300000.0,5,1.0,1670,6400,1.5,0,0,3,8,1670,0,1919,0,98119,47.6542,-122.373,1910,2983,4730,1073,203.125,0.16065573770491803,Cheap
20140915T000000,500000.0,3,1.75,2420,65501,2.0,0,1,3,8,2420,0,1984,0,98074,47.6525,-122.087,2970,19036,63081,16066,7.633471244713821,0.05573770491803279,Very Cheap
20140602T000000,675000.0,3,2.25,2610,9002,2.0,0,0,3,9,2610,0,1988,0,98052,47.6909,-122.104,2320,8306,6392,5986,74.98333703621418,0.07868852459016394,Very Cheap
20140926T000000,235000.0,3,1.0,960,5030,1.0,0,0,3,7,960,0,1955,0,98118,47.5611,-122.28,1460,5400,4070,3940,46.71968190854871,0.02098360655737705,Very Cheap
20150318T000000,545000.0,3,1.0,960,5030,1.0,0,0,3,7,960,0,1955,0,98118,47.5611,-122.28,1460,5400,4070,3940,108.34990059642148,0.06163934426229508,Very Cheap
20140507T000000,350000.0,3,1.0,1010,9360,1.0,0,0,3,6,1010,0,1981,0,98033,47.6874,-122.168,1470,9360,8350,7890,37.39316239316239,0.036065573770491806,Very Cheap
20141125T000000,320000.0,2,2.25,1550,1827,2.0,0,0,3,8,1550,0,2008,0,98106,47.5394,-122.368,1420,1826,277,406,175.1505199781062,0.032131147540983604,Very Cheap
20150318T000000,452000.0,5,2.5,5067,13315,1.0,0,2,3,9,3154,1913,1968,0,98003,47.3391,-122.325,2860,13957,8248,11097,33.9466766804356,0.04944262295081967,Very Cheap
20140725T000000,875000.0,3,2.0,2350,6000,1.5,0,0,4,8,1990,360,1922,0,98102,47.6476,-122.32,2010,5040,3650,3030,145.83333333333334,0.10491803278688525,Cheap
20141108T000000,325000.0,3,1.5,1310,2998,2.0,0,0,3,7,1310,0,1998,0,98144,47.5873,-122.299,1310,2997,1688,1687,108.40560373582389,0.03278688524590164,Very Cheap
20140619T000000,756000.0,4,2.25,2160,5600,1.0,0,0,5,7,1080,1080,1947,0,98119,47.6442,-122.372,1850,5150,3440,3300,135.0,0.08931147540983607,Very Cheap
20140624T000000,319000.0,4,2.5,2510,7992,1.0,0,0,3,8,1610,900,1978,0,98032,47.3715,-122.285,2030,7992,5482,5962,39.91491491491492,0.032,Very Cheap
20150121T000000,455000.0,3,1.75,890,3800,1.5,0,0,3,7,750,140,1926,0,98115,47.6803,-122.291,1280,3800,2910,2520,119.73684210526316,0.049836065573770495,Very Cheap
20150409T000000,330000.0,2,1.0,1129,3840,1.0,0,0,3,7,1129,0,1953,0,98106,47.5313,-122.351,1300,3880,2711,2580,85.9375,0.03344262295081967,Very Cheap
20150108T000000,510000.0,4,3.25,1980,9988,1.0,0,0,3,8,1340,640,1980,0,98052,47.6883,-122.111,1980,8972,8008,6992,51.06127352823388,0.057049180327868855,Very Cheap
20150416T000000,532000.0,3,1.0,2360,5012,1.0,0,0,3,7,1560,800,1964,0,98116,47.5705,-122.384,1690,4800,2652,3110,106.14525139664805,0.059934426229508196,Very Cheap
20150120T000000,775000.0,3,2.5,2480,5007,2.0,0,0,3,8,1960,520,2014,0,98117,47.6974,-122.369,1650,7806,2527,6156,154.7833033752746,0.09180327868852459,Very Cheap
20150417T000000,410000.0,3,1.75,2160,4000,1.0,0,0,3,7,1080,1080,1953,0,98144,47.5721,-122.309,1260,3200,1840,1940,102.5,0.043934426229508196,Very Cheap
20150318T000000,205000.0,2,1.75,1740,5100,1.0,0,0,3,6,580,1160,1915,0,98108,47.5211,-122.33,1440,5100,3360,3660,40.19607843137255,0.017049180327868854,Very Cheap
20141212T000000,585000.0,4,2.5,2430,6766,2.0,0,0,3,8,2430,0,1999,0,98177,47.7294,-122.358,1820,6772,4336,4952,86.46172036653857,0.06688524590163934,Very Cheap
20150310T000000,255000.0,2,1.75,1950,8200,1.0,0,0,3,8,1950,0,1975,0,98023,47.3161,-122.382,2370,8000,6250,5630,31.097560975609756,0.02360655737704918,Very Cheap
20140911T000000,415000.0,2,1.0,910,3750,1.0,0,0,3,7,910,0,1904,0,98117,47.6772,-122.369,1160,4000,2840,2840,110.66666666666667,0.04459016393442623,Very Cheap
20150402T000000,459000.0,4,2.0,2360,7080,1.0,0,0,5,6,1180,1180,1925,0,98126,47.5261,-122.376,1340,7200,4720,5860,64.83050847457628,0.050360655737704915,Very Cheap
20141211T000000,354000.0,3,1.0,1130,11250,1.0,0,0,3,7,1130,0,1965,0,98034,47.7254,-122.227,1410,11250,10120,9840,31.466666666666665,0.03659016393442623,Very Cheap
20140715T000000,587000.0,3,2.5,2150,5193,2.0,0,0,3,8,2150,0,1995,0,98033,47.6952,-122.187,2150,7172,3043,5022,113.0367802811477,0.06714754098360656,Very Cheap
20140708T000000,782000.0,4,3.5,5270,53428,2.0,0,0,3,10,3440,1830,2004,0,98058,47.4358,-122.085,2340,30904,48158,28564,14.636520176686382,0.09272131147540984,Very Cheap
20150504T000000,570000.0,3,1.5,1300,7287,1.0,0,0,4,7,1300,0,1965,0,98033,47.6889,-122.187,1300,9129,5987,7829,78.22149032523673,0.06491803278688525,Very Cheap
20150205T000000,414500.0,3,1.0,1050,6002,1.0,0,0,3,7,840,210,1941,0,98115,47.6988,-122.316,1180,6003,4952,4823,69.06031322892369,0.044524590163934424,Very Cheap
20140806T000000,185000.0,4,1.0,1380,6700,1.0,0,0,3,7,1190,190,1928,0,98168,47.4871,-122.281,1380,8292,5320,6912,27.611940298507463,0.014426229508196721,Very Cheap
20141001T000000,262500.0,3,1.5,1610,10291,1.0,0,0,4,7,1610,0,1961,0,98022,47.2025,-121.999,1410,7729,8681,6319,25.50772519677388,0.02459016393442623,Very Cheap
20140522T000000,370000.0,4,2.75,3150,67518,1.0,0,0,4,9,2250,900,1965,0,98092,47.3382,-122.196,2210,32391,64368,30181,5.480020142776741,0.038688524590163934,Very Cheap
20150105T000000,362500.0,3,1.0,1520,9507,1.0,0,0,3,7,1520,0,1954,0,98125,47.7162,-122.324,1360,7219,7987,5859,38.129799095403385,0.03770491803278689,Very Cheap
20150304T000000,536000.0,3,2.5,1990,7397,2.0,0,0,3,9,1990,0,1993,0,98072,47.7703,-122.165,2210,7397,5407,5187,72.4618088414222,0.06045901639344262,Very Cheap
20150421T000000,425000.0,5,2.0,2500,7804,1.5,0,0,3,7,1570,930,1921,0,98146,47.5031,-122.348,1170,7676,5304,6506,54.4592516658124,0.04590163934426229,Very Cheap
20140609T000000,435000.0,3,2.25,1890,7200,1.0,0,0,4,7,1230,660,1973,0,98125,47.7156,-122.317,1970,8101,5310,6131,60.416666666666664,0.04721311475409836,Very Cheap
20140505T000000,435000.0,5,2.0,1840,9240,1.0,0,0,4,7,1540,300,1942,1958,98133,47.7308,-122.34,1200,5250,7400,4050,47.077922077922075,0.04721311475409836,Very Cheap
20150312T000000,400000.0,2,1.0,1220,6300,1.0,0,0,3,7,760,460,1942,0,98136,47.5299,-122.387,1850,4886,5080,3036,63.492063492063494,0.04262295081967213,Very Cheap
20140626T000000,446000.0,2,1.5,1370,1221,2.0,0,0,3,8,1080,290,2008,0,98122,47.6039,-122.307,1560,2081,-149,521,365.27436527436527,0.04865573770491803,Very Cheap
20150126T000000,1250000.0,3,2.5,2710,13120,1.0,0,0,3,10,2710,0,1959,0,98105,47.6718,-122.256,3130,13566,10410,10436,95.27439024390245,0.1540983606557377,Cheap
20141120T000000,300000.0,3,2.25,1760,5421,2.0,0,0,3,7,1760,0,1991,0,98038,47.3484,-122.037,1570,6000,3661,4430,55.340343110127286,0.029508196721311476,Very Cheap
20140806T000000,404500.0,2,1.0,800,5080,1.0,0,0,3,7,800,0,1938,0,98115,47.6978,-122.314,1560,5110,4280,3550,79.6259842519685,0.043213114754098364,Very Cheap
20150305T000000,910000.0,4,2.5,3530,49222,2.0,0,0,4,9,3530,0,1986,0,98072,47.7285,-122.112,3750,49222,45692,45472,18.487668115883142,0.10950819672131147,Cheap
20140513T000000,771000.0,3,2.25,1780,6120,1.5,0,0,4,9,1390,390,1927,0,98122,47.6025,-122.286,1960,5568,4340,3608,125.98039215686275,0.09127868852459016,Very Cheap
20140605T000000,335000.0,4,2.5,2610,4781,2.0,0,0,3,8,2610,0,2009,0,98001,47.2649,-122.292,2583,4796,2171,2213,70.06902321690023,0.03409836065573771,Very Cheap
20140804T000000,390000.0,3,1.75,1850,15170,1.0,0,0,3,7,1850,0,1965,0,98045,47.4991,-121.774,1160,14175,13320,13015,25.708635464733025,0.04131147540983607,Very Cheap
20150428T000000,288000.0,3,2.25,1560,9706,1.0,0,0,4,7,1560,0,1963,0,98002,47.3191,-122.213,1510,9706,8146,8196,29.67236760766536,0.027934426229508195,Very Cheap
20141014T000000,403000.0,3,1.75,1270,10790,1.0,0,0,3,7,1270,0,1956,0,98033,47.6647,-122.177,1270,10790,9520,9520,37.34939759036145,0.04301639344262295,Very Cheap
20140624T000000,510000.0,3,2.25,1420,1309,3.0,0,0,3,8,1420,0,2006,0,98103,47.6534,-122.346,1500,1282,-111,-218,389.61038961038963,0.057049180327868855,Very Cheap
20150219T000000,751000.0,6,3.0,2880,6800,2.0,0,0,3,7,2880,0,1980,0,98144,47.5873,-122.299,1640,4000,3920,2360,110.44117647058823,0.08865573770491804,Very Cheap
20150203T000000,408000.0,3,1.0,1420,8000,1.0,0,4,3,7,1420,0,1950,0,98118,47.5169,-122.255,1780,8295,6580,6515,51.0,0.04367213114754098,Very Cheap
20140701T000000,1014250.0,3,1.0,1640,12855,1.5,0,0,5,6,1500,140,1920,0,98004,47.6169,-122.212,2190,11262,11215,9072,78.89926098794244,0.12318032786885245,Cheap
20150424T000000,575000.0,3,2.0,1730,9030,1.0,0,0,4,7,1730,0,1956,0,98007,47.5875,-122.134,1470,9030,7300,7560,63.67663344407531,0.06557377049180328,Very Cheap
20150417T000000,330000.0,3,1.75,1250,8100,1.0,0,0,3,7,1250,0,1951,2004,98146,47.5016,-122.348,1300,8175,6850,6875,40.74074074074074,0.03344262295081967,Very Cheap
20140516T000000,565000.0,3,2.25,1520,1221,3.0,0,0,3,8,1520,0,2013,0,98107,47.674,-122.377,1550,4750,-299,3200,462.73546273546276,0.06426229508196721,Very Cheap
20150413T000000,456000.0,3,2.5,1820,2935,2.0,0,0,3,8,1820,0,1999,0,98074,47.6018,-122.021,1820,2936,1115,1116,155.36626916524702,0.0499672131147541,Very Cheap
20140615T000000,652500.0,4,2.5,2700,9122,2.0,0,0,3,9,2700,0,1990,0,98029,47.5771,-121.994,2500,9122,6422,6622,71.53036614777461,0.07573770491803279,Very Cheap
20141231T000000,582000.0,3,1.75,1820,3140,2.0,0,0,5,8,1820,0,1949,1990,98136,47.5271,-122.384,2030,5499,1320,3469,185.35031847133757,0.06649180327868852,Very Cheap
20140625T000000,700000.0,4,2.5,2770,5686,2.0,0,0,3,9,2770,0,2004,0,98075,47.5997,-121.973,2910,5000,2916,2090,123.10939148786493,0.08196721311475409,Very Cheap
20141015T000000,235000.0,2,1.0,1270,9182,1.5,0,0,3,6,1270,0,1917,0,98126,47.5365,-122.378,1760,9100,7912,7340,25.593552602918756,0.02098360655737705,Very Cheap
20140731T000000,460000.0,3,1.75,1400,12155,1.0,0,0,4,7,1400,0,1977,0,98075,47.5926,-122.047,2540,23522,10755,20982,37.84450843274373,0.050491803278688525,Very Cheap
20140522T000000,475000.0,3,2.25,1820,8008,1.0,0,0,3,8,1240,580,1981,0,98052,47.7206,-122.11,2030,8750,6188,6720,59.315684315684315,0.05245901639344262,Very Cheap
20140609T000000,579000.0,2,2.0,1870,6275,1.0,0,0,3,8,1870,0,2003,0,98053,47.7108,-122.031,1670,5200,4405,3530,92.27091633466135,0.06609836065573771,Very Cheap
20141110T000000,507000.0,4,2.0,1360,2746,1.5,0,0,3,7,1360,0,1945,2011,98107,47.6736,-122.39,1960,2746,1386,786,184.63219227967954,0.05665573770491803,Very Cheap
20140512T000000,210000.0,3,2.5,1040,2643,2.0,0,0,3,7,720,320,2004,0,98118,47.5165,-122.268,1540,5110,1603,3570,79.45516458569807,0.017704918032786884,Very Cheap
20140630T000000,359500.0,4,2.75,2140,10316,2.0,0,0,3,8,2140,0,1993,0,98001,47.3537,-122.274,1920,11337,8176,9417,34.848778596355174,0.037311475409836065,Very Cheap
20141107T000000,248000.0,3,1.75,1330,9831,1.0,0,0,3,7,1330,0,1987,0,98001,47.3304,-122.277,1330,7500,8501,6170,25.22632489065202,0.022688524590163933,Very Cheap
20141022T000000,239300.0,3,1.0,1070,5750,1.0,0,0,3,7,1070,0,1952,0,98178,47.5071,-122.255,1420,6500,4680,5080,41.61739130434783,0.021547540983606558,Very Cheap
20141216T000000,315000.0,3,2.25,1370,1533,3.0,0,0,3,8,1370,0,2009,0,98133,47.7326,-122.343,1370,1125,163,-245,205.4794520547945,0.031475409836065574,Very Cheap
20150226T000000,970000.0,4,3.0,3510,12410,2.0,0,0,4,9,3510,0,1976,0,98005,47.6381,-122.166,3000,13209,8900,10209,78.1627719580983,0.11737704918032787,Cheap
20150317T000000,510000.0,3,1.5,1730,6240,1.0,0,1,3,8,1000,730,1954,0,98136,47.5282,-122.391,1620,6240,4510,4620,81.73076923076923,0.057049180327868855,Very Cheap
20140621T000000,418000.0,4,1.5,1550,9176,1.0,0,0,3,7,1000,550,1956,0,98008,47.6005,-122.129,1730,8539,7626,6809,45.553618134263296,0.04498360655737705,Very Cheap
20140612T000000,699000.0,4,2.5,3280,27441,2.0,0,0,3,9,3280,0,1996,0,98053,47.6711,-122.012,3200,26960,24161,23760,25.47283262271783,0.08183606557377049,Very Cheap
20150321T000000,871000.0,4,2.5,2150,8536,1.0,0,3,4,8,1400,750,1967,0,98006,47.5663,-122.163,2800,9500,6386,6700,102.03842549203374,0.10439344262295082,Cheap
20140507T000000,515000.0,3,1.75,1580,9147,1.0,0,1,4,7,1210,370,1967,0,98008,47.6069,-122.112,2600,23564,7567,20964,56.30261287853941,0.057704918032786885,Very Cheap
20140811T000000,400000.0,3,1.0,1460,43000,1.0,0,0,3,7,1460,0,1952,0,98166,47.4434,-122.347,2250,20023,41540,17773,9.30232558139535,0.04262295081967213,Very Cheap
20141209T000000,445000.0,3,1.75,1410,5100,1.0,0,0,4,7,1110,300,1954,0,98125,47.7026,-122.29,1600,7800,3690,6200,87.25490196078431,0.04852459016393443,Very Cheap
20150225T000000,1110000.0,4,2.75,3090,6600,1.0,0,2,3,9,1800,1290,1956,0,98199,47.6339,-122.396,2380,5000,3510,2620,168.1818181818182,0.13573770491803278,Cheap
20141027T000000,212000.0,3,1.5,1690,9600,1.0,0,0,3,7,1210,480,1976,0,98038,47.3857,-122.079,1450,9647,7910,8197,22.083333333333332,0.017967213114754098,Very Cheap
20150112T000000,710000.0,4,2.5,2870,11304,2.0,0,0,3,9,2870,0,1980,0,98006,47.5547,-122.154,2690,9940,8434,7250,62.80962491153574,0.08327868852459017,Very Cheap
20150331T000000,225800.0,4,1.0,1100,7110,1.0,0,0,4,7,880,220,1907,0,98030,47.3858,-122.227,1150,7110,6010,5960,31.758087201125175,0.01977704918032787,Very Cheap
20141222T000000,520000.0,3,1.75,2310,36665,1.0,0,2,3,8,1580,730,1983,0,98155,47.7697,-122.274,2000,14000,34355,12000,14.182462839219964,0.058360655737704915,Very Cheap
20150508T000000,1295000.0,5,3.75,3490,15246,1.0,0,1,4,10,1940,1550,1968,0,98040,47.5479,-122.212,3410,15682,11756,12272,84.94031221303949,0.16,Cheap
20140619T000000,248000.0,4,2.0,2080,13510,1.0,0,0,3,7,1040,1040,1950,0,98178,47.4918,-122.258,2010,11625,11430,9615,18.35677276091784,0.022688524590163933,Very Cheap
20141016T000000,556000.0,4,2.5,2230,7200,1.0,0,0,4,7,1220,1010,1957,0,98005,47.589,-122.156,1920,7200,4970,5280,77.22222222222223,0.06308196721311475,Very Cheap
20150512T000000,319950.0,5,1.75,1710,11900,1.0,0,0,3,7,1070,640,1958,0,98146,47.506,-122.365,1030,10360,10190,9330,26.886554621848738,0.03212459016393442,Very Cheap
20150331T000000,320000.0,4,2.75,1640,3000,1.0,0,0,3,7,1000,640,1984,0,98118,47.5625,-122.283,1150,4545,1360,3395,106.66666666666667,0.032131147540983604,Very Cheap
20140708T000000,245000.0,3,2.5,1600,2788,2.0,0,0,4,7,1600,0,1992,0,98031,47.4034,-122.187,1720,3605,1188,1885,87.87661406025825,0.022295081967213116,Very Cheap
20150203T000000,700000.0,3,2.5,2850,36585,2.0,0,0,3,10,2850,0,1987,0,98072,47.7376,-122.102,3340,35671,33735,32331,19.13352466858002,0.08196721311475409,Very Cheap
20150312T000000,628000.0,5,2.75,2600,8160,2.0,0,0,3,8,2600,0,2015,0,98133,47.7348,-122.34,1600,8160,5560,6560,76.96078431372548,0.07252459016393442,Very Cheap
20140617T000000,640000.0,3,2.0,1380,4800,1.0,0,0,3,7,1380,0,1948,0,98199,47.651,-122.369,1740,5640,3420,3900,133.33333333333334,0.0740983606557377,Very Cheap
20150428T000000,420000.0,4,1.75,1320,4978,1.0,0,0,4,7,940,380,1942,0,98126,47.5266,-122.379,1260,4693,3658,3433,84.37123342707915,0.04524590163934426,Very Cheap
20141008T000000,349950.0,3,2.5,1420,1162,3.0,0,0,3,8,1420,0,2002,0,98103,47.6982,-122.349,1430,1560,-258,130,301.16179001721173,0.036059016393442625,Very Cheap
20140714T000000,307999.0,4,2.75,2420,8438,2.0,0,0,3,8,2420,0,1996,0,98022,47.2091,-122.009,2420,8580,6018,6160,36.50142213794738,0.030557245901639343,Very Cheap
20140507T000000,749950.0,4,2.75,2600,6050,2.0,0,0,5,8,1960,640,1949,0,98116,47.5656,-122.4,1990,6050,3450,4060,123.95867768595042,0.08851803278688525,Very Cheap
20140711T000000,290000.0,2,1.0,840,3844,1.0,0,0,4,6,840,0,1919,0,98133,47.7048,-122.347,1040,3844,3004,2804,75.44224765868887,0.02819672131147541,Very Cheap
20140712T000000,235000.0,3,1.75,1420,7920,1.0,0,0,4,7,1420,0,1962,0,98092,47.2931,-122.188,1420,7920,6500,6500,29.671717171717173,0.02098360655737705,Very Cheap
20140903T000000,225000.0,3,1.0,1790,6120,1.0,0,0,3,6,1790,0,1937,1964,98146,47.508,-122.337,830,6120,4330,5290,36.76470588235294,0.019672131147540985,Very Cheap
20150424T000000,302100.0,3,1.0,1790,6120,1.0,0,0,3,6,1790,0,1937,1964,98146,47.508,-122.337,830,6120,4330,5290,49.36274509803921,0.029783606557377048,Very Cheap
20150212T000000,520000.0,2,1.0,1340,6380,1.0,0,0,3,7,890,450,1939,0,98115,47.697,-122.313,1380,6380,5040,5000,81.50470219435736,0.058360655737704915,Very Cheap
20140626T000000,285000.0,2,1.0,1010,7200,1.0,0,0,3,7,1010,0,1975,0,98155,47.7651,-122.291,1890,9248,6190,7358,39.583333333333336,0.02754098360655738,Very Cheap
20140821T000000,525000.0,3,2.0,1640,15258,1.0,0,0,3,8,1640,0,1981,0,98074,47.6301,-122.037,1640,16345,13618,14705,34.40817931576878,0.05901639344262295,Very Cheap
20150319T000000,374900.0,5,2.75,2980,8500,1.0,0,0,3,8,1540,1440,1982,0,98032,47.3641,-122.278,2310,8500,5520,6190,44.10588235294118,0.03933114754098361,Very Cheap
20141006T000000,377500.0,3,2.0,1370,7200,1.0,0,0,3,7,1130,240,1926,1955,98125,47.7329,-122.308,1300,7208,5830,5908,52.43055555555556,0.039672131147540986,Very Cheap
20150427T000000,587450.0,3,2.25,2190,8775,1.5,0,1,4,8,2190,0,1927,0,98125,47.7303,-122.287,1910,8145,6585,6235,66.94586894586895,0.06720655737704918,Very Cheap
20150121T000000,245000.0,3,2.25,1530,12000,1.0,0,0,3,7,1070,460,1979,0,98023,47.2715,-122.338,2140,13636,10470,11496,20.416666666666668,0.022295081967213116,Very Cheap
20140729T000000,200000.0,3,2.0,1290,5757,1.0,0,0,3,7,1290,0,1994,0,98092,47.3175,-122.17,1580,6798,4467,5218,34.74031613687684,0.01639344262295082,Very Cheap
20141125T000000,2140000.0,4,3.75,5150,453895,2.0,0,3,3,11,4360,790,1997,0,98053,47.6795,-121.991,2500,215186,448745,212686,4.714746802674627,0.27081967213114755,Cheap
20141109T000000,607000.0,3,2.5,2470,9226,2.0,0,0,3,9,2470,0,1991,0,98072,47.7439,-122.17,2820,11013,6756,8193,65.79232603511815,0.06977049180327868,Very Cheap
20150414T000000,1247000.0,1,1.25,1810,5070,1.5,1,4,4,8,1230,580,1967,0,98075,47.5814,-122.081,2280,5070,3260,2790,245.95660749506902,0.15370491803278688,Cheap
20150310T000000,549950.0,4,2.5,2230,14694,1.0,0,0,4,7,1180,1050,1981,0,98074,47.6305,-122.034,1470,13458,12464,11988,37.42684088743705,0.062288524590163936,Very Cheap
20141118T000000,250000.0,3,3.0,2300,7701,1.0,0,0,3,7,2300,0,1960,0,98056,47.5102,-122.18,1570,8116,5401,6546,32.463316452408776,0.022950819672131147,Very Cheap
20140509T000000,525000.0,3,2.5,2030,6970,2.0,0,0,4,8,2030,0,1991,0,98029,47.5718,-121.999,2000,6140,4940,4140,75.32281205164993,0.05901639344262295,Very Cheap
20140624T000000,440000.0,3,1.75,2000,9900,1.0,0,2,4,8,1480,520,1957,0,98166,47.4436,-122.339,2310,10200,7900,7890,44.44444444444444,0.04786885245901639,Very Cheap
20150313T000000,425000.0,3,2.75,3610,107386,1.5,1,3,3,8,3130,480,1918,1962,98023,47.3351,-122.362,2630,42126,103776,39496,3.9576853593578307,0.04590163934426229,Very Cheap
20140701T000000,739900.0,5,2.5,3290,5029,2.0,0,0,3,8,3290,0,2004,0,98075,47.5773,-122.056,2990,6441,1739,3451,147.12666534102206,0.0872,Very Cheap
20140528T000000,315000.0,3,2.0,1300,3731,1.0,0,0,3,7,900,400,1993,0,98118,47.5374,-122.27,1300,3731,2431,2431,84.42776735459663,0.031475409836065574,Very Cheap
20150303T000000,340000.0,5,1.0,1880,3774,1.5,0,0,3,6,1360,520,1917,0,98126,47.566,-122.37,1420,2550,1894,1130,90.09009009009009,0.03475409836065574,Very Cheap
20150501T000000,366000.0,4,2.75,2170,9743,2.0,0,0,3,7,2170,0,1995,0,98038,47.3814,-122.024,1670,7734,7573,6064,37.565431591912144,0.03816393442622951,Very Cheap
20141021T000000,315000.0,3,1.75,1680,7250,1.0,0,0,3,7,930,750,1952,0,98133,47.7201,-122.35,1340,7250,5570,5910,43.44827586206897,0.031475409836065574,Very Cheap
20141027T000000,299000.0,3,1.5,1190,9135,1.0,0,0,4,7,1190,0,1959,0,98056,47.5164,-122.189,1520,9146,7945,7626,32.731253420908594,0.02937704918032787,Very Cheap
20141113T000000,350000.0,2,1.0,940,5000,1.0,0,0,3,7,940,0,1950,0,98155,47.7518,-122.279,1800,7400,4060,5600,70.0,0.036065573770491806,Very Cheap
20141105T000000,340000.0,2,1.75,1010,1461,1.0,0,0,3,7,670,340,2003,0,98199,47.6515,-122.4,1500,2499,451,999,232.7173169062286,0.03475409836065574,Very Cheap
20141230T000000,460000.0,3,1.75,1290,8580,1.0,0,0,4,7,1290,0,1962,0,98033,47.6707,-122.174,1840,8580,7290,6740,53.613053613053616,0.050491803278688525,Very Cheap
20140731T000000,224000.0,3,1.5,1480,10588,1.0,0,0,3,7,1480,0,1957,0,98002,47.2872,-122.212,1370,10588,9108,9218,21.156025689459767,0.01954098360655738,Very Cheap
20140811T000000,140000.0,2,1.0,900,6400,1.0,0,0,2,6,900,0,1940,0,98118,47.5287,-122.281,1350,6405,5500,5055,21.875,0.008524590163934427,Very Cheap
20141013T000000,246000.0,4,2.0,1400,7632,1.5,0,0,5,6,1400,0,1930,0,98166,47.4625,-122.345,1400,7632,6232,6232,32.23270440251572,0.02242622950819672,Very Cheap
20150127T000000,330000.0,3,2.5,2040,14071,2.0,0,0,3,7,2040,0,1995,0,98019,47.7278,-121.963,1890,14040,12031,12150,23.452490938810318,0.03344262295081967,Very Cheap
20140709T000000,306000.0,3,1.0,1450,7200,1.0,0,0,3,7,1010,440,1969,0,98034,47.7311,-122.199,1500,6767,5750,5267,42.5,0.030295081967213113,Very Cheap
20140604T000000,324950.0,3,1.0,1210,7440,1.0,0,0,3,7,1210,0,1949,0,98155,47.7402,-122.323,1120,7440,6230,6320,43.67607526881721,0.03278032786885246,Very Cheap
20140613T000000,345000.0,2,1.5,1800,26615,1.0,0,0,5,7,1240,560,1987,0,98092,47.302,-122.123,2010,26337,24815,24327,12.962615066691715,0.03540983606557377,Very Cheap
20140508T000000,207000.0,3,1.0,1490,8995,1.0,0,0,4,7,1490,0,1954,0,98168,47.4901,-122.303,1490,9000,7505,7510,23.01278488048916,0.017311475409836064,Very Cheap
20140827T000000,238000.0,3,1.0,1240,5700,1.5,0,0,5,6,1240,0,1953,0,98056,47.4927,-122.169,1140,5700,4460,4560,41.75438596491228,0.02137704918032787,Very Cheap
20150401T000000,695000.0,3,2.0,2632,18743,2.0,0,3,3,10,2632,0,2000,0,98070,47.3743,-122.421,1970,14171,16111,12201,37.08051005708798,0.08131147540983606,Very Cheap
20140911T000000,649950.0,3,2.5,2150,15304,2.0,0,0,4,9,2150,0,1979,0,98006,47.5573,-122.136,2540,10507,13154,7967,42.4692890747517,0.07540327868852459,Very Cheap
20150414T000000,515000.0,3,2.75,1710,9448,1.0,0,0,3,7,1010,700,1947,0,98105,47.6693,-122.267,1960,8951,7738,6991,54.50889077053345,0.057704918032786885,Very Cheap
20141001T000000,452000.0,3,2.5,1530,5032,2.0,0,0,3,7,1530,0,1998,0,98103,47.6985,-122.349,1450,2136,3502,686,89.82511923688395,0.04944262295081967,Very Cheap
20141030T000000,236000.0,4,2.5,1630,3060,2.0,0,0,3,7,1630,0,2003,0,98146,47.5072,-122.336,1270,4590,1430,3320,77.12418300653594,0.021114754098360656,Very Cheap
20140730T000000,1285000.0,4,3.5,4080,14450,2.0,0,2,3,12,3210,870,1998,0,98006,47.5519,-122.106,4080,12114,10370,8034,88.92733564013841,0.15868852459016394,Cheap
20140610T000000,563000.0,3,2.75,2340,16500,1.0,0,0,4,8,1500,840,1972,0,98075,47.5952,-122.051,2210,15251,14160,13041,34.121212121212125,0.064,Very Cheap
20150402T000000,410988.0,3,1.75,1000,14061,1.0,0,0,4,7,1000,0,1967,0,98072,47.7417,-122.093,1260,12635,13061,11375,29.228931085982506,0.044064,Very Cheap
20141117T000000,339950.0,0,2.5,2290,8319,2.0,0,0,3,8,2290,0,1985,0,98042,47.3473,-122.151,2500,8751,6029,6251,40.8642865729054,0.03474754098360656,Very Cheap
20141021T000000,1200000.0,4,2.5,3180,13118,2.0,0,0,4,11,3180,0,1986,0,98040,47.5382,-122.23,3070,12861,9938,9791,91.47735935355999,0.14754098360655737,Cheap
20150319T000000,340000.0,4,2.5,2170,19785,2.0,0,0,3,8,2170,0,1992,0,98031,47.4034,-122.167,2280,8616,17615,6336,17.18473591104372,0.03475409836065574,Very Cheap
20141107T000000,808100.0,4,3.25,3020,13457,1.0,0,0,5,9,3020,0,1956,0,98133,47.7174,-122.336,2120,7553,10437,5433,60.05053132198856,0.09614426229508197,Very Cheap
20140609T000000,236000.0,3,1.75,1330,6301,1.0,0,0,3,7,1330,0,1998,0,98002,47.3411,-122.219,1330,6144,4971,4814,37.454372321853675,0.021114754098360656,Very Cheap
20150513T000000,330000.0,4,1.75,1720,8300,1.0,0,0,4,8,1720,0,1965,0,98055,47.4654,-122.194,1840,8300,6580,6460,39.75903614457831,0.03344262295081967,Very Cheap
20150127T000000,799990.0,4,3.5,2540,5808,2.0,0,0,5,8,1820,720,1910,1986,98117,47.6857,-122.376,1520,5461,3268,3941,137.73932506887053,0.09508065573770492,Very Cheap
20140925T000000,240000.0,0,2.5,1810,5669,2.0,0,0,3,7,1810,0,2003,0,98038,47.3493,-122.053,1810,5685,3859,3875,42.335508908096664,0.021639344262295083,Very Cheap
20150417T000000,343000.0,3,1.0,1410,18600,1.0,0,0,5,7,1410,0,1960,0,98059,47.5031,-122.152,1610,24941,17190,23331,18.440860215053764,0.035147540983606555,Very Cheap
20140617T000000,332000.0,3,2.5,1530,9406,1.0,0,0,3,7,1270,260,1993,0,98059,47.4852,-122.162,1700,7682,7876,5982,35.29661917924729,0.033704918032786885,Very Cheap
20150401T000000,945000.0,5,3.5,4380,14925,2.0,0,0,3,11,4380,0,2003,0,98075,47.5848,-121.969,4310,14633,10545,10323,63.31658291457286,0.11409836065573771,Cheap
20140617T000000,239950.0,3,1.0,1140,8366,1.0,0,0,5,6,1140,0,1943,0,98058,47.4768,-122.177,960,7200,7226,6240,28.681568252450393,0.021632786885245902,Very Cheap
20150303T000000,674000.0,5,1.75,2110,5000,1.5,0,0,4,7,1250,860,1946,0,98115,47.6745,-122.287,1720,5000,2890,3280,134.8,0.07855737704918032,Very Cheap
20140520T000000,200000.0,3,1.0,1050,5000,1.0,0,0,4,6,1050,0,1967,0,98056,47.4923,-122.165,1050,5200,3950,4150,40.0,0.01639344262295082,Very Cheap
20150305T000000,453000.0,3,1.75,1600,7232,1.0,0,0,3,8,1600,0,1966,0,98008,47.6293,-122.121,1970,8120,5632,6150,62.63827433628319,0.04957377049180328,Very Cheap
20140614T000000,330000.0,3,1.75,1430,8865,1.0,0,0,3,7,1430,0,1950,0,98125,47.7331,-122.299,1250,8154,7435,6904,37.22504230118443,0.03344262295081967,Very Cheap
20150416T000000,285000.0,4,2.5,1996,4547,2.0,0,0,3,7,1996,0,2009,0,98042,47.3365,-122.051,2180,5127,2551,2947,62.67868924565648,0.02754098360655738,Very Cheap
20141106T000000,338000.0,4,1.75,1530,8152,1.0,0,0,5,6,910,620,1948,0,98155,47.7557,-122.328,1310,8152,6622,6842,41.46221786064769,0.034491803278688525,Very Cheap
20150424T000000,264950.0,2,1.0,1000,6000,1.0,0,0,3,6,1000,0,1951,0,98126,47.5208,-122.372,1250,6000,5000,4750,44.15833333333333,0.024911475409836067,Very Cheap
20150311T000000,880000.0,4,2.0,2530,10800,1.0,0,0,5,8,1350,1180,1954,0,98040,47.5705,-122.225,2960,12150,8270,9190,81.48148148148148,0.10557377049180328,Cheap
20150406T000000,209500.0,3,1.5,970,5488,1.0,0,0,3,7,970,0,1976,0,98106,47.5366,-122.359,1040,5488,4518,4448,38.174198250728864,0.017639344262295083,Very Cheap
20150425T000000,380000.0,4,2.5,2400,9398,1.0,0,0,4,7,1310,1090,1958,0,98056,47.4952,-122.178,1330,8249,6998,6919,40.4341349223239,0.04,Very Cheap
20141217T000000,336500.0,3,2.0,1830,12891,1.0,0,0,3,7,1830,0,1994,0,98031,47.3924,-122.192,2320,8709,11061,6389,26.103483050190054,0.03429508196721311,Very Cheap
20140714T000000,360000.0,3,2.25,2130,8466,1.0,0,0,3,7,1290,840,1983,0,98055,47.4537,-122.211,2250,9682,6336,7432,42.523033309709426,0.037377049180327866,Very Cheap
20140821T000000,911100.0,4,3.25,3330,33826,2.0,0,0,5,8,3330,0,1924,0,98155,47.7596,-122.275,2580,28707,30496,26127,26.93490214627801,0.10965245901639344,Cheap
20141124T000000,249900.0,2,1.0,560,7560,1.0,0,0,3,6,560,0,1944,0,98126,47.5271,-122.375,990,7560,7000,6570,33.05555555555556,0.02293770491803279,Very Cheap
20140923T000000,175000.0,4,1.0,1210,6250,1.0,0,0,3,7,1210,0,1962,0,98168,47.5008,-122.333,1210,8291,5040,7081,28.0,0.013114754098360656,Very Cheap
20141113T000000,549950.0,3,2.5,2380,2500,3.0,0,3,3,9,2380,0,1988,0,98126,47.5734,-122.375,2270,5000,120,2730,219.98,0.062288524590163936,Very Cheap
20141021T000000,225000.0,3,1.75,1370,10866,1.0,0,0,4,6,1370,0,1945,0,98052,47.6774,-122.164,1580,14250,9496,12670,20.706791827719492,0.019672131147540985,Very Cheap
20141222T000000,270000.0,3,1.75,1370,10866,1.0,0,0,4,6,1370,0,1945,0,98052,47.6774,-122.164,1580,14250,9496,12670,24.84815019326339,0.025573770491803278,Very Cheap
20140819T000000,400000.0,3,2.25,1740,11040,2.0,0,0,3,8,1740,0,1980,0,98028,47.7376,-122.242,1720,11778,9300,10058,36.231884057971016,0.04262295081967213,Very Cheap
20140521T000000,299800.0,2,1.0,790,5240,1.0,0,0,4,6,790,0,1925,0,98118,47.5303,-122.288,1430,5320,4450,3890,57.213740458015266,0.029481967213114753,Very Cheap
20140806T000000,555000.0,3,2.5,2480,8676,2.0,0,0,4,8,2480,0,1989,0,98056,47.53,-122.172,2540,9496,6196,6956,63.96957123098202,0.06295081967213115,Very Cheap
20140507T000000,230000.0,3,2.5,1920,9180,2.0,0,0,3,8,1920,0,1988,0,98055,47.4818,-122.231,1930,7252,7260,5322,25.054466230936818,0.020327868852459016,Very Cheap
20141210T000000,360000.0,4,2.5,2750,6259,2.0,0,0,3,9,2750,0,2002,0,98092,47.3304,-122.179,2810,6824,3509,4014,57.51717526761463,0.037377049180327866,Very Cheap
20140903T000000,415000.0,2,1.0,880,3200,1.0,0,0,3,7,880,0,1910,1970,98199,47.6575,-122.402,1880,6000,2320,4120,129.6875,0.04459016393442623,Very Cheap
20140818T000000,355000.0,4,1.75,2160,8000,1.0,0,0,4,9,1660,500,1976,0,98023,47.3165,-122.382,2350,8200,5840,5850,44.375,0.036721311475409836,Very Cheap
20150323T000000,635000.0,4,2.5,2570,27972,2.0,0,0,3,8,2570,0,1997,0,98053,47.6343,-121.969,2500,29761,25402,27261,22.7012727012727,0.07344262295081967,Very Cheap
20141202T000000,353000.0,5,2.75,2130,5000,1.0,0,0,5,7,1100,1030,1978,0,98118,47.5271,-122.274,1340,6837,2870,5497,70.6,0.03645901639344262,Very Cheap
20140528T000000,999000.0,7,4.0,3150,34830,1.0,0,0,3,9,3150,0,1957,2005,98007,47.6029,-122.147,2390,12054,31680,9664,28.68217054263566,0.12118032786885245,Cheap
20150422T000000,265000.0,3,1.5,1780,10196,1.0,0,0,4,7,1270,510,1967,0,98001,47.3375,-122.291,1320,7875,8416,6555,25.990584542958022,0.024918032786885248,Very Cheap
20150326T000000,250000.0,4,1.75,1910,8250,1.0,0,0,4,7,1910,0,1959,0,98008,47.6131,-122.123,1500,8250,6340,6750,30.303030303030305,0.022950819672131147,Very Cheap
20140820T000000,225000.0,2,1.0,1170,7142,1.0,0,0,3,7,1170,0,1951,0,98155,47.7497,-122.313,1170,7615,5972,6445,31.50378045365444,0.019672131147540985,Very Cheap
20140503T000000,553000.0,2,1.0,900,5000,1.0,0,0,3,7,900,0,1944,0,98117,47.6883,-122.395,1280,5000,4100,3720,110.6,0.06268852459016394,Very Cheap
20140604T000000,565000.0,5,2.5,2650,11455,1.0,0,0,3,7,1400,1250,1961,0,98008,47.6141,-122.116,1960,9880,8805,7920,49.32343954604976,0.06426229508196721,Very Cheap
20140818T000000,312000.0,2,1.0,1170,5150,1.0,0,0,3,6,980,190,1907,0,98118,47.5503,-122.283,1660,5150,3980,3490,60.58252427184466,0.031081967213114754,Very Cheap
20140722T000000,475000.0,3,2.5,2630,185130,2.0,0,0,3,9,2630,0,1991,0,98014,47.7035,-121.894,2630,210394,182500,207764,2.5657645978501593,0.05245901639344262,Very Cheap
20141106T000000,320000.0,4,2.75,2150,9163,1.0,0,0,3,8,1340,810,1992,0,98003,47.266,-122.307,2260,7750,7013,5490,34.92306013314417,0.032131147540983604,Very Cheap
20140825T000000,453000.0,3,2.0,1430,9583,1.0,0,0,4,7,1430,0,1964,0,98034,47.7206,-122.197,1890,11100,8153,9210,47.271209433371595,0.04957377049180328,Very Cheap
20150325T000000,320000.0,3,1.0,960,6180,1.0,0,0,4,6,960,0,1910,0,98118,47.5518,-122.279,1250,4120,5220,2870,51.77993527508091,0.032131147540983604,Very Cheap
20150122T000000,610000.0,4,2.75,2640,8400,1.0,0,2,3,8,1440,1200,1947,0,98144,47.5882,-122.29,2610,6000,5760,3390,72.61904761904762,0.07016393442622951,Very Cheap
20140520T000000,385000.0,3,1.5,1490,9630,1.0,0,0,4,8,1490,0,1959,0,98028,47.7623,-122.256,1960,10469,8140,8509,39.979231568016615,0.04065573770491803,Very Cheap
20140528T000000,215000.0,3,1.75,1210,8075,1.0,0,0,4,6,1210,0,1983,0,98001,47.2666,-122.254,1310,8025,6865,6715,26.625386996904023,0.018360655737704918,Very Cheap
20140709T000000,215000.0,4,1.5,1860,5040,1.5,0,0,5,8,1860,0,1920,0,98022,47.2077,-121.993,1680,5800,3180,4120,42.65873015873016,0.018360655737704918,Very Cheap
20141230T000000,415000.0,3,2.5,1980,4274,2.0,0,0,3,7,1980,0,2003,0,98028,47.7767,-122.239,2000,4394,2294,2394,97.0987365465606,0.04459016393442623,Very Cheap
20140814T000000,350000.0,1,1.0,900,6380,1.0,0,0,3,6,900,0,1947,0,98125,47.7019,-122.311,1830,6380,5480,4550,54.858934169278996,0.036065573770491806,Very Cheap
20150428T000000,395000.0,1,1.0,900,6380,1.0,0,0,3,6,900,0,1947,0,98125,47.7019,-122.311,1830,6380,5480,4550,61.912225705329156,0.0419672131147541,Very Cheap
20141110T000000,898000.0,2,1.75,1490,9874,1.0,0,0,4,7,1490,0,1963,0,98004,47.6246,-122.199,2280,9869,8384,7589,90.94591857403282,0.10793442622950819,Cheap
20141218T000000,480000.0,3,2.5,2980,7338,2.0,0,0,3,8,2980,0,2006,0,98055,47.437,-122.207,3010,5267,4358,2257,65.41291905151267,0.05311475409836065,Very Cheap
20141110T000000,1240000.0,3,2.5,2660,1973,3.0,0,3,3,9,1870,790,2007,0,98119,47.6264,-122.364,1640,1369,-687,-271,628.4845413076533,0.15278688524590164,Cheap
20140611T000000,599000.0,4,2.5,2790,230868,2.0,0,0,3,8,2790,0,1989,0,98077,47.7647,-122.019,1590,217800,228078,216210,2.5945561966145156,0.06872131147540983,Very Cheap
20150508T000000,770000.0,4,3.0,2800,9127,2.0,0,0,3,9,2800,0,1999,0,98074,47.6123,-122.007,2780,8165,6327,5385,84.36507066944232,0.09114754098360656,Very Cheap
20150313T000000,1208000.0,3,2.25,1590,8520,2.0,0,0,4,8,1590,0,1980,0,98004,47.6477,-122.216,2470,12005,6930,9535,141.78403755868544,0.14859016393442623,Cheap
20150116T000000,1590000.0,4,2.25,3240,11131,1.0,0,0,4,9,2080,1160,1953,0,98004,47.6182,-122.215,2300,12150,7891,9850,142.84430868744946,0.19868852459016392,Cheap
20140526T000000,880000.0,3,2.0,2130,35169,1.0,0,0,4,8,2130,0,1989,0,98072,47.7489,-122.123,2860,43560,33039,40700,25.02203645255765,0.10557377049180328,Cheap
20140620T000000,332000.0,3,2.0,1510,7884,1.0,0,0,3,6,1510,0,1942,2014,98166,47.4683,-122.348,1050,7620,6374,6570,42.110603754439374,0.033704918032786885,Very Cheap
20141106T000000,445000.0,3,1.75,1750,7200,1.0,0,0,3,7,1750,0,1966,0,98008,47.6289,-122.119,1810,7590,5450,5780,61.80555555555556,0.04852459016393443,Very Cheap
20140825T000000,849000.0,4,2.75,4010,87555,2.0,0,0,3,10,4010,0,2004,0,98038,47.4299,-121.998,2451,209523,83545,207072,9.696762035292101,0.10150819672131148,Cheap
20141211T000000,752000.0,4,1.5,1650,2970,1.5,0,0,3,7,1650,0,1903,0,98102,47.6233,-122.319,1670,2970,1320,1300,253.1986531986532,0.08878688524590164,Very Cheap
20140811T000000,450000.0,9,7.5,4050,6504,2.0,0,0,3,7,4050,0,1996,0,98144,47.5923,-122.301,1448,3866,2454,2418,69.18819188191883,0.04918032786885246,Very Cheap
20140918T000000,420000.0,3,1.0,1320,5500,1.0,0,0,3,7,1320,0,1955,0,98116,47.5705,-122.398,1480,5250,4180,3770,76.36363636363636,0.04524590163934426,Very Cheap
20150317T000000,330000.0,4,2.5,2310,6320,2.0,0,0,3,8,2310,0,1997,0,98092,47.3287,-122.167,1850,6181,4010,4331,52.21518987341772,0.03344262295081967,Very Cheap
20141203T000000,409000.0,3,1.75,1440,9065,1.0,0,0,4,8,1440,0,1972,0,98133,47.7163,-122.333,1990,8812,7625,6822,45.11858797573083,0.04380327868852459,Very Cheap
20140627T000000,350000.0,5,1.75,2330,14322,1.0,0,0,4,7,1180,1150,1968,0,98059,47.4768,-122.155,1690,10010,11992,8320,24.437927663734115,0.036065573770491806,Very Cheap
20150415T000000,570000.0,4,2.5,2430,44001,1.0,0,0,3,8,2430,0,1994,0,98019,47.7125,-121.916,2200,46924,41571,44724,12.954251039749096,0.06491803278688525,Very Cheap
20140916T000000,315000.0,3,1.0,1390,8333,1.0,0,0,3,7,1390,0,1982,0,98155,47.7652,-122.31,1320,7090,6943,5770,37.801512060482416,0.031475409836065574,Very Cheap
20141006T000000,224000.0,2,1.0,1150,15000,1.0,0,0,3,6,1060,90,1930,2013,98168,47.4935,-122.316,1350,15000,13850,13650,14.933333333333334,0.01954098360655738,Very Cheap
20141006T000000,293550.0,4,1.75,2120,9706,1.0,0,0,3,7,1370,750,1965,0,98168,47.4939,-122.297,1730,11337,7586,9607,30.24417885843808,0.02866229508196721,Very Cheap
20141003T000000,350000.0,4,2.75,2300,3175,1.5,0,0,3,6,1340,960,1966,0,98144,47.5732,-122.305,1260,3175,875,1915,110.23622047244095,0.036065573770491806,Very Cheap
20140916T000000,1108000.0,4,2.5,3320,9380,2.0,0,3,3,10,3320,0,1988,0,98006,47.5655,-122.114,2870,11779,6060,8909,118.12366737739872,0.13547540983606557,Cheap
20150319T000000,442500.0,4,2.5,2400,7092,2.0,0,0,3,7,2400,0,1997,0,98133,47.7522,-122.338,2350,8310,4692,5960,62.39424703891709,0.04819672131147541,Very Cheap
20140804T000000,616500.0,3,2.5,3580,118047,1.0,0,0,3,9,3240,340,1992,0,98027,47.4453,-121.98,3240,123275,114467,120035,5.222496124425017,0.07101639344262295,Very Cheap
20141119T000000,506400.0,3,2.5,2100,9040,1.0,0,0,3,8,1700,400,1989,0,98056,47.5329,-122.173,2430,8809,6940,6379,56.017699115044245,0.05657704918032787,Very Cheap
20141222T000000,324000.0,3,2.25,1550,4411,2.0,0,0,3,7,1550,0,2001,0,98019,47.7373,-121.966,1620,4621,2861,3001,73.45273180684651,0.03265573770491803,Very Cheap
20140805T000000,169000.0,3,1.5,1570,6450,1.5,0,0,4,6,1570,0,1931,0,98022,47.2021,-121.996,1400,6450,4880,5050,26.2015503875969,0.012327868852459017,Very Cheap
20140529T000000,595000.0,3,2.0,1480,5000,1.0,0,0,4,7,750,730,1928,0,98117,47.6859,-122.37,1250,4000,3520,2750,119.0,0.06819672131147542,Very Cheap
20140521T000000,299900.0,3,2.5,2720,6014,2.0,0,0,3,7,2720,0,2002,0,98092,47.3344,-122.174,2760,6537,3294,3777,49.86697705354174,0.029495081967213115,Very Cheap
20140529T000000,332000.0,3,2.25,2270,8876,1.0,0,0,3,7,1380,890,1977,0,98058,47.4653,-122.176,2150,7455,6606,5305,37.40423614240649,0.033704918032786885,Very Cheap
20141020T000000,432000.0,4,1.75,2410,8400,1.0,0,0,3,7,1600,810,1978,0,98011,47.7341,-122.2,1850,8400,5990,6550,51.42857142857143,0.046819672131147544,Very Cheap
20141002T000000,510000.0,4,2.75,2730,9112,1.0,0,2,3,9,1740,990,1996,0,98198,47.4005,-122.312,3050,10454,6382,7404,55.97014925373134,0.057049180327868855,Very Cheap
20150501T000000,270000.0,3,2.5,1540,7739,2.0,0,0,4,7,1540,0,1986,0,98030,47.3511,-122.169,1720,7200,6199,5480,34.88822845328854,0.025573770491803278,Very Cheap
20150330T000000,750000.0,5,2.5,3120,15593,2.0,0,4,3,11,3120,0,1986,0,98074,47.6142,-122.065,3390,17003,12473,13613,48.09850573975502,0.08852459016393442,Very Cheap
20141014T000000,509250.0,2,1.5,1480,3120,1.0,0,0,3,7,930,550,1914,2007,98105,47.6684,-122.323,1000,3780,1640,2780,163.22115384615384,0.05695081967213115,Very Cheap
20150219T000000,189000.0,3,1.0,860,5200,1.0,0,0,5,6,860,0,1969,0,98042,47.3677,-122.078,1010,5200,4340,4190,36.34615384615385,0.014950819672131148,Very Cheap
20141208T000000,726500.0,4,2.5,2180,3893,2.0,0,0,3,8,2180,0,1999,0,98117,47.6886,-122.388,1710,4550,1713,2840,186.61700488055484,0.08544262295081967,Very Cheap
20140619T000000,287000.0,3,2.0,1300,11374,1.5,0,0,5,7,1300,0,1933,0,98168,47.4839,-122.302,1480,9670,10074,8190,25.232987515385968,0.02780327868852459,Very Cheap
20140917T000000,679000.0,4,3.5,3420,49223,2.0,0,0,3,9,3420,0,2004,0,98010,47.3534,-121.992,3580,49223,45803,45643,13.794364423135526,0.07921311475409835,Very Cheap
20140602T000000,316000.0,3,2.25,2130,8721,1.0,0,0,3,8,1570,560,1987,0,98031,47.4202,-122.204,2130,9477,6591,7347,36.23437679165233,0.03160655737704918,Very Cheap
20150427T000000,498000.0,4,2.5,2300,22445,2.0,0,0,4,8,2300,0,1992,0,98014,47.6454,-121.902,2640,21886,20145,19246,22.1875696146135,0.055475409836065574,Very Cheap
20141007T000000,448000.0,4,1.75,2560,8270,1.0,0,0,3,7,1480,1080,1979,0,98072,47.7572,-122.147,2320,8450,5710,6130,54.17170495767836,0.048918032786885245,Very Cheap
20140527T000000,535000.0,2,1.0,1040,5527,1.0,0,0,3,7,1040,0,1951,0,98115,47.6774,-122.284,2080,7020,4487,4940,96.79753935227068,0.06032786885245902,Very Cheap
20150116T000000,560000.0,4,3.0,3080,9601,2.0,0,1,3,10,3080,0,1990,0,98003,47.334,-122.332,3200,9375,6521,6175,58.32725757733569,0.06360655737704918,Very Cheap
20141002T000000,437850.0,4,2.25,2670,14255,1.0,0,0,4,8,1610,1060,1975,0,98006,47.5623,-122.175,2470,10290,11585,7820,30.71553840757629,0.04758688524590164,Very Cheap
20140606T000000,435000.0,4,2.75,3270,50994,2.0,0,0,4,8,2720,550,1983,0,98042,47.347,-122.087,2780,36036,47724,33256,8.530415342981527,0.04721311475409836,Very Cheap
20140619T000000,510000.0,4,2.5,2610,8031,2.0,0,0,3,8,2610,0,1998,0,98155,47.7717,-122.27,2320,8031,5421,5711,63.5039223010833,0.057049180327868855,Very Cheap
20140506T000000,520000.0,3,2.5,2460,54885,2.0,0,0,4,8,2460,0,1980,0,98059,47.4996,-122.146,2770,21407,52425,18637,9.47435547052929,0.058360655737704915,Very Cheap
20140703T000000,509000.0,2,1.5,1930,3521,2.0,0,0,3,8,1930,0,1989,0,98007,47.6092,-122.146,1840,3576,1591,1736,144.5612042033513,0.056918032786885245,Very Cheap
20150406T000000,575000.0,3,1.0,1220,5652,1.0,0,0,3,6,1220,0,1905,0,98116,47.5767,-122.408,1490,2467,4432,977,101.73389950460015,0.06557377049180328,Very Cheap
20150422T000000,365000.0,4,2.5,2030,7210,1.0,0,0,5,7,1330,700,1969,0,98059,47.5067,-122.16,1980,7560,5180,5580,50.624133148404994,0.0380327868852459,Very Cheap
20140612T000000,795000.0,3,2.0,2420,17859,1.0,0,1,5,9,1500,920,1979,0,98034,47.7074,-122.246,2955,17859,15439,14904,44.51537040147824,0.09442622950819672,Very Cheap
20140611T000000,285000.0,3,2.5,1870,4060,2.0,0,0,3,7,1870,0,2005,0,98042,47.3986,-122.163,2190,4060,2190,1870,70.19704433497537,0.02754098360655738,Very Cheap
20140602T000000,955000.0,3,2.25,3020,43560,2.0,0,0,3,10,2720,300,1969,0,98005,47.6456,-122.173,3910,43560,40540,39650,21.923783287419653,0.11540983606557377,Cheap
20140714T000000,775000.0,4,2.5,2880,8400,2.0,0,4,3,8,2050,830,1955,1987,98177,47.7704,-122.386,2880,7440,5520,4560,92.26190476190476,0.09180327868852459,Very Cheap
20141006T000000,400000.0,4,3.0,1810,5012,2.0,0,0,4,7,1810,0,1997,0,98108,47.5691,-122.292,1670,5161,3202,3491,79.80845969672785,0.04262295081967213,Very Cheap
20140701T000000,570000.0,4,2.5,2590,8483,2.0,0,0,3,9,2590,0,1991,0,98011,47.738,-122.221,2660,8717,5893,6057,67.19320994931039,0.06491803278688525,Very Cheap
20141020T000000,955990.0,5,3.25,3830,6507,2.0,0,0,3,9,3830,0,2014,0,98053,47.6843,-122.016,3950,6723,2677,2773,146.91716612878437,0.11553967213114755,Cheap
20140929T000000,1150000.0,3,2.25,3250,34848,1.0,0,0,3,10,2260,990,2006,0,98005,47.6077,-122.158,2770,21512,31598,18742,33.000459136822776,0.14098360655737704,Cheap
20150414T000000,459950.0,4,2.0,2760,21465,1.0,0,0,4,9,2120,640,1979,0,98042,47.3818,-122.165,2550,13144,18705,10594,21.427905893314698,0.050485245901639345,Very Cheap
20150219T000000,245000.0,2,1.75,1220,8382,1.0,0,0,3,6,1220,0,1942,0,98146,47.5033,-122.359,1100,8382,7162,7282,29.22930088284419,0.022295081967213116,Very Cheap
20140908T000000,281000.0,3,1.5,1280,974,3.0,0,0,3,7,1280,0,2003,0,98125,47.7162,-122.293,1420,1422,-306,2,288.50102669404515,0.027016393442622952,Very Cheap
20141022T000000,205000.0,3,0.75,770,7000,1.0,0,0,3,4,770,0,1942,0,98024,47.5661,-121.887,950,10500,6230,9550,29.285714285714285,0.017049180327868854,Very Cheap
20140611T000000,290000.0,3,1.75,1520,15090,1.0,0,0,4,7,1520,0,1968,0,98038,47.398,-121.964,1580,18618,13570,17038,19.218025182239895,0.02819672131147541,Very Cheap
20150226T000000,635000.0,4,2.5,2080,11176,1.0,0,0,5,8,2080,0,1954,0,98125,47.7107,-122.289,1390,7928,9096,6538,56.81818181818182,0.07344262295081967,Very Cheap
20140903T000000,310000.0,1,1.0,570,6000,1.0,0,0,2,5,570,0,1918,0,98136,47.5517,-122.385,1530,6000,5430,4470,51.666666666666664,0.03081967213114754,Very Cheap
20150114T000000,470000.0,4,2.0,1500,3659,1.0,0,0,3,7,830,670,1906,0,98122,47.6088,-122.293,1560,3706,2159,2146,128.45039628313748,0.05180327868852459,Very Cheap
20140701T000000,600000.0,2,2.5,2510,14878,2.0,0,0,3,10,2510,0,1990,0,98011,47.7525,-122.205,3080,13594,12368,10514,40.32800107541336,0.06885245901639345,Very Cheap
20141217T000000,279000.0,4,2.0,1980,10051,1.0,0,0,3,7,1980,0,1969,2003,98092,47.3231,-122.103,1520,10125,8071,8605,27.75843199681624,0.02675409836065574,Very Cheap
20140804T000000,538500.0,3,3.5,2500,4270,2.0,0,0,3,8,2500,0,2000,0,98065,47.536,-121.877,2420,4205,1770,1785,126.11241217798595,0.06078688524590164,Very Cheap
20140709T000000,594950.0,4,2.5,2720,10006,2.0,0,0,3,9,2720,0,1989,0,98074,47.6295,-122.042,2720,10759,7286,8039,59.45932440535679,0.06819016393442623,Very Cheap
20140808T000000,533050.0,2,1.0,910,295772,1.0,0,0,3,5,910,0,1953,0,98042,47.3752,-122.11,2050,48351,294862,46301,1.8022328009412656,0.06007213114754098,Very Cheap
20140606T000000,510000.0,3,1.75,1480,7040,1.0,0,0,3,7,1480,0,1974,0,98033,47.6723,-122.169,2040,7810,5560,5770,72.44318181818181,0.057049180327868855,Very Cheap
20140929T000000,360000.0,4,2.25,2470,8686,1.0,0,0,4,7,1270,1200,1974,0,98058,47.4371,-122.166,1900,7350,6216,5450,41.44600506562284,0.037377049180327866,Very Cheap
20140721T000000,435000.0,2,1.0,1650,5106,1.0,0,0,3,7,1090,560,1960,0,98115,47.6992,-122.309,1300,6947,3456,5647,85.19388954171563,0.04721311475409836,Very Cheap
20150324T000000,559000.0,3,1.75,1700,6500,1.0,0,0,3,8,1700,0,1967,0,98115,47.6837,-122.284,1880,6000,4800,4120,86.0,0.06347540983606557,Very Cheap
20140827T000000,645000.0,2,1.5,1995,115670,1.5,0,1,4,8,1995,0,1991,0,98070,47.4022,-122.464,2142,29375,113675,27233,5.5762081784386615,0.07475409836065573,Very Cheap
20141028T000000,340000.0,2,1.0,1280,9690,1.0,0,0,4,6,640,640,1919,0,98118,47.5341,-122.279,1630,15884,8410,14254,35.08771929824562,0.03475409836065574,Very Cheap
20150312T000000,565000.0,4,2.5,2980,10459,2.0,0,0,3,9,2980,0,2001,0,98019,47.7354,-121.974,2920,7700,7479,4780,54.02046084711731,0.06426229508196721,Very Cheap
20150213T000000,575700.0,3,1.75,1730,6130,1.0,0,0,3,7,1480,250,1941,0,98115,47.6978,-122.316,1730,6131,4400,4401,93.91517128874388,0.0656655737704918,Very Cheap
20140617T000000,1010000.0,3,3.25,2420,1923,2.0,0,2,3,10,1840,580,2006,0,98109,47.637,-122.341,1840,2890,-497,1050,525.2210088403536,0.12262295081967213,Cheap
20140710T000000,540500.0,3,2.0,2800,185130,1.0,0,0,3,8,2320,480,1996,0,98038,47.4133,-122.006,2200,72055,182330,69855,2.919570031869497,0.06104918032786885,Very Cheap
20140818T000000,265000.0,5,4.0,1400,8580,1.0,0,0,5,7,900,500,1954,0,98188,47.456,-122.292,1220,8832,7180,7612,30.885780885780886,0.024918032786885248,Very Cheap
20140811T000000,699950.0,4,2.0,2070,7830,1.0,0,1,5,7,1180,890,1941,0,98125,47.7058,-122.278,2390,7830,5760,5440,89.3933588761175,0.08196065573770492,Very Cheap
20140611T000000,355000.0,1,1.75,750,20339,1.0,0,0,4,4,550,200,1946,0,98059,47.4756,-122.09,2020,23958,19589,21938,17.4541521215399,0.036721311475409836,Very Cheap
20140611T000000,381000.0,3,1.5,1460,11407,1.0,0,0,3,7,1460,0,1954,0,98155,47.746,-122.294,1470,11407,9947,9937,33.40054352590514,0.040131147540983604,Very Cheap
20150414T000000,564000.0,5,2.25,2140,8700,1.0,0,2,3,8,1220,920,1962,0,98115,47.6969,-122.31,1720,6670,6560,4950,64.82758620689656,0.0641311475409836,Very Cheap
20140710T000000,114975.0,2,1.0,740,6250,1.0,0,0,3,6,740,0,1942,0,98146,47.506,-122.335,980,6957,5510,5977,18.396,0.005242622950819672,Very Cheap
20150130T000000,325000.0,1,0.75,410,8636,1.0,0,0,2,4,410,0,1953,0,98146,47.5077,-122.357,1190,8636,8226,7446,37.63316350162112,0.03278688524590164,Very Cheap
20141027T000000,299990.0,2,1.0,1570,125452,1.0,0,3,4,7,1570,0,1953,0,98022,47.2077,-122.016,1660,46119,123882,44459,2.391273156266939,0.02950688524590164,Very Cheap
20150513T000000,751000.0,5,2.75,2860,5280,2.0,0,0,3,9,2860,0,2006,0,98052,47.707,-122.102,3150,6442,2420,3292,142.2348484848485,0.08865573770491804,Very Cheap
20141231T000000,425000.0,3,2.25,1400,6970,2.0,0,0,3,8,1400,0,1984,0,98006,47.542,-122.184,1800,8140,5570,6340,60.97560975609756,0.04590163934426229,Very Cheap
20150114T000000,665000.0,3,1.75,2700,5040,1.0,0,2,3,8,1560,1140,1947,0,98144,47.5834,-122.29,3010,5000,2340,1990,131.94444444444446,0.07737704918032787,Very Cheap
20150325T000000,833450.0,5,4.0,4460,269345,2.0,0,4,3,9,3330,1130,1996,0,98027,47.4992,-122.06,2670,115434,264885,112764,3.094358536449535,0.09946885245901639,Very Cheap
20141028T000000,575000.0,7,1.5,2670,11250,1.5,0,0,4,8,2320,350,1948,0,98133,47.7121,-122.332,2030,9000,8580,6970,51.111111111111114,0.06557377049180328,Very Cheap
20141125T000000,190000.0,3,1.75,1520,9600,1.0,0,0,4,7,1520,0,1967,0,98059,47.473,-122.149,1590,10183,8080,8593,19.791666666666668,0.015081967213114755,Very Cheap
20150223T000000,314950.0,3,1.75,1520,9600,1.0,0,0,4,7,1520,0,1967,0,98059,47.473,-122.149,1590,10183,8080,8593,32.807291666666664,0.03146885245901639,Very Cheap
20141203T000000,601150.0,2,2.0,1660,5200,1.0,0,0,5,7,1120,540,1906,0,98103,47.6871,-122.334,1260,5160,3540,3900,115.60576923076923,0.06900327868852459,Very Cheap
20141212T000000,315000.0,2,1.0,860,8308,1.0,0,0,3,7,860,0,1948,0,98146,47.508,-122.378,1200,8308,7448,7108,37.91526239768898,0.031475409836065574,Very Cheap
20150402T000000,545000.0,2,1.5,2340,13380,1.0,0,0,4,7,1280,1060,1954,0,98146,47.5017,-122.377,1490,8100,11040,6610,40.732436472346784,0.06163934426229508,Very Cheap
20140519T000000,565000.0,4,2.25,2110,10698,2.0,0,0,4,8,2110,0,1979,0,98027,47.5614,-122.082,2220,8252,8588,6032,52.81361002056459,0.06426229508196721,Very Cheap
20140506T000000,175000.0,3,1.0,1010,7034,1.0,0,0,3,7,1010,0,1954,0,98055,47.49,-122.22,1440,10994,6024,9554,24.879158373613876,0.013114754098360656,Very Cheap
20140626T000000,530000.0,3,2.0,2330,26571,2.5,0,0,3,8,2330,0,1987,0,98005,47.6009,-122.158,2030,20037,24241,18007,19.946558277821687,0.05967213114754098,Very Cheap
20140618T000000,4489000.0,4,3.0,6430,27517,2.0,0,0,3,12,6430,0,2001,0,98004,47.6208,-122.219,3720,14592,21087,10872,163.1355162263328,0.5788852459016394,Very High
20141007T000000,430000.0,3,1.75,1610,7900,1.0,0,0,4,8,1310,300,1960,0,98177,47.7588,-122.36,2210,7700,6290,5490,54.43037974683544,0.04655737704918033,Very Cheap
20141030T000000,225000.0,3,1.75,1460,8372,1.0,0,0,4,7,1460,0,1981,0,98042,47.3683,-122.087,1220,7803,6912,6583,26.87529861442905,0.019672131147540985,Very Cheap
20140717T000000,312000.0,5,4.0,2900,9779,2.0,0,0,4,7,1950,950,1937,0,98168,47.5003,-122.306,1360,8000,6879,6640,31.905102771244504,0.031081967213114754,Very Cheap
20150302T000000,380000.0,3,1.0,1260,7980,1.0,0,0,3,7,1260,0,1951,0,98177,47.7013,-122.373,1760,7606,6720,5846,47.61904761904762,0.04,Very Cheap
20150417T000000,222200.0,2,1.0,1210,10000,1.0,0,0,3,7,1210,0,1953,0,98148,47.4402,-122.333,1620,10959,8790,9339,22.22,0.019304918032786885,Very Cheap
20141201T000000,1438890.0,5,3.5,3420,8000,2.0,0,0,3,10,3420,0,2006,0,98040,47.5736,-122.212,1900,8000,4580,6100,179.86125,0.17887081967213114,Cheap
20140702T000000,329950.0,4,2.5,2120,4558,2.0,0,0,3,7,2120,0,2002,0,98038,47.3795,-122.022,2370,5506,2438,3136,72.38920579201404,0.03343606557377049,Very Cheap
20140923T000000,995000.0,3,2.5,2460,10300,1.0,0,0,3,10,2460,0,1992,0,98117,47.6999,-122.391,2410,5250,7840,2840,96.60194174757281,0.12065573770491804,Cheap
20140714T000000,929950.0,3,3.5,3790,10829,2.0,0,0,3,11,3790,0,1993,0,98027,47.5525,-122.098,3620,10989,7039,7369,85.87588881706529,0.11212459016393443,Cheap
20150327T000000,692000.0,4,2.5,2350,9779,1.0,0,0,3,10,2350,0,1987,0,98074,47.6411,-122.065,2700,10441,7429,7741,70.76388178750383,0.08091803278688525,Very Cheap
20140626T000000,402000.0,2,1.0,620,2475,1.0,0,0,5,6,620,0,1911,0,98107,47.6655,-122.371,1290,2475,1855,1185,162.42424242424244,0.04288524590163934,Very Cheap
20140912T000000,510000.0,3,1.75,1920,43560,1.0,0,0,4,7,1340,580,1962,0,98074,47.6052,-122.044,2540,58806,41640,56266,11.707988980716253,0.057049180327868855,Very Cheap
20140619T000000,249000.0,3,1.0,1050,8498,1.0,0,0,4,7,1050,0,1959,0,98031,47.4043,-122.202,1050,8498,7448,7448,29.301012002824194,0.02281967213114754,Very Cheap
20141202T000000,244900.0,3,1.5,1360,9980,1.0,0,0,4,7,1360,0,1966,0,98031,47.4143,-122.206,1360,9750,8620,8390,24.539078156312627,0.022281967213114755,Very Cheap
20150219T000000,289900.0,3,1.0,1180,7068,1.0,0,0,3,6,1180,0,1944,0,98178,47.4947,-122.238,1180,7068,5888,5888,41.01584606677985,0.02818360655737705,Very Cheap
20150331T000000,552500.0,4,1.0,1560,7980,1.0,0,0,4,7,1170,390,1939,0,98146,47.5093,-122.387,1570,7980,6420,6410,69.23558897243107,0.06262295081967213,Very Cheap
20140630T000000,760000.0,4,2.5,3300,165528,2.0,0,0,3,8,3300,0,1984,0,98077,47.7657,-122.028,3030,144696,162228,141666,4.591368227731864,0.0898360655737705,Very Cheap
20141027T000000,440000.0,2,2.75,1100,1088,2.0,0,0,3,7,750,350,2006,0,98102,47.6405,-122.324,2090,4125,-12,2035,404.4117647058824,0.04786885245901639,Very Cheap
20140801T000000,286000.0,3,1.75,1770,9000,1.0,0,0,3,7,1090,680,1954,0,98168,47.4997,-122.326,1520,21141,7230,19621,31.77777777777778,0.027672131147540982,Very Cheap
20140905T000000,260000.0,3,1.0,1200,4592,1.0,0,0,3,6,800,400,1950,0,98106,47.519,-122.352,940,4440,3392,3500,56.62020905923345,0.024262295081967214,Very Cheap
20140627T000000,355000.0,2,2.25,1330,10838,2.0,0,0,3,8,1330,0,1985,0,98028,47.7689,-122.241,1390,10310,9508,8920,32.75512087100941,0.036721311475409836,Very Cheap
20150130T000000,318000.0,3,1.75,1570,12506,1.0,0,0,4,8,1570,0,1959,0,98003,47.3365,-122.319,2120,13243,10936,11123,25.42779465856389,0.03186885245901639,Very Cheap
20140826T000000,255000.0,2,1.0,1610,19965,1.0,0,0,3,7,1610,0,1952,0,98168,47.5095,-122.313,2100,28400,18355,26300,12.772351615326821,0.02360655737704918,Very Cheap
20140514T000000,139000.0,3,1.0,1100,17334,1.0,0,0,3,7,1100,0,1978,0,98001,47.3003,-122.27,1530,18694,16234,17164,8.018922349140418,0.00839344262295082,Very Cheap
20150401T000000,485000.0,4,2.25,1810,7068,2.0,0,0,5,7,1810,0,1976,0,98034,47.7319,-122.204,1460,7274,5258,5814,68.61912846632711,0.05377049180327869,Very Cheap
20141019T000000,549950.0,3,1.75,2930,266587,2.0,0,0,3,8,2440,490,1995,0,98014,47.6991,-121.947,2700,438213,263657,435513,2.0629287999789936,0.062288524590163936,Very Cheap
20140916T000000,588000.0,3,1.5,1780,4200,1.5,0,0,4,8,1780,0,1916,0,98103,47.662,-122.349,1380,3333,2420,1953,140.0,0.06727868852459017,Very Cheap
20140715T000000,975000.0,3,2.5,3050,7410,1.5,0,0,5,8,1950,1100,1950,0,98115,47.6772,-122.296,1890,5814,4360,3924,131.57894736842104,0.1180327868852459,Cheap
20140523T000000,402000.0,3,2.0,1540,1827,2.0,0,0,3,8,1540,0,2005,0,98029,47.5479,-121.998,1540,1827,287,287,220.0328407224959,0.04288524590163934,Very Cheap
20150501T000000,245000.0,3,1.0,1380,9875,1.0,0,0,3,7,1380,0,1959,0,98168,47.5131,-122.334,1200,6250,8495,5050,24.810126582278482,0.022295081967213116,Very Cheap
20140616T000000,445000.0,3,1.75,1890,32340,1.5,0,3,3,8,1890,0,1976,0,98070,47.4137,-122.439,1890,40180,30450,38290,13.760049474335188,0.04852459016393443,Very Cheap
20140525T000000,195000.0,3,1.75,1570,8459,1.0,0,0,3,7,1570,0,1991,0,98022,47.2016,-122.006,1650,8844,6889,7194,23.052370256531503,0.015737704918032787,Very Cheap
20150112T000000,385000.0,5,2.0,2540,11750,1.0,0,0,3,7,1480,1060,1962,0,98155,47.7754,-122.291,2000,12000,9210,10000,32.765957446808514,0.04065573770491803,Very Cheap
20140716T000000,450000.0,3,1.5,1520,7903,1.0,0,0,4,7,1000,520,1955,0,98006,47.5659,-122.141,1520,9830,6383,8310,56.94040237884348,0.04918032786885246,Very Cheap
20141028T000000,1090000.0,4,2.5,2780,6837,2.0,0,0,3,9,2780,0,2004,0,98033,47.666,-122.201,1160,6837,4057,5677,159.42664911510897,0.13311475409836065,Cheap
20140520T000000,396675.0,2,1.0,1730,6375,2.0,0,0,4,6,1730,0,1945,0,98126,47.5357,-122.368,1180,6250,4645,5070,62.22352941176471,0.04218688524590164,Very Cheap
20141002T000000,242000.0,5,2.25,2340,7494,1.0,0,0,3,7,1170,1170,1951,0,98188,47.448,-122.28,1650,10125,5154,8475,32.29250066720043,0.021901639344262296,Very Cheap
20141031T000000,380000.0,3,1.75,1300,12378,1.0,0,0,4,6,1300,0,1943,0,98045,47.4996,-121.778,1300,11596,11078,10296,30.699628372919697,0.04,Very Cheap
20141203T000000,496000.0,2,1.0,1420,4635,2.0,0,0,4,7,1420,0,1941,1973,98115,47.68,-122.304,1810,4635,3215,2825,107.0118662351672,0.05521311475409836,Very Cheap
20141208T000000,399950.0,3,2.5,1470,4488,2.0,0,0,5,7,1470,0,1980,0,98034,47.723,-122.162,1400,4441,3018,3041,89.11541889483065,0.04261639344262295,Very Cheap
20150304T000000,895000.0,4,2.5,2850,8526,2.0,0,0,3,9,2850,0,1998,0,98033,47.6747,-122.191,2440,7072,5676,4632,104.97302369223551,0.10754098360655738,Cheap
20141104T000000,690000.0,3,2.0,2360,6149,2.0,0,3,3,8,1560,800,1926,1989,98136,47.5433,-122.384,2000,6149,3789,4149,112.21336802732152,0.08065573770491803,Very Cheap
20140902T000000,270000.0,3,1.5,1610,8375,2.0,0,0,3,7,1610,0,1927,0,98155,47.7527,-122.306,1610,9107,6765,7497,32.23880597014925,0.025573770491803278,Very Cheap
20140623T000000,349900.0,3,2.0,2420,38781,1.0,0,0,5,7,1210,1210,1949,0,98027,47.4511,-121.976,2650,88426,36361,85776,9.022459451793404,0.036052459016393444,Very Cheap
20150504T000000,454280.0,3,2.5,1470,1741,2.0,0,0,3,8,1170,300,2004,0,98029,47.5464,-121.999,1470,1583,271,113,260.93049971280874,0.049741639344262296,Very Cheap
20150512T000000,390000.0,3,2.5,1410,26375,1.0,0,0,3,6,1410,0,1992,0,98077,47.7432,-122.076,1410,12474,24965,11064,14.786729857819905,0.04131147540983607,Very Cheap
20150115T000000,275000.0,3,1.75,1840,14005,1.0,0,0,3,8,1840,0,1983,0,98023,47.3124,-122.345,2170,7992,12165,5822,19.635844341306676,0.02622950819672131,Very Cheap
20150429T000000,300000.0,4,2.5,2450,8932,2.0,0,0,3,8,2450,0,1990,0,98023,47.3093,-122.345,2410,8775,6482,6365,33.5871025526198,0.029508196721311476,Very Cheap
20150508T000000,700000.0,3,1.75,1500,6000,1.0,0,0,5,7,850,650,1940,0,98199,47.6474,-122.402,1700,6000,4500,4300,116.66666666666667,0.08196721311475409,Very Cheap
20141218T000000,520000.0,3,1.75,2080,6609,1.0,0,0,3,7,1280,800,1950,0,98115,47.6883,-122.3,1680,6270,4529,4590,78.68058707822667,0.058360655737704915,Very Cheap
20150402T000000,715000.0,3,2.5,2770,39529,2.0,0,0,3,9,2770,0,1987,0,98053,47.6495,-122.042,3010,35435,36759,32425,18.08798603556882,0.0839344262295082,Very Cheap
20150420T000000,404000.0,3,2.5,2370,4324,2.0,0,0,3,8,2370,0,2006,0,98038,47.3515,-121.999,2370,4348,1954,1978,93.43200740055504,0.043147540983606555,Very Cheap
20140926T000000,490500.0,3,2.0,3000,21883,2.0,0,0,3,7,1970,1030,1998,0,98011,47.7599,-122.214,2280,14025,18883,11745,22.4146597815656,0.05449180327868852,Very Cheap
20150506T000000,1485000.0,6,2.75,4430,6440,2.0,0,3,3,10,2680,1750,1964,2015,98118,47.5462,-122.265,3530,7314,2010,3784,230.59006211180125,0.18491803278688523,Cheap
20150409T000000,557800.0,4,1.75,1550,6000,1.0,0,0,5,7,1550,0,1944,0,98199,47.6567,-122.399,1550,6000,4450,4450,92.96666666666667,0.06331803278688525,Very Cheap
20150413T000000,571000.0,4,2.25,2290,9900,1.0,0,2,4,8,1550,740,1959,0,98166,47.4434,-122.343,2320,9900,7610,7580,57.676767676767675,0.06504918032786886,Very Cheap
20140708T000000,410000.0,4,2.5,2560,4020,2.0,0,0,3,9,2560,0,2006,0,98038,47.3533,-122.027,3010,4916,1460,1906,101.99004975124379,0.043934426229508196,Very Cheap
20150313T000000,225000.0,3,1.5,1240,5506,1.0,0,0,4,7,1240,0,1971,0,98118,47.5294,-122.285,1670,5589,4266,3919,40.864511442063204,0.019672131147540985,Very Cheap
20140716T000000,700000.0,4,2.5,2590,4498,2.0,0,0,3,9,2590,0,2004,0,98052,47.7047,-122.128,2660,5238,1908,2578,155.62472209871055,0.08196721311475409,Very Cheap
20150209T000000,500000.0,3,1.0,1370,3500,1.5,0,0,3,7,1370,0,1905,1985,98103,47.6857,-122.348,1590,4500,2130,2910,142.85714285714286,0.05573770491803279,Very Cheap
20150428T000000,536500.0,2,2.0,1360,1860,1.0,0,0,4,7,680,680,1925,0,98107,47.6727,-122.396,1440,5000,500,3560,288.44086021505376,0.060524590163934425,Very Cheap
20150410T000000,330000.0,3,2.5,2060,25046,1.0,0,0,4,8,1600,460,1980,0,98022,47.184,-121.959,2050,21255,22986,19205,13.17575660784157,0.03344262295081967,Very Cheap
20150211T000000,249950.0,3,1.75,1120,15210,1.0,0,0,5,7,1120,0,1976,0,98042,47.3659,-122.113,1710,8470,14090,6760,16.43326758711374,0.022944262295081966,Very Cheap
20141015T000000,249000.0,4,1.75,1630,8410,1.5,0,0,5,7,1630,0,1943,0,98188,47.4538,-122.288,1390,8410,6780,7020,29.607609988109395,0.02281967213114754,Very Cheap
20150408T000000,249000.0,3,1.75,1590,7535,1.5,0,0,5,6,1590,0,1909,0,98032,47.3769,-122.234,1110,6000,5945,4890,33.045786330457865,0.02281967213114754,Very Cheap
20140508T000000,780000.0,4,1.75,2480,9195,1.0,0,0,3,7,1390,1090,1950,0,98004,47.584,-122.195,2440,9195,6715,6755,84.82871125611746,0.09245901639344262,Very Cheap
20140705T000000,1200000.0,4,2.5,2700,4275,2.0,0,0,3,9,2700,0,2004,0,98115,47.6725,-122.327,1810,4500,1575,2690,280.70175438596493,0.14754098360655737,Cheap
20140915T000000,434500.0,3,1.75,1930,7210,1.0,0,0,3,7,1110,820,1975,0,98072,47.735,-122.174,1870,7877,5280,6007,60.26352288488211,0.04714754098360656,Very Cheap
20141010T000000,590000.0,4,2.0,2490,339332,1.0,0,0,3,8,2490,0,2002,0,98022,47.2725,-121.929,1910,129373,336842,127463,1.7387101717492013,0.06754098360655737,Very Cheap
20150219T000000,417200.0,2,1.0,1000,4000,1.0,0,0,3,6,1000,0,1910,0,98107,47.6742,-122.396,1490,5000,3000,3510,104.3,0.04487868852459016,Very Cheap
20140924T000000,649990.0,4,2.25,2130,11900,2.0,0,0,3,9,2130,0,1976,0,98074,47.6408,-122.058,2590,11900,9770,9310,54.621008403361344,0.07540852459016394,Very Cheap
20141202T000000,506000.0,2,1.0,1060,3588,1.0,0,0,4,7,960,100,1926,0,98107,47.6721,-122.395,1570,3741,2528,2171,141.02564102564102,0.05652459016393443,Very Cheap
20150421T000000,348000.0,3,2.5,1730,4004,2.0,0,0,3,7,1730,0,1999,0,98148,47.4317,-122.328,1730,5523,2274,3793,86.91308691308691,0.03580327868852459,Very Cheap
20140728T000000,301000.0,4,2.5,2810,6146,2.0,0,0,3,9,2810,0,1998,0,98031,47.4045,-122.208,2810,6180,3336,3370,48.9749430523918,0.029639344262295083,Very Cheap
20140708T000000,427550.0,2,1.0,880,4000,1.0,0,0,3,7,880,0,1940,0,98117,47.6848,-122.386,1150,4000,3120,2850,106.8875,0.04623606557377049,Very Cheap
20150501T000000,361000.0,3,1.0,1040,6720,1.5,0,0,3,7,1040,0,1951,0,98155,47.7444,-122.294,1880,11407,5680,9527,53.720238095238095,0.037508196721311476,Very Cheap
20140821T000000,460000.0,2,2.5,1830,8107,1.0,0,0,5,7,930,900,1946,0,98125,47.701,-122.305,1260,6960,6277,5700,56.74108794868632,0.050491803278688525,Very Cheap
20140710T000000,958000.0,4,3.5,1800,6400,2.0,0,2,3,8,1800,0,1984,2011,98112,47.625,-122.3,1700,4736,4600,3036,149.6875,0.1158032786885246,Cheap
20140612T000000,445000.0,5,1.75,2460,6846,1.5,0,0,5,7,1340,1120,1911,0,98108,47.5445,-122.321,1410,4800,4386,3390,65.00146070698219,0.04852459016393443,Very Cheap
20140519T000000,373000.0,3,2.5,1670,3565,2.0,0,0,3,7,1670,0,1999,0,98072,47.7623,-122.161,1510,3770,1895,2260,104.62833099579242,0.03908196721311476,Very Cheap
20150414T000000,525000.0,4,2.25,2660,7957,1.0,0,0,4,8,1750,910,1977,0,98011,47.7351,-122.199,1890,8250,5297,6360,65.97964056805328,0.05901639344262295,Very Cheap
20140826T000000,364988.0,3,2.5,2850,12593,2.0,0,0,3,9,2850,0,1997,0,98023,47.2848,-122.345,2850,9435,9743,6585,28.983403478122767,0.038031213114754096,Very Cheap
20140814T000000,324000.0,2,1.0,820,8370,1.0,0,0,4,7,820,0,1941,0,98177,47.7256,-122.361,1410,8370,7550,6960,38.70967741935484,0.03265573770491803,Very Cheap
20150305T000000,625000.0,4,3.0,2350,5627,1.0,0,0,5,8,1490,860,1960,0,98118,47.5514,-122.268,2020,5627,3277,3607,111.07161897991826,0.07213114754098361,Very Cheap
20140908T000000,237500.0,3,1.75,1480,7830,1.0,0,0,3,7,1480,0,1980,0,98022,47.1967,-121.998,1130,7553,6350,6423,30.33205619412516,0.021311475409836064,Very Cheap
20140806T000000,429300.0,6,2.25,2930,15949,1.0,0,0,4,8,1730,1200,1965,0,98034,47.7188,-122.185,1730,8550,13019,6820,26.91704809078939,0.046465573770491805,Very Cheap
20140529T000000,155000.0,3,1.0,1250,6250,1.0,0,0,2,7,1030,220,1949,0,98108,47.5292,-122.323,1130,6250,5000,5120,24.8,0.010491803278688525,Very Cheap
20150223T000000,614000.0,4,2.75,2760,8160,1.5,0,2,4,8,1780,980,1940,0,98177,47.7248,-122.365,2720,8160,5400,5440,75.24509803921569,0.07068852459016393,Very Cheap
20150331T000000,650000.0,3,2.5,2380,3332,2.0,0,0,3,9,2380,0,2014,0,98034,47.7194,-122.199,2590,4382,952,1792,195.078031212485,0.07540983606557378,Very Cheap
20140721T000000,625000.0,3,2.0,1730,12219,1.0,0,0,4,7,1730,0,1986,0,98004,47.5825,-122.189,2470,13594,10489,11124,51.14984859644815,0.07213114754098361,Very Cheap
20150325T000000,587100.0,3,2.25,1670,6414,1.0,0,0,4,8,1670,0,1961,0,98117,47.6921,-122.386,2130,7035,4744,4905,91.53414405986904,0.06716065573770492,Very Cheap
20140617T000000,380000.0,4,2.5,2150,37647,2.0,0,0,3,8,2150,0,1991,0,98042,47.3117,-122.083,2410,42193,35497,39783,10.093765771509018,0.04,Very Cheap
20150505T000000,479500.0,2,1.0,930,5760,1.0,0,0,3,6,730,200,1917,0,98118,47.5598,-122.266,1970,5760,4830,3790,83.24652777777777,0.05304918032786885,Very Cheap
20150317T000000,382888.0,1,1.0,620,2380,1.0,0,0,3,6,620,0,1900,0,98115,47.6746,-122.326,980,3570,1760,2590,160.87731092436974,0.040378754098360656,Very Cheap
20140527T000000,540000.0,4,4.25,1960,3565,2.0,0,0,3,7,1960,0,1940,2003,98116,47.5849,-122.384,1920,5750,1605,3830,151.4726507713885,0.06098360655737705,Very Cheap
20140521T000000,691000.0,4,2.75,2550,8632,1.0,0,0,3,8,1700,850,1972,0,98033,47.6477,-122.197,2550,9534,6082,6984,80.05097312326228,0.08078688524590164,Very Cheap
20140604T000000,760500.0,3,2.0,1990,3990,1.0,0,0,5,7,1130,860,1912,0,98103,47.6572,-122.333,1710,4000,2000,2290,190.6015037593985,0.08990163934426229,Very Cheap
20150430T000000,685000.0,4,2.5,3550,10968,2.0,0,0,3,9,3550,0,2006,0,98065,47.5431,-121.886,3550,8583,7418,5033,62.454412837345004,0.08,Very Cheap
20140929T000000,199129.0,3,1.0,860,33664,1.0,0,0,4,6,860,0,1955,0,98001,47.295,-122.275,1290,18287,32804,16997,5.915191302281369,0.0162792131147541,Very Cheap
20140724T000000,335000.0,3,3.0,2031,7702,2.0,0,0,3,9,2031,0,1988,0,98023,47.3058,-122.348,2390,7700,5671,5310,43.495196052973256,0.03409836065573771,Very Cheap
20140609T000000,305100.0,3,2.0,1590,35988,1.0,0,0,4,8,1590,0,1974,0,98058,47.4365,-122.106,2780,23789,34398,21009,8.47782594198066,0.030177049180327868,Very Cheap
20150325T000000,830000.0,4,2.25,3010,12202,1.0,0,0,4,9,3010,0,1959,0,98005,47.6387,-122.174,2480,10143,9192,7663,68.02163579741026,0.09901639344262295,Very Cheap
20150128T000000,810000.0,3,2.5,2610,8481,2.0,0,0,3,10,2610,0,1993,0,98006,47.5535,-122.115,3140,10008,5871,6868,95.5076052352317,0.09639344262295083,Very Cheap
20150113T000000,500000.0,3,2.25,1440,15661,1.0,0,0,3,8,1180,260,1988,0,98074,47.6225,-122.038,1440,13963,14221,12523,31.926441478832768,0.05573770491803279,Very Cheap
20140530T000000,490000.0,3,1.75,1920,5405,1.0,0,2,4,7,960,960,1947,0,98126,47.5583,-122.38,1190,5405,3485,4215,90.65679925994449,0.05442622950819672,Very Cheap
20141028T000000,490000.0,2,1.75,1670,4200,2.0,0,0,3,7,1670,0,1912,0,98116,47.5862,-122.387,1340,2875,2530,1535,116.66666666666667,0.05442622950819672,Very Cheap
20140918T000000,272000.0,4,1.75,1390,10660,1.0,0,0,4,7,1030,360,1960,0,98198,47.4128,-122.323,1800,11960,9270,10160,25.515947467166978,0.02583606557377049,Very Cheap
20140910T000000,280000.0,3,2.25,2140,7200,2.0,0,0,4,7,2140,0,1979,0,98031,47.3913,-122.191,1890,7455,5060,5565,38.888888888888886,0.026885245901639345,Very Cheap
20140625T000000,233000.0,3,1.0,1250,6180,1.5,0,0,3,7,1250,0,1955,0,98155,47.7474,-122.327,1490,6180,4930,4690,37.702265372168284,0.020721311475409836,Very Cheap
20140623T000000,275000.0,3,1.0,1080,6000,1.0,0,0,4,7,1080,0,1952,0,98133,47.7579,-122.33,1200,7210,4920,6010,45.833333333333336,0.02622950819672131,Very Cheap
20140728T000000,375000.0,3,3.25,2760,6420,2.0,0,2,3,9,2110,650,1991,0,98031,47.3895,-122.221,2030,7725,3660,5695,58.41121495327103,0.03934426229508197,Very Cheap
20140826T000000,445000.0,3,2.75,2180,3703,2.0,0,0,3,8,2180,0,2004,0,98011,47.776,-122.169,2190,3963,1523,1773,120.17283283823926,0.04852459016393443,Very Cheap
20140919T000000,437500.0,3,2.5,1260,1125,3.0,0,0,3,8,1260,0,2002,0,98107,47.6706,-122.381,1360,1250,-135,-110,388.8888888888889,0.047540983606557376,Very Cheap
20150511T000000,426250.0,4,1.0,1610,6000,1.5,0,0,4,7,1510,100,1905,0,98118,47.5261,-122.266,1430,6000,4390,4570,71.04166666666667,0.0460655737704918,Very Cheap
20140626T000000,358000.0,3,1.5,2450,12497,1.0,0,0,4,7,2450,0,1967,0,98065,47.5317,-121.834,1560,11700,10047,10140,28.646875250060013,0.03711475409836065,Very Cheap
20141023T000000,1175000.0,4,3.5,4150,49503,2.0,0,0,3,11,4150,0,2003,0,98053,47.6746,-122.018,3330,60137,45353,56807,23.735935195846718,0.14426229508196722,Cheap
20150430T000000,305000.0,2,1.0,960,8276,1.0,0,0,3,5,960,0,1939,0,98027,47.5322,-122.033,1620,6000,7316,4380,36.853552440792654,0.03016393442622951,Very Cheap
20140530T000000,415000.0,2,1.75,1340,4664,1.0,0,0,3,8,1340,0,2004,0,98053,47.7182,-122.034,1350,4236,3324,2886,88.97941680960548,0.04459016393442623,Very Cheap
20140821T000000,520000.0,11,3.0,3000,4960,2.0,0,0,3,7,2400,600,1918,1999,98106,47.556,-122.363,1420,4960,1960,3540,104.83870967741936,0.058360655737704915,Very Cheap
20141013T000000,733000.0,4,3.5,3080,5974,2.0,0,0,3,9,3080,0,2003,0,98075,47.6007,-121.974,2950,5425,2894,2475,122.69835955808503,0.08629508196721311,Very Cheap
20150309T000000,411500.0,3,1.0,1130,8159,1.0,0,0,4,7,1130,0,1954,0,98133,47.7362,-122.333,1570,8162,7029,6592,50.43510234097316,0.04413114754098361,Very Cheap
20140919T000000,540000.0,3,1.75,2280,16671,1.5,0,0,4,6,1760,520,1909,0,98034,47.7096,-122.219,1850,9351,14391,7501,32.39157818967069,0.06098360655737705,Very Cheap
20150224T000000,270500.0,3,1.5,1952,8613,1.0,0,0,4,7,1652,300,1960,0,98032,47.3715,-122.29,1400,8712,6661,7312,31.406014164634854,0.025639344262295083,Very Cheap
20150410T000000,422250.0,2,1.5,1280,1256,2.0,0,0,3,8,1200,80,1998,0,98107,47.6741,-122.375,1390,1256,-24,-134,336.1863057324841,0.045540983606557374,Very Cheap
20140516T000000,655000.0,5,3.25,3690,12353,2.0,0,0,5,9,3690,0,1977,0,98155,47.7672,-122.292,2290,9082,8663,6792,53.023557030680806,0.0760655737704918,Very Cheap
20140807T000000,1200000.0,5,3.25,4610,10576,2.0,0,3,3,11,3310,1300,2006,0,98027,47.5373,-122.07,4042,8321,5966,4279,113.464447806354,0.14754098360655737,Cheap
20140804T000000,550000.0,3,2.5,2920,169448,2.5,0,0,3,9,2920,0,1990,0,98022,47.2492,-121.975,2360,326097,166528,323737,3.245833530050517,0.06229508196721312,Very Cheap
20140506T000000,460000.0,2,2.25,1230,929,2.0,0,0,3,8,1020,210,2004,0,98122,47.6191,-122.301,1270,1370,-301,100,495.15608180839615,0.050491803278688525,Very Cheap
20141025T000000,159075.0,4,1.5,1580,6200,1.0,0,0,3,6,790,790,1944,0,98178,47.4971,-122.24,1320,6499,4620,5179,25.657258064516128,0.011026229508196721,Very Cheap
20141209T000000,470000.0,2,1.0,1220,4000,1.5,0,0,4,6,1220,0,1908,0,98103,47.6801,-122.354,1580,4000,2780,2420,117.5,0.05180327868852459,Very Cheap
20140708T000000,235000.0,2,1.0,1020,7920,1.0,0,0,3,6,1020,0,1939,0,98108,47.5558,-122.31,1530,6900,6900,5370,29.671717171717173,0.02098360655737705,Very Cheap
20140918T000000,309950.0,2,1.5,1510,9843,1.0,0,0,4,7,1510,0,1961,0,98188,47.4419,-122.27,1590,9368,8333,7778,31.489383318094077,0.03081311475409836,Very Cheap
20140523T000000,433000.0,4,1.75,1830,9600,1.0,0,0,4,7,1010,820,1966,0,98006,47.5728,-122.125,1910,11100,7770,9190,45.104166666666664,0.04695081967213115,Very Cheap
20150203T000000,895000.0,3,2.5,2750,10000,1.0,0,3,3,8,1650,1100,1967,0,98006,47.5644,-122.153,2490,10000,7250,7510,89.5,0.10754098360655738,Cheap
20140620T000000,291000.0,3,1.5,1860,60960,1.0,0,0,4,7,1140,720,1967,0,98042,47.3796,-122.102,2170,82764,59100,80594,4.7736220472440944,0.028327868852459016,Very Cheap
20150209T000000,835000.0,3,2.5,2720,13124,2.0,0,0,3,9,2720,0,1988,0,98052,47.6371,-122.094,2760,16200,10404,13440,63.623895153916486,0.09967213114754099,Very Cheap
20150109T000000,640000.0,2,1.0,1360,5000,1.0,0,0,3,7,1200,160,1936,0,98199,47.6372,-122.392,1540,4000,3640,2460,128.0,0.0740983606557377,Very Cheap
20150126T000000,438000.0,3,2.25,2340,14279,1.0,0,0,3,8,1340,1000,1965,0,98006,47.5715,-122.124,2340,13600,11939,11260,30.67441697597871,0.04760655737704918,Very Cheap
20140722T000000,540000.0,4,2.5,2600,9935,2.0,0,0,3,8,2600,0,2005,0,98059,47.4865,-122.142,2830,7620,7335,4790,54.35329642677403,0.06098360655737705,Very Cheap
20150309T000000,325000.0,4,2.5,2090,7434,1.0,0,0,3,7,1090,1000,1993,0,98146,47.4962,-122.349,1260,8404,5344,7144,43.71805219262846,0.03278688524590164,Very Cheap
20150126T000000,380000.0,4,1.75,2260,7200,1.5,0,0,5,7,1360,900,1924,0,98056,47.5122,-122.186,1410,7465,4940,6055,52.77777777777778,0.04,Very Cheap
20141113T000000,510000.0,2,1.0,1390,5544,1.0,0,0,3,7,930,460,1947,0,98105,47.6696,-122.267,1710,6200,4154,4490,91.991341991342,0.057049180327868855,Very Cheap
20140812T000000,380000.0,4,2.5,2300,7707,2.0,0,0,3,8,2300,0,2004,0,98038,47.3497,-122.044,2320,6035,5407,3715,49.30582587258336,0.04,Very Cheap
20140616T000000,825000.0,4,2.5,2810,9800,1.0,0,0,4,8,1710,1100,1973,0,98006,47.5657,-122.149,2800,9800,6990,7000,84.18367346938776,0.09836065573770492,Very Cheap
20140926T000000,880000.0,4,3.25,4060,52707,2.0,0,0,4,9,4060,0,1996,0,98077,47.7615,-122.041,3100,50755,48647,47655,16.69607452520538,0.10557377049180328,Cheap
20150306T000000,1800000.0,3,3.0,2790,13295,2.0,1,4,4,10,2370,420,1933,1989,98006,47.5466,-122.197,3140,11949,10505,8809,135.38924407672056,0.2262295081967213,Cheap
20150107T000000,790000.0,3,1.0,1290,6380,1.5,0,0,3,7,1290,0,1930,0,98115,47.6951,-122.319,1630,6380,5090,4750,123.82445141065831,0.09377049180327869,Very Cheap
20141212T000000,287000.0,2,1.5,720,4346,1.0,0,0,4,6,720,0,1942,0,98106,47.5225,-122.351,790,4346,3626,3556,66.0377358490566,0.02780327868852459,Very Cheap
20140912T000000,509000.0,3,3.0,2130,5000,1.5,0,0,3,7,1570,560,1913,0,98118,47.5451,-122.284,1638,4500,2870,2862,101.8,0.056918032786885245,Very Cheap
20140908T000000,270000.0,3,2.25,1750,8400,1.0,0,0,3,7,1350,400,1965,0,98188,47.4571,-122.272,2020,9110,6650,7090,32.142857142857146,0.025573770491803278,Very Cheap
20140708T000000,210000.0,3,2.0,960,9380,1.0,0,0,3,6,960,0,1949,0,98146,47.4852,-122.343,1460,9240,8420,7780,22.388059701492537,0.017704918032786884,Very Cheap
20141124T000000,415000.0,3,1.0,1570,11752,1.5,0,0,5,8,1570,0,1930,0,98133,47.7686,-122.348,2010,8291,10182,6281,35.313138189244384,0.04459016393442623,Very Cheap
20141205T000000,550000.0,3,2.5,3070,14400,1.0,0,3,5,9,1720,1350,1985,0,98198,47.3716,-122.321,2020,18211,11330,16191,38.19444444444444,0.06229508196721312,Very Cheap
20140709T000000,1250000.0,4,2.5,2920,5500,1.0,0,3,3,10,2030,890,1957,0,98199,47.6406,-122.412,3790,5500,2580,1710,227.27272727272728,0.1540983606557377,Cheap
20140801T000000,499950.0,3,1.0,1870,4984,1.0,0,0,3,7,1120,750,1955,0,98116,47.5771,-122.391,1650,5750,3114,4100,100.3109951845907,0.05573114754098361,Very Cheap
20140905T000000,659000.0,3,1.5,1540,5040,2.0,0,0,3,8,1540,0,1907,0,98122,47.6138,-122.299,1590,3600,3500,2010,130.75396825396825,0.07659016393442623,Very Cheap
20150302T000000,265000.0,2,1.5,1440,22081,2.0,0,0,3,7,1440,0,1990,0,98019,47.7698,-121.896,1440,19544,20641,18104,12.001268058511842,0.024918032786885248,Very Cheap
20140605T000000,492000.0,4,3.75,2810,10840,2.0,0,2,4,8,2070,740,1994,0,98045,47.4861,-121.804,2370,11248,8030,8878,45.38745387453874,0.054688524590163934,Very Cheap
20140813T000000,715000.0,4,2.5,2450,7700,1.0,0,0,3,8,1250,1200,1958,0,98040,47.5731,-122.212,2450,8000,5250,5550,92.85714285714286,0.0839344262295082,Very Cheap
20150313T000000,175000.0,2,1.0,1330,28270,1.5,0,0,3,6,1330,0,1925,0,98168,47.4824,-122.274,1210,6926,26940,5716,6.190307746727981,0.013114754098360656,Very Cheap
20141128T000000,975000.0,4,3.5,3130,52322,2.0,0,0,3,9,2430,700,2011,0,98005,47.5932,-122.159,3200,5820,49192,2620,18.63460876877795,0.1180327868852459,Cheap
20141009T000000,306950.0,1,1.0,730,5005,1.0,0,0,4,5,730,0,1945,0,98117,47.6992,-122.364,1630,5667,4275,4037,61.32867132867133,0.030419672131147543,Very Cheap
20150407T000000,630000.0,4,2.0,2480,3680,1.5,0,0,4,7,1470,1010,1916,0,98116,47.5686,-122.392,1500,5750,1200,4250,171.19565217391303,0.07278688524590164,Very Cheap
20150109T000000,367500.0,3,1.0,1270,8792,1.0,0,0,5,7,1270,0,1969,0,98056,47.5351,-122.174,1780,8792,7522,7012,41.79936305732484,0.03836065573770492,Very Cheap
20150325T000000,699950.0,3,3.25,2230,5460,1.0,0,1,4,8,1430,800,1977,0,98136,47.53,-122.388,2070,5600,3230,3530,128.1959706959707,0.08196065573770492,Very Cheap
20150416T000000,1000000.0,3,3.0,2880,3750,2.0,0,0,3,9,2220,660,1909,1991,98122,47.6155,-122.29,1910,4000,870,2090,266.6666666666667,0.12131147540983607,Cheap
20141016T000000,285000.0,4,2.5,2434,4400,2.0,0,0,3,8,2434,0,2007,0,98001,47.2874,-122.283,2434,4400,1966,1966,64.77272727272727,0.02754098360655738,Very Cheap
20150114T000000,215000.0,2,1.5,1120,1312,2.0,0,0,3,7,1000,120,2004,0,98106,47.534,-122.364,1560,1314,192,-246,163.8719512195122,0.018360655737704918,Very Cheap
20150306T000000,1050000.0,4,2.5,4080,11054,2.0,0,0,3,11,4080,0,2001,0,98059,47.5188,-122.151,3520,11914,6974,8394,94.98823955129365,0.12786885245901639,Cheap
20140509T000000,1370000.0,4,2.75,3720,9450,1.0,0,4,5,10,1960,1760,1962,0,98006,47.5627,-122.156,2900,8605,5730,5705,144.97354497354496,0.16983606557377048,Cheap
20150401T000000,235000.0,3,1.0,1430,7599,1.5,0,0,4,6,1010,420,1930,0,98168,47.4783,-122.265,1290,10320,6169,9030,30.925121726542965,0.02098360655737705,Very Cheap
20150416T000000,604000.0,3,2.0,1560,2589,1.0,0,0,3,7,790,770,1923,2001,98103,47.6587,-122.344,1450,3893,1029,2443,233.29470838161453,0.06937704918032787,Very Cheap
20140530T000000,750000.0,3,1.75,1700,8400,1.0,0,0,3,8,1460,240,1947,0,98199,47.6534,-122.415,2010,7000,6700,4990,89.28571428571429,0.08852459016393442,Very Cheap
20141124T000000,800000.0,4,2.25,2510,9963,1.0,0,0,4,9,2200,310,1967,0,98005,47.5973,-122.177,3110,9963,7453,6853,80.29709926728897,0.09508196721311475,Very Cheap
20150107T000000,580000.0,5,2.0,2600,3750,1.5,0,0,4,6,1400,1200,1914,0,98105,47.6691,-122.299,1700,3750,1150,2050,154.66666666666666,0.06622950819672131,Very Cheap
20141204T000000,350000.0,1,1.0,790,4590,1.0,0,0,3,6,790,0,1911,0,98118,47.5677,-122.285,1070,4590,3800,3520,76.25272331154684,0.036065573770491806,Very Cheap
20141216T000000,353750.0,4,2.0,1710,7490,2.0,0,0,3,7,1320,390,1956,0,98166,47.4544,-122.357,1880,7704,5780,5824,47.22963951935915,0.03655737704918033,Very Cheap
20140604T000000,1100000.0,5,2.75,2660,8737,1.0,0,4,5,8,1470,1190,1969,0,98006,47.5667,-122.155,3280,8783,6077,5503,125.90133913242532,0.13442622950819672,Cheap
20150209T000000,465000.0,4,2.0,1470,10291,1.0,0,0,4,7,1470,0,1963,0,98008,47.6316,-122.121,1460,9601,8821,8141,45.18511320571373,0.051147540983606556,Very Cheap
20140507T000000,568000.0,3,2.0,2350,5080,1.5,0,0,3,8,1780,570,1929,0,98118,47.5516,-122.263,1700,5080,2730,3380,111.81102362204724,0.06465573770491803,Very Cheap
20141106T000000,1005000.0,5,2.0,2440,3080,2.0,0,0,4,8,2440,0,1910,0,98112,47.6242,-122.306,1640,3077,640,1437,326.2987012987013,0.1219672131147541,Cheap
20140916T000000,213500.0,3,1.5,1150,11571,1.0,0,0,3,7,1150,0,1961,0,98168,47.4931,-122.298,1630,11571,10421,9941,18.451300665456746,0.01816393442622951,Very Cheap
20140605T000000,250000.0,3,2.5,1510,10384,1.0,0,0,2,7,1030,480,1976,0,98077,47.758,-122.071,1490,10000,8874,8510,24.075500770416024,0.022950819672131147,Very Cheap
20140703T000000,357000.0,2,1.0,870,4600,1.0,0,0,4,7,870,0,1942,0,98126,47.5274,-122.379,930,4600,3730,3670,77.6086956521739,0.03698360655737705,Very Cheap
20140926T000000,425000.0,2,2.0,1280,4095,2.0,0,0,4,8,1280,0,1918,0,98136,47.5501,-122.393,1470,5500,2815,4030,103.78510378510379,0.04590163934426229,Very Cheap
20140611T000000,571000.0,3,2.5,2600,7465,2.0,0,0,3,9,2600,0,1988,0,98011,47.7387,-122.217,2660,7683,4865,5023,76.49028801071668,0.06504918032786886,Very Cheap
20140519T000000,588000.0,3,2.25,2030,7350,1.0,0,0,4,7,1190,840,1977,0,98052,47.6939,-122.126,1950,7350,5320,5400,80.0,0.06727868852459017,Very Cheap
20140523T000000,275000.0,4,1.5,1930,15531,2.0,0,0,3,7,1930,0,1979,0,98003,47.345,-122.296,1580,7800,13601,6220,17.70652243899298,0.02622950819672131,Very Cheap
20150225T000000,565000.0,3,2.75,3210,15939,2.0,0,1,3,10,3210,0,1998,0,98023,47.3357,-122.351,2870,15939,12729,13069,35.447644143296316,0.06426229508196721,Very Cheap
20150319T000000,460000.0,3,1.75,1970,9135,1.0,0,0,4,7,1370,600,1961,0,98011,47.7603,-122.215,1880,9650,7165,7770,50.355774493705525,0.050491803278688525,Very Cheap
20140604T000000,603500.0,4,2.5,4060,9734,1.0,0,4,3,9,2150,1910,1977,0,98028,47.7678,-122.254,2750,10370,5674,7620,61.999178138483664,0.06931147540983607,Very Cheap
20140703T000000,490600.0,3,2.5,3316,11447,2.0,0,0,3,9,3316,0,1986,0,98023,47.3036,-122.34,3000,11447,8131,8447,42.85839084476282,0.054504918032786884,Very Cheap
20140624T000000,1010000.0,2,2.0,1460,9052,1.0,0,2,5,6,1460,0,1900,0,98033,47.6857,-122.208,2554,7834,7592,5280,111.57755192222713,0.12262295081967213,Cheap
20140827T000000,500000.0,4,2.0,2100,12620,1.0,0,0,4,7,2100,0,1972,0,98034,47.7239,-122.173,1720,7840,10520,6120,39.61965134706814,0.05573770491803279,Very Cheap
20140625T000000,249000.0,4,2.25,1830,6136,2.0,0,0,3,7,1830,0,1990,0,98030,47.367,-122.181,1830,7664,4306,5834,40.58018252933507,0.02281967213114754,Very Cheap
20140603T000000,235000.0,3,2.0,1530,8700,1.0,0,0,4,7,1530,0,1970,0,98055,47.4529,-122.207,1960,7600,7170,5640,27.011494252873565,0.02098360655737705,Very Cheap
20150121T000000,410000.0,4,2.0,1490,13736,1.0,0,0,4,6,1490,0,1942,0,98125,47.712,-122.281,2040,7200,12246,5160,29.848573092603377,0.043934426229508196,Very Cheap
20140701T000000,370000.0,2,1.0,860,6050,1.0,0,0,3,7,860,0,1952,0,98116,47.5697,-122.4,1130,6050,5190,4920,61.15702479338843,0.038688524590163934,Very Cheap
20140916T000000,360000.0,5,2.5,2130,7111,1.0,0,0,3,7,1330,800,1968,0,98059,47.5071,-122.16,1840,7592,4981,5752,50.62579102798481,0.037377049180327866,Very Cheap
20141205T000000,1406890.0,5,2.25,3580,16789,2.0,0,0,5,9,3580,0,1966,0,98040,47.5364,-122.239,3390,17000,13209,13610,83.7983203287867,0.17467409836065573,Cheap
20141121T000000,298000.0,4,2.5,2420,3825,2.0,0,0,3,8,2420,0,2003,0,98042,47.3687,-122.126,1880,4250,1405,2370,77.90849673202614,0.029245901639344263,Very Cheap
20140708T000000,485000.0,4,2.25,1900,7200,1.0,0,0,3,8,1370,530,1977,0,98146,47.5033,-122.372,2030,8008,5300,5978,67.36111111111111,0.05377049180327869,Very Cheap
20140826T000000,400000.0,3,1.75,1330,9143,1.0,0,0,3,7,1330,0,1960,0,98006,47.5538,-122.176,1950,10384,7813,8434,43.74931641693099,0.04262295081967213,Very Cheap
20140805T000000,580000.0,3,2.5,2150,4604,2.0,0,0,3,8,2150,0,2003,0,98075,47.5893,-122.019,2280,4253,2454,1973,125.97741094700261,0.06622950819672131,Very Cheap
20140807T000000,355000.0,2,2.5,1370,1140,2.0,0,0,3,8,1080,290,2009,0,98133,47.7055,-122.342,1340,1050,-230,-290,311.4035087719298,0.036721311475409836,Very Cheap
20140721T000000,650000.0,3,2.5,2430,12997,2.0,0,0,3,9,2430,0,1992,0,98011,47.744,-122.194,2720,12500,10567,9780,50.011541124874974,0.07540983606557378,Very Cheap
20140929T000000,261490.0,4,1.0,1640,8467,1.0,0,2,4,6,1220,420,1943,0,98056,47.4894,-122.188,1060,7396,6827,6336,30.883429786228888,0.024457704918032785,Very Cheap
20140716T000000,347000.0,3,1.0,1010,7200,1.0,0,0,3,7,1010,0,1968,0,98034,47.7225,-122.179,1120,7200,6190,6080,48.19444444444444,0.03567213114754098,Very Cheap
20140519T000000,485000.0,3,1.0,1500,4100,1.5,0,0,3,7,1370,130,1926,0,98107,47.6689,-122.367,1500,4100,2600,2600,118.29268292682927,0.05377049180327869,Very Cheap
20141022T000000,601000.0,3,2.5,1740,1251,2.0,0,0,3,9,1180,560,2012,0,98199,47.644,-122.385,1740,1625,-489,-115,480.4156674660272,0.06898360655737705,Very Cheap
20150411T000000,380000.0,3,3.25,2090,51212,1.0,0,0,3,8,1510,580,1989,0,98092,47.3097,-122.099,2690,40820,49122,38130,7.420135905647114,0.04,Very Cheap
20140829T000000,565000.0,3,3.0,1850,12556,2.0,0,0,3,9,1850,0,1976,0,98074,47.6286,-122.053,2390,12474,10706,10084,44.998407136030586,0.06426229508196721,Very Cheap
20150323T000000,750000.0,3,2.5,2790,21043,2.0,0,0,3,9,2790,0,1993,0,98053,47.673,-122.03,2900,34589,18253,31689,35.641305897448085,0.08852459016393442,Very Cheap
20150107T000000,291000.0,3,2.25,1480,7200,1.0,0,0,3,7,1190,290,1975,0,98023,47.3037,-122.375,1830,7200,5720,5370,40.416666666666664,0.028327868852459016,Very Cheap
20141105T000000,560000.0,3,2.5,2280,12498,2.0,0,0,4,9,2280,0,1987,0,98029,47.5688,-122.014,2330,8844,10218,6514,44.80716914706353,0.06360655737704918,Very Cheap
20150325T000000,725000.0,4,2.25,3180,9600,2.0,0,0,3,10,3180,0,1984,0,98074,47.6313,-122.045,2840,10739,6420,7899,75.52083333333333,0.08524590163934426,Very Cheap
20140903T000000,539000.0,3,2.0,2350,209088,1.0,0,0,3,7,2350,0,1993,0,98014,47.6527,-121.949,2300,209088,206738,206788,2.577861952861953,0.06085245901639344,Very Cheap
20140722T000000,470000.0,5,3.25,3910,7077,2.0,0,0,3,9,2710,1200,2000,0,98038,47.3766,-122.027,2650,7077,3167,4427,66.41232160519995,0.05180327868852459,Very Cheap
20150109T000000,264950.0,2,1.0,770,7434,1.0,0,0,3,6,770,0,1947,0,98155,47.7606,-122.32,1060,7453,6664,6393,35.64030131826742,0.024911475409836067,Very Cheap
20150225T000000,200000.0,4,1.5,1780,8000,2.0,0,0,4,6,1080,700,1900,1996,98010,47.3124,-122.003,1750,9147,6220,7397,25.0,0.01639344262295082,Very Cheap
20140604T000000,453500.0,5,2.5,2300,23345,1.0,0,0,5,7,1170,1130,1967,0,98059,47.4739,-122.114,2280,23345,21045,21065,19.42600128507175,0.04963934426229508,Very Cheap
20140825T000000,811000.0,2,2.5,2510,17986,2.0,0,0,3,9,2510,0,1943,2014,98052,47.6832,-122.164,2440,8039,15476,5599,45.09062604247748,0.09652459016393443,Very Cheap
20140916T000000,425000.0,3,3.25,1410,1350,3.0,0,0,3,8,1410,0,2005,0,98103,47.698,-122.34,1410,1253,-60,-157,314.81481481481484,0.04590163934426229,Very Cheap
20140918T000000,1530000.0,4,2.25,4250,16940,1.0,0,2,4,9,2380,1870,1974,0,98040,47.5453,-122.234,3460,17693,12690,14233,90.31877213695395,0.19081967213114753,Cheap
20141229T000000,562000.0,4,2.75,2560,83200,1.0,0,0,3,8,1860,700,1980,0,98072,47.7511,-122.111,1990,38332,80640,36342,6.7548076923076925,0.0638688524590164,Very Cheap
20140723T000000,281000.0,3,2.5,1760,7601,2.0,0,0,3,8,1760,0,1992,0,98003,47.2672,-122.313,1920,6851,5841,4931,36.968819892119456,0.027016393442622952,Very Cheap
20141016T000000,270000.0,3,2.25,2100,14027,2.0,0,0,3,8,2100,0,1979,0,98042,47.3833,-122.1,2730,5999,11927,3269,19.248592001140658,0.025573770491803278,Very Cheap
20140811T000000,205950.0,3,1.0,1490,8239,1.0,0,0,4,6,1490,0,1963,0,98023,47.306,-122.37,1200,8470,6749,7270,24.99696565117126,0.01717377049180328,Very Cheap
20140625T000000,310000.0,2,1.0,870,5400,1.0,0,0,3,6,870,0,1950,2007,98126,47.52,-122.374,990,5200,4530,4210,57.407407407407405,0.03081967213114754,Very Cheap
20150312T000000,350000.0,3,1.75,1260,1111,2.0,0,0,3,8,1260,0,2003,0,98029,47.5476,-122.005,1410,1630,-149,220,315.031503150315,0.036065573770491806,Very Cheap
20140601T000000,843500.0,4,2.0,2630,16475,2.0,0,0,4,8,2630,0,1953,0,98004,47.639,-122.219,2670,15001,13845,12331,51.198786039453715,0.10078688524590164,Cheap
20150508T000000,370000.0,4,2.0,1950,3757,1.0,0,0,4,6,1160,790,1908,0,98118,47.5372,-122.269,1720,3757,1807,2037,98.48283204684589,0.038688524590163934,Very Cheap
20140620T000000,279000.0,4,2.0,2200,7700,1.0,0,0,3,7,1100,1100,1979,0,98058,47.464,-122.18,1790,7700,5500,5910,36.23376623376623,0.02675409836065574,Very Cheap
20150102T000000,408000.0,3,1.75,1600,313672,1.0,0,0,4,7,1600,0,1960,0,98058,47.4129,-122.08,1780,90860,312072,89080,1.300721773062307,0.04367213114754098,Very Cheap
20150106T000000,392000.0,3,1.0,1230,9600,1.0,0,0,3,7,1230,0,1952,0,98118,47.5553,-122.288,1510,6600,8370,5090,40.833333333333336,0.04157377049180328,Very Cheap
20140929T000000,455000.0,2,1.0,1030,5000,1.0,0,0,5,6,1030,0,1917,0,98107,47.6585,-122.363,1550,5000,3970,3450,91.0,0.049836065573770495,Very Cheap
20141113T000000,310000.0,2,1.5,1040,83199,1.0,0,0,4,7,870,170,1965,0,98070,47.4222,-122.443,1760,75794,82159,74034,3.7260063221913726,0.03081967213114754,Very Cheap
20140917T000000,323500.0,3,3.0,2240,11536,2.0,0,0,3,7,2240,0,1943,2005,98178,47.4886,-122.245,1650,8760,9296,7110,28.042649098474342,0.03259016393442623,Very Cheap
20140926T000000,364500.0,3,1.0,1600,4489,1.0,0,2,3,6,800,800,1944,0,98126,47.5686,-122.378,1640,6013,2889,4373,81.19848518601025,0.0379672131147541,Very Cheap
20140509T000000,280000.0,4,2.0,2190,14439,1.0,0,0,4,7,1180,1010,1977,0,98001,47.2702,-122.29,2160,14439,12249,12279,19.391924648521364,0.026885245901639345,Very Cheap
20141215T000000,289900.0,3,1.75,1899,11325,2.0,0,0,3,7,1899,0,1943,2005,98198,47.3987,-122.3,2000,10454,9426,8454,25.598233995584987,0.02818360655737705,Very Cheap
20140613T000000,585000.0,3,1.0,1870,2807,1.5,0,0,4,7,1580,290,1927,0,98107,47.6674,-122.358,1640,4500,937,2860,208.4075525472034,0.06688524590163934,Very Cheap
20140916T000000,269000.0,3,2.5,1730,6653,1.0,0,0,4,7,1360,370,1990,0,98042,47.3588,-122.088,1730,7061,4923,5331,40.43288741920938,0.02544262295081967,Very Cheap
20140808T000000,280000.0,3,2.25,1860,9210,2.0,0,0,3,7,1860,0,1994,0,98038,47.3864,-122.03,1530,8091,7350,6561,30.40173724212812,0.026885245901639345,Very Cheap
20150409T000000,287000.0,3,1.75,1940,9000,1.0,0,0,3,7,1290,650,1965,0,98055,47.4361,-122.189,1900,9120,7060,7220,31.88888888888889,0.02780327868852459,Very Cheap
20140812T000000,183000.0,2,1.0,670,5140,1.0,0,0,3,6,670,0,1926,0,98126,47.5387,-122.371,850,5140,4470,4290,35.60311284046693,0.014163934426229508,Very Cheap
20141219T000000,309000.0,3,1.0,1820,8142,1.0,0,0,3,7,1040,780,1961,0,98168,47.505,-122.316,1820,8142,6322,6322,37.95136330140015,0.030688524590163933,Very Cheap
20141013T000000,920000.0,4,2.5,3810,13579,2.0,0,0,3,10,3810,0,2003,0,98007,47.6006,-122.153,3310,9270,9769,5960,67.75167538110317,0.11081967213114755,Cheap
20140929T000000,815241.0,5,2.25,2060,4800,2.5,0,0,3,8,2060,0,1907,0,98105,47.66,-122.282,1740,4800,2740,3060,169.841875,0.0970807868852459,Very Cheap
20141121T000000,405000.0,3,1.75,1520,7252,1.0,0,0,3,7,1140,380,1975,0,98072,47.7358,-122.175,1910,7820,5732,5910,55.846662989520134,0.043278688524590166,Very Cheap
20150430T000000,525000.0,5,3.5,3450,19080,2.0,0,3,3,9,3450,0,2001,0,98022,47.2123,-122.005,2570,17007,15630,14437,27.51572327044025,0.05901639344262295,Very Cheap
20140717T000000,150000.0,2,1.0,830,4045,1.0,0,0,3,6,830,0,1943,0,98106,47.5293,-122.351,1100,4116,3215,3016,37.08281829419036,0.009836065573770493,Very Cheap
20140925T000000,240000.0,4,1.75,1880,9600,1.0,0,0,5,7,1020,860,1946,0,98001,47.2633,-122.281,1560,14400,7720,12840,25.0,0.021639344262295083,Very Cheap
20140502T000000,698000.0,4,2.25,2200,11250,1.5,0,0,5,7,1300,900,1920,0,98033,47.6845,-122.201,2320,10814,9050,8494,62.044444444444444,0.08170491803278689,Very Cheap
20150309T000000,440000.0,3,2.0,1800,10950,1.0,0,0,4,8,1800,0,1982,0,98006,47.557,-122.163,2400,11300,9150,8900,40.182648401826484,0.04786885245901639,Very Cheap
20150414T000000,204000.0,3,1.0,1200,12500,1.5,0,0,3,6,1200,0,1936,0,98198,47.4162,-122.329,1200,7500,11300,6300,16.32,0.016918032786885247,Very Cheap
20140516T000000,875000.0,3,2.0,2220,6641,1.0,0,2,4,7,1220,1000,1947,0,98199,47.6426,-122.388,1800,5900,4421,4100,131.75726547206747,0.10491803278688525,Cheap
20140703T000000,650000.0,3,1.5,1380,4500,1.0,0,0,5,7,1380,0,1960,0,98040,47.5866,-122.25,1590,9000,3120,7410,144.44444444444446,0.07540983606557378,Very Cheap
20150408T000000,392500.0,3,1.0,1660,8839,1.0,0,0,4,7,1660,0,1947,0,98155,47.7485,-122.3,1230,9236,7179,8006,44.40547573254893,0.04163934426229508,Very Cheap
20141017T000000,400000.0,4,1.0,2320,4000,1.5,0,0,3,6,1310,1010,1921,0,98144,47.573,-122.312,1750,4000,1680,2250,100.0,0.04262295081967213,Very Cheap
20150428T000000,653000.0,3,2.25,2800,17300,1.0,0,0,4,8,1420,1380,1971,0,98006,47.5716,-122.128,2140,12650,14500,10510,37.74566473988439,0.07580327868852459,Very Cheap
20140520T000000,452000.0,4,1.0,1210,3760,1.5,0,0,3,6,1210,0,1900,0,98103,47.6872,-122.344,1540,3800,2550,2260,120.2127659574468,0.04944262295081967,Very Cheap
20140506T000000,345000.0,4,2.5,2331,3826,2.0,0,0,3,8,2331,0,2007,0,98058,47.4444,-122.182,2441,3826,1495,1385,90.17250392054365,0.03540983606557377,Very Cheap
20141202T000000,350000.0,4,1.75,1820,6930,1.0,0,2,4,7,1320,500,1952,0,98178,47.5053,-122.242,1820,6825,5110,5005,50.505050505050505,0.036065573770491806,Very Cheap
20140731T000000,650000.0,4,2.5,2860,5576,2.0,0,0,3,8,2860,0,2004,0,98028,47.745,-122.224,2290,10667,2716,8377,116.57101865136299,0.07540983606557378,Very Cheap
20140527T000000,525000.0,5,3.0,2750,3800,1.5,0,0,5,7,1750,1000,1926,0,98115,47.6845,-122.313,1900,3800,1050,1900,138.1578947368421,0.05901639344262295,Very Cheap
20150126T000000,840000.0,5,3.0,2750,3800,1.5,0,0,5,7,1750,1000,1926,0,98115,47.6845,-122.313,1900,3800,1050,1900,221.05263157894737,0.10032786885245902,Cheap
20141124T000000,1325000.0,3,2.5,2280,5000,2.0,0,3,4,9,2280,0,1926,0,98105,47.6574,-122.278,2200,5000,2720,2800,265.0,0.16393442622950818,Cheap
20150120T000000,259950.0,4,2.0,1610,6650,1.0,0,0,3,7,1610,0,1989,0,98023,47.3085,-122.358,1960,6650,5040,4690,39.090225563909776,0.024255737704918033,Very Cheap
20150220T000000,998000.0,5,3.5,3760,10207,2.0,0,0,3,10,3150,610,1969,0,98040,47.5605,-122.225,3550,12118,6447,8568,97.77603605368864,0.12104918032786885,Cheap
20140610T000000,1070000.0,3,3.0,2940,4622,2.0,0,0,4,9,2230,710,1988,0,98105,47.6641,-122.293,1580,4000,1682,2420,231.50151449588924,0.13049180327868853,Cheap
20140710T000000,1910000.0,4,3.0,4460,6833,2.0,0,0,3,10,3140,1320,1955,2007,98112,47.6342,-122.289,3130,7450,2373,4320,279.52583052831847,0.24065573770491802,Cheap
20150309T000000,190500.0,3,1.5,1110,1150,2.0,0,0,3,8,940,170,2007,0,98144,47.5929,-122.306,1380,1751,40,371,165.65217391304347,0.015147540983606557,Very Cheap
20141112T000000,465000.0,3,2.25,2560,117176,1.0,0,0,4,9,1280,1280,1977,0,98027,47.4655,-122.033,2760,57063,114616,54303,3.9683894312828567,0.051147540983606556,Very Cheap
20150204T000000,370000.0,3,1.0,1060,7419,1.0,0,2,4,6,1060,0,1906,0,98177,47.7712,-122.392,2190,5953,6359,3763,49.871950397627714,0.038688524590163934,Very Cheap
20140731T000000,290000.0,6,4.5,2810,11214,1.0,0,0,3,8,2010,800,1958,0,98031,47.4045,-122.197,1940,8349,8404,6409,25.860531478509007,0.02819672131147541,Very Cheap
20141104T000000,350000.0,3,1.75,1380,4590,1.0,0,0,2,7,930,450,1950,0,98115,47.6841,-122.293,1320,4692,3210,3372,76.25272331154684,0.036065573770491806,Very Cheap
20150305T000000,740000.0,3,1.75,1380,4590,1.0,0,0,2,7,930,450,1950,0,98115,47.6841,-122.293,1320,4692,3210,3372,161.22004357298474,0.08721311475409836,Very Cheap
20141007T000000,460000.0,3,1.75,2560,8400,1.0,0,0,3,7,1970,590,1959,0,98011,47.7668,-122.197,1970,8400,5840,6430,54.76190476190476,0.050491803278688525,Very Cheap
20140826T000000,290000.0,3,1.0,1010,10800,1.0,0,0,4,7,1010,0,1972,0,98045,47.4483,-121.773,1370,9500,9790,8130,26.85185185185185,0.02819672131147541,Very Cheap
20140918T000000,475000.0,3,1.5,1790,229125,2.0,0,3,3,7,1790,0,1987,0,98022,47.2309,-122.009,1970,216928,227335,214958,2.073104200763775,0.05245901639344262,Very Cheap
20140926T000000,214000.0,3,2.5,1600,2231,2.0,0,0,3,7,1600,0,2003,0,98001,47.3314,-122.29,1600,2962,631,1362,95.92111160914388,0.01822950819672131,Very Cheap
20150508T000000,455000.0,2,1.0,910,5759,1.0,0,0,3,6,910,0,1951,0,98125,47.7153,-122.284,1520,7518,4849,5998,79.00677200902935,0.049836065573770495,Very Cheap
20140725T000000,275000.0,3,2.5,2497,4400,2.0,0,0,3,8,2497,0,2007,0,98001,47.2873,-122.283,2434,4400,1903,1966,62.5,0.02622950819672131,Very Cheap
20140709T000000,305000.0,3,1.5,1800,12196,1.0,0,0,4,7,1800,0,1966,0,98023,47.333,-122.345,1490,11730,10396,10240,25.008199409642504,0.03016393442622951,Very Cheap
20150409T000000,449000.0,5,2.5,2570,61855,1.0,0,0,4,7,1470,1100,1981,0,98092,47.3013,-122.109,1990,49658,59285,47668,7.258911971546358,0.049049180327868855,Very Cheap
20141021T000000,366000.0,3,2.5,1320,4320,1.0,0,0,3,6,660,660,1918,0,98106,47.5327,-122.347,1190,4200,3000,3010,84.72222222222223,0.03816393442622951,Very Cheap
20150328T000000,348000.0,3,2.5,1670,5090,2.0,0,0,3,7,1670,0,2003,0,98056,47.4799,-122.18,2560,4851,3420,2291,68.36935166994107,0.03580327868852459,Very Cheap
20141203T000000,515000.0,4,2.5,2800,21370,2.0,0,0,3,8,2800,0,2003,0,98028,47.776,-122.246,1880,9336,18570,7456,24.099204492278897,0.057704918032786885,Very Cheap
20140620T000000,950000.0,4,2.5,3360,11548,2.0,0,0,3,9,3360,0,1988,0,98033,47.6534,-122.182,3400,14091,8188,10691,82.26532732940768,0.11475409836065574,Cheap
20140730T000000,815000.0,3,2.5,2590,21494,2.0,0,0,4,8,2590,0,1991,0,98074,47.6139,-122.061,2590,10720,18904,8130,37.917558388387455,0.09704918032786886,Very Cheap
20150120T000000,199950.0,3,3.0,1530,2132,2.0,0,0,3,8,1530,0,1993,0,98038,47.3746,-122.056,1530,3384,602,1854,93.78517823639775,0.01638688524590164,Very Cheap
20140605T000000,386000.0,3,2.0,1330,8100,1.0,0,0,4,7,1330,0,1969,0,98034,47.7251,-122.175,1590,8100,6770,6510,47.65432098765432,0.04078688524590164,Very Cheap
20150102T000000,273000.0,3,2.25,2160,7964,2.0,0,0,3,8,2160,0,1991,0,98042,47.3622,-122.074,2000,7964,5804,5964,34.27925665494726,0.025967213114754098,Very Cheap
20150325T000000,284000.0,4,2.5,1830,6360,2.0,0,0,3,8,1830,0,1994,0,98031,47.4184,-122.18,1830,6596,4530,4766,44.65408805031446,0.027409836065573772,Very Cheap
20140826T000000,399950.0,3,1.0,1470,7930,1.0,0,0,3,7,1070,400,1950,0,98177,47.7013,-122.368,1440,8100,6460,6660,50.435056746532155,0.04261639344262295,Very Cheap
20150115T000000,285000.0,3,1.75,1150,6423,1.0,0,0,3,5,590,560,1927,0,98115,47.6973,-122.297,1150,8367,5273,7217,44.3717888836992,0.02754098360655738,Very Cheap
20150403T000000,315000.0,3,2.5,1790,6452,2.0,0,0,3,7,1790,0,2004,0,98038,47.3841,-122.042,1610,3600,4662,1990,48.822070675759456,0.031475409836065574,Very Cheap
20140807T000000,250000.0,3,1.0,1700,7700,1.0,0,0,3,7,1120,580,1960,0,98168,47.5114,-122.318,1700,8800,6000,7100,32.467532467532465,0.022950819672131147,Very Cheap
20150316T000000,290000.0,4,2.0,1630,7618,1.5,0,0,3,7,1630,0,1967,0,98198,47.3658,-122.317,1320,8774,5988,7454,38.0677343134681,0.02819672131147541,Very Cheap
20140623T000000,725000.0,4,2.5,3420,30410,2.0,0,0,3,9,3420,0,1988,0,98077,47.7745,-122.088,2940,45916,26990,42976,23.84084182834594,0.08524590163934426,Very Cheap
20140523T000000,410000.0,3,2.0,1650,9641,1.5,0,0,3,7,1650,0,1983,0,98034,47.7145,-122.231,1940,6701,7991,4761,42.52670884762991,0.043934426229508196,Very Cheap
20140817T000000,855000.0,4,2.5,2810,52062,1.5,0,0,4,9,2810,0,1988,0,98075,47.5941,-122.029,3330,49783,49252,46453,16.42272674887634,0.10229508196721311,Cheap
20140728T000000,399900.0,4,2.5,2710,8127,2.0,0,0,3,8,2710,0,1994,0,98038,47.379,-122.032,2520,8436,5417,5916,49.20634920634921,0.042609836065573774,Very Cheap
20140611T000000,852600.0,4,2.5,3320,11901,2.0,0,0,5,9,2650,670,1977,0,98006,47.554,-122.16,2700,11114,8581,8414,71.64103856818755,0.10198032786885246,Cheap
20140808T000000,235000.0,2,1.0,720,6321,1.0,0,0,3,6,720,0,1940,0,98118,47.551,-122.289,920,5684,5601,4764,37.17766176237937,0.02098360655737705,Very Cheap
20140807T000000,230950.0,2,1.0,930,12724,1.0,0,0,4,6,930,0,1912,0,98014,47.6567,-121.909,1240,21828,11794,20588,18.150738761395786,0.02045245901639344,Very Cheap
20150330T000000,230000.0,3,2.25,1490,8722,2.0,0,0,3,7,1490,0,1997,0,98030,47.3648,-122.185,1510,8061,7232,6551,26.370098601238247,0.020327868852459016,Very Cheap
20140729T000000,404763.0,3,2.5,1690,1609,2.0,0,0,3,8,1150,540,2014,0,98029,47.5521,-121.998,1690,1860,-81,170,251.56183965195774,0.04324760655737705,Very Cheap
20140923T000000,245000.0,3,2.5,1720,3407,2.0,0,0,3,7,1720,0,1992,0,98031,47.4034,-122.188,1720,3407,1687,1687,71.91077194012327,0.022295081967213116,Very Cheap
20150129T000000,188000.0,3,1.5,1140,8500,1.0,0,0,4,7,1140,0,1964,0,98022,47.2093,-122.005,1600,8500,7360,6900,22.11764705882353,0.014819672131147541,Very Cheap
20141204T000000,626100.0,4,2.5,2280,7219,2.0,0,0,4,8,2280,0,1987,0,98029,47.5719,-122.021,2240,7471,4939,5231,86.72946391466962,0.07227540983606558,Very Cheap
20150302T000000,428750.0,3,1.0,1100,4080,1.0,0,0,4,7,900,200,1929,0,98103,47.6872,-122.351,1170,4080,2980,2910,105.08578431372548,0.04639344262295082,Very Cheap
20140512T000000,522000.0,4,2.25,1800,8623,1.0,0,0,4,8,1360,440,1980,0,98033,47.692,-122.184,2370,8623,6823,6253,60.5357764119216,0.05862295081967213,Very Cheap
20150311T000000,684000.0,4,2.5,2500,8434,2.0,0,0,4,8,2500,0,1988,0,98052,47.6915,-122.101,1900,8131,5934,6231,81.10030827602561,0.0798688524590164,Very Cheap
20150420T000000,1065500.0,3,2.25,2950,7232,1.0,0,2,3,8,1520,1430,1983,0,98136,47.5257,-122.382,2130,7140,4282,5010,147.33130530973452,0.1299016393442623,Cheap
20150505T000000,611206.0,1,1.0,1940,6300,1.0,0,3,3,8,1940,0,1963,0,98116,47.5782,-122.4,2560,6300,4360,3740,97.0168253968254,0.07032209836065574,Very Cheap
20140915T000000,350000.0,2,1.0,1280,5250,1.0,0,0,4,7,1140,140,1942,0,98126,47.5258,-122.377,1050,5250,3970,4200,66.66666666666667,0.036065573770491806,Very Cheap
20150423T000000,894000.0,4,2.5,3800,22029,2.0,0,0,3,9,3800,0,1993,0,98053,47.6734,-122.026,3170,24979,18229,21809,40.58286803758682,0.10740983606557378,Cheap
20140903T000000,420000.0,2,1.0,930,5368,1.0,0,0,4,7,930,0,1953,0,98115,47.6952,-122.275,1770,6000,4438,4230,78.2414307004471,0.04524590163934426,Very Cheap
20140529T000000,400000.0,5,2.0,1930,9747,1.0,0,0,4,7,1020,910,1962,0,98028,47.7743,-122.235,2040,9370,7817,7330,41.038268185082586,0.04262295081967213,Very Cheap
20140525T000000,675000.0,3,3.0,2980,28000,1.0,0,0,3,10,1820,1160,1981,0,98052,47.7318,-122.139,2570,28500,25020,25930,24.107142857142858,0.07868852459016394,Very Cheap
20140520T000000,426000.0,4,2.5,2800,8494,2.0,0,0,3,8,2800,0,2004,0,98038,47.3521,-122.009,3740,8494,5694,4754,50.153049211207914,0.046032786885245904,Very Cheap
20140627T000000,750000.0,4,2.25,3190,11597,2.0,0,0,3,10,2300,890,1984,0,98074,47.6323,-122.039,2990,10679,8407,7689,64.67189790463051,0.08852459016393442,Very Cheap
20140609T000000,368000.0,3,1.75,1710,10800,1.0,0,0,4,7,1710,0,1958,0,98028,47.7391,-122.241,1890,10800,9090,8910,34.074074074074076,0.03842622950819672,Very Cheap
20150327T000000,342000.0,3,1.0,1980,6450,1.0,0,0,4,6,1120,860,1950,0,98106,47.5291,-122.356,1180,5160,4470,3980,53.02325581395349,0.03501639344262295,Very Cheap
20140605T000000,700000.0,3,1.75,1910,4800,1.0,0,0,3,7,1080,830,1959,0,98103,47.6844,-122.332,1750,4800,2890,3050,145.83333333333334,0.08196721311475409,Very Cheap
20140722T000000,848750.0,6,3.75,3160,5000,2.0,0,0,3,8,3160,0,1989,0,98107,47.6748,-122.384,1740,5000,1840,3260,169.75,0.10147540983606558,Cheap
20150303T000000,720000.0,3,2.0,1590,5200,1.0,0,0,3,7,1320,270,1939,0,98103,47.6864,-122.341,1620,5150,3610,3530,138.46153846153845,0.08459016393442623,Very Cheap
20140922T000000,525000.0,4,2.25,1890,8549,1.0,0,0,3,8,1890,0,1967,0,98008,47.6328,-122.117,1940,7210,6659,5270,61.41069130892502,0.05901639344262295,Very Cheap
20150324T000000,397900.0,3,2.75,2500,35245,1.0,0,0,3,7,1580,920,2000,0,98042,47.3414,-122.117,2060,153766,32745,151706,11.289544616257626,0.04234754098360656,Very Cheap
20140815T000000,405000.0,3,2.0,1740,18000,1.0,0,0,3,7,1230,510,1989,0,98028,47.7397,-122.242,1740,11250,16260,9510,22.5,0.043278688524590166,Very Cheap
20150128T000000,392800.0,3,2.0,1080,11856,1.0,0,0,5,7,1080,0,1986,0,98033,47.6955,-122.175,1220,9247,10776,8027,33.13090418353576,0.04167868852459016,Very Cheap
20150224T000000,394999.0,3,1.5,1730,7800,1.0,0,0,3,7,1330,400,1958,0,98133,47.7365,-122.337,1780,8309,6070,6529,50.640897435897436,0.04196708196721311,Very Cheap
20140619T000000,340000.0,3,2.5,2480,6112,2.0,0,0,3,7,2480,0,2004,0,98058,47.4387,-122.114,3220,6727,3632,3507,55.6282722513089,0.03475409836065574,Very Cheap
20140519T000000,482500.0,3,2.25,1450,1445,2.0,0,0,3,7,980,470,2005,0,98122,47.6184,-122.301,1510,1370,-5,-140,333.9100346020761,0.053442622950819675,Very Cheap
20140909T000000,812500.0,4,2.5,2750,10159,2.0,0,0,3,10,2750,0,1991,0,98006,47.5426,-122.135,3160,10159,7409,6999,79.97834432522886,0.09672131147540984,Very Cheap
20140926T000000,450000.0,3,2.5,2820,10208,1.0,0,1,4,8,1410,1410,1954,0,98028,47.7609,-122.26,1540,10684,7388,9144,44.08307210031348,0.04918032786885246,Very Cheap
20141104T000000,398000.0,3,1.75,1830,27468,1.0,0,0,3,7,1830,0,1954,0,98028,47.7754,-122.233,1860,10180,25638,8320,14.489587884083297,0.042360655737704915,Very Cheap
20150507T000000,1075000.0,2,3.25,1550,1767,3.0,1,3,3,8,1550,0,2006,0,98075,47.5684,-122.06,2710,3444,217,734,608.3757781550651,0.13114754098360656,Cheap
20141014T000000,540000.0,2,2.0,1640,3021,1.0,0,2,3,7,840,800,1959,0,98107,47.666,-122.358,1780,4500,1381,2720,178.74875868917576,0.06098360655737705,Very Cheap
20141003T000000,275000.0,4,2.0,1720,5472,1.0,0,0,3,6,860,860,1923,0,98118,47.5299,-122.288,1720,5670,3752,3950,50.255847953216374,0.02622950819672131,Very Cheap
20140822T000000,780000.0,5,2.0,2880,12000,2.0,0,0,3,8,2880,0,1921,0,98144,47.5861,-122.295,1720,5000,9120,3280,65.0,0.09245901639344262,Very Cheap
20140724T000000,225000.0,3,1.5,1220,8345,1.5,0,0,3,7,1220,0,1931,0,98178,47.5038,-122.266,1880,10169,7125,8289,26.962252846015577,0.019672131147540985,Very Cheap
20140722T000000,503045.0,3,3.0,1560,2250,2.0,0,0,3,9,1560,0,2009,0,98103,47.6929,-122.333,1610,4500,690,2890,223.57555555555555,0.05613704918032787,Very Cheap
20140912T000000,249000.0,2,2.0,1090,1357,2.0,0,0,3,7,1090,0,1990,0,98028,47.7526,-122.244,1078,1318,267,240,183.49299926308032,0.02281967213114754,Very Cheap
20140710T000000,569950.0,4,1.0,1140,5940,1.0,0,2,3,7,1140,0,1916,0,98103,47.6795,-122.354,1630,4000,4800,2370,95.95117845117845,0.06491147540983606,Very Cheap
20150126T000000,450000.0,2,2.25,1040,1377,2.0,0,0,3,8,1040,0,2003,0,98105,47.6692,-122.279,1264,1892,337,628,326.797385620915,0.04918032786885246,Very Cheap
20140603T000000,1099500.0,4,2.0,2580,6000,1.0,0,0,5,9,1300,1280,1950,0,98199,47.6514,-122.413,2300,6200,3420,3900,183.25,0.13436065573770492,Cheap
20140530T000000,700000.0,4,2.5,2310,3570,1.5,0,0,3,7,1490,820,1927,2014,98103,47.6889,-122.347,1580,3060,1260,1480,196.07843137254903,0.08196721311475409,Very Cheap
20140819T000000,454000.0,3,2.5,1590,4094,2.0,0,0,3,7,1590,0,1991,0,98122,47.61,-122.293,1940,3924,2504,1984,110.89399120664388,0.049704918032786885,Very Cheap
20150429T000000,555000.0,3,1.75,1270,9170,1.0,0,0,3,7,1270,0,1969,0,98052,47.6706,-122.151,1700,8500,7900,6800,60.523446019629226,0.06295081967213115,Very Cheap
20150106T000000,214000.0,3,1.5,1240,5200,1.0,0,0,5,6,1240,0,1970,0,98042,47.3683,-122.079,1060,5200,3960,4140,41.15384615384615,0.01822950819672131,Very Cheap
20140808T000000,590000.0,3,2.5,2210,8622,2.0,0,0,3,8,2210,0,1988,0,98029,47.5715,-122.02,2340,7192,6412,4852,68.42959870099745,0.06754098360655737,Very Cheap
20140811T000000,459900.0,3,1.75,2340,51836,1.5,0,0,3,8,1510,830,1978,0,98027,47.4846,-122.035,2060,77536,49496,75476,8.872212362064975,0.050478688524590164,Very Cheap
20150512T000000,205000.0,3,1.5,1420,5000,1.0,0,0,3,7,920,500,1987,0,98198,47.4192,-122.33,1400,7500,3580,6100,41.0,0.017049180327868854,Very Cheap
20150512T000000,390000.0,3,1.75,1430,9857,1.0,0,2,4,7,1140,290,1980,0,98045,47.4964,-121.771,1310,9880,8427,8570,39.56579080856244,0.04131147540983607,Very Cheap
20140620T000000,970500.0,3,2.75,2470,10125,2.0,0,0,3,8,2470,0,1960,2012,98040,47.5651,-122.223,2290,10125,7655,7835,95.85185185185185,0.11744262295081967,Cheap
20150421T000000,790000.0,3,2.5,2390,15084,2.0,0,0,3,8,2390,0,2000,0,98010,47.3389,-122.048,1850,17494,12694,15644,52.373375762397245,0.09377049180327869,Very Cheap
20140707T000000,320000.0,3,1.0,1120,10576,1.0,0,0,4,7,1120,0,1969,0,98077,47.7575,-122.072,1300,10000,9456,8700,30.257186081694403,0.032131147540983604,Very Cheap
20140723T000000,552500.0,3,2.25,2700,4025,2.0,0,0,4,8,1760,940,1907,0,98122,47.6074,-122.294,1580,4025,1325,2445,137.26708074534162,0.06262295081967213,Very Cheap
20141119T000000,1050000.0,3,3.0,3490,4500,2.5,0,0,3,9,3170,320,1924,0,98102,47.6394,-122.321,2840,4050,1010,1210,233.33333333333334,0.12786885245901639,Cheap
20140923T000000,230000.0,3,1.0,1640,7187,1.0,0,0,3,7,1640,0,1966,0,98058,47.455,-122.182,1340,8346,5547,7006,32.00222624182552,0.020327868852459016,Very Cheap
20140729T000000,680000.0,3,1.75,1620,5500,1.0,0,0,3,7,1110,510,1950,0,98112,47.6393,-122.308,2100,6500,3880,4400,123.63636363636364,0.07934426229508197,Very Cheap
20140602T000000,985000.0,3,1.75,1670,5400,2.0,0,0,5,8,1670,0,1912,0,98112,47.635,-122.284,2100,5400,3730,3300,182.40740740740742,0.11934426229508197,Cheap
20140623T000000,375000.0,4,2.5,1870,7471,2.0,0,0,3,8,1870,0,1990,0,98055,47.4314,-122.204,2020,8912,5601,6892,50.19408379065721,0.03934426229508197,Very Cheap
20150422T000000,431000.0,2,1.5,1300,4000,1.5,0,0,4,6,1300,0,1900,0,98144,47.5937,-122.301,1480,4000,2700,2520,107.75,0.046688524590163934,Very Cheap
20140909T000000,463000.0,3,2.5,2190,17108,2.0,0,0,3,8,2190,0,1991,0,98019,47.7321,-121.964,2400,14040,14918,11640,27.063362169745147,0.05088524590163934,Very Cheap
20141006T000000,350000.0,3,1.75,1320,10500,1.0,0,0,3,7,1320,0,1966,0,98034,47.7267,-122.226,1310,10500,9180,9190,33.333333333333336,0.036065573770491806,Very Cheap
20150414T000000,485000.0,3,1.0,1250,7200,1.0,0,0,3,7,1250,0,1964,0,98008,47.6342,-122.12,1430,7400,5950,5970,67.36111111111111,0.05377049180327869,Very Cheap
20140929T000000,355000.0,4,1.75,2040,15000,1.0,0,0,4,7,1360,680,1967,0,98092,47.3107,-122.189,2310,15000,12960,12690,23.666666666666668,0.036721311475409836,Very Cheap
20150327T000000,603500.0,3,1.75,2140,7280,1.0,0,0,3,7,1070,1070,1910,0,98117,47.6993,-122.377,2280,8400,5140,6120,82.89835164835165,0.06931147540983607,Very Cheap
20140819T000000,860000.0,5,1.75,2510,6000,1.5,0,0,5,8,2010,500,1920,0,98144,47.5798,-122.292,2240,5000,3490,2760,143.33333333333334,0.10295081967213114,Cheap
20150306T000000,259875.0,5,2.5,2200,6250,2.0,0,0,3,7,2200,0,1996,0,98038,47.3675,-122.021,1850,6091,4050,4241,41.58,0.024245901639344262,Very Cheap
20140716T000000,685000.0,4,2.5,2170,8680,1.0,0,0,3,7,1220,950,1959,0,98004,47.6078,-122.192,2010,8680,6510,6670,78.91705069124424,0.08,Very Cheap
20140930T000000,382500.0,4,2.5,2980,8786,2.0,0,0,3,8,2980,0,2003,0,98038,47.378,-122.03,2980,6718,5806,3738,43.53516958798088,0.040327868852459016,Very Cheap
20150301T000000,490000.0,3,1.0,1180,2250,1.5,0,0,3,7,1180,0,1902,0,98117,47.6779,-122.377,1320,5100,1070,3780,217.77777777777777,0.05442622950819672,Very Cheap
20150126T000000,229000.0,3,2.0,1540,6000,1.0,0,0,4,6,1540,0,1953,0,98155,47.7372,-122.307,1490,8213,4460,6723,38.166666666666664,0.02019672131147541,Very Cheap
20150505T000000,430000.0,3,2.0,1540,6000,1.0,0,0,4,6,1540,0,1953,0,98155,47.7372,-122.307,1490,8213,4460,6723,71.66666666666667,0.04655737704918033,Very Cheap
20140818T000000,580000.0,5,2.5,3110,15783,1.0,0,0,3,8,1720,1390,1974,0,98052,47.6301,-122.103,2550,12220,12673,9670,36.74840017740607,0.06622950819672131,Very Cheap
20141113T000000,510000.0,3,1.75,1370,6700,1.0,0,0,3,8,1370,0,1940,2012,98117,47.6982,-122.362,1180,6694,5330,5514,76.11940298507463,0.057049180327868855,Very Cheap
20140508T000000,489990.0,5,2.25,2440,20828,1.5,0,0,4,8,2440,0,1975,0,98042,47.3762,-122.158,2670,14472,18388,11802,23.525542538889955,0.05442491803278689,Very Cheap
20140916T000000,440000.0,3,2.25,1760,1800,2.0,0,0,3,7,1330,430,1983,0,98199,47.6579,-122.394,1150,4575,40,3425,244.44444444444446,0.04786885245901639,Very Cheap
20150428T000000,479950.0,3,2.5,2810,4984,1.0,0,0,3,9,1750,1060,2006,0,98055,47.4461,-122.209,2810,5711,2174,2901,96.2981540930979,0.05310819672131147,Very Cheap
20140623T000000,806000.0,4,2.5,2500,206474,1.0,0,0,3,10,2500,0,1997,0,98053,47.6778,-121.994,3680,208652,203974,204972,3.903639199124345,0.0958688524590164,Very Cheap
20140624T000000,875000.0,4,2.5,3220,22588,2.0,0,0,3,10,3220,0,1996,0,98077,47.7311,-122.055,3220,22922,19368,19702,38.7373826810696,0.10491803278688525,Cheap
20140911T000000,710800.0,3,2.5,2880,36820,2.0,0,0,3,10,2880,0,1992,0,98077,47.766,-122.044,3190,36820,33940,33630,19.304725692558392,0.08338360655737705,Very Cheap
20150210T000000,565000.0,3,2.5,2700,6037,2.0,0,0,3,8,2700,0,2004,0,98065,47.5376,-121.879,2740,6054,3337,3314,93.58953122411793,0.06426229508196721,Very Cheap
20150223T000000,359999.0,5,3.0,2680,9624,2.0,0,0,3,7,1870,810,1995,0,98010,47.3279,-122.006,1860,9921,6944,8061,37.406379883624275,0.037376918032786886,Very Cheap
20150123T000000,625000.0,3,1.75,1780,4500,1.0,0,0,4,7,920,860,1922,0,98117,47.6827,-122.362,1360,4000,2720,2640,138.88888888888889,0.07213114754098361,Very Cheap
20140912T000000,349950.0,3,2.5,2240,7565,2.0,0,0,3,8,2240,0,1999,0,98003,47.3485,-122.301,2190,8254,5325,6064,46.25908790482485,0.036059016393442625,Very Cheap
20140617T000000,415000.0,4,2.0,1610,9600,1.0,0,0,5,7,1610,0,1967,0,98056,47.5327,-122.186,1450,9600,7990,8150,43.229166666666664,0.04459016393442623,Very Cheap
20141105T000000,435000.0,2,2.0,1440,1170,2.0,0,0,3,9,960,480,2004,0,98116,47.5592,-122.385,1440,1350,-270,-90,371.79487179487177,0.04721311475409836,Very Cheap
20141121T000000,225000.0,3,1.75,1550,9060,2.0,0,0,3,7,1550,0,1948,1979,98146,47.5093,-122.345,1080,7620,7510,6540,24.834437086092716,0.019672131147540985,Very Cheap
20140512T000000,770000.0,3,1.75,1720,5000,1.0,0,0,3,9,1720,0,1954,2014,98122,47.6157,-122.29,2120,4188,3280,2068,154.0,0.09114754098360656,Very Cheap
20150106T000000,340000.0,3,1.75,1740,10800,1.0,0,0,3,7,1740,0,1959,0,98133,47.7717,-122.351,1810,7735,9060,5925,31.48148148148148,0.03475409836065574,Very Cheap
20150312T000000,965000.0,5,2.75,3280,12673,1.0,0,0,4,9,2050,1230,1981,0,98006,47.5504,-122.146,3060,12847,9393,9787,76.146137457587,0.11672131147540983,Cheap
20150113T000000,667000.0,3,2.75,2216,31215,1.0,0,0,3,9,2216,0,1968,2005,98092,47.3164,-122.199,2216,30048,28999,27832,21.367932083934004,0.07763934426229509,Very Cheap
20140507T000000,250000.0,1,1.0,1100,4373,1.0,0,0,2,6,820,280,1947,0,98166,47.4653,-122.338,1100,7500,3273,6400,57.16899153898925,0.022950819672131147,Very Cheap
20140612T000000,397990.0,3,1.0,1180,11862,1.0,0,0,4,7,1180,0,1948,0,98177,47.7153,-122.363,1540,8100,10682,6560,33.551677626032706,0.04235934426229508,Very Cheap
20140918T000000,535000.0,3,1.75,2020,10031,1.0,0,0,5,7,1370,650,1952,0,98155,47.7487,-122.319,1500,8456,8011,6956,53.33466254610707,0.06032786885245902,Very Cheap
20140625T000000,265950.0,3,1.5,1150,8450,1.0,0,0,4,6,1150,0,1951,0,98178,47.4927,-122.224,1160,6800,7300,5640,31.473372781065088,0.025042622950819673,Very Cheap
20141007T000000,258000.0,3,1.75,2090,7461,1.0,0,0,3,6,1200,890,1986,0,98030,47.3764,-122.184,1420,7462,5371,6042,34.57981503819863,0.024,Very Cheap
20141202T000000,505500.0,3,2.5,1300,1187,3.0,0,0,3,8,1300,0,2005,0,98107,47.6704,-122.391,1320,1194,-113,-126,425.8635214827296,0.05645901639344262,Very Cheap
20140506T000000,455000.0,5,2.5,2240,7770,1.0,0,0,3,7,1340,900,1978,0,98034,47.7198,-122.171,1820,7770,5530,5950,58.55855855855856,0.049836065573770495,Very Cheap
20141031T000000,1348000.0,5,3.25,3540,5971,1.0,0,2,3,10,2000,1540,2005,0,98033,47.6643,-122.202,2820,6029,2431,3209,225.75782950929494,0.16695081967213116,Cheap
20150109T000000,600000.0,4,2.25,2840,31720,1.0,0,0,3,8,1780,1060,1958,0,98177,47.7505,-122.375,2290,29577,28880,27287,18.915510718789406,0.06885245901639345,Very Cheap
20150205T000000,329800.0,4,2.5,2080,7047,2.0,0,0,3,8,2080,0,1996,0,98092,47.2627,-122.215,2580,7227,4967,4647,46.80005676174259,0.03341639344262295,Very Cheap
20150421T000000,222000.0,2,1.0,1550,38449,1.0,0,0,3,6,1550,0,1947,0,98055,47.4315,-122.199,1188,25875,36899,24687,5.773882285625114,0.019278688524590165,Very Cheap
20150405T000000,450000.0,4,2.5,1900,9240,1.0,0,0,3,7,1900,0,1962,0,98007,47.6167,-122.137,2040,8052,7340,6012,48.701298701298704,0.04918032786885246,Very Cheap
20141218T000000,952000.0,3,3.5,2760,4500,2.0,0,0,3,9,2120,640,2004,0,98119,47.6529,-122.372,1950,6000,1740,4050,211.55555555555554,0.11501639344262295,Cheap
20140723T000000,625000.0,4,2.0,1410,4480,1.5,0,0,3,8,1410,0,1927,0,98109,47.6385,-122.344,1240,3400,3070,2160,139.50892857142858,0.07213114754098361,Very Cheap
20150312T000000,226800.0,2,1.0,1240,11393,1.0,0,0,4,7,1240,0,1960,0,98030,47.3714,-122.207,1660,11393,10153,9733,19.906960414289475,0.019908196721311475,Very Cheap
20141212T000000,1205000.0,5,4.25,4420,13497,2.0,0,0,3,11,3510,910,2000,0,98059,47.5262,-122.143,4220,12015,9077,7795,89.27909905905015,0.1481967213114754,Cheap
20141003T000000,350000.0,4,2.75,3390,16153,1.0,0,0,4,7,1970,1420,1961,0,98031,47.3954,-122.184,2530,8495,12763,5965,21.667801646752924,0.036065573770491806,Very Cheap
20150312T000000,395000.0,3,1.75,1400,8640,1.0,0,0,3,7,1400,0,1962,0,98011,47.7659,-122.204,1630,8640,7240,7010,45.717592592592595,0.0419672131147541,Very Cheap
20140919T000000,285000.0,5,3.0,2110,5260,2.0,0,0,3,7,1670,440,2002,0,98118,47.5449,-122.272,2110,5260,3150,3150,54.18250950570342,0.02754098360655738,Very Cheap
20150107T000000,553000.0,3,1.0,1310,18135,1.0,0,0,3,7,1310,0,1948,0,98008,47.6065,-122.113,2150,18135,16825,15985,30.493520816101462,0.06268852459016394,Very Cheap
20150505T000000,254000.0,3,1.0,1270,16800,1.0,0,0,4,7,1270,0,1957,0,98188,47.4599,-122.276,1700,10200,15530,8500,15.119047619047619,0.023475409836065574,Very Cheap
20140826T000000,348140.0,2,1.5,2060,10880,1.0,0,0,3,6,1190,870,1924,0,98106,47.515,-122.362,1430,8781,8820,7351,31.998161764705884,0.035821639344262295,Very Cheap
20140626T000000,354950.0,4,2.75,2530,7350,1.0,0,0,5,8,1280,1250,1977,0,98023,47.313,-122.374,2280,7350,4820,5070,48.29251700680272,0.036714754098360655,Very Cheap
20140612T000000,706000.0,3,2.75,1900,6400,1.0,0,0,5,7,1410,490,1942,0,98105,47.6697,-122.281,1350,6400,4500,5050,110.3125,0.08275409836065574,Very Cheap
20140505T000000,499000.0,4,2.5,2910,6479,2.0,0,0,3,7,2910,0,2006,0,98065,47.5402,-121.887,2320,5178,3569,2858,77.01805834233679,0.05560655737704918,Very Cheap
20141204T000000,427500.0,3,1.5,1900,43186,1.5,0,0,4,7,1300,600,1971,0,98038,47.4199,-121.99,2080,108028,41286,105948,9.899041355995,0.04622950819672131,Very Cheap
20150217T000000,439000.0,5,3.5,2880,10000,2.0,0,3,3,8,1980,900,1991,0,98055,47.4874,-122.223,2120,9535,7120,7415,43.9,0.04773770491803279,Very Cheap
20141117T000000,545000.0,4,2.5,2820,25995,2.0,0,0,3,9,2820,0,1998,0,98010,47.3415,-122.029,3330,27653,23175,24323,20.96557030198115,0.06163934426229508,Very Cheap
20141017T000000,842000.0,3,1.0,1620,4774,1.5,0,0,3,7,1620,0,1920,0,98103,47.659,-122.339,1880,4560,3154,2680,176.3720150816925,0.10059016393442623,Cheap
20141210T000000,685000.0,4,2.5,3320,38043,2.0,0,0,3,9,3320,0,1997,0,98053,47.6504,-122.004,3170,42621,34723,39451,18.00594064611098,0.08,Very Cheap
20140903T000000,665000.0,4,3.5,3770,47480,2.0,0,0,3,9,3770,0,2003,0,98010,47.3552,-121.99,3380,42689,43710,39309,14.005897219882055,0.07737704918032787,Very Cheap
20140609T000000,255000.0,2,1.0,1200,9000,1.0,0,2,5,6,1200,0,1917,0,98198,47.4039,-122.323,1660,9000,7800,7340,28.333333333333332,0.02360655737704918,Very Cheap
20141231T000000,565000.0,5,2.25,2130,4360,1.0,0,2,3,8,1240,890,1959,0,98199,47.6586,-122.395,1830,5000,2230,3170,129.58715596330276,0.06426229508196721,Very Cheap
20150225T000000,274000.0,5,1.75,1950,8720,1.0,0,0,3,7,1050,900,1962,0,98001,47.3381,-122.289,1660,8030,6770,6370,31.422018348623855,0.026098360655737705,Very Cheap
20140509T000000,260000.0,3,2.0,1920,8075,1.0,0,0,4,7,1510,410,1969,0,98023,47.3092,-122.375,1920,7826,6155,5906,32.19814241486068,0.024262295081967214,Very Cheap
20140507T000000,581000.0,4,2.0,2510,13695,1.0,0,0,4,7,1280,1230,1961,2001,98033,47.7005,-122.174,1220,12500,11185,11280,42.42424242424242,0.06636065573770492,Very Cheap
20140725T000000,625000.0,3,1.5,1990,5978,1.5,1,4,4,7,1990,0,1926,0,98198,47.3449,-122.329,2100,6221,3988,4121,104.55001672800267,0.07213114754098361,Very Cheap
20141229T000000,220000.0,3,1.0,1230,9720,1.0,0,0,5,7,1230,0,1969,0,98042,47.3266,-122.138,1230,9720,8490,8490,22.633744855967077,0.01901639344262295,Very Cheap
20141028T000000,765000.0,3,2.25,3190,324086,2.0,0,2,3,9,3190,0,1982,0,98024,47.5477,-121.93,3190,217800,320896,214610,2.36048456273952,0.09049180327868853,Very Cheap
20140710T000000,1325000.0,6,4.25,5720,10213,2.0,0,0,3,10,4170,1550,2004,0,98006,47.5464,-122.116,4300,10224,4493,5924,129.73661020268287,0.16393442622950818,Cheap
20150318T000000,700000.0,8,2.5,2280,3000,1.5,0,0,3,7,1210,1070,1911,0,98105,47.6675,-122.316,1610,3000,720,1390,233.33333333333334,0.08196721311475409,Very Cheap
20140924T000000,351000.0,4,1.0,1550,7260,1.0,0,0,4,6,1550,0,1959,0,98008,47.6229,-122.121,1210,7260,5710,6050,48.34710743801653,0.03619672131147541,Very Cheap
20140805T000000,413565.0,3,2.5,1690,1613,2.0,0,0,3,8,1150,540,2014,0,98029,47.5524,-121.998,1690,1619,-77,-71,256.3949163050217,0.044401967213114756,Very Cheap
20140612T000000,363000.0,3,3.25,1651,1779,2.0,0,0,3,8,1341,310,2008,0,98133,47.7076,-122.346,1650,2908,128,1258,204.04721753794266,0.03777049180327869,Very Cheap
20150404T000000,679000.0,4,1.75,2260,41236,1.0,0,0,4,8,1690,570,1962,0,98029,47.5528,-122.034,3080,30240,38976,27160,16.466194587253856,0.07921311475409835,Very Cheap
20140910T000000,473000.0,2,1.75,1510,4555,1.0,0,0,3,8,1510,0,2005,0,98053,47.7136,-122.031,1640,4500,3045,2860,103.84193194291987,0.05219672131147541,Very Cheap
20150421T000000,585888.0,3,2.0,1490,7431,1.0,0,0,4,7,1490,0,1966,0,98052,47.6697,-122.162,1700,7725,5941,6025,78.84376261606782,0.06700170491803278,Very Cheap
20140626T000000,405000.0,4,2.5,2220,4652,2.0,0,0,3,7,2220,0,2001,0,98059,47.4902,-122.154,1840,4500,2432,2660,87.05932932072227,0.043278688524590166,Very Cheap
20150116T000000,650000.0,3,1.75,2800,19386,1.0,1,4,3,8,1400,1400,1965,0,98198,47.3554,-122.324,3270,31450,16586,28180,33.5293510780976,0.07540983606557378,Very Cheap
20150224T000000,415000.0,4,2.5,2210,213008,1.0,0,0,4,7,1210,1000,1975,0,98038,47.4039,-121.98,2270,52707,210798,50437,1.948283632539623,0.04459016393442623,Very Cheap
20141222T000000,575000.0,3,2.0,2150,3880,1.0,0,0,3,8,1080,1070,1951,0,98117,47.6814,-122.392,2130,4000,1730,1870,148.1958762886598,0.06557377049180328,Very Cheap
20140717T000000,220000.0,3,2.25,1400,7205,1.0,0,0,3,7,1140,260,1985,0,98030,47.349,-122.166,1970,7252,5805,5282,30.53435114503817,0.01901639344262295,Very Cheap
20140506T000000,610000.0,4,3.0,2450,10117,1.0,0,0,5,8,1580,870,1967,0,98006,47.5694,-122.132,2530,10125,7667,7595,60.29455372145893,0.07016393442622951,Very Cheap
20140512T000000,499950.0,3,1.0,980,6380,1.0,0,0,3,7,760,220,1941,0,98115,47.692,-122.308,1390,6380,5400,4990,78.36206896551724,0.05573114754098361,Very Cheap
20150303T000000,883000.0,4,2.5,2800,6874,2.0,0,0,3,9,2170,630,1990,0,98112,47.6215,-122.29,1430,6240,4074,4810,128.45504800698282,0.1059672131147541,Cheap
20141023T000000,436000.0,2,1.0,1240,8100,1.5,0,2,3,7,1240,0,1925,0,98125,47.7326,-122.288,2790,8100,6860,5310,53.82716049382716,0.047344262295081964,Very Cheap
20141213T000000,320000.0,3,2.5,1610,1356,2.0,0,0,3,8,1240,370,2007,0,98106,47.5257,-122.361,1270,1314,-254,44,235.9882005899705,0.032131147540983604,Very Cheap
20140530T000000,425000.0,3,1.75,1510,44000,1.0,0,0,3,7,1240,270,1989,0,98045,47.4851,-121.716,2290,36242,42490,33952,9.659090909090908,0.04590163934426229,Very Cheap
20140515T000000,204700.0,4,2.0,1670,9987,1.0,0,0,3,7,1670,0,1967,0,98001,47.3406,-122.284,1640,7280,8317,5640,20.49664563933113,0.01700983606557377,Very Cheap
20140717T000000,384000.0,6,3.0,2320,4502,1.0,0,0,4,7,1200,1120,1987,0,98108,47.5552,-122.3,1160,5628,2182,4468,85.29542425588627,0.04052459016393443,Very Cheap
20150113T000000,314000.0,3,2.75,1900,8200,2.0,0,0,4,7,1900,0,1984,0,98031,47.402,-122.183,1620,8200,6300,6580,38.292682926829265,0.03134426229508197,Very Cheap
20150430T000000,535000.0,3,2.5,2390,6263,2.0,0,0,3,9,2390,0,2003,0,98028,47.7379,-122.248,2390,11761,3873,9371,85.42232157113204,0.06032786885245902,Very Cheap
20140626T000000,568000.0,4,1.75,2110,265716,1.0,0,0,4,8,2110,0,1979,0,98053,47.657,-122.026,2110,110597,263606,108487,2.1376206175013923,0.06465573770491803,Very Cheap
20150501T000000,426000.0,4,1.5,1470,5850,1.0,0,0,4,7,810,660,1973,0,98052,47.7,-122.129,1290,7300,4380,6010,72.82051282051282,0.046032786885245904,Very Cheap
20141209T000000,675000.0,4,2.75,2670,6780,2.0,0,3,5,8,1630,1040,1908,0,98118,47.5131,-122.256,2400,5989,4110,3589,99.5575221238938,0.07868852459016394,Very Cheap
20140613T000000,380000.0,4,2.5,2540,6365,2.0,0,0,3,8,1870,670,2000,0,98055,47.4608,-122.215,2290,5942,3825,3652,59.701492537313435,0.04,Very Cheap
20140723T000000,685000.0,3,2.5,3450,8000,3.0,0,0,4,8,2970,480,1927,1975,98116,47.5605,-122.402,1880,6135,4550,4255,85.625,0.08,Very Cheap
20140819T000000,429000.0,3,2.0,1700,52826,1.0,0,0,3,7,1700,0,1991,0,98058,47.4164,-122.092,2480,114728,51126,112248,8.121001022223904,0.04642622950819672,Very Cheap
20150421T000000,799000.0,4,1.5,1810,6583,1.0,0,0,3,7,1500,310,1968,0,98133,47.7273,-122.351,860,8670,4773,7810,121.37323408780192,0.09495081967213115,Very Cheap
20140920T000000,318500.0,5,1.75,1550,6986,1.0,0,0,3,7,1030,520,1978,0,98106,47.5503,-122.356,1550,6986,5436,5436,45.591182364729455,0.0319344262295082,Very Cheap
20150420T000000,925000.0,3,3.25,4110,20900,2.0,0,0,3,9,2630,1480,2002,0,98006,47.5506,-122.187,2640,14700,16790,12060,44.25837320574163,0.11147540983606558,Cheap
20150224T000000,420000.0,3,1.5,2080,5000,1.0,0,0,3,7,1300,780,1963,0,98118,47.5322,-122.29,1860,5000,2920,3140,84.0,0.04524590163934426,Very Cheap
20141218T000000,570000.0,2,1.0,1100,4000,1.0,0,0,3,7,1100,0,1906,0,98109,47.6388,-122.35,1590,4000,2900,2410,142.5,0.06491803278688525,Very Cheap
20140813T000000,1052500.0,4,2.75,3950,12840,2.0,0,0,5,8,3950,0,1960,0,98040,47.5489,-122.219,2350,12507,8890,10157,81.97040498442368,0.12819672131147541,Cheap
20140917T000000,333000.0,3,1.0,1250,8450,1.0,0,0,4,7,1250,0,1954,0,98146,47.503,-122.364,1350,9300,7200,7950,39.40828402366864,0.033836065573770495,Very Cheap
20150224T000000,1360000.0,2,1.75,2620,14138,2.0,1,4,3,8,2120,500,1931,1991,98125,47.7142,-122.277,1830,8279,11518,6449,96.19465270901118,0.16852459016393442,Cheap
20140603T000000,660000.0,3,2.5,2290,2798,3.0,0,0,4,9,2290,0,1953,1983,98102,47.641,-122.315,2260,5000,508,2740,235.88277340957828,0.07672131147540984,Very Cheap
20140917T000000,350000.0,6,4.5,3500,8504,2.0,0,0,3,7,3500,0,1980,0,98155,47.7351,-122.295,1550,8460,5004,6910,41.15710253998119,0.036065573770491806,Very Cheap
20150121T000000,682500.0,6,4.5,3500,8504,2.0,0,0,3,7,3500,0,1980,0,98155,47.7351,-122.295,1550,8460,5004,6910,80.2563499529633,0.07967213114754099,Very Cheap
20141210T000000,399990.0,5,2.75,1690,4000,1.0,0,0,5,7,970,720,1943,0,98106,47.5312,-122.354,1240,4000,2310,2760,99.9975,0.042621639344262295,Very Cheap
20140625T000000,860000.0,5,3.25,4500,9648,2.0,0,4,4,8,3000,1500,1968,0,98125,47.7262,-122.282,2780,21132,5148,18352,89.13764510779436,0.10295081967213114,Cheap
20141021T000000,216180.0,2,1.0,1120,7797,1.0,0,0,3,6,1120,0,1948,0,98055,47.4871,-122.22,2180,7200,6677,5020,27.726048480184687,0.018515409836065574,Very Cheap
20140915T000000,300000.0,4,2.25,1740,9613,2.0,0,0,5,8,1740,0,1989,0,98058,47.463,-122.125,1680,9769,7873,8089,31.20773951940081,0.029508196721311476,Very Cheap
20141014T000000,145000.0,3,1.0,1010,11880,1.0,0,0,3,7,1010,0,1960,0,98030,47.3762,-122.219,1150,9435,10870,8285,12.205387205387206,0.009180327868852459,Very Cheap
20150305T000000,255000.0,3,1.0,1010,11880,1.0,0,0,3,7,1010,0,1960,0,98030,47.3762,-122.219,1150,9435,10870,8285,21.464646464646464,0.02360655737704918,Very Cheap
20140702T000000,250000.0,3,1.75,1200,24805,1.0,0,0,3,6,1200,0,1984,0,98031,47.4236,-122.195,2150,4339,23605,2189,10.078613182826043,0.022950819672131147,Very Cheap
20141029T000000,245000.0,3,1.0,1020,8625,1.0,0,0,3,7,1020,0,1978,0,98045,47.4465,-121.77,1290,9440,7605,8150,28.405797101449274,0.022295081967213116,Very Cheap
20141014T000000,445000.0,3,1.75,1850,7056,2.5,0,0,4,8,1850,0,1979,0,98052,47.6602,-122.13,1970,7056,5206,5086,63.06689342403628,0.04852459016393443,Very Cheap
20140514T000000,562000.0,3,1.5,1830,8000,1.0,0,0,4,7,1830,0,1957,0,98008,47.6017,-122.122,1310,7500,6170,6190,70.25,0.0638688524590164,Very Cheap
20140505T000000,501000.0,4,1.0,2070,7519,1.0,0,0,3,7,1160,910,1963,0,98008,47.632,-122.119,1730,7519,5449,5789,66.63120095757415,0.05586885245901639,Very Cheap
20150113T000000,190000.0,3,1.75,1160,5850,1.0,0,0,4,6,1160,0,1918,0,98146,47.5064,-122.356,1110,8382,4690,7272,32.47863247863248,0.015081967213114755,Very Cheap
20140516T000000,862500.0,4,2.75,3280,24440,2.0,0,0,3,10,3280,0,1996,0,98077,47.7073,-122.07,3490,25138,21160,21648,35.29050736497545,0.10327868852459017,Cheap
20140611T000000,1085000.0,5,2.5,2340,6000,2.0,0,0,4,10,2340,0,1922,0,98144,47.5764,-122.287,2350,6000,3660,3650,180.83333333333334,0.13245901639344262,Cheap
20140626T000000,575000.0,5,3.0,3690,49709,1.0,0,2,3,9,2690,1000,1960,0,98198,47.3908,-122.32,2590,8691,46019,6101,11.567321812951377,0.06557377049180328,Very Cheap
20141230T000000,250000.0,1,1.0,720,123710,1.0,0,0,4,6,720,0,1935,0,98092,47.2893,-122.084,1860,297514,122990,295654,2.0208552259316144,0.022950819672131147,Very Cheap
20150506T000000,310000.0,7,1.5,2660,15111,1.5,0,0,4,7,2660,0,1962,0,98059,47.4644,-122.066,1710,15429,12451,13719,20.514856726887697,0.03081967213114754,Very Cheap
20141009T000000,1400000.0,5,3.25,4300,9270,2.0,0,3,3,10,2910,1390,1957,2009,98116,47.5717,-122.409,2780,6610,4970,3830,151.02481121898597,0.1737704918032787,Cheap
20141216T000000,284850.0,3,1.5,1590,8256,1.0,0,1,3,7,1090,500,1969,0,98003,47.3488,-122.304,1950,7840,6666,5890,34.50218023255814,0.027521311475409836,Very Cheap
20150219T000000,570000.0,4,2.5,2590,7910,2.0,0,0,3,9,2590,0,2003,0,98028,47.7378,-122.248,2110,11761,5320,9651,72.0606826801517,0.06491803278688525,Very Cheap
20141003T000000,304000.0,3,1.75,1720,6000,1.0,0,2,3,7,1000,720,1954,0,98178,47.4999,-122.223,1690,6000,4280,4310,50.666666666666664,0.030032786885245903,Very Cheap
20141216T000000,560000.0,4,2.5,1790,9787,1.0,0,2,4,8,1240,550,1983,0,98056,47.5344,-122.189,1790,9787,7997,7997,57.21875957903341,0.06360655737704918,Very Cheap
20140826T000000,325000.0,3,1.0,1590,8160,1.0,0,1,3,7,1090,500,1954,0,98198,47.4013,-122.321,1540,10500,6570,8960,39.82843137254902,0.03278688524590164,Very Cheap
20150206T000000,557510.0,4,2.0,1580,4800,1.5,0,2,3,7,1580,0,1912,0,98136,47.5454,-122.383,1580,4800,3220,3220,116.14791666666666,0.06328,Very Cheap
20150420T000000,305000.0,4,2.25,2580,8820,1.0,0,0,4,9,1620,960,1967,0,98023,47.3122,-122.376,2140,8400,6240,6260,34.580498866213155,0.03016393442622951,Very Cheap
20140902T000000,320000.0,5,1.0,1740,27350,1.0,0,0,4,5,1740,0,1958,0,98059,47.4809,-122.153,2760,10749,25610,7989,11.70018281535649,0.032131147540983604,Very Cheap
20140905T000000,455000.0,5,2.25,3470,28212,1.5,0,0,4,8,2790,680,1978,0,98042,47.3342,-122.108,2020,28177,24742,26157,16.127888841627676,0.049836065573770495,Very Cheap
20140904T000000,383001.0,3,1.0,1180,7210,1.0,0,0,4,7,1180,0,1963,0,98034,47.7267,-122.241,1700,7210,6030,5510,53.12080443828017,0.040393573770491804,Very Cheap
20140605T000000,545000.0,3,1.75,1700,51649,1.5,0,0,5,6,1700,0,1931,0,98059,47.4704,-122.076,1100,39504,49949,38404,10.551995198358147,0.06163934426229508,Very Cheap
20150408T000000,487500.0,2,1.0,1190,5000,1.0,0,0,3,7,1190,0,1925,0,98116,47.5717,-122.382,1600,5000,3810,3400,97.5,0.054098360655737705,Very Cheap
20140702T000000,345000.0,5,2.5,2450,6994,2.0,0,0,3,8,2450,0,2002,0,98030,47.3572,-122.192,1940,6035,4544,4095,49.3279954246497,0.03540983606557377,Very Cheap
20140604T000000,583000.0,6,2.75,2630,16411,1.0,0,0,4,8,1650,980,1974,0,98052,47.6309,-122.093,2250,12255,13781,10005,35.524952775577354,0.06662295081967214,Very Cheap
20140812T000000,534950.0,3,2.25,2130,12286,2.0,0,0,3,8,2130,0,1977,0,98052,47.6471,-122.114,2130,10158,10156,8028,43.54142926908676,0.06032131147540984,Very Cheap
20140812T000000,403504.0,4,1.0,1060,5750,1.0,0,0,3,6,950,110,1904,0,98199,47.6562,-122.389,1790,5857,4690,4067,70.17460869565217,0.04308249180327869,Very Cheap
20150427T000000,500000.0,3,1.75,1480,6120,1.5,0,0,3,7,1480,0,1946,0,98115,47.6858,-122.295,1480,6120,4640,4640,81.69934640522875,0.05573770491803279,Very Cheap
20150224T000000,319502.0,3,1.75,1610,38707,1.0,0,0,3,7,1610,0,1990,0,98010,47.3778,-122.001,1930,45151,37097,43221,8.254372594104426,0.03206583606557377,Very Cheap
20141112T000000,525000.0,4,2.75,2440,5080,2.0,0,0,3,8,1750,690,1960,0,98126,47.5547,-122.379,1920,6375,2640,4455,103.34645669291339,0.05901639344262295,Very Cheap
20140506T000000,563000.0,4,3.0,3100,15480,2.0,0,0,3,8,2400,700,1996,0,98028,47.7466,-122.241,2000,42500,12380,40500,36.36950904392765,0.064,Very Cheap
20140804T000000,898500.0,4,2.75,2890,5000,1.5,0,0,3,8,1990,900,1911,2014,98117,47.6768,-122.363,1080,3750,2110,2670,179.7,0.108,Cheap
20140507T000000,651000.0,3,2.5,3240,108366,2.0,0,0,4,10,3240,0,1991,0,98042,47.327,-122.094,2090,108366,105126,106276,6.007419301256852,0.07554098360655738,Very Cheap
20141201T000000,450000.0,4,2.75,2900,6400,2.0,0,0,3,7,2040,860,1911,1970,98136,47.5563,-122.393,1340,6144,3500,4804,70.3125,0.04918032786885246,Very Cheap
20150321T000000,665000.0,4,2.25,2650,8149,1.0,0,0,4,8,1610,1040,1975,0,98006,47.5624,-122.176,2290,8019,5499,5729,81.60510492084919,0.07737704918032787,Very Cheap
20141102T000000,825000.0,4,2.5,2560,4000,2.0,0,0,5,8,1610,950,1929,0,98117,47.6885,-122.386,1760,4000,1440,2240,206.25,0.09836065573770492,Very Cheap
20140625T000000,200000.0,3,1.0,1150,4800,1.5,0,0,4,6,1150,0,1938,0,98002,47.3101,-122.212,1310,9510,3650,8200,41.666666666666664,0.01639344262295082,Very Cheap
20140904T000000,295000.0,3,2.0,1760,6092,1.0,0,0,3,7,1760,0,1998,0,98030,47.3838,-122.184,2590,6255,4332,3665,48.424162836506895,0.028852459016393443,Very Cheap
20141215T000000,748000.0,4,2.5,3220,8379,2.0,0,0,3,10,3220,0,2004,0,98034,47.7043,-122.192,2720,7635,5159,4915,89.27079603771332,0.08826229508196722,Very Cheap
20140714T000000,580000.0,3,2.5,3200,18750,1.0,0,0,2,9,2660,540,1967,1996,98027,47.5717,-122.12,3200,22475,15550,19275,30.933333333333334,0.06622950819672131,Very Cheap
20150212T000000,275000.0,3,1.0,1250,10744,1.0,0,0,3,6,1250,0,1942,0,98198,47.4226,-122.327,1500,10710,9494,9210,25.595681310498883,0.02622950819672131,Very Cheap
20150326T000000,196000.0,3,1.0,1000,8470,1.0,0,0,4,6,1000,0,1963,0,98023,47.3056,-122.37,1020,8470,7470,7450,23.140495867768596,0.015868852459016394,Very Cheap
20140522T000000,235750.0,2,1.0,740,11250,1.0,0,0,2,6,740,0,1938,0,98146,47.5036,-122.362,1390,11250,10510,9860,20.955555555555556,0.021081967213114755,Very Cheap
20150323T000000,315000.0,3,2.25,2170,8480,1.0,0,0,3,8,2170,0,1965,0,98148,47.4562,-122.33,2080,8452,6310,6372,37.14622641509434,0.031475409836065574,Very Cheap
20140825T000000,338000.0,4,2.5,2370,10631,2.0,0,0,3,8,2370,0,1999,0,98003,47.3473,-122.302,2200,8297,8261,6097,31.79381055404007,0.034491803278688525,Very Cheap
20150121T000000,353000.0,4,2.5,2300,4249,2.0,0,0,3,8,2300,0,2006,0,98038,47.3516,-122.0,2390,4385,1949,1995,83.07837138150153,0.03645901639344262,Very Cheap
20140627T000000,235000.0,3,1.75,1400,6300,1.0,0,0,3,7,1400,0,1998,0,98022,47.2074,-122.001,1400,8490,4900,7090,37.301587301587304,0.02098360655737705,Very Cheap
20150320T000000,569999.0,3,2.5,3080,13880,2.0,0,0,3,9,3080,0,1990,0,98038,47.3726,-122.025,2780,15318,10800,12538,41.066210374639766,0.06491790163934426,Very Cheap
20140918T000000,505000.0,4,2.25,2350,12540,2.0,0,0,3,8,2350,0,1968,0,98177,47.7732,-122.382,2090,7964,10190,5874,40.271132376395535,0.05639344262295082,Very Cheap
20150306T000000,1234000.0,4,3.0,2660,4600,1.5,0,0,3,8,1820,840,1906,2002,98112,47.6258,-122.305,2350,4600,1940,2250,268.2608695652174,0.152,Cheap
20140514T000000,299000.0,2,1.75,1250,34395,1.0,0,0,4,7,1250,0,1950,0,98003,47.2802,-122.316,1910,26042,33145,24132,8.69312400058148,0.02937704918032787,Very Cheap
20141016T000000,240000.0,3,2.0,1100,6360,1.0,0,0,3,7,1100,0,1991,0,98038,47.3878,-122.052,1620,6360,5260,4740,37.735849056603776,0.021639344262295083,Very Cheap
20150213T000000,1955000.0,3,1.75,3330,12566,1.0,1,4,4,8,1940,1390,1960,0,98040,47.5287,-122.22,3730,16560,9236,12830,155.57854528091676,0.24655737704918032,Cheap
20140911T000000,1265000.0,4,3.25,3640,3604,2.0,0,2,5,9,1960,1680,1913,0,98122,47.6145,-122.284,1940,4600,-36,2660,350.99889012208655,0.1560655737704918,Cheap
20150414T000000,405000.0,2,1.75,1350,2653,2.0,0,0,3,7,1350,0,1986,0,98033,47.6934,-122.184,1370,4115,1303,2745,152.65736901620807,0.043278688524590166,Very Cheap
20140624T000000,304000.0,4,2.0,1310,8454,1.0,0,0,4,7,1310,0,1953,0,98155,47.7572,-122.318,1320,8274,7144,6954,35.959309202744265,0.030032786885245903,Very Cheap
20141010T000000,272000.0,4,2.25,1800,5555,2.0,0,0,3,7,1800,0,2003,0,98038,47.3498,-122.052,1810,5669,3755,3859,48.964896489648964,0.02583606557377049,Very Cheap
20140620T000000,412000.0,2,1.0,1260,3960,1.0,0,0,3,6,690,570,1925,0,98117,47.6899,-122.391,1250,3960,2700,2710,104.04040404040404,0.04419672131147541,Very Cheap
20140718T000000,698000.0,4,2.5,2990,7231,2.0,0,0,3,9,2990,0,2001,0,98075,47.5623,-122.032,3160,8339,4241,5179,96.528834186143,0.08170491803278689,Very Cheap
20140609T000000,400000.0,2,1.0,1140,5100,1.0,0,0,3,7,1140,0,1942,0,98136,47.5323,-122.383,1230,5100,3960,3870,78.43137254901961,0.04262295081967213,Very Cheap
20141120T000000,305000.0,3,2.5,2100,6825,2.0,0,0,3,8,2100,0,1994,0,98055,47.4314,-122.189,2180,7614,4725,5434,44.688644688644686,0.03016393442622951,Very Cheap
20140910T000000,585000.0,4,2.0,2400,12753,1.0,0,0,4,7,2400,0,1962,0,98033,47.6947,-122.177,1830,12060,10353,10230,45.87155963302752,0.06688524590163934,Very Cheap
20140812T000000,190000.0,2,1.5,1400,9031,1.0,0,0,3,7,960,440,1982,0,98023,47.2915,-122.368,1450,7658,7631,6208,21.038644668364523,0.015081967213114755,Very Cheap
20140720T000000,760000.0,4,2.5,2990,12788,2.0,0,0,3,10,2990,0,1988,0,98075,47.5601,-122.037,3250,12212,9798,8962,59.430716296528,0.0898360655737705,Very Cheap
20140527T000000,570000.0,3,1.75,1930,36210,1.0,0,0,3,8,1930,0,1977,0,98072,47.7692,-122.128,1930,35060,34280,33130,15.741507870753935,0.06491803278688525,Very Cheap
20141106T000000,144000.0,3,1.0,980,6800,1.0,0,0,3,6,980,0,1946,0,98058,47.4411,-122.186,1140,9975,5820,8835,21.176470588235293,0.009049180327868852,Very Cheap
20140624T000000,139000.0,2,1.0,690,5280,1.0,0,0,4,5,690,0,1942,0,98056,47.4953,-122.187,1140,4860,4590,3720,26.325757575757574,0.00839344262295082,Very Cheap
20141119T000000,525000.0,4,1.5,1430,6380,1.5,0,0,4,7,1130,300,1945,0,98115,47.6942,-122.319,1570,6380,4950,4810,82.2884012539185,0.05901639344262295,Very Cheap
20140716T000000,293000.0,1,1.0,1110,5421,1.0,0,0,3,6,1110,0,1935,0,98177,47.7322,-122.359,1230,8100,4311,6870,54.049068437557644,0.02859016393442623,Very Cheap
20150427T000000,267100.0,2,2.5,1250,1580,2.0,0,0,3,7,1030,220,2005,0,98106,47.5243,-122.36,1250,1361,330,111,169.0506329113924,0.02519344262295082,Very Cheap
20150421T000000,1500000.0,4,3.25,3470,5222,2.0,0,0,3,10,2830,640,2005,0,98033,47.6845,-122.209,3090,6758,1752,3668,287.24626579854464,0.18688524590163935,Cheap
20141028T000000,240000.0,3,2.25,1500,15334,2.0,0,0,4,7,1500,0,1992,0,98042,47.3719,-122.091,1530,8102,13834,6572,15.651493413329856,0.021639344262295083,Very Cheap
20150409T000000,975000.0,3,2.5,2530,7000,2.5,0,4,3,9,2530,0,1915,1999,98136,47.5465,-122.398,2380,7000,4470,4620,139.28571428571428,0.1180327868852459,Cheap
20140618T000000,279950.0,5,1.75,2150,7171,1.0,0,0,4,7,1460,690,1970,0,98031,47.3952,-122.176,1710,7300,5021,5590,39.039185608701715,0.026878688524590164,Very Cheap
20150127T000000,405000.0,3,1.75,1260,7373,1.0,0,0,4,7,1260,0,1979,0,98034,47.7296,-122.233,1360,7373,6113,6013,54.93015054930151,0.043278688524590166,Very Cheap
20140516T000000,400000.0,3,2.5,2740,83199,2.0,0,4,3,9,2740,0,1973,0,98032,47.3581,-122.266,2500,29269,80459,26769,4.807750093150158,0.04262295081967213,Very Cheap
20141124T000000,225000.0,3,1.0,960,6500,1.0,0,0,4,5,960,0,1954,0,98056,47.497,-122.171,1150,6500,5540,5350,34.61538461538461,0.019672131147540985,Very Cheap
20141229T000000,250000.0,3,1.0,1520,7800,1.0,0,0,4,7,1120,400,1967,0,98032,47.3784,-122.29,1740,8000,6280,6260,32.05128205128205,0.022950819672131147,Very Cheap
20150331T000000,272950.0,3,2.25,1570,9096,1.0,0,0,4,7,1180,390,1991,0,98022,47.1937,-121.99,1570,8418,7526,6848,30.007695690413367,0.025960655737704917,Very Cheap
20140722T000000,625000.0,5,1.0,3240,5324,2.0,0,0,3,9,3240,0,2007,0,98065,47.523,-121.875,3240,6036,2084,2796,117.39293764087152,0.07213114754098361,Very Cheap
20140718T000000,670000.0,3,1.75,1280,2147,1.5,0,0,4,7,1280,0,1910,0,98102,47.6362,-122.324,2010,2640,867,630,312.063344201211,0.0780327868852459,Very Cheap
20150401T000000,1065000.0,3,2.5,2130,3545,3.0,0,0,5,9,2130,0,1990,0,98109,47.6389,-122.349,1970,3464,1415,1494,300.4231311706629,0.1298360655737705,Cheap
20140618T000000,540000.0,3,1.75,1970,8200,1.0,0,0,5,8,1420,550,1963,0,98177,47.7602,-122.363,2140,8000,6230,5860,65.85365853658537,0.06098360655737705,Very Cheap
20141105T000000,525000.0,3,2.5,2990,6725,2.0,0,0,3,9,2990,0,2003,0,98059,47.4928,-122.142,2790,6725,3735,3935,78.06691449814126,0.05901639344262295,Very Cheap
20150303T000000,425000.0,2,1.0,1160,17700,1.0,0,0,3,7,1160,0,1947,0,98133,47.7244,-122.331,1440,9000,16540,7560,24.01129943502825,0.04590163934426229,Very Cheap
20140602T000000,465500.0,3,1.75,1890,7004,1.0,0,0,3,7,1290,600,1965,0,98118,47.5557,-122.28,1440,5378,5114,3938,66.46202170188464,0.05121311475409836,Very Cheap
20140717T000000,443500.0,3,2.5,2170,5866,2.0,0,0,3,7,2170,0,2006,0,98065,47.5403,-121.889,2440,5798,3696,3358,75.60518240709172,0.048327868852459016,Very Cheap
20141203T000000,350000.0,4,2.25,1570,499571,1.0,0,3,4,7,1570,0,1972,0,98022,47.1808,-122.023,1700,181708,498001,180008,0.7006011157573198,0.036065573770491806,Very Cheap
20140918T000000,850000.0,3,2.5,3260,91911,2.0,0,0,4,9,3260,0,1984,0,98077,47.737,-122.074,2520,65775,88651,63255,9.248076944000173,0.10163934426229508,Cheap
20150220T000000,205000.0,3,2.25,1250,952,3.0,0,0,3,8,1250,0,2008,0,98133,47.7098,-122.333,1250,1030,-298,-220,215.3361344537815,0.017049180327868854,Very Cheap
20140626T000000,315000.0,4,2.5,1940,10200,1.0,0,0,4,8,1140,800,1977,0,98042,47.4157,-122.161,1920,12600,8260,10680,30.88235294117647,0.031475409836065574,Very Cheap
20140623T000000,470000.0,3,2.5,2150,8221,2.0,0,0,3,8,2150,0,1992,0,98059,47.5085,-122.15,2490,7951,6071,5461,57.17066050358837,0.05180327868852459,Very Cheap
20140729T000000,1100000.0,4,2.25,3310,8540,1.0,0,4,4,9,1660,1650,1973,0,98006,47.5603,-122.158,3450,9566,5230,6116,128.8056206088993,0.13442622950819672,Cheap
20141120T000000,340000.0,3,1.75,3400,46382,1.0,0,0,3,7,2050,1350,1979,0,98053,47.6458,-121.955,2320,20624,42982,18304,7.330429908154025,0.03475409836065574,Very Cheap
20140618T000000,310000.0,4,2.5,2660,12672,1.0,0,0,4,8,1740,920,1960,0,98003,47.3334,-122.323,2280,12477,10012,10197,24.463383838383837,0.03081967213114754,Very Cheap
20140602T000000,305000.0,3,1.0,950,13475,1.0,0,0,3,7,950,0,1950,0,98155,47.7543,-122.306,1240,8910,12525,7670,22.634508348794064,0.03016393442622951,Very Cheap
20140710T000000,307150.0,3,1.5,1480,6752,1.0,0,0,4,7,1480,0,1959,0,98056,47.4993,-122.176,1450,8023,5272,6573,45.490225118483416,0.030445901639344262,Very Cheap
20140701T000000,729032.0,4,2.5,2840,12866,1.0,0,0,4,9,1780,1060,1977,0,98005,47.6388,-122.167,2840,13209,10026,10369,56.66345406497746,0.08577468852459016,Very Cheap
20150303T000000,750000.0,5,2.5,3240,9960,1.0,0,1,3,8,2020,1220,1958,0,98008,47.5858,-122.112,2730,10400,6720,7670,75.3012048192771,0.08852459016393442,Very Cheap
20150203T000000,289000.0,4,2.5,1961,3207,2.0,0,0,3,7,1961,0,2006,0,98042,47.3507,-122.16,1961,3401,1246,1440,90.11537262238852,0.028065573770491802,Very Cheap
20150415T000000,480000.0,3,1.0,1100,5700,1.0,0,0,3,7,1100,0,1950,0,98115,47.6883,-122.282,1560,6588,4600,5028,84.21052631578948,0.05311475409836065,Very Cheap
20150219T000000,529000.0,3,1.75,1500,7367,1.0,0,0,3,8,1500,0,1974,0,98033,47.6722,-122.167,1920,7579,5867,5659,71.80670557893308,0.05954098360655738,Very Cheap
20140728T000000,585000.0,3,1.75,1480,4800,2.0,0,0,4,7,1140,340,1944,0,98199,47.6567,-122.397,1810,4800,3320,2990,121.875,0.06688524590163934,Very Cheap
20140925T000000,704000.0,4,2.75,2510,12500,1.0,0,0,5,8,2050,460,1976,0,98052,47.6278,-122.11,2200,12088,9990,9888,56.32,0.08249180327868852,Very Cheap
20150304T000000,607000.0,4,2.0,1490,4054,1.5,0,0,5,7,1490,0,1926,0,98115,47.6744,-122.301,1510,3889,2564,2379,149.72866304884064,0.06977049180327868,Very Cheap
20150310T000000,580000.0,3,2.25,2190,8188,2.0,0,0,3,8,1810,380,1978,0,98052,47.6883,-122.113,2190,8374,5998,6184,70.83536883243771,0.06622950819672131,Very Cheap
20140805T000000,875000.0,5,2.5,2530,8564,2.0,0,0,4,8,2530,0,1976,0,98006,47.5622,-122.153,2480,8714,6034,6234,102.17188229799159,0.10491803278688525,Cheap
20141015T000000,610000.0,4,2.5,2440,9350,1.0,0,0,4,8,1560,880,1976,0,98006,47.5614,-122.13,2260,8500,6910,6240,65.24064171122994,0.07016393442622951,Very Cheap
20140728T000000,230000.0,3,0.75,1040,15000,1.0,0,0,3,6,1040,0,1941,0,98028,47.7639,-122.234,1410,19000,13960,17590,15.333333333333334,0.020327868852459016,Very Cheap
20140608T000000,510000.0,4,2.25,2450,62290,2.0,0,0,3,8,2450,0,1976,0,98077,47.7603,-122.074,2450,41181,59840,38731,8.187510033713277,0.057049180327868855,Very Cheap
20150305T000000,733000.0,4,2.5,2210,5002,1.0,0,0,3,7,1370,840,1977,0,98199,47.6637,-122.401,1970,4920,2792,2950,146.54138344662135,0.08629508196721311,Very Cheap
20140814T000000,169100.0,3,2.0,1050,18304,1.0,0,0,4,7,1050,0,1953,0,98001,47.3206,-122.269,1690,15675,17254,13985,9.238417832167832,0.012340983606557377,Very Cheap
20150506T000000,250000.0,3,2.0,1050,18304,1.0,0,0,4,7,1050,0,1953,0,98001,47.3206,-122.269,1690,15675,17254,13985,13.658216783216783,0.022950819672131147,Very Cheap
20141103T000000,500000.0,4,2.25,2730,35100,2.0,0,0,3,8,2730,0,1977,0,98075,47.5913,-122.012,2730,36677,32370,33947,14.245014245014245,0.05573770491803279,Very Cheap
20141007T000000,700000.0,2,1.0,1620,9855,1.0,0,4,3,8,1320,300,1948,0,98136,47.5264,-122.384,1820,7700,8235,5880,71.02993404363268,0.08196721311475409,Very Cheap
20141222T000000,379000.0,4,2.75,2410,5225,2.0,0,0,3,8,2410,0,2001,0,98058,47.4244,-122.151,2300,5378,2815,3078,72.53588516746412,0.03986885245901639,Very Cheap
20140715T000000,650000.0,4,2.5,3420,222156,2.0,0,0,3,9,3420,0,2002,0,98010,47.3608,-121.97,3340,222156,218736,218816,2.9258719098291293,0.07540983606557378,Very Cheap
20141119T000000,412133.0,2,1.0,920,4400,1.0,0,0,3,7,920,0,1948,0,98103,47.6903,-122.332,1560,4600,3480,3040,93.66659090909091,0.04421416393442623,Very Cheap
20150402T000000,480000.0,4,2.25,2330,14190,1.0,0,0,3,8,1740,590,1962,0,98034,47.718,-122.242,2330,14190,11860,11860,33.82663847780127,0.05311475409836065,Very Cheap
20141218T000000,650000.0,3,1.75,1940,10245,1.0,0,0,3,7,1940,0,1957,0,98040,47.5833,-122.241,2720,11448,8305,8728,63.4455832113226,0.07540983606557378,Very Cheap
20150330T000000,505000.0,2,2.5,1900,5065,2.0,0,0,3,8,1900,0,2005,0,98053,47.7175,-122.034,1350,4664,3165,3314,99.70384995064165,0.05639344262295082,Very Cheap
20150505T000000,931088.0,4,2.5,3510,17400,1.0,0,0,4,9,1930,1580,1957,0,98005,47.5963,-122.171,2730,12120,13890,9390,53.51080459770115,0.11227383606557377,Cheap
20140926T000000,570000.0,4,1.75,1860,7700,1.0,0,0,4,8,1860,0,1964,0,98008,47.626,-122.112,1860,7700,5840,5840,74.02597402597402,0.06491803278688525,Very Cheap
20140813T000000,475000.0,3,1.0,1380,4635,1.0,0,0,4,6,1380,0,1919,0,98144,47.57,-122.285,1790,4635,3255,2845,102.48112189859762,0.05245901639344262,Very Cheap
20140805T000000,240000.0,6,1.75,2210,8594,1.0,0,0,3,7,1310,900,1959,0,98188,47.4594,-122.273,1850,8594,6384,6744,27.926460321154295,0.021639344262295083,Very Cheap
20150114T000000,462000.0,4,2.5,2640,47480,1.0,0,0,4,8,1590,1050,1979,0,98038,47.4258,-122.021,2390,67415,44840,65025,9.730412805391744,0.05075409836065574,Very Cheap
20150210T000000,1115000.0,3,2.5,4530,22873,2.0,0,2,5,8,3220,1310,1912,0,98166,47.4567,-122.369,3100,18210,18343,15110,48.74743146941809,0.13639344262295083,Cheap
20140916T000000,243000.0,3,1.0,1500,6600,1.0,0,0,2,6,1500,0,1970,0,98168,47.4845,-122.33,1730,6600,5100,4870,36.81818181818182,0.022032786885245903,Very Cheap
20150211T000000,660000.0,4,2.25,2010,15375,1.0,0,0,4,8,2010,0,1957,0,98005,47.5956,-122.174,1930,15375,13365,13445,42.926829268292686,0.07672131147540984,Very Cheap
20141013T000000,1190000.0,2,1.75,2080,8112,1.0,1,4,4,8,1040,1040,1939,1984,98125,47.7134,-122.277,2030,8408,6032,6378,146.69625246548324,0.14622950819672131,Cheap
20140524T000000,1680000.0,4,4.25,5584,68257,2.0,0,0,3,11,5584,0,1998,0,98014,47.6113,-121.952,5030,101901,62673,96871,24.61286021946467,0.21049180327868852,Cheap
20140919T000000,6885000.0,6,7.75,9890,31374,2.0,0,4,3,13,8860,1030,2001,0,98039,47.6305,-122.24,4540,42730,21484,38190,219.44922547332186,0.8931147540983606,Very High
20140910T000000,368000.0,3,2.5,2080,4307,2.0,0,0,3,7,2080,0,2004,0,98065,47.53,-121.848,2080,4947,2227,2867,85.4423032273044,0.03842622950819672,Very Cheap
20141120T000000,811500.0,5,4.25,3970,4500,2.0,0,0,3,9,2860,1110,2004,0,98027,47.5402,-122.069,3480,4500,530,1020,180.33333333333334,0.09659016393442622,Very Cheap
20140604T000000,275000.0,2,1.0,770,8149,1.0,0,0,5,6,770,0,1948,0,98155,47.7406,-122.302,770,8150,7379,7380,33.74647195974966,0.02622950819672131,Very Cheap
20140929T000000,650000.0,4,2.5,2500,6005,2.0,0,0,3,9,2500,0,2001,0,98033,47.6922,-122.174,2680,7200,3505,4520,108.24313072439634,0.07540983606557378,Very Cheap
20150219T000000,485000.0,3,2.0,2410,50654,1.5,0,0,3,7,2410,0,1995,0,98070,47.4154,-122.458,1900,36300,48244,34400,9.574762111580526,0.05377049180327869,Very Cheap
20140815T000000,425000.0,3,2.5,1340,10018,1.0,0,0,4,7,1340,0,1976,0,98052,47.6366,-122.094,2520,13068,8678,10548,42.423637452585346,0.04590163934426229,Very Cheap
20141210T000000,530000.0,3,2.5,2640,13775,1.0,0,0,3,8,1550,1090,1978,0,98005,47.5875,-122.177,2120,12432,11135,10312,38.475499092558984,0.05967213114754098,Very Cheap
20140522T000000,657000.0,4,1.75,2740,8520,1.0,0,2,3,8,1370,1370,1954,0,98118,47.5445,-122.263,2740,9286,5780,6546,77.11267605633803,0.07632786885245901,Very Cheap
20141231T000000,315000.0,4,2.75,1580,3770,1.0,0,0,3,7,1080,500,2002,0,98019,47.7368,-121.968,1740,3800,2190,2060,83.55437665782493,0.031475409836065574,Very Cheap
20140513T000000,273000.0,4,1.5,2180,22870,1.0,0,0,4,6,1280,900,1954,1975,98042,47.3187,-122.081,2420,22614,20690,20194,11.937035417577613,0.025967213114754098,Very Cheap
20140915T000000,550000.0,3,2.75,1960,13252,1.0,0,0,5,8,1240,720,1975,0,98006,47.5582,-122.139,2040,9866,11292,7826,41.50316933293088,0.06229508196721312,Very Cheap
20141215T000000,347000.0,2,2.25,1560,1705,2.0,0,0,3,8,1270,290,2006,0,98126,47.5482,-122.374,1560,1758,145,198,203.51906158357772,0.03567213114754098,Very Cheap
20140606T000000,525000.0,5,2.75,2440,8000,1.0,0,0,4,7,1240,1200,1972,0,98034,47.7283,-122.17,1780,8391,5560,6611,65.625,0.05901639344262295,Very Cheap
20140925T000000,490000.0,3,1.5,990,1343,2.0,0,0,3,8,840,150,2007,0,98112,47.6236,-122.306,1350,2521,353,1171,364.8548026805659,0.05442622950819672,Very Cheap
20141229T000000,500000.0,3,2.25,2210,7916,2.0,0,0,3,8,2210,0,1978,0,98133,47.7175,-122.339,1450,7955,5706,6505,63.163213744315314,0.05573770491803279,Very Cheap
20150128T000000,585000.0,3,2.75,3080,7282,2.0,0,0,3,9,3080,0,2008,0,98059,47.4826,-122.149,3080,7274,4202,4194,80.33507278220269,0.06688524590163934,Very Cheap
20141106T000000,926500.0,4,2.75,2900,17802,1.0,0,2,3,9,1750,1150,1981,0,98034,47.7004,-122.229,2900,15720,14902,12820,52.04471407706999,0.11167213114754099,Cheap
20141024T000000,465000.0,1,1.0,1020,3200,1.0,0,0,3,7,1020,0,1927,0,98109,47.6361,-122.343,1670,3480,2180,1810,145.3125,0.051147540983606556,Very Cheap
20150327T000000,200000.0,4,2.0,1900,8160,1.0,0,0,3,7,1900,0,1975,0,98022,47.2114,-121.986,1280,6532,6260,5252,24.50980392156863,0.01639344262295082,Very Cheap
20150126T000000,1680000.0,6,4.75,5770,16747,2.0,0,3,3,12,4500,1270,1998,0,98006,47.5512,-122.11,4470,14571,10977,10101,100.31647459246432,0.21049180327868852,Cheap
20140923T000000,220500.0,2,1.0,990,57499,1.0,0,0,2,6,990,0,1949,0,98070,47.4145,-122.463,2090,27442,56509,25352,3.8348493017269867,0.019081967213114753,Very Cheap
20150504T000000,329000.0,2,1.0,990,57499,1.0,0,0,2,6,990,0,1949,0,98070,47.4145,-122.463,2090,27442,56509,25352,5.721838640672011,0.03331147540983607,Very Cheap
20140703T000000,715000.0,3,4.0,2080,2250,3.0,0,4,3,8,2080,0,1997,0,98103,47.6598,-122.355,2080,2250,170,170,317.77777777777777,0.0839344262295082,Very Cheap
20150424T000000,780000.0,3,4.0,2080,2250,3.0,0,4,3,8,2080,0,1997,0,98103,47.6598,-122.355,2080,2250,170,170,346.6666666666667,0.09245901639344262,Very Cheap
20140818T000000,410000.0,2,1.0,1480,4080,1.0,0,0,3,7,1050,430,1949,0,98117,47.6842,-122.393,1310,4080,2600,2770,100.49019607843137,0.043934426229508196,Very Cheap
20150506T000000,778100.0,2,1.0,1480,4080,1.0,0,0,3,7,1050,430,1949,0,98117,47.6842,-122.393,1310,4080,2600,2770,190.7107843137255,0.09220983606557377,Very Cheap
20150330T000000,406000.0,3,1.0,1090,11292,1.0,0,0,4,7,1090,0,1952,0,98133,47.7429,-122.358,1570,8198,10202,6628,35.954658165072615,0.04340983606557377,Very Cheap
20140505T000000,665000.0,4,2.5,2800,5900,1.0,0,0,3,8,1660,1140,1963,0,98115,47.6809,-122.286,2580,5900,3100,3320,112.71186440677967,0.07737704918032787,Very Cheap
20141125T000000,305000.0,2,1.0,1000,8212,1.0,0,0,4,7,1000,0,1947,0,98133,47.7444,-122.341,1620,8214,7212,6594,37.14076960545543,0.03016393442622951,Very Cheap
20140822T000000,265000.0,3,2.5,1640,7668,2.0,0,0,3,7,1640,0,1991,0,98038,47.3505,-122.027,1850,7200,6028,5350,34.55920709441836,0.024918032786885248,Very Cheap
20141002T000000,485000.0,4,1.0,1620,4080,1.5,0,0,3,7,1620,0,1923,0,98105,47.6696,-122.324,1760,4080,2460,2320,118.87254901960785,0.05377049180327869,Very Cheap
20140507T000000,600000.0,3,2.5,2460,108900,1.0,0,0,4,9,1860,600,1977,0,98027,47.4824,-122.0,2870,102366,106440,99496,5.509641873278237,0.06885245901639345,Very Cheap
20150421T000000,510000.0,2,1.5,1860,5100,1.0,0,0,3,7,1060,800,1940,0,98136,47.5573,-122.392,1710,5100,3240,3390,100.0,0.057049180327868855,Very Cheap
20140521T000000,195000.0,2,1.0,1080,3899,1.0,0,0,4,8,1080,0,1972,0,98198,47.3792,-122.321,1090,3899,2819,2809,50.01282380097461,0.015737704918032787,Very Cheap
20140528T000000,432500.0,3,1.75,1980,5100,1.0,0,0,3,7,1270,710,1965,0,98103,47.6911,-122.347,1400,5100,3120,3700,84.80392156862744,0.046885245901639346,Very Cheap
20141210T000000,490000.0,3,1.75,1510,8433,1.0,0,0,4,7,1220,290,1967,0,98008,47.6226,-122.103,1950,8199,6923,6249,58.105063441242734,0.05442622950819672,Very Cheap
20140711T000000,270000.0,3,2.5,1690,7165,2.0,0,0,4,7,1690,0,1992,0,98038,47.3498,-122.058,1410,8590,5475,7180,37.68318213538032,0.025573770491803278,Very Cheap
20140826T000000,370000.0,2,1.5,1010,2102,2.0,0,0,3,7,1010,0,1984,0,98119,47.6374,-122.375,1480,2632,1092,1152,176.02283539486203,0.038688524590163934,Very Cheap
20141215T000000,327500.0,3,2.5,2090,12027,2.0,0,0,3,8,2090,0,1991,0,98031,47.4084,-122.213,2090,12666,9937,10576,27.230398270557913,0.033114754098360656,Very Cheap
20150323T000000,826000.0,2,1.0,1060,6120,1.0,0,0,3,7,1060,0,1908,0,98103,47.6739,-122.329,1730,4080,5060,2350,134.96732026143792,0.09849180327868852,Very Cheap
20140701T000000,510000.0,3,1.75,1750,7020,2.0,0,0,3,7,1750,0,1934,1978,98010,47.3264,-122.038,1170,9546,5270,8376,72.64957264957265,0.057049180327868855,Very Cheap
20150311T000000,587750.0,2,1.0,890,4730,1.0,0,0,3,7,890,0,1941,0,98103,47.6876,-122.341,1330,5904,3840,4574,124.26004228329809,0.06724590163934427,Very Cheap
20150327T000000,449228.0,5,2.5,3020,24750,1.0,0,0,3,8,1650,1370,1965,0,98005,47.5897,-122.179,2930,16062,21730,13132,18.15062626262626,0.04907908196721311,Very Cheap
20140902T000000,565000.0,3,2.5,2030,217805,1.0,0,0,3,9,2030,0,1999,0,98070,47.3942,-122.515,1870,109468,215775,107598,2.5940634971648953,0.06426229508196721,Very Cheap
20150424T000000,660000.0,4,2.5,3170,186436,2.0,0,0,3,9,3170,0,2000,0,98038,47.4475,-122.034,3250,215186,183266,211936,3.5400888240468578,0.07672131147540984,Very Cheap
20141203T000000,400000.0,5,2.75,2470,19200,1.0,0,0,5,8,1250,1220,1977,0,98058,47.4496,-122.083,2140,35140,16730,33000,20.833333333333332,0.04262295081967213,Very Cheap
20140506T000000,612500.0,4,2.0,2060,5000,1.0,0,0,3,7,1030,1030,1949,2013,98117,47.6992,-122.379,1280,5000,2940,3720,122.5,0.07049180327868852,Very Cheap
20150313T000000,560000.0,4,1.75,2120,6250,1.0,0,0,5,7,1060,1060,1917,0,98136,47.5506,-122.385,1410,6250,4130,4840,89.6,0.06360655737704918,Very Cheap
20140903T000000,727000.0,3,2.25,2180,4200,1.5,0,0,5,8,1520,660,1939,0,98112,47.6412,-122.302,1850,4200,2020,2350,173.0952380952381,0.08550819672131148,Very Cheap
20150423T000000,224000.0,4,3.0,2300,7609,2.0,0,0,4,7,2300,0,1976,0,98002,47.2943,-122.227,940,5937,5309,4997,29.438822447102115,0.01954098360655738,Very Cheap
20141017T000000,1080000.0,4,2.5,4200,35267,2.0,0,0,3,11,4200,0,1990,0,98077,47.7108,-122.071,3540,22234,31067,18694,30.623529078175064,0.1318032786885246,Cheap
20150423T000000,439000.0,3,2.25,1480,7565,1.0,0,0,3,7,1220,260,1977,0,98034,47.7288,-122.191,1660,7565,6085,5905,58.030403172504954,0.04773770491803279,Very Cheap
20140508T000000,335000.0,3,1.5,2240,87625,1.5,0,0,2,7,1480,760,1980,0,98092,47.3043,-122.094,1920,110206,85385,108286,3.8231098430813124,0.03409836065573771,Very Cheap
20141016T000000,779000.0,4,1.5,2740,4912,1.0,0,0,4,8,1370,1370,1937,0,98199,47.6523,-122.412,2160,5006,2172,2846,158.5912052117264,0.09232786885245901,Very Cheap
20140730T000000,452000.0,5,1.75,1830,47916,1.5,0,0,3,6,1830,0,1948,0,98045,47.4881,-121.777,2010,13135,46086,11125,9.433174722430921,0.04944262295081967,Very Cheap
20150327T000000,775000.0,4,3.0,2000,5304,1.5,0,0,4,7,2000,0,1947,0,98115,47.6762,-122.285,1670,5304,3304,3634,146.1161387631976,0.09180327868852459,Very Cheap
20140916T000000,235000.0,3,1.75,1380,8362,1.0,0,0,3,7,1380,0,1967,0,98003,47.3121,-122.323,1380,8800,6982,7420,28.103324563501555,0.02098360655737705,Very Cheap
20141028T000000,370000.0,3,1.75,1620,37913,2.0,0,0,4,7,1620,0,1953,1975,98001,47.2875,-122.289,2190,21518,36293,19328,9.7591855036531,0.038688524590163934,Very Cheap
20141114T000000,790000.0,4,3.0,3180,12070,2.0,0,0,4,9,3180,0,1976,0,98074,47.6371,-122.058,3110,12600,8890,9490,65.45153272576637,0.09377049180327869,Very Cheap
20141201T000000,903000.0,2,1.5,1140,7800,1.0,0,0,4,6,1140,0,1947,0,98004,47.6142,-122.209,2020,7800,6660,5780,115.76923076923077,0.10859016393442623,Cheap
20140627T000000,209950.0,3,1.0,970,9583,1.0,0,0,4,6,970,0,1967,0,98023,47.3044,-122.366,970,7875,8613,6905,21.90858812480434,0.017698360655737704,Very Cheap
20140827T000000,309000.0,3,2.5,1780,7859,2.0,0,0,3,7,1780,0,1988,0,98038,47.3772,-122.045,1670,6618,6079,4948,39.31797938669042,0.030688524590163933,Very Cheap
20140609T000000,440000.0,3,1.75,2240,8153,1.0,0,0,3,7,1120,1120,1948,0,98125,47.7303,-122.329,1710,8100,5913,6390,53.96786458972157,0.04786885245901639,Very Cheap
20141006T000000,571500.0,4,2.25,2810,25990,2.0,0,0,3,8,1860,950,1959,0,98001,47.2993,-122.293,2020,16140,23180,14120,21.98922662562524,0.06511475409836065,Very Cheap
20140815T000000,514000.0,2,1.0,920,4000,1.0,0,0,4,7,920,0,1906,0,98105,47.6711,-122.328,1300,4000,3080,2700,128.5,0.05757377049180328,Very Cheap
20140728T000000,323000.0,3,1.75,1830,12500,1.0,0,1,3,7,1200,630,1947,0,98178,47.5087,-122.25,1830,7300,10670,5470,25.84,0.03252459016393443,Very Cheap
20141103T000000,290000.0,2,1.75,1560,7575,1.0,0,0,3,8,1560,0,2002,0,98030,47.3776,-122.228,2050,9000,6015,6950,38.28382838283829,0.02819672131147541,Very Cheap
20141205T000000,2575000.0,4,4.25,5540,15408,2.0,0,1,3,11,4280,1260,2006,0,98004,47.6071,-122.212,3570,14750,9868,11180,167.1209761163032,0.32786885245901637,Medium
20141009T000000,1362500.0,3,2.0,2310,21318,1.0,0,0,3,10,2310,0,1979,1996,98004,47.6381,-122.224,2950,21814,19008,18864,63.91312505863589,0.16885245901639345,Cheap
20140723T000000,551000.0,4,1.5,1470,5100,1.5,0,0,3,7,1470,0,1946,0,98117,47.6769,-122.381,1470,5100,3630,3630,108.03921568627452,0.06242622950819672,Very Cheap
20141023T000000,960000.0,4,2.5,3430,43560,1.5,0,2,5,10,3430,0,1979,0,98005,47.6426,-122.18,3700,44431,40130,40731,22.038567493112946,0.1160655737704918,Cheap
20141103T000000,720000.0,5,2.5,2900,9525,2.0,0,0,3,9,2900,0,1989,0,98006,47.5442,-122.138,2910,11854,6625,8944,75.59055118110236,0.08459016393442623,Very Cheap
20140506T000000,218000.0,3,1.75,1850,7684,1.0,0,0,3,8,1320,530,1979,0,98023,47.2975,-122.37,1940,7630,5834,5690,28.370640291514835,0.018754098360655738,Very Cheap
20141223T000000,334950.0,4,2.5,2190,7000,2.0,0,0,3,8,2190,0,1997,0,98042,47.3718,-122.109,2040,7700,4810,5660,47.85,0.03409180327868853,Very Cheap
20140729T000000,605000.0,4,2.25,2510,31584,2.0,0,0,4,9,2510,0,1979,0,98074,47.6153,-122.054,2510,39221,29074,36711,19.155268490374873,0.06950819672131148,Very Cheap
20141217T000000,825000.0,4,3.25,3200,4477,2.0,0,0,3,9,2390,810,2006,0,98199,47.664,-122.402,1830,4920,1277,3090,184.27518427518427,0.09836065573770492,Very Cheap
20140812T000000,268500.0,4,1.75,1670,8000,1.0,0,0,4,8,1670,0,1974,0,98023,47.3193,-122.383,1720,8000,6330,6280,33.5625,0.02537704918032787,Very Cheap
20140627T000000,230000.0,3,1.75,1010,9600,1.0,0,0,5,7,1010,0,1969,0,98042,47.3828,-122.09,1320,9600,8590,8280,23.958333333333332,0.020327868852459016,Very Cheap
20141121T000000,1335000.0,4,4.0,5050,202554,2.0,0,0,3,10,3260,1790,2000,0,98027,47.5269,-121.922,3370,213444,197504,210074,6.590835036582837,0.16524590163934427,Cheap
20150401T000000,245500.0,2,1.5,1430,9782,1.0,0,0,3,7,1430,0,1955,0,98188,47.441,-122.282,1430,9828,8352,8398,25.097117153956248,0.022360655737704918,Very Cheap
20140729T000000,440000.0,3,2.25,1880,7989,1.0,0,0,3,7,1280,600,1982,0,98125,47.7077,-122.299,1820,7414,6109,5594,55.07572912755038,0.04786885245901639,Very Cheap
20141007T000000,571500.0,4,2.75,2180,5799,2.0,0,0,4,8,2180,0,1993,0,98029,47.5702,-121.995,2060,6061,3619,4001,98.55147439213657,0.06511475409836065,Very Cheap
20150427T000000,182500.0,3,2.25,1830,4744,2.0,0,0,3,7,1830,0,1997,0,98001,47.2734,-122.248,1670,8001,2914,6331,38.46964586846543,0.014098360655737704,Very Cheap
20141028T000000,217000.0,2,1.0,970,5600,1.0,0,0,3,6,970,0,1951,0,98118,47.5297,-122.277,1020,5600,4630,4580,38.75,0.01862295081967213,Very Cheap
20150109T000000,335000.0,2,1.5,1170,5248,1.0,0,0,5,6,1170,0,1941,0,98126,47.5318,-122.374,1170,5120,4078,3950,63.833841463414636,0.03409836065573771,Very Cheap
20140524T000000,501000.0,2,1.0,1010,4320,1.0,0,0,5,7,1010,0,1924,0,98115,47.6846,-122.317,1680,4320,3310,2640,115.97222222222223,0.05586885245901639,Very Cheap
20141027T000000,339950.0,3,2.5,2140,7641,1.0,0,0,3,8,1290,850,1979,0,98056,47.5053,-122.186,2090,8000,5501,5910,44.49024996728177,0.03474754098360656,Very Cheap
20150121T000000,340000.0,3,1.75,2230,10403,1.0,0,0,3,8,1630,600,1968,0,98198,47.4092,-122.295,1730,9450,8173,7720,32.68287993847928,0.03475409836065574,Very Cheap
20150204T000000,582500.0,2,1.0,1140,23779,1.5,0,0,3,6,1140,0,1966,0,98033,47.6948,-122.172,2940,8417,22639,5477,24.49640439042853,0.06655737704918033,Very Cheap
20140825T000000,298800.0,2,1.0,860,8189,1.0,0,0,3,6,860,0,1948,0,98155,47.735,-122.306,1180,8189,7329,7009,36.48797166931249,0.029350819672131146,Very Cheap
20150312T000000,317500.0,6,1.75,2540,8400,1.0,0,0,3,8,1340,1200,1977,0,98058,47.4414,-122.129,1900,7695,5860,5795,37.79761904761905,0.03180327868852459,Very Cheap
20150402T000000,598000.0,4,2.5,2420,5118,1.5,0,2,5,7,1550,870,1926,0,98126,47.5671,-122.378,1740,5750,2698,4010,116.84251660805002,0.06859016393442623,Very Cheap
20150430T000000,375000.0,2,2.25,1640,2240,2.0,0,0,3,8,1640,0,1980,0,98133,47.7154,-122.341,1640,2240,600,600,167.41071428571428,0.03934426229508197,Very Cheap
20150116T000000,465000.0,4,2.25,2550,7650,2.0,0,2,4,9,2550,0,1996,0,98106,47.5296,-122.342,2550,7650,5100,5100,60.78431372549019,0.051147540983606556,Very Cheap
20150225T000000,551870.0,3,2.5,2507,18400,2.0,0,0,3,8,2507,0,2006,0,98001,47.2867,-122.27,1520,14709,15893,13189,29.992934782608696,0.06254032786885245,Very Cheap
20140508T000000,295000.0,3,2.5,1920,7229,2.0,0,0,3,8,1920,0,1993,0,98003,47.2659,-122.31,2310,8009,5309,5699,40.807857241665516,0.028852459016393443,Very Cheap
20140924T000000,263500.0,4,1.75,2210,6375,1.0,0,0,3,8,1640,570,1977,0,98003,47.3268,-122.328,2070,7210,4165,5140,41.333333333333336,0.024721311475409836,Very Cheap
20140616T000000,1095000.0,4,4.0,3530,8400,2.0,0,0,5,8,2630,900,1958,0,98199,47.6402,-122.395,2340,8216,4870,5876,130.35714285714286,0.13377049180327868,Cheap
20141112T000000,300000.0,2,1.0,1100,4010,1.5,0,0,5,6,1100,0,1920,0,98106,47.5296,-122.351,980,4501,2910,3521,74.81296758104739,0.029508196721311476,Very Cheap
20140722T000000,780000.0,4,1.0,3390,4500,1.5,0,0,3,8,2190,1200,1924,2014,98144,47.5824,-122.293,2030,4872,1110,2842,173.33333333333334,0.09245901639344262,Very Cheap
20150327T000000,325000.0,3,1.5,1590,7936,1.0,0,0,3,7,1590,0,1956,0,98106,47.5201,-122.366,1590,7936,6346,6346,40.952620967741936,0.03278688524590164,Very Cheap
20140807T000000,370000.0,2,1.0,820,6550,1.0,0,0,3,7,820,0,1949,2012,98126,47.5478,-122.381,1640,6550,5730,4910,56.48854961832061,0.038688524590163934,Very Cheap
20140725T000000,715000.0,4,2.5,2370,10000,1.0,0,0,5,8,1660,710,1974,0,98052,47.6383,-122.099,2480,9875,7630,7395,71.5,0.0839344262295082,Very Cheap
20150116T000000,356000.0,4,2.0,1600,12500,1.0,0,0,5,7,1600,0,1938,0,98166,47.4713,-122.355,1260,8306,10900,7046,28.48,0.03685245901639344,Very Cheap
20150324T000000,329950.0,4,1.75,1740,7208,1.5,0,0,3,8,1740,0,1976,0,98058,47.4483,-122.13,1680,7350,5468,5670,45.77552719200888,0.03343606557377049,Very Cheap
20140623T000000,490000.0,3,2.25,1470,2500,2.0,0,0,3,8,1080,390,1984,0,98117,47.6762,-122.36,1640,4300,1030,2660,196.0,0.05442622950819672,Very Cheap
20140610T000000,429000.0,3,3.25,1410,1246,3.0,0,0,3,8,1410,0,2005,0,98103,47.6981,-122.34,1410,1253,-164,-157,344.30176565008026,0.04642622950819672,Very Cheap
20150331T000000,510000.0,4,2.5,1620,8125,2.0,0,0,4,7,1620,0,1983,0,98074,47.6255,-122.059,1480,8120,6505,6640,62.76923076923077,0.057049180327868855,Very Cheap
20140924T000000,550000.0,3,2.5,2360,4080,2.0,0,0,3,7,2360,0,2003,0,98053,47.6825,-122.038,2290,4080,1720,1790,134.80392156862746,0.06229508196721312,Very Cheap
20150105T000000,467500.0,3,1.0,1830,6453,1.0,0,0,4,7,1830,0,1956,0,98125,47.7139,-122.288,1670,8012,4623,6342,72.44692391135906,0.05147540983606557,Very Cheap
20140623T000000,615000.0,5,2.0,2130,4180,1.5,0,0,5,7,1270,860,1926,0,98116,47.575,-122.388,1710,4180,2050,2470,147.12918660287082,0.07081967213114754,Very Cheap
20141013T000000,325000.0,2,1.0,990,15120,1.0,0,0,4,6,990,0,1953,0,98011,47.7669,-122.206,1300,11500,14130,10200,21.494708994708994,0.03278688524590164,Very Cheap
20140808T000000,219950.0,2,1.0,1010,4120,2.0,0,0,3,6,1010,0,1907,1953,98055,47.488,-122.2,1200,4120,3110,2920,53.38592233009709,0.01900983606557377,Very Cheap
20150413T000000,950000.0,3,1.0,1720,9830,1.0,0,0,4,7,1720,0,1946,0,98040,47.5905,-122.245,3200,8923,8110,5723,96.64292980671414,0.11475409836065574,Cheap
20140922T000000,925000.0,3,1.0,1630,3200,1.5,0,0,4,8,1630,0,1912,0,98109,47.6351,-122.352,1710,3600,1570,1890,289.0625,0.11147540983606558,Cheap
20140519T000000,251200.0,4,1.5,1310,8250,1.0,0,0,3,7,1060,250,1953,0,98148,47.425,-122.332,1260,8255,6940,6995,30.44848484848485,0.023108196721311477,Very Cheap
20140918T000000,215000.0,3,1.5,1610,5304,1.0,0,0,4,6,1610,0,1968,0,98042,47.3632,-122.087,1060,5304,3694,4244,40.535444947209655,0.018360655737704918,Very Cheap
20140805T000000,245000.0,3,2.0,1850,8208,1.0,0,0,4,7,1180,670,1970,0,98023,47.3109,-122.362,1790,8174,6358,6384,29.848927875243664,0.022295081967213116,Very Cheap
20150206T000000,259000.0,3,1.75,1270,4815,1.5,0,0,3,6,980,290,1922,0,98108,47.5495,-122.31,1270,6431,3545,5161,53.79023883696781,0.024131147540983607,Very Cheap
20141113T000000,349950.0,4,1.5,1420,6720,1.5,0,0,3,7,1420,0,1925,0,98108,47.5518,-122.311,1560,5600,5300,4040,52.075892857142854,0.036059016393442625,Very Cheap
20141118T000000,1565000.0,5,4.5,5220,67319,2.0,0,0,3,11,5220,0,2001,0,98072,47.7666,-122.128,4190,40609,62099,36419,23.24752298756666,0.19540983606557377,Cheap
20150508T000000,600000.0,2,1.0,1410,4500,1.0,0,0,3,7,1020,390,1939,0,98117,47.6883,-122.384,1300,4500,3090,3200,133.33333333333334,0.06885245901639345,Very Cheap
20141002T000000,405000.0,2,1.5,1170,1274,3.0,0,0,3,8,1170,0,2001,0,98107,47.6719,-122.381,1290,1308,104,18,317.89638932496075,0.043278688524590166,Very Cheap
20141202T000000,625000.0,3,2.5,1860,10027,2.0,0,0,3,8,1860,0,1993,0,98033,47.6775,-122.165,1530,9204,8167,7674,62.33170439812506,0.07213114754098361,Very Cheap
20140717T000000,430000.0,4,1.0,1620,37075,1.5,0,0,3,7,1620,0,1943,0,98024,47.5654,-121.929,2190,87117,35455,84927,11.598111935266353,0.04655737704918033,Very Cheap
20150429T000000,533000.0,3,3.0,1280,1085,3.0,0,0,3,8,1280,0,2004,0,98103,47.6569,-122.346,1300,1310,-195,10,491.2442396313364,0.060065573770491806,Very Cheap
20140728T000000,1050000.0,4,2.5,2750,9949,2.0,0,0,3,10,2750,0,1999,0,98007,47.6595,-122.147,2750,9860,7199,7110,105.53824504975374,0.12786885245901639,Cheap
20141024T000000,230000.0,3,1.75,1420,3000,1.0,0,0,3,5,710,710,1931,2014,98178,47.4928,-122.274,1960,5000,1580,3040,76.66666666666667,0.020327868852459016,Very Cheap
20140905T000000,275000.0,4,1.75,2000,8700,1.0,0,0,5,7,1010,990,1975,0,98042,47.374,-122.141,1490,7350,6700,5860,31.60919540229885,0.02622950819672131,Very Cheap
20140610T000000,403000.0,2,1.0,1100,3598,1.0,0,0,4,7,1100,0,1926,0,98144,47.5738,-122.313,1240,3598,2498,2358,112.00667037242913,0.04301639344262295,Very Cheap
20140910T000000,550388.0,3,3.0,1720,70567,1.0,0,2,5,7,1720,0,1966,0,98027,47.4936,-122.069,2740,70567,68847,67827,7.799509685830487,0.06234596721311476,Very Cheap
20140922T000000,415500.0,3,1.5,1240,12400,1.0,0,0,3,7,1240,0,1958,0,98007,47.607,-122.132,1640,9600,11160,7960,33.50806451612903,0.044655737704918035,Very Cheap
20150420T000000,913000.0,3,1.75,2170,4000,1.0,0,0,4,7,1110,1060,1925,0,98103,47.6546,-122.337,1890,4000,1830,2110,228.25,0.1099016393442623,Cheap
20150313T000000,334998.0,2,1.0,1800,5182,1.0,0,0,3,6,900,900,1942,0,98108,47.5508,-122.3,1570,5876,3382,4306,64.64646854496334,0.034098098360655735,Very Cheap
20140509T000000,201500.0,3,1.0,1160,8320,1.0,0,0,4,7,1160,0,1959,0,98032,47.3831,-122.288,1480,7800,7160,6320,24.21875,0.01659016393442623,Very Cheap
20150327T000000,820000.0,3,2.5,3030,46538,2.0,0,0,3,10,3030,0,1997,0,98053,47.664,-122.041,3370,51450,43508,48080,17.62000945463922,0.09770491803278689,Very Cheap
20140611T000000,371000.0,3,1.0,890,7200,1.0,0,0,3,7,890,0,1951,0,98125,47.71,-122.286,1630,7455,6310,5825,51.52777777777778,0.038819672131147544,Very Cheap
20141022T000000,229950.0,4,2.5,2150,7670,1.0,0,0,5,7,1240,910,1976,0,98031,47.3942,-122.189,1610,7350,5520,5740,29.980443285528033,0.020321311475409835,Very Cheap
20150422T000000,344900.0,4,2.5,2150,7670,1.0,0,0,5,7,1240,910,1976,0,98031,47.3942,-122.189,1610,7350,5520,5740,44.96740547588005,0.03539672131147541,Very Cheap
20140820T000000,840000.0,3,2.5,2060,9715,2.0,0,0,3,8,2060,0,1924,2006,98115,47.6961,-122.316,1240,7072,7655,5832,86.46423057128152,0.10032786885245902,Cheap
20140916T000000,285000.0,3,1.5,1380,12196,1.0,0,0,4,7,1380,0,1967,0,98003,47.3204,-122.322,1600,10720,10816,9120,23.368317481141357,0.02754098360655738,Very Cheap
20150326T000000,475000.0,4,2.25,1800,7200,1.0,0,0,3,7,1230,570,1979,0,98177,47.7717,-122.376,2260,7498,5400,5238,65.97222222222223,0.05245901639344262,Very Cheap
20150303T000000,420000.0,2,1.0,1460,7832,1.0,0,0,3,6,1460,0,1924,0,98166,47.4617,-122.346,1460,7632,6372,6172,53.62614913176711,0.04524590163934426,Very Cheap
20141030T000000,685000.0,3,2.0,2210,5000,1.5,0,2,3,7,1710,500,1909,0,98103,47.6754,-122.357,1920,5000,2790,3080,137.0,0.08,Very Cheap
20140721T000000,879000.0,4,3.0,3590,89640,2.0,0,0,3,10,3590,0,2005,0,98077,47.7557,-122.036,2790,54014,86050,51224,9.805890227576974,0.10544262295081967,Cheap
20150120T000000,197200.0,3,1.0,1140,8775,1.0,0,0,3,6,990,150,1942,0,98146,47.4824,-122.336,1300,8775,7635,7475,22.472934472934472,0.01602622950819672,Very Cheap
20140703T000000,529950.0,3,1.0,1240,5000,1.5,0,0,5,7,1240,0,1909,0,98107,47.6755,-122.367,1240,4900,3760,3660,105.99,0.0596655737704918,Very Cheap
20140505T000000,1090000.0,4,2.5,4340,141570,2.5,0,0,3,11,4340,0,1992,0,98053,47.6805,-122.048,2720,97138,137230,94418,7.6993713357349725,0.13311475409836065,Cheap
20140520T000000,792000.0,3,1.5,1570,1050,2.0,0,0,3,8,1570,0,1915,0,98109,47.6358,-122.356,2070,3600,-520,1530,754.2857142857143,0.0940327868852459,Very Cheap
20140820T000000,262000.0,3,2.5,1680,10300,2.0,0,0,4,7,1680,0,1994,0,98010,47.314,-122.001,1680,9849,8620,8169,25.436893203883496,0.024524590163934427,Very Cheap
20141007T000000,353900.0,3,1.75,1560,5760,1.0,0,0,5,6,780,780,1927,0,98106,47.5272,-122.359,1320,7680,4200,6360,61.44097222222222,0.03657704918032787,Very Cheap
20140818T000000,380000.0,1,1.5,1200,44866,1.5,0,0,3,7,1200,0,1983,0,98019,47.7205,-121.93,1480,67082,43666,65602,8.469665225337673,0.04,Very Cheap
20150327T000000,305000.0,3,2.5,1690,5175,2.0,0,0,3,7,1690,0,2002,0,98038,47.3564,-122.016,1830,5175,3485,3345,58.93719806763285,0.03016393442622951,Very Cheap
20150420T000000,440000.0,4,2.0,2310,5004,1.0,0,0,3,7,1430,880,1994,0,98108,47.5471,-122.298,1630,5060,2694,3430,87.92965627498002,0.04786885245901639,Very Cheap
20140617T000000,1008000.0,4,3.5,2650,3060,2.0,0,0,3,9,2060,590,2001,0,98103,47.6735,-122.332,1470,3060,410,1590,329.4117647058824,0.12236065573770492,Cheap
20140919T000000,549900.0,5,3.0,3610,7555,2.0,0,0,3,8,3610,0,2003,0,98038,47.3534,-122.012,3610,7979,3945,4369,72.7862342819325,0.062281967213114756,Very Cheap
20150127T000000,678500.0,4,3.0,2620,214750,2.0,0,0,3,8,2620,0,1992,0,98058,47.4239,-122.068,2060,212137,212130,210077,3.159487776484284,0.07914754098360656,Very Cheap
20140826T000000,270000.0,3,2.25,1760,8287,1.0,0,0,3,7,1160,600,1986,0,98188,47.4501,-122.274,1290,9587,6527,8297,32.581151200675755,0.025573770491803278,Very Cheap
20150330T000000,430000.0,3,1.0,940,12521,1.5,0,0,4,7,940,0,1949,0,98133,47.7169,-122.331,1920,9046,11581,7126,34.34230492772143,0.04655737704918033,Very Cheap
20140630T000000,1925000.0,5,4.25,4830,8050,2.5,0,2,4,11,3710,1120,1914,0,98144,47.5789,-122.286,4470,9194,3220,4724,239.1304347826087,0.24262295081967214,Cheap
20140813T000000,790500.0,4,2.75,3350,5416,2.0,0,0,3,9,3350,0,2014,0,98053,47.6849,-122.016,3625,5637,2066,2012,145.95642540620383,0.09383606557377049,Very Cheap
20141017T000000,447450.0,3,2.25,1570,7200,2.0,0,0,3,8,1570,0,1991,0,98034,47.7332,-122.232,1620,7318,5630,5698,62.145833333333336,0.04884590163934426,Very Cheap
20150209T000000,375000.0,3,2.0,2240,5200,1.0,0,0,3,7,1630,610,1954,0,98112,47.6191,-122.296,1470,3775,2960,2305,72.11538461538461,0.03934426229508197,Very Cheap
20150206T000000,565000.0,4,2.0,1950,9940,1.0,0,0,4,7,1950,0,1963,0,98008,47.6332,-122.118,1920,9270,7990,7350,56.841046277665995,0.06426229508196721,Very Cheap
20150423T000000,400000.0,2,1.0,1010,3916,1.0,0,2,4,6,810,200,1918,0,98144,47.5728,-122.306,1580,3888,2906,2308,102.14504596527068,0.04262295081967213,Very Cheap
20150220T000000,246000.0,3,1.5,1630,10200,1.0,0,0,4,8,1300,330,1976,0,98023,47.3155,-122.364,1960,6700,8570,4740,24.11764705882353,0.02242622950819672,Very Cheap
20141029T000000,329922.0,3,1.75,1420,6289,1.0,0,0,3,7,1100,320,1967,0,98155,47.7398,-122.314,1460,7402,4869,5942,52.46016854825886,0.03343239344262295,Very Cheap
20150414T000000,1249000.0,5,3.25,3950,44431,1.0,0,0,3,10,2100,1850,1969,0,98005,47.6451,-122.173,3860,45870,40481,42010,28.111003578582523,0.1539672131147541,Cheap
20150420T000000,375000.0,3,1.0,1210,7425,1.0,0,0,4,6,1210,0,1910,0,98133,47.7125,-122.33,1260,7425,6215,6165,50.505050505050505,0.03934426229508197,Very Cheap
20140508T000000,385000.0,3,1.75,1890,9920,1.0,0,0,3,7,1230,660,1944,0,98125,47.7327,-122.306,1380,9086,8030,7706,38.810483870967744,0.04065573770491803,Very Cheap
20140903T000000,591500.0,4,2.5,1690,4080,1.5,0,0,4,7,1140,550,1912,0,98117,47.6825,-122.379,1600,4590,2390,2990,144.97549019607843,0.06773770491803278,Very Cheap
20140918T000000,255000.0,4,2.0,2560,12155,1.0,0,0,4,7,1350,1210,1960,0,98003,47.3326,-122.323,1790,11906,9595,10116,20.97902097902098,0.02360655737704918,Very Cheap
20150316T000000,275000.0,3,1.5,1350,7800,1.0,0,0,3,7,1350,0,1959,0,98059,47.4805,-122.158,1510,8040,6450,6530,35.256410256410255,0.02622950819672131,Very Cheap
20141229T000000,800000.0,4,2.75,3120,5000,2.0,0,0,3,9,3120,0,2010,0,98074,47.594,-122.062,3200,5000,1880,1800,160.0,0.09508196721311475,Very Cheap
20150425T000000,327000.0,2,1.0,1140,7435,1.0,0,0,3,7,1140,0,1952,1990,98125,47.73,-122.31,1320,9385,6295,8065,43.98117014122394,0.033049180327868855,Very Cheap
20141230T000000,355000.0,4,1.5,2230,11536,1.0,0,1,4,7,1220,1010,1954,0,98166,47.4409,-122.348,2170,12465,9306,10295,30.773231622746184,0.036721311475409836,Very Cheap
20141003T000000,310000.0,2,1.0,1050,8220,1.0,0,0,4,6,780,270,1947,0,98155,47.7598,-122.316,1340,7651,7170,6311,37.71289537712895,0.03081967213114754,Very Cheap
20140519T000000,869000.0,5,3.25,4180,49222,2.0,0,0,4,8,2880,1300,1979,0,98027,47.5488,-122.094,3170,8029,45042,4859,17.654707244727966,0.10413114754098361,Cheap
20140808T000000,272000.0,3,2.0,1200,5700,1.0,0,0,5,7,1200,0,1942,0,98178,47.5031,-122.242,1190,6384,4500,5194,47.719298245614034,0.02583606557377049,Very Cheap
20140711T000000,665000.0,5,2.25,3320,60984,2.0,0,0,3,9,3320,0,2000,0,98045,47.4862,-121.718,1580,55322,57664,53742,10.904499540863178,0.07737704918032787,Very Cheap
20141117T000000,225000.0,3,2.5,1590,8449,2.0,0,0,3,7,1590,0,1989,0,98030,47.3493,-122.177,1750,7172,6859,5422,26.63037045804237,0.019672131147540985,Very Cheap
20141226T000000,375000.0,3,2.5,2750,37096,2.0,0,0,3,9,2750,0,1989,0,98038,47.3732,-122.023,2700,40091,34346,37391,10.10890662065991,0.03934426229508197,Very Cheap
20140610T000000,375500.0,3,1.5,1530,7200,1.0,0,0,3,8,1530,0,1975,0,98155,47.7691,-122.297,2150,7216,5670,5066,52.15277777777778,0.03940983606557377,Very Cheap
20150402T000000,550000.0,3,1.75,1570,6500,1.0,0,0,3,7,920,650,1948,0,98116,47.565,-122.398,1570,5750,4930,4180,84.61538461538461,0.06229508196721312,Very Cheap
20140918T000000,248000.0,3,1.0,1470,7680,1.0,0,0,3,7,1220,250,1946,0,98106,47.5276,-122.359,1470,6784,6210,5314,32.291666666666664,0.022688524590163933,Very Cheap
20150506T000000,546940.0,3,1.0,1470,7680,1.0,0,0,3,7,1220,250,1946,0,98106,47.5276,-122.359,1470,6784,6210,5314,71.21614583333333,0.06189377049180328,Very Cheap
20140902T000000,680000.0,4,3.0,3150,6175,2.0,0,0,3,9,3150,0,2001,0,98075,47.5968,-122.017,3150,6986,3025,3836,110.12145748987854,0.07934426229508197,Very Cheap
20140718T000000,350000.0,4,2.5,2380,6124,2.0,0,0,3,8,2380,0,1997,0,98030,47.3662,-122.175,2170,6097,3744,3927,57.152188112344874,0.036065573770491806,Very Cheap
20150325T000000,593000.0,2,2.5,2000,2500,3.0,0,1,3,8,1810,190,1994,0,98116,47.5788,-122.396,1970,5650,500,3680,237.2,0.0679344262295082,Very Cheap
20150319T000000,390000.0,2,1.0,1140,8147,1.0,0,0,3,7,1140,0,1958,0,98125,47.7278,-122.289,1260,8148,7007,6888,47.8703817356082,0.04131147540983607,Very Cheap
20141007T000000,297000.0,3,1.0,1340,18000,1.0,0,0,4,7,1340,0,1924,0,98070,47.4443,-122.509,1660,196591,16660,194931,16.5,0.029114754098360656,Very Cheap
20150305T000000,355000.0,2,1.0,1450,9150,1.0,0,0,4,7,1450,0,1965,0,98188,47.4689,-122.277,1440,10636,7700,9196,38.797814207650276,0.036721311475409836,Very Cheap
20140814T000000,309900.0,3,2.5,2020,26670,2.0,0,0,3,7,2020,0,1987,0,98003,47.2597,-122.31,1680,10939,24650,9259,11.619797525309336,0.030806557377049182,Very Cheap
20140924T000000,257000.0,3,2.25,1810,12000,2.0,0,0,3,7,1810,0,1992,0,98003,47.3476,-122.3,1720,9916,10190,8196,21.416666666666668,0.023868852459016394,Very Cheap
20140826T000000,1698000.0,4,3.0,3600,9687,2.0,0,0,4,9,3600,0,1959,1995,98004,47.6257,-122.208,2620,10400,6087,7780,175.28646639826573,0.21285245901639344,Cheap
20150113T000000,300000.0,3,2.0,1260,2550,2.0,0,0,3,7,1260,0,1987,0,98117,47.6821,-122.378,1590,3825,1290,2235,117.6470588235294,0.029508196721311476,Very Cheap
20141217T000000,500000.0,3,2.0,1560,1156,3.0,0,0,3,8,1560,0,2014,0,98122,47.605,-122.304,1560,1728,-404,168,432.52595155709344,0.05573770491803279,Very Cheap
20141016T000000,900000.0,8,4.0,4020,7500,1.0,0,0,3,8,2010,2010,1968,0,98107,47.6732,-122.363,1560,3737,3480,2177,120.0,0.10819672131147541,Cheap
20140515T000000,695000.0,4,3.0,3150,9130,2.0,0,0,3,9,3150,0,2001,0,98075,47.5974,-122.017,2970,6228,5980,3258,76.12267250821468,0.08131147540983606,Very Cheap
20141218T000000,213400.0,4,2.5,1680,6655,2.0,0,0,3,7,1680,0,2001,0,98030,47.3867,-122.191,1680,6982,4975,5302,32.06611570247934,0.018150819672131148,Very Cheap
20140709T000000,425000.0,2,1.0,1320,8830,1.0,0,0,3,7,1020,300,1939,0,98199,47.6433,-122.404,1620,8531,7510,6911,48.131370328425824,0.04590163934426229,Very Cheap
20140811T000000,420000.0,3,3.0,2700,47050,2.0,0,0,4,9,1570,1130,1986,0,98058,47.4446,-122.104,2260,45901,44350,43641,8.926673751328375,0.04524590163934426,Very Cheap
20150209T000000,411000.0,1,1.0,1080,5000,1.5,0,0,3,7,1080,0,1948,0,98199,47.6603,-122.394,1620,4000,3920,2380,82.2,0.044065573770491806,Very Cheap
20150209T000000,762500.0,4,2.25,3130,41382,2.0,0,0,3,9,3130,0,1986,0,98053,47.6683,-122.034,3130,54886,38252,51756,18.425885650766034,0.09016393442622951,Very Cheap
20140527T000000,569950.0,5,4.5,4850,40902,2.0,0,0,3,10,4850,0,2001,0,98023,47.3181,-122.344,1640,13503,36052,11863,13.934526429025475,0.06491147540983606,Very Cheap
20150424T000000,258000.0,4,1.0,1220,8500,1.5,0,0,5,6,1220,0,1916,0,98168,47.4792,-122.277,1460,8500,7280,7040,30.352941176470587,0.024,Very Cheap
20150224T000000,499000.0,3,2.25,1780,3665,2.0,0,0,3,8,1780,0,2004,0,98029,47.5495,-121.997,1770,3669,1885,1899,136.15279672578444,0.05560655737704918,Very Cheap
20150511T000000,310000.0,3,1.0,1250,10723,1.0,0,0,4,7,1250,0,1961,0,98059,47.4894,-122.135,1520,10723,9473,9203,28.90982001305605,0.03081967213114754,Very Cheap
20141103T000000,398500.0,2,2.5,1780,1311,3.0,0,0,3,8,1350,430,2005,0,98103,47.6962,-122.34,1390,1227,-469,-163,303.96643783371474,0.042426229508196724,Very Cheap
20140613T000000,250600.0,4,2.5,1930,8660,1.0,0,0,3,7,1120,810,1981,0,98001,47.3261,-122.26,1830,9591,6730,7761,28.937644341801384,0.02302950819672131,Very Cheap
20140812T000000,352000.0,4,2.5,2470,6116,1.0,0,0,3,7,1420,1050,1985,0,98038,47.3792,-122.047,1670,7627,3646,5957,57.55395683453237,0.03632786885245902,Very Cheap
20140715T000000,600000.0,2,1.0,1180,2160,1.0,0,1,3,7,940,240,1909,0,98119,47.6313,-122.368,2700,5400,980,2700,277.77777777777777,0.06885245901639345,Very Cheap
20150324T000000,645000.0,3,1.0,2270,4182,1.0,0,0,4,7,1170,1100,1946,0,98115,47.688,-122.32,1860,4080,1912,2220,154.23242467718794,0.07475409836065573,Very Cheap
20140724T000000,291500.0,4,2.5,1770,5000,2.0,0,0,3,7,1770,0,2004,0,98038,47.3503,-122.005,2080,5100,3230,3020,58.3,0.02839344262295082,Very Cheap
20140508T000000,350000.0,4,1.75,2250,13515,1.0,0,0,4,8,2150,100,1940,0,98030,47.3789,-122.229,2150,12508,11265,10358,25.897151313355533,0.036065573770491806,Very Cheap
20140919T000000,279000.0,3,2.5,1540,7280,1.0,0,0,3,7,1080,460,1974,0,98003,47.3102,-122.322,1220,6440,5740,5220,38.324175824175825,0.02675409836065574,Very Cheap
20150304T000000,320000.0,2,1.0,820,5400,1.0,0,0,3,6,820,0,1940,0,98117,47.6976,-122.375,1370,5632,4580,4262,59.25925925925926,0.032131147540983604,Very Cheap
20150310T000000,495000.0,2,2.0,1580,5203,1.0,0,0,3,8,1580,0,2004,0,98053,47.7174,-122.032,1560,4770,3623,3210,95.13742071881607,0.05508196721311476,Very Cheap
20140828T000000,490000.0,4,2.5,2430,42646,1.0,0,0,3,7,1450,980,1989,0,98014,47.6164,-121.953,2000,38159,40216,36159,11.489940439900577,0.05442622950819672,Very Cheap
20140717T000000,770000.0,5,1.5,2160,5000,1.5,0,2,4,8,2160,0,1926,0,98107,47.6645,-122.36,1450,4265,2840,2815,154.0,0.09114754098360656,Very Cheap
20140709T000000,215000.0,3,1.75,1770,29004,1.0,0,0,3,8,1770,0,1959,0,98023,47.3204,-122.364,2300,24534,27234,22234,7.412770652323817,0.018360655737704918,Very Cheap
20150330T000000,665000.0,3,3.5,3580,95832,1.5,0,0,3,9,3580,0,2005,0,98038,47.4239,-122.015,2880,60548,92252,57668,6.939226980549295,0.07737704918032787,Very Cheap
20140819T000000,423500.0,3,2.25,1890,7498,1.0,0,0,3,7,1190,700,1987,0,98125,47.73,-122.297,1660,8100,5608,6440,56.481728460922916,0.04570491803278689,Very Cheap
20141009T000000,850000.0,3,3.0,1910,4800,1.5,0,0,3,9,1910,0,1900,1991,98103,47.6572,-122.346,1280,1310,2890,30,177.08333333333334,0.10163934426229508,Cheap
20140513T000000,155000.0,2,1.0,910,6232,1.0,0,0,3,6,910,0,1943,0,98118,47.5328,-122.272,1070,6232,5322,5162,24.87163029525032,0.010491803278688525,Very Cheap
20150413T000000,505000.0,3,2.25,1460,7210,1.0,0,0,3,7,1460,0,1963,0,98008,47.6316,-122.119,1850,7519,5750,5669,70.04160887656033,0.05639344262295082,Very Cheap
20150227T000000,780000.0,3,3.5,3310,5558,2.0,0,0,3,9,3310,0,2005,0,98029,47.5553,-122.003,3310,5270,2248,1960,140.33825116948543,0.09245901639344262,Very Cheap
20140825T000000,165000.0,3,1.5,1630,22764,1.0,0,0,3,7,1630,0,1970,0,98032,47.3611,-122.293,1620,17859,21134,16239,7.248286768581972,0.01180327868852459,Very Cheap
20140828T000000,707000.0,2,2.5,2130,5001,1.0,0,0,5,8,1330,800,1972,0,98199,47.6573,-122.399,1750,6000,2871,4250,141.37172565486904,0.08288524590163934,Very Cheap
20150501T000000,497000.0,3,2.5,1220,1475,3.0,0,0,3,8,1220,0,2000,0,98117,47.6909,-122.395,1220,1546,255,326,336.9491525423729,0.055344262295081964,Very Cheap
20141105T000000,349170.0,4,1.75,1670,8856,1.0,0,2,3,7,1070,600,1955,0,98178,47.5056,-122.251,1660,8088,7186,6428,39.42750677506775,0.03595672131147541,Very Cheap
20150102T000000,287000.0,4,1.5,1300,10050,1.5,0,0,3,7,1300,0,1963,0,98059,47.4899,-122.116,1730,10050,8750,8320,28.557213930348258,0.02780327868852459,Very Cheap
20141119T000000,2375000.0,4,2.5,3220,20251,1.0,0,0,3,10,3220,0,1969,0,98006,47.5692,-122.192,4200,22114,17031,17914,117.27815910325415,0.3016393442622951,Medium
20140602T000000,645000.0,4,2.5,2430,14400,1.0,0,0,5,8,1670,760,1963,0,98007,47.6202,-122.138,2140,9048,11970,6908,44.791666666666664,0.07475409836065573,Very Cheap
20141016T000000,238000.0,5,2.25,2240,9652,2.0,0,0,3,7,2240,0,1990,0,98055,47.4249,-122.211,2180,11644,7412,9464,24.658101947782843,0.02137704918032787,Very Cheap
20150213T000000,328000.0,5,2.25,2240,9652,2.0,0,0,3,7,2240,0,1990,0,98055,47.4249,-122.211,2180,11644,7412,9464,33.982594280978034,0.03318032786885246,Very Cheap
20141103T000000,365000.0,2,1.5,790,1123,2.0,0,0,3,8,700,90,2003,0,98119,47.651,-122.368,1370,1281,333,-89,325.02226179875333,0.0380327868852459,Very Cheap
20150317T000000,380000.0,3,1.0,1380,8147,1.0,0,0,4,7,1380,0,1948,0,98155,47.7407,-122.3,1360,8147,6767,6787,46.64293605007978,0.04,Very Cheap
20150310T000000,525000.0,4,1.5,1680,10500,2.0,0,0,3,7,1680,0,1962,0,98033,47.6806,-122.166,1830,10264,8820,8434,50.0,0.05901639344262295,Very Cheap
20140625T000000,402000.0,4,2.25,2000,3672,2.0,0,0,5,7,1650,350,1926,0,98117,47.6769,-122.383,2000,5100,1672,3100,109.47712418300654,0.04288524590163934,Very Cheap
20150424T000000,308000.0,2,1.0,1680,9250,1.0,0,0,3,7,860,820,1969,0,98072,47.7618,-122.162,1590,9542,7570,7952,33.2972972972973,0.030557377049180327,Very Cheap
20141009T000000,405000.0,3,2.5,1960,6997,2.0,0,0,3,7,1960,0,2006,0,98065,47.5415,-121.887,2320,5178,5037,2858,57.881949406888666,0.043278688524590166,Very Cheap
20140923T000000,808000.0,3,1.75,2590,32380,1.0,0,0,3,8,2590,0,1951,1994,98177,47.7539,-122.37,2340,28456,29790,26116,24.953675108091414,0.0961311475409836,Very Cheap
20150210T000000,875000.0,4,3.5,3790,6874,2.5,0,0,3,9,3790,0,2010,0,98053,47.6956,-122.022,3370,6535,3084,3165,127.29124236252545,0.10491803278688525,Cheap
20150319T000000,860000.0,3,2.5,2370,55321,3.0,0,0,4,8,2370,0,1982,0,98074,47.6148,-122.057,2590,41553,52951,38963,15.545633665335044,0.10295081967213114,Cheap
20140811T000000,367500.0,4,2.25,1930,7925,1.0,0,0,3,8,1300,630,1960,0,98155,47.7626,-122.312,1930,7200,5995,5270,46.37223974763407,0.03836065573770492,Very Cheap
20140805T000000,604000.0,6,3.5,2580,13572,1.0,0,0,3,8,1290,1290,1987,0,98052,47.6796,-122.113,2020,11656,10992,9636,44.50338933097554,0.06937704918032787,Very Cheap
20150204T000000,230000.0,2,0.75,890,19703,1.0,0,0,3,6,890,0,1934,0,98045,47.4922,-121.783,1270,9800,18813,8530,11.67334923615693,0.020327868852459016,Very Cheap
20141217T000000,435000.0,4,2.75,2160,8148,1.0,0,0,3,7,1410,750,1978,0,98125,47.7261,-122.306,2060,8100,5988,6040,53.38733431516937,0.04721311475409836,Very Cheap
20141010T000000,347500.0,4,2.5,1970,7098,2.0,0,0,3,7,1970,0,2007,0,98038,47.3576,-122.058,1970,5361,5128,3391,48.95745280360665,0.035737704918032784,Very Cheap
20150318T000000,525000.0,4,1.75,1570,16697,1.0,0,2,3,7,1030,540,1981,0,98052,47.671,-122.135,1560,9698,15127,8138,31.442774151045096,0.05901639344262295,Very Cheap
20140603T000000,280000.0,2,1.5,1480,15641,1.0,0,0,4,7,1480,0,1940,0,98146,47.5008,-122.366,1520,7525,14161,6005,17.90166869126015,0.026885245901639345,Very Cheap
20150205T000000,490000.0,2,1.5,1480,15641,1.0,0,0,4,7,1480,0,1940,0,98146,47.5008,-122.366,1520,7525,14161,6005,31.327920209705262,0.05442622950819672,Very Cheap
20150323T000000,265000.0,4,1.75,1430,5490,1.0,0,0,5,6,1430,0,1942,0,98056,47.494,-122.184,1030,5900,4060,4870,48.2695810564663,0.024918032786885248,Very Cheap
20140902T000000,645000.0,4,2.25,2720,18295,1.0,0,0,4,8,2000,720,1979,0,98075,47.5851,-122.073,2720,18295,15575,15575,35.25553429898879,0.07475409836065573,Very Cheap
20150427T000000,390000.0,3,2.25,2420,31497,1.0,0,0,4,8,1750,670,1964,0,98058,47.4422,-122.151,2040,30472,29077,28432,12.38213163158396,0.04131147540983607,Very Cheap
20150417T000000,267500.0,3,2.5,1400,7629,1.0,0,0,3,7,1120,280,1988,0,98030,47.3788,-122.179,1530,7688,6229,6158,35.063573207497704,0.025245901639344263,Very Cheap
20141217T000000,1275000.0,4,3.5,5844,10766,2.0,0,1,3,11,5844,0,2007,0,98023,47.3293,-122.364,3413,10766,4922,7353,118.4283856585547,0.15737704918032788,Cheap
20140506T000000,404000.0,4,1.75,1840,10720,1.0,0,0,3,7,960,880,1958,0,98008,47.6074,-122.125,1840,9044,8880,7204,37.6865671641791,0.043147540983606555,Very Cheap
20150429T000000,380000.0,3,2.25,2530,12042,2.0,0,0,3,8,2530,0,1989,0,98042,47.3742,-122.125,2480,10172,9512,7692,31.556219897027074,0.04,Very Cheap
20140808T000000,812500.0,4,2.75,2810,10300,1.0,0,0,4,9,1810,1000,1978,0,98006,47.5626,-122.149,2710,9900,7490,7190,78.88349514563107,0.09672131147540984,Very Cheap
20140703T000000,265000.0,3,1.0,1020,8610,1.0,0,0,5,7,1020,0,1959,0,98056,47.4974,-122.169,1070,5940,7590,4870,30.778164924506388,0.024918032786885248,Very Cheap
20140709T000000,480000.0,5,2.75,2550,7725,1.0,0,0,5,8,1390,1160,1967,0,98056,47.5388,-122.171,2450,7725,5175,5275,62.13592233009709,0.05311475409836065,Very Cheap
20140916T000000,264000.0,1,1.0,710,4725,1.0,0,0,3,6,710,0,1939,0,98133,47.7328,-122.34,900,5250,4015,4350,55.87301587301587,0.02478688524590164,Very Cheap
20150423T000000,1350000.0,5,3.0,5530,38816,1.5,0,2,3,10,5530,0,1969,1994,98072,47.7352,-122.116,3800,44417,33286,40617,34.77947238252267,0.16721311475409836,Cheap
20140709T000000,550000.0,4,1.75,2150,9000,1.0,0,0,4,7,1110,1040,1966,0,98052,47.6812,-122.113,2040,9000,6850,6960,61.111111111111114,0.06229508196721312,Very Cheap
20150504T000000,615000.0,2,1.5,880,2400,1.5,0,0,3,7,880,0,1929,0,98122,47.6144,-122.295,1220,4440,1520,3220,256.25,0.07081967213114754,Very Cheap
20140519T000000,464000.0,3,1.75,1630,28600,1.0,0,0,3,8,1630,0,1967,0,98072,47.7742,-122.14,2260,26000,26970,23740,16.223776223776223,0.05101639344262295,Very Cheap
20140716T000000,365000.0,3,1.0,1380,30940,2.0,0,0,3,8,1380,0,1976,0,98042,47.334,-122.106,2350,32500,29560,30150,11.797026502908857,0.0380327868852459,Very Cheap
20140715T000000,490000.0,4,2.25,2800,10800,1.0,0,0,3,8,1680,1120,1977,0,98011,47.7448,-122.177,2260,9800,8000,7540,45.370370370370374,0.05442622950819672,Very Cheap
20140626T000000,280927.0,4,2.25,2070,7350,2.0,0,0,4,8,2070,0,1977,0,98032,47.3615,-122.274,2080,7210,5280,5130,38.22136054421769,0.027006819672131147,Very Cheap
20140516T000000,282613.0,2,1.0,830,6017,1.0,0,0,4,6,830,0,1954,0,98133,47.7466,-122.334,1340,6040,5187,4700,46.96908758517534,0.02722793442622951,Very Cheap
20141023T000000,675000.0,3,2.25,2770,15886,2.0,0,0,3,10,2770,0,1982,0,98177,47.7464,-122.362,3290,15886,13116,12596,42.490242981241344,0.07868852459016394,Very Cheap
20140518T000000,575550.0,4,2.5,2060,7475,1.0,0,0,3,8,1440,620,1985,0,98052,47.7272,-122.105,2280,8396,5415,6116,76.99665551839465,0.06564590163934426,Very Cheap
20140520T000000,259900.0,3,2.0,1490,7770,1.0,0,0,4,7,1490,0,1990,0,98042,47.3686,-122.09,1540,7366,6280,5826,33.44916344916345,0.024249180327868852,Very Cheap
20141209T000000,450000.0,4,2.25,2120,8267,2.0,0,0,3,8,2120,0,1996,0,98045,47.4885,-121.779,2150,7746,6147,5596,54.43328898028305,0.04918032786885246,Very Cheap
20140729T000000,487500.0,4,2.5,2810,6296,2.0,0,0,3,9,2810,0,2013,0,98059,47.5019,-122.151,2850,6140,3486,3290,77.43011435832274,0.054098360655737705,Very Cheap
20150128T000000,275000.0,4,2.25,2400,17842,2.0,0,0,4,7,2400,0,1973,0,98002,47.2866,-122.217,1610,12100,15442,10490,15.413070283600494,0.02622950819672131,Very Cheap
20140811T000000,305000.0,3,2.5,2460,5027,2.0,0,0,3,8,2460,0,2002,0,98042,47.372,-122.102,2740,5000,2567,2260,60.67236920628606,0.03016393442622951,Very Cheap
20141010T000000,395000.0,3,1.75,2030,217800,1.0,0,2,4,8,2030,0,1977,0,98092,47.2618,-122.12,2570,216057,215770,213487,1.8135904499540862,0.0419672131147541,Very Cheap
20150422T000000,215000.0,3,1.0,880,7648,1.0,0,2,4,6,880,0,1940,0,98022,47.1963,-121.997,1020,7566,6768,6546,28.11192468619247,0.018360655737704918,Very Cheap
20140708T000000,410000.0,3,2.0,1320,6000,1.5,0,0,4,7,1320,0,1920,0,98144,47.5752,-122.304,1620,4000,4680,2380,68.33333333333333,0.043934426229508196,Very Cheap
20140626T000000,440000.0,4,2.5,2160,7826,1.0,0,0,4,7,1390,770,1976,0,98155,47.7754,-122.276,2190,9900,5666,7710,56.22284692052134,0.04786885245901639,Very Cheap
20140829T000000,1160000.0,4,3.5,4190,15724,2.0,0,2,3,11,4190,0,1994,0,98027,47.5518,-122.096,3300,10113,11534,6813,73.7725769524294,0.1422950819672131,Cheap
20141125T000000,500000.0,4,2.0,2280,7200,1.0,0,0,4,7,2280,0,1956,0,98133,47.7132,-122.355,1100,7620,4920,6520,69.44444444444444,0.05573770491803279,Very Cheap
20141120T000000,961000.0,5,2.75,2590,6120,2.0,0,0,3,8,2590,0,1909,0,98105,47.6667,-122.327,1390,3060,3530,1670,157.0261437908497,0.1161967213114754,Cheap
20140724T000000,825000.0,4,2.25,2770,9340,2.0,0,0,4,9,2770,0,1979,0,98027,47.5628,-122.081,3010,9340,6570,6330,88.32976445396146,0.09836065573770492,Very Cheap
20141103T000000,734000.0,3,1.75,2145,3840,1.5,0,0,5,8,2145,0,1910,0,98103,47.6875,-122.357,1140,3840,1695,2700,191.14583333333334,0.08642622950819673,Very Cheap
20141002T000000,490000.0,4,4.25,4480,5715,2.0,0,0,3,7,3680,800,2003,0,98030,47.373,-122.179,2190,6070,1235,3880,85.7392825896763,0.05442622950819672,Very Cheap
20140702T000000,175000.0,4,2.5,1780,6000,2.0,0,0,3,7,1780,0,1991,0,98198,47.3828,-122.302,1630,6000,4220,4370,29.166666666666668,0.013114754098360656,Very Cheap
20140618T000000,190000.0,1,1.0,720,4800,1.0,0,0,3,6,720,0,1914,0,98118,47.5303,-122.27,1240,4860,4080,3620,39.583333333333336,0.015081967213114755,Very Cheap
20140812T000000,305000.0,4,2.25,2050,12581,2.0,0,0,4,7,2050,0,1978,0,98002,47.3215,-122.204,1620,7400,10531,5780,24.242905969318816,0.03016393442622951,Very Cheap
20150316T000000,1300000.0,3,1.0,2040,7936,1.0,0,3,5,8,1680,360,1940,0,98177,47.7028,-122.385,2300,10080,5896,7780,163.81048387096774,0.16065573770491803,Cheap
20140609T000000,417000.0,2,1.0,920,6600,1.0,0,0,3,6,920,0,1919,2003,98118,47.5452,-122.27,1510,5944,5680,4434,63.18181818181818,0.04485245901639344,Very Cheap
20141113T000000,275000.0,2,1.0,680,4190,1.0,0,0,2,5,680,0,1906,0,98103,47.6901,-122.358,1070,4175,3510,3105,65.63245823389022,0.02622950819672131,Very Cheap
20141210T000000,661000.0,3,2.5,1940,8196,2.0,0,0,3,8,1940,0,1991,0,98052,47.6786,-122.151,2070,8514,6256,6444,80.64909712054661,0.07685245901639344,Very Cheap
20140708T000000,435000.0,4,2.75,2230,9640,1.0,0,0,3,8,1320,910,1998,0,98125,47.7269,-122.325,2100,9600,7410,7500,45.12448132780083,0.04721311475409836,Very Cheap
20141023T000000,788000.0,5,2.25,2910,9454,1.0,0,1,3,8,1910,1000,1972,0,98005,47.5871,-122.173,2400,10690,6544,8290,83.35096255553205,0.09350819672131147,Very Cheap
20140610T000000,1795000.0,5,3.25,5270,17232,2.0,0,1,3,10,4010,1260,1977,2003,98040,47.5536,-122.228,3550,13917,11962,10367,104.16666666666667,0.22557377049180327,Cheap
20140630T000000,408000.0,5,3.25,2820,6589,1.5,0,0,3,7,2320,500,1906,2014,98118,47.5357,-122.273,1560,5647,3769,4087,61.92138412505691,0.04367213114754098,Very Cheap
20141020T000000,570000.0,2,1.0,1790,3760,1.5,0,0,4,8,1490,300,1912,0,98144,47.5926,-122.293,1458,3760,1970,2302,151.59574468085106,0.06491803278688525,Very Cheap
20150507T000000,1540000.0,5,3.25,2920,6960,2.0,0,1,3,9,2120,800,1953,2008,98105,47.6712,-122.272,2470,6735,4040,4265,221.26436781609195,0.1921311475409836,Cheap
20140505T000000,400000.0,2,1.0,840,5510,1.0,0,0,3,7,840,0,1955,0,98136,47.5247,-122.391,1630,5510,4670,3880,72.59528130671507,0.04262295081967213,Very Cheap
20141017T000000,247000.0,3,1.75,1820,8740,1.0,0,0,4,8,1820,0,1987,0,98023,47.3074,-122.385,2210,8320,6920,6110,28.26086956521739,0.022557377049180326,Very Cheap
20150304T000000,453000.0,3,1.75,1550,7200,1.0,0,0,3,7,1100,450,1949,0,98125,47.7071,-122.314,1560,7440,5650,5880,62.916666666666664,0.04957377049180328,Very Cheap
20140508T000000,235000.0,2,1.0,1270,3008,1.0,0,0,4,6,650,620,1923,0,98118,47.5351,-122.279,1270,1514,1738,244,78.125,0.02098360655737705,Very Cheap
20150421T000000,675000.0,4,1.75,2460,5750,1.5,0,3,5,7,1620,840,1919,0,98126,47.5601,-122.378,1760,4830,3290,3070,117.3913043478261,0.07868852459016394,Very Cheap
20140610T000000,516200.0,3,2.0,2110,5150,1.0,0,0,5,6,1080,1030,1919,0,98118,47.5521,-122.271,1170,5107,3040,3937,100.23300970873787,0.05786229508196721,Very Cheap
20140714T000000,650000.0,1,1.0,920,91476,1.5,0,0,3,6,920,0,1996,2002,98070,47.448,-122.472,1746,91476,90556,89730,7.105688923870742,0.07540983606557378,Very Cheap
20141216T000000,257100.0,3,1.5,1500,10227,1.0,0,0,4,7,1000,500,1945,0,98022,47.2043,-121.996,1490,7670,8727,6180,25.139337048987972,0.023881967213114755,Very Cheap
20150330T000000,457000.0,2,2.0,1440,9985,1.0,0,0,3,8,1440,0,2006,0,98053,47.7217,-122.03,1510,4560,8545,3050,45.7686529794692,0.0500983606557377,Very Cheap
20141117T000000,540000.0,3,1.75,1610,3478,1.5,0,0,4,7,1060,550,1929,0,98117,47.6774,-122.372,1610,3478,1868,1868,155.26164462334674,0.06098360655737705,Very Cheap
20140603T000000,268000.0,3,1.75,1970,10270,1.0,0,0,4,8,1970,0,1966,0,98032,47.3619,-122.285,1970,8400,8300,6430,26.095423563777995,0.025311475409836064,Very Cheap
20140708T000000,300000.0,3,1.0,1150,7314,1.0,0,0,3,7,1150,0,1960,0,98008,47.6246,-122.113,1350,7350,6164,6000,41.01722723543888,0.029508196721311476,Very Cheap
20140909T000000,380000.0,2,2.5,2110,114127,1.0,0,0,4,8,1590,520,1975,0,98031,47.4137,-122.212,1960,11250,112017,9290,3.3296240153513192,0.04,Very Cheap
20140627T000000,725000.0,3,2.5,3580,54450,1.5,0,0,3,9,3580,0,1990,0,98038,47.4026,-122.033,3090,35943,50870,32853,13.314967860422406,0.08524590163934426,Very Cheap
20140623T000000,249000.0,3,1.0,1000,19204,1.0,0,0,3,7,1000,0,1968,2010,98042,47.3167,-122.081,2450,25927,18204,23477,12.966048739845865,0.02281967213114754,Very Cheap
20140805T000000,274000.0,5,1.0,1680,9383,1.0,0,0,3,7,1400,280,1929,0,98155,47.7523,-122.311,1680,9458,7703,7778,29.201747841841627,0.026098360655737705,Very Cheap
20150429T000000,1780000.0,4,3.25,3950,10912,2.0,0,0,3,10,3950,0,2003,0,98004,47.5877,-122.196,3000,10998,6962,7998,163.12316715542522,0.22360655737704918,Cheap
20140623T000000,396500.0,3,1.75,2390,7149,1.0,0,0,3,8,1350,1040,1955,0,98125,47.7244,-122.326,1710,7402,4759,5692,55.46230241991887,0.04216393442622951,Very Cheap
20141119T000000,460000.0,2,1.5,1820,7800,1.0,0,0,4,7,1240,580,1956,0,98133,47.7513,-122.357,1400,7800,5980,6400,58.97435897435897,0.050491803278688525,Very Cheap
20140616T000000,277000.0,3,1.0,1100,8536,1.0,0,0,4,7,1100,0,1957,0,98118,47.5162,-122.261,1570,8040,7436,6470,32.450796626054355,0.026491803278688525,Very Cheap
20141104T000000,449500.0,6,4.0,2280,5275,1.0,0,0,3,7,1270,1010,1998,0,98108,47.5556,-122.294,1760,6642,2995,4882,85.2132701421801,0.049114754098360656,Very Cheap
20140903T000000,785950.0,4,3.0,2530,4560,1.5,0,0,3,7,1540,990,1925,2014,98112,47.6287,-122.3,1640,4560,2030,2920,172.35745614035088,0.09323934426229508,Very Cheap
20140616T000000,545000.0,3,2.5,1940,9775,1.0,0,2,3,8,1440,500,1975,0,98034,47.7142,-122.222,2830,9775,7835,6945,55.75447570332481,0.06163934426229508,Very Cheap
20141222T000000,244000.0,3,2.0,1360,9688,1.0,0,0,4,7,1360,0,1983,0,98003,47.2574,-122.31,1390,9685,8328,8295,25.18579686209744,0.02216393442622951,Very Cheap
20140822T000000,165000.0,3,2.5,1660,2415,2.0,0,0,3,7,1660,0,1983,0,98042,47.3763,-122.148,1740,2624,755,884,68.32298136645963,0.01180327868852459,Very Cheap
20140609T000000,435000.0,2,1.0,800,5000,1.0,0,0,3,7,800,0,1906,0,98107,47.6751,-122.372,1410,5000,4200,3590,87.0,0.04721311475409836,Very Cheap
20140530T000000,642000.0,3,2.5,2670,10082,1.0,0,0,3,10,2670,0,1987,0,98074,47.6359,-122.045,2740,10854,7412,8114,63.67784169807578,0.07436065573770492,Very Cheap
20150409T000000,340000.0,3,2.5,1720,4120,2.0,0,0,3,7,1720,0,1999,0,98148,47.4319,-122.328,1720,5544,2400,3824,82.52427184466019,0.03475409836065574,Very Cheap
20140722T000000,730000.0,4,2.5,3550,35689,2.0,0,0,4,9,3550,0,1991,0,98077,47.7503,-122.074,3350,35711,32139,32361,20.454481773095353,0.0859016393442623,Very Cheap
20150123T000000,563250.0,3,1.75,1370,2800,1.0,0,0,5,7,800,570,1982,0,98122,47.6157,-122.291,2270,3773,1430,1503,201.16071428571428,0.0640327868852459,Very Cheap
20140502T000000,675000.0,5,2.5,2820,67518,2.0,0,0,3,8,2820,0,1979,0,98029,47.5794,-122.025,2820,48351,64698,45531,9.997334044254865,0.07868852459016394,Very Cheap
20140512T000000,620000.0,3,1.5,1620,6630,1.0,0,0,3,8,1280,340,1954,0,98117,47.6948,-122.394,1880,5100,5010,3220,93.51432880844645,0.07147540983606557,Very Cheap
20141210T000000,275000.0,2,2.0,1290,9041,1.0,0,0,3,7,950,340,1956,0,98108,47.5346,-122.291,1290,5000,7751,3710,30.41698927109833,0.02622950819672131,Very Cheap
20140512T000000,270000.0,3,1.0,1830,8209,1.0,0,0,3,7,1830,0,1942,0,98028,47.7439,-122.228,2150,12000,6379,9850,32.89072968692898,0.025573770491803278,Very Cheap
20150415T000000,325000.0,4,2.5,2040,5472,2.0,0,0,3,8,2040,0,2003,0,98092,47.3337,-122.189,2420,5782,3432,3362,59.39327485380117,0.03278688524590164,Very Cheap
20141003T000000,476100.0,4,2.5,1850,1836,2.0,0,0,3,7,1600,250,2005,0,98029,47.5529,-121.996,1770,2236,-14,466,259.3137254901961,0.05260327868852459,Very Cheap
20141020T000000,700000.0,2,1.0,1300,12000,1.0,0,0,4,8,1300,0,1959,0,98004,47.6366,-122.229,2420,15000,10700,12580,58.333333333333336,0.08196721311475409,Very Cheap
20140926T000000,220000.0,4,2.0,1620,5200,1.5,0,0,4,7,1620,0,1978,0,98042,47.3629,-122.091,1500,5200,3580,3700,42.30769230769231,0.01901639344262295,Very Cheap
20141114T000000,236000.0,3,1.75,1560,10919,1.0,0,0,3,7,1560,0,1975,0,98023,47.2917,-122.366,1730,10919,9359,9189,21.61370088835974,0.021114754098360656,Very Cheap
20140502T000000,790000.0,3,2.5,2600,4750,1.0,0,0,4,9,1700,900,1951,0,98117,47.6833,-122.4,2380,4750,2150,2370,166.31578947368422,0.09377049180327869,Very Cheap
20140820T000000,350000.0,3,1.0,2010,6000,1.0,0,0,3,7,1210,800,1967,0,98108,47.5515,-122.298,2460,6000,3990,3540,58.333333333333336,0.036065573770491806,Very Cheap
20150324T000000,130000.0,2,1.0,780,5300,1.0,0,0,3,6,780,0,1941,0,98146,47.513,-122.354,780,5300,4520,4520,24.528301886792452,0.007213114754098361,Very Cheap
20140527T000000,283200.0,4,2.5,1982,6406,2.0,0,0,3,8,1982,0,2004,0,98030,47.3636,-122.192,2340,6501,4424,4161,44.20855448017483,0.027304918032786885,Very Cheap
20141015T000000,273000.0,3,1.0,1500,6250,1.0,0,0,3,6,890,610,1945,0,98126,47.5365,-122.368,1210,6250,4750,5040,43.68,0.025967213114754098,Very Cheap
20141215T000000,599000.0,5,2.25,2460,8710,1.0,0,0,4,8,1330,1130,1976,0,98052,47.6651,-122.15,2460,8870,6250,6410,68.77152698048221,0.06872131147540983,Very Cheap
20150423T000000,460000.0,4,2.5,2680,11998,1.0,0,3,3,8,1510,1170,1960,0,98003,47.337,-122.321,2680,12746,9318,10066,38.33972328721453,0.050491803278688525,Very Cheap
20140509T000000,1157200.0,4,4.25,5860,52889,2.0,0,0,4,10,4910,950,1996,0,98072,47.7245,-122.095,3320,39066,47029,35746,21.879785966836206,0.141927868852459,Cheap
20140610T000000,385000.0,4,1.75,1720,8750,1.0,0,0,3,7,860,860,1971,0,98034,47.726,-122.21,1790,8750,7030,6960,44.0,0.04065573770491803,Very Cheap
20140910T000000,264250.0,3,1.0,1420,7420,1.5,0,0,3,6,1420,0,1944,0,98178,47.4949,-122.239,1290,6600,6000,5310,35.613207547169814,0.02481967213114754,Very Cheap
20141029T000000,608000.0,3,2.5,1760,1472,3.0,0,0,3,8,1640,120,2006,0,98119,47.6473,-122.374,1760,5400,-288,3640,413.04347826086956,0.0699016393442623,Very Cheap
20140915T000000,450000.0,3,2.5,2790,48994,2.0,0,0,4,9,2790,0,1984,0,98042,47.3487,-122.088,2550,37834,46204,35284,9.184798138547578,0.04918032786885246,Very Cheap
20140703T000000,1755000.0,3,2.0,2360,4800,2.0,0,0,3,9,2360,0,1909,2014,98112,47.6317,-122.312,2260,4800,2440,2540,365.625,0.22032786885245903,Cheap
20141114T000000,339950.0,5,2.0,1890,6050,2.0,0,0,4,7,1890,0,1944,0,98178,47.5018,-122.242,1170,6050,4160,4880,56.1900826446281,0.03474754098360656,Very Cheap
20150410T000000,760000.0,6,3.75,3810,6150,2.0,0,0,4,8,3810,0,1977,0,98103,47.694,-122.34,1830,5125,2340,3295,123.57723577235772,0.0898360655737705,Very Cheap
20150408T000000,350000.0,2,1.0,1160,5395,1.0,0,0,3,7,860,300,1940,0,98103,47.7007,-122.354,1664,5363,4235,3699,64.87488415199259,0.036065573770491806,Very Cheap
20150421T000000,541500.0,3,1.75,2320,55847,1.0,0,2,4,8,2320,0,1960,0,98001,47.3121,-122.253,2400,26112,53527,23712,9.696134080613104,0.06118032786885246,Very Cheap
20150327T000000,730000.0,6,2.75,3280,16449,1.0,0,0,4,7,1910,1370,1963,0,98007,47.5914,-122.134,2550,9532,13169,6982,44.379597543923644,0.0859016393442623,Very Cheap
20150429T000000,215000.0,3,1.0,980,5600,1.0,0,0,2,6,980,0,1949,0,98106,47.5308,-122.361,1840,5302,4620,3462,38.392857142857146,0.018360655737704918,Very Cheap
20140515T000000,420000.0,3,2.0,1640,9972,1.0,0,0,4,7,1640,0,1977,0,98075,47.5812,-122.002,1680,10165,8332,8485,42.1179302045728,0.04524590163934426,Very Cheap
20140530T000000,655000.0,4,2.25,2060,8470,1.0,0,0,3,8,1440,620,1983,0,98006,47.5605,-122.124,2180,8978,6410,6798,77.33175914994096,0.0760655737704918,Very Cheap
20150115T000000,240000.0,3,2.5,1500,10652,2.0,0,0,4,7,1500,0,1981,0,98031,47.4015,-122.176,1610,7417,9152,5807,22.53098009763425,0.021639344262295083,Very Cheap
20140602T000000,730000.0,4,2.0,2360,6000,1.0,0,0,5,7,1260,1100,1939,0,98199,47.6534,-122.41,1720,6000,3640,4280,121.66666666666667,0.0859016393442623,Very Cheap
20141013T000000,390000.0,4,1.5,1940,12100,1.0,0,0,3,7,1940,0,1962,0,98033,47.6892,-122.164,1380,12100,10160,10720,32.231404958677686,0.04131147540983607,Very Cheap
20141028T000000,473000.0,3,1.0,1280,10000,1.0,0,0,4,7,1280,0,1954,0,98006,47.5716,-122.139,1240,10000,8720,8760,47.3,0.05219672131147541,Very Cheap
20150324T000000,698000.0,4,3.5,3630,5670,2.0,0,0,3,10,3630,0,1970,2008,98056,47.5189,-122.206,1620,5400,2040,3780,123.10405643738977,0.08170491803278689,Very Cheap
20140514T000000,511000.0,3,2.5,1820,4883,2.0,0,0,3,9,1820,0,2005,0,98028,47.7355,-122.224,2720,5002,3063,2282,104.64878148679091,0.05718032786885246,Very Cheap
20140508T000000,358000.0,2,1.5,960,1808,2.0,0,0,3,7,960,0,1993,0,98122,47.6183,-122.298,1290,1668,848,378,198.00884955752213,0.03711475409836065,Very Cheap
20150410T000000,499990.0,3,1.75,1630,8400,1.0,0,0,4,7,1060,570,1955,0,98007,47.5983,-122.149,1630,7245,6770,5615,59.522619047619045,0.05573639344262295,Very Cheap
20150313T000000,322000.0,4,2.25,1940,10200,1.0,0,0,3,7,1360,580,1960,0,98188,47.4253,-122.283,1940,10200,8260,8260,31.568627450980394,0.03239344262295082,Very Cheap
20141008T000000,201000.0,3,1.0,980,9682,1.0,0,0,3,7,980,0,1969,0,98031,47.4136,-122.207,1580,9682,8702,8102,20.76017351786821,0.016524590163934427,Very Cheap
20141112T000000,765000.0,4,2.5,3140,16200,1.0,0,1,3,9,2570,570,1988,0,98166,47.4363,-122.342,2530,13200,13060,10670,47.22222222222222,0.09049180327868853,Very Cheap
20140606T000000,920000.0,4,2.75,2880,5750,1.5,0,0,5,9,1710,1170,1928,0,98116,47.5874,-122.387,1640,5750,2870,4110,160.0,0.11081967213114755,Cheap
20150415T000000,360000.0,4,2.0,1650,7552,1.0,0,0,4,7,860,790,1977,0,98155,47.7765,-122.324,1410,7199,5902,5789,47.66949152542373,0.037377049180327866,Very Cheap
20150507T000000,297300.0,3,1.75,1980,9220,2.0,0,0,3,8,1980,0,1987,0,98092,47.2602,-122.219,2080,8305,7240,6225,32.24511930585683,0.029154098360655738,Very Cheap
20140925T000000,399000.0,3,1.0,860,9403,1.0,0,0,4,6,860,0,1942,1990,98033,47.6815,-122.173,2136,13009,8543,10873,42.43326597894289,0.042491803278688525,Very Cheap
20140620T000000,400000.0,3,1.0,1430,10005,1.5,0,0,4,7,1430,0,1950,0,98133,47.7181,-122.338,1720,8822,8575,7102,39.9800099950025,0.04262295081967213,Very Cheap
20140827T000000,230000.0,3,1.75,1260,10164,1.0,0,0,4,6,1260,0,1964,0,98059,47.4752,-122.133,1190,10640,8904,9450,22.6288862652499,0.020327868852459016,Very Cheap
20150220T000000,290000.0,3,1.0,960,4560,1.0,0,0,4,7,960,0,1968,0,98106,47.5539,-122.365,970,4800,3600,3830,63.59649122807018,0.02819672131147541,Very Cheap
20150430T000000,323800.0,3,2.5,2060,7658,2.0,0,0,3,8,2060,0,2003,0,98023,47.2923,-122.36,2250,7299,5598,5049,42.28258030817446,0.032629508196721314,Very Cheap
20141020T000000,574500.0,4,1.5,1430,6380,1.5,0,0,4,9,1430,0,1930,0,98125,47.7014,-122.313,1220,5112,4950,3892,90.04702194357367,0.06550819672131147,Very Cheap
20140522T000000,505000.0,3,2.25,1670,1596,2.0,0,0,3,8,1220,450,2002,0,98199,47.6474,-122.396,1670,1596,-74,-74,316.41604010025065,0.05639344262295082,Very Cheap
20150422T000000,372500.0,2,1.0,880,10950,1.0,0,0,4,7,880,0,1944,0,98133,47.7332,-122.352,1450,7560,10070,6110,34.018264840182646,0.03901639344262295,Very Cheap
20140701T000000,425000.0,3,1.5,1300,19163,1.0,0,0,3,7,1300,0,1964,0,98052,47.6686,-122.153,1590,9744,17863,8154,22.178155821113606,0.04590163934426229,Very Cheap
20150416T000000,446250.0,3,2.5,2380,214315,1.5,0,0,3,9,2380,0,2000,0,98045,47.4525,-121.748,2400,68824,211935,66424,2.0822154305578238,0.048688524590163935,Very Cheap
20140814T000000,330000.0,2,0.75,520,6862,1.0,0,0,4,4,520,0,1924,1980,98010,47.326,-122.037,1170,8756,6342,7586,48.090935587292336,0.03344262295081967,Very Cheap
20150427T000000,608095.0,3,2.5,2680,17707,2.0,0,1,3,9,2680,0,1983,0,98034,47.7031,-122.224,2840,21743,15027,18903,34.34206810865759,0.06991409836065574,Very Cheap
20150125T000000,550000.0,3,2.5,2140,10136,1.0,0,0,3,8,1320,820,1958,0,98006,47.5602,-122.184,1980,11200,7996,9220,54.2620363062352,0.06229508196721312,Very Cheap
20140828T000000,265000.0,4,2.5,1820,16103,2.0,0,0,3,7,1820,0,2004,0,98030,47.3553,-122.196,2120,21277,14283,19157,16.45656088927529,0.024918032786885248,Very Cheap
20140619T000000,399888.0,4,2.25,1820,8255,1.5,0,0,4,7,1320,500,1930,0,98133,47.723,-122.337,1550,7628,6435,6078,48.44191399152029,0.04260826229508197,Very Cheap
20140627T000000,430000.0,2,1.0,1050,2570,1.0,0,0,5,7,850,200,1927,0,98117,47.6764,-122.366,1080,2800,1520,1720,167.31517509727627,0.04655737704918033,Very Cheap
20150513T000000,554990.0,3,2.5,2100,6092,2.0,0,0,3,8,2100,0,2013,0,98028,47.7508,-122.239,2250,8592,3992,6342,91.10144451739987,0.06294950819672131,Very Cheap
20141107T000000,359950.0,3,2.5,2210,6280,2.0,0,0,3,8,2210,0,2003,0,98038,47.35,-122.043,2250,5972,4070,3722,57.31687898089172,0.037370491803278685,Very Cheap
20140623T000000,405000.0,2,1.0,860,2599,1.0,0,0,4,6,860,0,1901,0,98107,47.675,-122.379,1300,3900,1739,2600,155.82916506348596,0.043278688524590166,Very Cheap
20150406T000000,280000.0,2,1.0,870,4025,1.0,0,0,3,7,870,0,1981,0,98034,47.7243,-122.161,1370,3488,3155,2118,69.56521739130434,0.026885245901639345,Very Cheap
20150408T000000,479950.0,4,2.25,2570,11070,2.0,0,0,4,8,2570,0,1966,0,98058,47.4507,-122.152,2210,9600,8500,7390,43.35591689250226,0.05310819672131147,Very Cheap
20140904T000000,575000.0,5,1.75,2980,53578,1.0,0,0,4,9,2230,750,1976,0,98027,47.4908,-122.059,2860,75546,50598,72686,10.732016872596962,0.06557377049180328,Very Cheap
20150226T000000,392000.0,4,2.25,2360,7733,2.0,0,0,3,8,2360,0,1983,0,98058,47.4403,-122.137,2160,7733,5373,5573,50.691840165524376,0.04157377049180328,Very Cheap
20150225T000000,760500.0,4,2.25,2310,36136,2.0,0,0,4,9,2310,0,1977,0,98072,47.7506,-122.122,3930,36136,33826,32206,21.045494797431925,0.08990163934426229,Very Cheap
20140616T000000,435000.0,3,2.5,2300,9521,2.0,0,0,3,8,2300,0,2003,0,98019,47.7447,-121.976,3020,10042,7221,7022,45.688478101039806,0.04721311475409836,Very Cheap
20140819T000000,1565000.0,4,2.75,2810,8570,2.0,0,0,3,10,2810,0,1993,0,98004,47.6159,-122.211,2810,9621,5760,6811,182.61376896149358,0.19540983606557377,Cheap
20141203T000000,261000.0,4,1.5,2040,10488,1.0,0,0,3,7,1190,850,1961,0,98188,47.4557,-122.269,1960,10488,8448,8528,24.88558352402746,0.02439344262295082,Very Cheap
20150507T000000,1482500.0,3,2.25,3290,5000,2.0,0,0,3,9,2730,560,1939,0,98105,47.6582,-122.28,2340,4000,1710,1660,296.5,0.18459016393442623,Cheap
20150430T000000,853800.0,7,4.0,2960,2665,2.0,0,0,3,9,1950,1010,1927,2013,98144,47.5835,-122.313,1970,4410,-295,2440,320.375234521576,0.10213770491803278,Cheap
20140522T000000,657500.0,3,2.5,2670,10496,2.0,0,0,3,9,2670,0,1989,0,98074,47.6272,-122.026,2490,8636,7826,6146,62.64291158536585,0.07639344262295082,Very Cheap
20140504T000000,331950.0,4,2.5,2530,9933,2.0,0,2,3,8,2010,520,1990,0,98092,47.2654,-122.216,2140,9933,7403,7793,33.41890667472063,0.033698360655737704,Very Cheap
20140611T000000,514000.0,3,1.75,1720,5899,1.0,0,1,3,8,1220,500,1986,0,98136,47.5399,-122.385,1900,6244,4179,4344,87.13341244278692,0.05757377049180328,Very Cheap
20140912T000000,496000.0,3,3.5,3090,27598,2.0,0,2,4,9,2020,1070,1995,0,98070,47.3541,-122.453,2180,17085,24508,14905,17.97231683455323,0.05521311475409836,Very Cheap
20150218T000000,1093000.0,4,2.5,3930,21894,2.0,0,0,3,11,3930,0,1987,0,98052,47.7209,-122.128,3930,20000,17964,16070,49.92235315611583,0.13350819672131148,Cheap
20141106T000000,195700.0,3,1.0,1120,5200,1.0,0,0,5,7,1120,0,1976,0,98042,47.3638,-122.088,1690,5200,4080,3510,37.63461538461539,0.015829508196721312,Very Cheap
20140729T000000,1395710.0,4,2.25,3960,8640,2.0,0,2,3,9,2630,1330,1925,0,98112,47.6317,-122.304,3850,8640,4680,4790,161.54050925925927,0.173207868852459,Cheap
20141205T000000,1175000.0,4,3.25,4060,20822,2.0,0,0,3,10,4060,0,1991,0,98077,47.7213,-122.055,4170,23958,16762,19788,56.43069829987513,0.14426229508196722,Cheap
20140923T000000,643403.0,3,2.5,2350,9648,1.0,0,0,4,9,2350,0,1966,0,98008,47.6156,-122.108,2320,10512,7298,8192,66.68770729684908,0.07454465573770491,Very Cheap
20140512T000000,357000.0,4,2.5,2380,7066,2.0,0,0,4,7,2380,0,1997,0,98031,47.3982,-122.172,2310,8127,4686,5817,50.523634305123124,0.03698360655737705,Very Cheap
20150408T000000,865000.0,3,1.75,1480,8163,1.0,0,0,3,7,1040,440,1953,0,98004,47.638,-122.206,2170,11124,6683,8954,105.96594389317653,0.10360655737704919,Cheap
20141118T000000,905000.0,3,2.5,2930,9280,2.0,0,0,4,10,2930,0,1988,0,98007,47.6335,-122.151,2730,10090,6350,7360,97.52155172413794,0.10885245901639344,Cheap
20141022T000000,265000.0,3,1.5,1290,7100,1.0,0,0,3,6,1290,0,1954,0,98198,47.4227,-122.332,1300,7183,5810,5883,37.32394366197183,0.024918032786885248,Very Cheap
20141224T000000,535000.0,2,2.5,2730,7246,2.0,0,0,3,9,2730,0,1998,0,98056,47.512,-122.175,3220,7214,4516,3994,73.8338393596467,0.06032786885245902,Very Cheap
20140811T000000,450000.0,3,1.0,1290,5440,1.0,0,0,4,6,790,500,1929,0,98117,47.6951,-122.367,1220,5464,4150,4244,82.72058823529412,0.04918032786885246,Very Cheap
20150218T000000,460500.0,4,2.5,2170,7533,2.0,0,0,3,8,2170,0,1991,0,98059,47.5057,-122.149,2170,8728,5363,6558,61.131023496614894,0.05055737704918033,Very Cheap
20141124T000000,315000.0,4,1.75,1850,8580,1.0,0,0,3,7,1140,710,1960,0,98178,47.4877,-122.24,2210,9240,6730,7030,36.71328671328671,0.031475409836065574,Very Cheap
20150213T000000,607500.0,4,2.5,2110,13939,1.0,0,0,3,8,1270,840,1978,0,98008,47.6431,-122.113,2140,8882,11829,6742,43.58275342564029,0.06983606557377049,Very Cheap
20150126T000000,432000.0,2,1.0,960,3235,1.0,0,0,4,7,960,0,1916,0,98103,47.661,-122.344,1290,2069,2275,779,133.53941267387944,0.046819672131147544,Very Cheap
20150209T000000,1695000.0,3,4.0,3910,5350,2.0,0,2,5,10,2610,1300,1933,0,98199,47.6393,-122.408,2890,5350,1440,2460,316.8224299065421,0.2124590163934426,Cheap
20140820T000000,479000.0,4,2.5,2590,6139,2.0,0,0,3,8,2590,0,2001,0,98038,47.3883,-122.035,2410,6139,3549,3729,78.02573709073138,0.05298360655737705,Very Cheap
20150320T000000,475000.0,5,2.75,3080,6600,2.0,0,0,3,9,3080,0,2002,0,98058,47.4501,-122.122,3080,6600,3520,3520,71.96969696969697,0.05245901639344262,Very Cheap
20141119T000000,415000.0,3,1.0,1630,8146,1.0,0,0,3,7,1630,0,1952,0,98125,47.7293,-122.29,1480,8146,6516,6666,50.945249202062364,0.04459016393442623,Very Cheap
20140826T000000,450000.0,2,1.0,910,5000,1.0,0,0,4,6,910,0,1914,0,98117,47.683,-122.374,1480,5000,4090,3520,90.0,0.04918032786885246,Very Cheap
20140703T000000,1140000.0,3,2.5,2780,33503,1.5,0,1,4,8,2110,670,1969,0,98075,47.5844,-122.081,3150,15542,30723,12392,34.02680356982957,0.13967213114754098,Cheap
20140915T000000,430000.0,5,3.0,3880,8432,2.0,0,0,3,7,3880,0,2004,0,98056,47.4806,-122.176,2620,5623,4552,3003,50.99620493358634,0.04655737704918033,Very Cheap
20140903T000000,296000.0,3,1.75,1360,10742,1.0,0,0,5,7,960,400,1971,0,98058,47.4351,-122.173,1830,9000,9382,7170,27.55539005771737,0.02898360655737705,Very Cheap
20140711T000000,303000.0,4,2.25,2560,8927,1.0,0,0,3,7,1790,770,1976,0,98001,47.34,-122.271,1920,9669,6367,7749,33.94197378738658,0.029901639344262296,Very Cheap
20141021T000000,641000.0,4,2.5,2600,6015,2.0,0,0,3,8,2600,0,2004,0,98075,47.5971,-122.031,2910,5305,3415,2395,106.56691604322528,0.0742295081967213,Very Cheap
20150210T000000,280000.0,3,2.25,1220,5739,1.0,0,0,3,7,790,430,1984,0,98115,47.6952,-122.326,1870,5739,4519,3869,48.78898762850671,0.026885245901639345,Very Cheap
20140805T000000,260750.0,3,2.0,1560,9635,1.0,0,0,3,7,1260,300,1966,0,98003,47.341,-122.309,1570,8276,8075,6706,27.06279190451479,0.024360655737704916,Very Cheap
20141119T000000,601000.0,4,2.5,2080,5191,2.0,0,0,3,8,2080,0,2001,0,98075,47.5978,-122.017,2170,5518,3111,3348,115.77730687728761,0.06898360655737705,Very Cheap
20140828T000000,255000.0,3,1.5,1490,6604,1.0,0,0,4,6,1490,0,1918,0,98166,47.4683,-122.351,1330,6604,5114,5274,38.6129618413083,0.02360655737704918,Very Cheap
20140605T000000,555000.0,4,2.75,2020,10720,1.0,0,0,4,8,1420,600,1976,0,98052,47.6373,-122.104,2190,10164,8700,7974,51.77238805970149,0.06295081967213115,Very Cheap
20141118T000000,865000.0,3,1.5,1530,10827,1.0,0,0,4,8,1530,0,1955,0,98039,47.6354,-122.234,2050,10827,9297,8777,79.89286044148886,0.10360655737704919,Cheap
20140922T000000,1388000.0,4,2.5,3450,17400,1.5,0,0,4,9,2180,1270,1964,0,98004,47.5969,-122.206,3770,19530,13950,15760,79.77011494252874,0.1721967213114754,Cheap
20140520T000000,315000.0,3,2.25,1400,31626,1.0,0,0,2,7,1140,260,1987,0,98092,47.3029,-122.069,1680,35093,30226,33413,9.9601593625498,0.031475409836065574,Very Cheap
20140606T000000,200000.0,2,1.0,1730,9610,1.0,0,0,3,7,1380,350,1962,0,98001,47.2956,-122.285,1310,9812,7880,8502,20.81165452653486,0.01639344262295082,Very Cheap
20141117T000000,357000.0,3,1.0,1370,6450,1.0,0,0,3,7,1370,0,1948,0,98125,47.7195,-122.288,1550,6898,5080,5348,55.348837209302324,0.03698360655737705,Very Cheap
20141204T000000,390000.0,2,1.5,1050,934,2.0,0,0,3,8,960,90,2007,0,98122,47.6029,-122.309,1470,1885,-116,415,417.55888650963595,0.04131147540983607,Very Cheap
20140729T000000,462000.0,5,1.75,2840,10220,1.0,0,0,4,7,2210,630,1954,0,98177,47.764,-122.36,2000,9750,7380,7750,45.205479452054796,0.05075409836065574,Very Cheap
20140516T000000,174500.0,2,1.0,1010,5200,1.0,0,0,3,7,1010,0,1955,0,98198,47.4166,-122.323,1580,7500,4190,5920,33.55769230769231,0.013049180327868852,Very Cheap
20150210T000000,305000.0,2,1.0,1210,7140,1.5,0,0,3,6,1210,0,1921,0,98133,47.7225,-122.349,1150,7376,5930,6226,42.71708683473389,0.03016393442622951,Very Cheap
20150205T000000,449000.0,5,1.75,1720,14040,1.0,0,0,4,8,1150,570,1956,0,98133,47.7365,-122.339,1750,7800,12320,6050,31.98005698005698,0.049049180327868855,Very Cheap
20140829T000000,260000.0,3,2.0,2710,5000,2.0,0,0,3,6,2710,0,1951,0,98126,47.5188,-122.373,850,5000,2290,4150,52.0,0.024262295081967214,Very Cheap
20140512T000000,751000.0,4,2.5,3110,6142,2.0,0,0,3,9,3110,0,2004,0,98052,47.701,-122.111,3200,6826,3032,3626,122.27287528492347,0.08865573770491804,Very Cheap
20150401T000000,370037.0,2,1.0,1250,9270,1.0,0,0,4,7,1250,0,1948,0,98133,47.7284,-122.339,1130,6800,8020,5670,39.917691477885654,0.03869337704918033,Very Cheap
20140825T000000,229950.0,3,1.75,1900,8910,2.0,0,0,4,7,1900,0,1988,0,98092,47.2769,-122.145,1610,8586,7010,6976,25.80808080808081,0.020321311475409835,Very Cheap
20150422T000000,349000.0,3,1.75,1740,7682,1.0,0,0,3,8,1330,410,1978,0,98058,47.4451,-122.126,2010,8820,5942,6810,45.430877375683416,0.035934426229508196,Very Cheap
20150120T000000,348000.0,4,2.5,2070,3808,2.0,0,0,3,8,2070,0,2003,0,98058,47.4498,-122.12,1900,2992,1738,1092,91.38655462184875,0.03580327868852459,Very Cheap
20150417T000000,1220000.0,3,3.25,3030,5600,2.0,0,2,3,9,2220,810,1905,2005,98144,47.5978,-122.292,2040,6600,2570,4560,217.85714285714286,0.1501639344262295,Cheap
20150102T000000,510000.0,4,3.0,3610,18948,2.0,0,0,3,10,3610,0,1993,0,98023,47.2911,-122.342,3568,18948,15338,15380,26.915769474350856,0.057049180327868855,Very Cheap
20150323T000000,265000.0,3,1.5,1520,6805,1.0,0,0,4,7,1040,480,1981,0,98023,47.2907,-122.367,1440,7041,5285,5601,38.94195444526084,0.024918032786885248,Very Cheap
20141028T000000,1250000.0,3,2.75,2780,4815,3.0,0,2,3,10,2780,0,1974,0,98105,47.6569,-122.286,2820,5000,2035,2180,259.60539979231567,0.1540983606557377,Cheap
20150107T000000,937500.0,4,4.0,5545,871200,2.0,0,0,3,11,3605,1940,2003,0,98014,47.676,-121.882,3420,871200,865655,867780,1.0761019283746556,0.11311475409836065,Cheap
20140805T000000,485000.0,3,1.75,2590,8384,1.0,0,0,4,8,1590,1000,1971,0,98011,47.7739,-122.199,2590,8800,5794,6210,57.84828244274809,0.05377049180327869,Very Cheap
20150320T000000,489000.0,4,1.0,1150,5217,1.5,0,0,3,7,1150,0,1951,0,98115,47.6806,-122.287,1220,5217,4067,3997,93.73202990224267,0.05429508196721312,Very Cheap
20150122T000000,400000.0,2,1.0,920,5120,1.0,0,0,5,7,920,0,1952,0,98136,47.5569,-122.394,1190,5120,4200,3930,78.125,0.04262295081967213,Very Cheap
20140616T000000,638000.0,3,2.5,2110,3600,2.0,0,0,3,9,2110,0,2005,0,98052,47.665,-122.082,2540,4384,1490,1844,177.22222222222223,0.0738360655737705,Very Cheap
20140619T000000,440000.0,3,1.75,1170,8740,1.0,0,0,4,7,1170,0,1968,0,98052,47.6849,-122.117,1870,8448,7570,6578,50.34324942791762,0.04786885245901639,Very Cheap
20140625T000000,305000.0,6,2.0,1900,8240,1.0,0,0,2,7,1200,700,1964,0,98125,47.7037,-122.296,1900,8240,6340,6340,37.01456310679612,0.03016393442622951,Very Cheap
20150319T000000,649950.0,6,2.0,1900,8240,1.0,0,0,2,7,1200,700,1964,0,98125,47.7037,-122.296,1900,8240,6340,6340,78.87742718446601,0.07540327868852459,Very Cheap
20150213T000000,680000.0,4,2.5,3290,6012,2.0,0,0,3,9,3290,0,2005,0,98075,47.5961,-121.98,3210,6005,2722,2795,113.10711909514305,0.07934426229508197,Very Cheap
20140714T000000,629000.0,4,2.5,2660,22050,2.0,0,0,3,9,2660,0,1996,0,98059,47.4911,-122.125,3060,21111,19390,18051,28.52607709750567,0.07265573770491804,Very Cheap
20140904T000000,555000.0,3,2.5,2160,7584,2.0,0,0,3,8,2160,0,1988,0,98029,47.5751,-122.014,2160,7372,5424,5212,73.18037974683544,0.06295081967213115,Very Cheap
20140617T000000,669000.0,4,2.75,2700,35362,2.0,0,0,5,8,2700,0,1976,0,98077,47.7628,-122.094,2810,35915,32662,33105,18.918613200610825,0.0779016393442623,Very Cheap
20140808T000000,272000.0,3,2.5,1980,6608,2.0,0,0,3,8,1980,0,1994,0,98092,47.2642,-122.213,2150,7495,4628,5345,41.16222760290557,0.02583606557377049,Very Cheap
20140626T000000,270000.0,4,2.25,2600,9900,1.0,0,0,3,7,1600,1000,1965,0,98178,47.4881,-122.237,1770,11250,7300,9480,27.272727272727273,0.025573770491803278,Very Cheap
20150106T000000,215000.0,3,1.0,1280,9775,1.0,0,0,3,6,1280,0,1964,0,98003,47.3262,-122.334,1230,8750,8495,7520,21.994884910485933,0.018360655737704918,Very Cheap
20150402T000000,690000.0,3,1.5,1710,17707,1.0,0,0,4,7,1180,530,1947,0,98040,47.5393,-122.216,2590,9508,15997,6918,38.967639916417234,0.08065573770491803,Very Cheap
20150305T000000,256000.0,4,1.75,1270,6825,1.0,0,2,3,7,1270,0,1950,0,98178,47.5051,-122.242,1800,6930,5555,5130,37.50915750915751,0.023737704918032787,Very Cheap
20150324T000000,255000.0,3,2.25,1890,7314,1.0,0,0,3,7,1100,790,1981,0,98031,47.4121,-122.172,1520,7676,5424,6156,34.86464315012305,0.02360655737704918,Very Cheap
20140513T000000,550000.0,7,4.0,3440,8100,2.0,0,0,3,7,3440,0,1970,0,98103,47.6981,-122.349,1420,1560,4660,140,67.90123456790124,0.06229508196721312,Very Cheap
20150508T000000,410000.0,3,1.0,1190,5280,1.0,0,0,4,7,1190,0,1957,0,98146,47.5131,-122.383,1280,5280,4090,4000,77.65151515151516,0.043934426229508196,Very Cheap
20141106T000000,410000.0,2,1.0,1030,4366,1.0,0,0,3,7,1030,0,1912,0,98136,47.5311,-122.384,1890,4499,3336,2609,93.90746678882272,0.043934426229508196,Very Cheap
20140716T000000,259000.0,3,1.75,1240,4000,1.0,0,0,3,7,1240,0,1986,0,98055,47.4728,-122.191,1570,4586,2760,3016,64.75,0.024131147540983607,Very Cheap
20150327T000000,292000.0,3,1.0,1730,21183,1.0,0,0,3,7,1030,700,1955,0,98168,47.5024,-122.332,1610,13000,19453,11390,13.78463862531275,0.028459016393442622,Very Cheap
20140812T000000,1648000.0,4,3.5,4610,12500,2.0,0,2,3,11,4610,0,2003,0,98033,47.6508,-122.203,2340,11538,7890,9198,131.84,0.2062950819672131,Cheap
20141113T000000,518000.0,5,1.0,1590,5000,1.5,0,0,3,7,1190,400,1929,0,98116,47.5752,-122.381,1590,5000,3410,3410,103.6,0.0580983606557377,Very Cheap
20150305T000000,485000.0,3,2.5,1760,3097,2.0,0,0,3,8,1760,0,1992,0,98029,47.5764,-121.996,1760,3285,1337,1525,156.6031643525993,0.05377049180327869,Very Cheap
20150303T000000,259500.0,3,2.0,1330,35060,1.0,0,0,3,7,1330,0,1989,0,98092,47.3128,-122.13,1660,35100,33730,33440,7.4015972618368515,0.02419672131147541,Very Cheap
20150423T000000,354000.0,4,2.5,2340,5420,2.0,0,0,3,8,2340,0,2003,0,98038,47.3773,-122.029,2420,6252,3080,3832,65.31365313653137,0.03659016393442623,Very Cheap
20150323T000000,999950.0,3,2.25,3740,22464,2.0,0,0,5,8,2330,1410,1966,0,98004,47.6354,-122.196,2680,19564,18724,16884,44.513443732193736,0.12130491803278688,Cheap
20140624T000000,464500.0,3,1.75,1150,10466,1.0,0,0,5,7,1150,0,1959,0,98006,47.5531,-122.177,1350,10384,9316,9034,44.381807758455956,0.051081967213114754,Very Cheap
20140825T000000,300000.0,3,2.5,1750,4200,2.0,0,0,3,7,1750,0,2005,0,98038,47.3605,-122.04,1890,4048,2450,2158,71.42857142857143,0.029508196721311476,Very Cheap
20140701T000000,1080000.0,3,2.75,3890,7216,2.0,0,1,3,8,3260,630,1967,2010,98118,47.5445,-122.266,2490,9920,3326,7430,149.66740576496673,0.1318032786885246,Cheap
20140721T000000,309950.0,4,2.5,1770,6666,2.0,0,0,3,7,1770,0,1989,0,98023,47.2877,-122.349,1780,6666,4896,4886,46.4971497149715,0.03081311475409836,Very Cheap
20140917T000000,315000.0,3,1.0,1160,3700,1.5,0,0,3,7,1160,0,1909,0,98106,47.5651,-122.359,1340,3750,2540,2410,85.13513513513513,0.031475409836065574,Very Cheap
20140724T000000,499950.0,3,1.0,1440,5580,1.5,0,0,3,7,1440,0,1908,0,98115,47.6898,-122.326,2010,5580,4140,3570,89.59677419354838,0.05573114754098361,Very Cheap
20140707T000000,780000.0,4,2.0,2600,4800,1.0,0,2,3,8,1400,1200,1953,0,98119,47.637,-122.371,2050,3505,2200,1455,162.5,0.09245901639344262,Very Cheap
20141121T000000,885000.0,3,3.25,2640,16090,1.0,0,2,4,8,1960,680,1976,0,98040,47.5374,-122.213,3690,15000,13450,11310,55.00310752019888,0.1062295081967213,Cheap
20140507T000000,500000.0,2,1.0,1010,3885,1.5,0,0,4,7,1010,0,1906,1990,98112,47.6224,-122.304,1770,4200,2875,2430,128.7001287001287,0.05573770491803279,Very Cheap
20141219T000000,329000.0,3,2.0,1840,6755,1.0,0,2,3,8,1840,0,1989,0,98003,47.3512,-122.305,1790,6459,4915,4669,48.704663212435236,0.03331147540983607,Very Cheap
20141028T000000,246000.0,4,1.75,1720,7455,1.0,0,0,4,7,1020,700,1963,0,98058,47.4669,-122.182,1720,7700,5735,5980,32.99798792756539,0.02242622950819672,Very Cheap
20141223T000000,405000.0,3,1.5,1280,9600,1.0,0,0,4,7,1280,0,1960,0,98033,47.6922,-122.163,1510,10005,8320,8495,42.1875,0.043278688524590166,Very Cheap
20140529T000000,349000.0,4,1.75,1700,7800,1.0,0,0,5,7,1120,580,1981,0,98059,47.4801,-122.158,1560,7800,6100,6240,44.743589743589745,0.035934426229508196,Very Cheap
20150323T000000,374950.0,4,2.5,1980,12062,2.0,0,0,3,8,1980,0,1992,0,98031,47.4038,-122.167,2300,7902,10082,5602,31.085226330625105,0.03933770491803279,Very Cheap
20140729T000000,306000.0,3,2.0,1160,7217,1.0,0,0,3,7,1160,0,1969,0,98034,47.7279,-122.227,1870,9104,6057,7234,42.3998891506166,0.030295081967213113,Very Cheap
20140805T000000,416000.0,4,1.75,1980,7840,1.0,0,0,4,7,990,990,1961,0,98008,47.6226,-122.115,1520,8400,5860,6880,53.06122448979592,0.044721311475409836,Very Cheap
20140623T000000,560000.0,3,2.5,1960,12476,2.0,0,0,4,8,1960,0,1989,0,98056,47.5315,-122.172,2450,12177,10516,9727,44.886181468419366,0.06360655737704918,Very Cheap
20140617T000000,260000.0,3,1.5,1270,20700,1.0,0,0,2,7,1150,120,1948,0,98155,47.7576,-122.296,1990,15000,19430,13010,12.560386473429952,0.024262295081967214,Very Cheap
20140516T000000,306500.0,3,2.25,2060,38377,1.0,0,0,4,8,1560,500,1978,0,98003,47.2752,-122.319,2080,60513,36317,58433,7.9865544466737886,0.03036065573770492,Very Cheap
20141211T000000,299950.0,3,1.75,1980,11274,1.0,0,0,4,7,1480,500,1968,0,98058,47.4474,-122.167,1520,8010,9294,6490,26.605463899237183,0.029501639344262295,Very Cheap
20150406T000000,265500.0,3,2.5,1450,8977,1.0,0,0,3,8,1450,0,1990,0,98092,47.2576,-122.214,2410,8850,7527,6440,29.575582042998775,0.02498360655737705,Very Cheap
20140812T000000,219000.0,3,1.5,1200,12000,1.0,0,0,3,7,1200,0,1986,0,98001,47.268,-122.245,1200,9405,10800,8205,18.25,0.018885245901639345,Very Cheap
20150505T000000,365000.0,3,1.75,1830,17349,1.0,0,0,3,8,1230,600,1977,0,98072,47.7427,-122.109,1840,11694,15519,9854,21.038676580782756,0.0380327868852459,Very Cheap
20140514T000000,499000.0,3,2.0,2090,42689,1.5,0,0,3,7,2090,0,1959,1998,98010,47.3497,-121.944,1890,18276,40599,16386,11.689193937548314,0.05560655737704918,Very Cheap
20140602T000000,366000.0,3,1.75,1510,8301,1.0,0,0,3,7,1510,0,1967,0,98034,47.7243,-122.222,1460,7910,6791,6450,44.09107336465486,0.03816393442622951,Very Cheap
20150501T000000,514950.0,3,2.25,1310,1264,3.0,0,0,3,8,1310,0,2014,0,98117,47.6987,-122.366,1330,2183,-46,853,407.3971518987342,0.057698360655737704,Very Cheap
20140604T000000,875000.0,4,2.75,3790,10669,2.0,0,0,3,10,3790,0,1999,0,98075,47.5976,-121.983,3750,11634,6879,7884,82.0133095885275,0.10491803278688525,Cheap
20150120T000000,831000.0,3,2.25,2240,8800,1.0,0,0,5,8,2240,0,1957,0,98005,47.5937,-122.172,2240,8800,6560,6560,94.43181818181819,0.09914754098360656,Very Cheap
20140515T000000,689900.0,4,3.25,2740,7266,2.0,0,0,3,9,2060,680,2003,0,98027,47.5346,-122.066,3030,6546,4526,3516,94.94907789705478,0.08064262295081967,Very Cheap
20140724T000000,315000.0,3,2.5,1660,10763,2.0,0,0,3,7,1660,0,1994,0,98038,47.3812,-122.029,2010,7983,9103,5973,29.26693301124222,0.031475409836065574,Very Cheap
20150429T000000,355000.0,0,0.0,2460,8049,2.0,0,0,3,8,2460,0,1990,0,98031,47.4095,-122.168,2520,8050,5589,5530,44.104857746303885,0.036721311475409836,Very Cheap
20140624T000000,336500.0,3,1.0,1480,7284,1.0,0,0,3,7,970,510,1963,0,98133,47.7757,-122.353,2020,7920,5804,5900,46.19714442613948,0.03429508196721311,Very Cheap
20140527T000000,1100000.0,3,2.75,2640,4050,1.5,0,0,5,8,1750,890,1926,0,98112,47.6332,-122.281,1920,3600,1410,1680,271.60493827160496,0.13442622950819672,Cheap
20140804T000000,375000.0,6,2.0,1900,8057,1.0,0,0,4,7,1170,730,1959,0,98133,47.762,-122.335,2090,8626,6157,6536,46.54337842869555,0.03934426229508197,Very Cheap
20140811T000000,289275.0,3,2.0,2860,24046,1.0,0,0,3,9,1700,1160,1985,0,98019,47.7718,-121.904,1460,13648,21186,12188,12.030067370872494,0.028101639344262293,Very Cheap
20140708T000000,455000.0,4,3.5,3440,6000,2.0,0,0,4,8,3440,0,2002,0,98198,47.4077,-122.331,1660,7800,2560,6140,75.83333333333333,0.049836065573770495,Very Cheap
20140625T000000,505000.0,3,1.75,1640,10695,1.0,0,2,3,8,1640,0,1975,0,98034,47.7145,-122.222,2790,9775,9055,6985,47.21832632071061,0.05639344262295082,Very Cheap
20140730T000000,450000.0,3,1.0,1450,3350,1.5,0,0,4,7,1450,0,1919,0,98126,47.5607,-122.378,1340,4255,1900,2915,134.32835820895522,0.04918032786885246,Very Cheap
20140608T000000,567500.0,3,2.5,2300,7398,2.0,0,0,3,8,2300,0,2001,0,98065,47.5369,-121.876,2580,6983,5098,4403,76.70992160043255,0.06459016393442622,Very Cheap
20141006T000000,265000.0,3,1.5,1460,8505,1.0,0,0,4,7,1460,0,1955,0,98055,47.4402,-122.195,1580,8505,7045,6925,31.158142269253382,0.024918032786885248,Very Cheap
20141230T000000,340000.0,3,2.0,1570,14992,1.0,0,0,3,8,1570,0,2001,0,98014,47.6965,-121.922,1640,15000,13422,13360,22.678762006403414,0.03475409836065574,Very Cheap
20150430T000000,375000.0,3,2.0,1540,8885,1.5,0,0,5,6,1540,0,1939,0,98019,47.7403,-121.984,1730,5000,7345,3270,42.20596510973551,0.03934426229508197,Very Cheap
20141226T000000,920000.0,6,3.0,3300,4218,2.0,0,0,3,8,2200,1100,1970,0,98103,47.6557,-122.344,1420,4218,918,2798,218.11284969179707,0.11081967213114755,Cheap
20140612T000000,850000.0,4,2.25,2130,11843,2.0,0,0,4,9,2130,0,1972,0,98040,47.5358,-122.225,2380,11643,9713,9263,71.77235497762392,0.10163934426229508,Cheap
20141210T000000,202000.0,3,1.0,1010,9750,1.0,0,0,5,7,1010,0,1969,0,98042,47.3244,-122.144,1230,9750,8740,8520,20.71794871794872,0.016655737704918034,Very Cheap
20140929T000000,725000.0,4,3.0,2420,12000,1.0,0,0,3,9,2420,0,1984,0,98077,47.7267,-122.063,3100,13020,9580,9920,60.416666666666664,0.08524590163934426,Very Cheap
20150206T000000,900000.0,3,3.25,3870,33980,2.0,0,0,3,10,3150,720,1991,0,98006,47.5589,-122.117,3590,10750,30110,7160,26.486168334314304,0.10819672131147541,Cheap
20150206T000000,680200.0,2,1.5,1960,6000,1.0,0,0,3,8,1210,750,1951,0,98103,47.6849,-122.333,2060,6000,4040,3940,113.36666666666666,0.0793704918032787,Very Cheap
20150414T000000,216500.0,3,1.0,1170,9000,1.0,0,0,4,6,1170,0,1918,0,98022,47.2109,-121.987,1280,8160,7830,6880,24.055555555555557,0.018557377049180326,Very Cheap
20141212T000000,325000.0,3,1.5,1890,7650,1.0,0,0,5,7,1890,0,1966,0,98003,47.3454,-122.314,1510,7560,5760,6050,42.48366013071895,0.03278688524590164,Very Cheap
20140812T000000,675000.0,3,2.5,2250,4134,2.0,0,0,3,9,2250,0,2004,0,98052,47.6651,-122.084,2390,4134,1884,1744,163.2801161103048,0.07868852459016394,Very Cheap
20150512T000000,435000.0,2,0.75,750,16321,1.0,0,1,3,4,750,0,1936,0,98034,47.6985,-122.229,3020,10625,15571,7605,26.652778628760494,0.04721311475409836,Very Cheap
20150122T000000,263500.0,3,1.75,1610,14000,1.0,0,0,4,7,1050,560,1977,0,98010,47.3429,-122.036,1550,10080,12390,8530,18.821428571428573,0.024721311475409836,Very Cheap
20150507T000000,550000.0,4,2.25,2590,36256,2.0,0,0,3,8,2590,0,1978,0,98077,47.769,-122.094,2670,35657,33666,32987,15.169902912621358,0.06229508196721312,Very Cheap
20150422T000000,875000.0,3,2.5,2520,3750,2.0,0,1,4,9,2520,0,1995,0,98116,47.5671,-122.404,2250,6200,1230,3950,233.33333333333334,0.10491803278688525,Cheap
20150411T000000,246600.0,4,1.0,1340,8400,1.0,0,0,5,7,1340,0,1966,0,98023,47.3313,-122.343,1120,8400,7060,7280,29.357142857142858,0.022504918032786887,Very Cheap
20140701T000000,337000.0,3,2.25,1460,941,3.0,0,0,3,8,1460,0,2006,0,98133,47.7145,-122.356,1490,1399,-519,-91,358.1296493092455,0.034360655737704915,Very Cheap
20141111T000000,240000.0,3,1.75,1380,7500,1.0,0,0,3,7,1380,0,1988,0,98038,47.3628,-122.045,1530,7500,6120,5970,32.0,0.021639344262295083,Very Cheap
20140910T000000,490000.0,3,1.75,1510,11120,1.0,0,0,4,8,1510,0,1984,0,98005,47.5931,-122.158,2660,10800,9610,8140,44.064748201438846,0.05442622950819672,Very Cheap
20140806T000000,510000.0,5,2.5,2510,83231,1.0,0,0,4,7,1260,1250,1975,0,98027,47.4576,-121.984,2460,46431,80721,43971,6.127524600209057,0.057049180327868855,Very Cheap
20150307T000000,305000.0,3,1.0,910,8008,1.0,0,0,3,7,910,0,1971,0,98034,47.726,-122.22,1480,7404,7098,5924,38.086913086913086,0.03016393442622951,Very Cheap
20150403T000000,350000.0,3,2.5,1970,3655,2.0,0,0,3,7,1970,0,2003,0,98019,47.7453,-121.984,1970,2952,1685,982,95.75923392612859,0.036065573770491806,Very Cheap
20150224T000000,284200.0,3,1.75,1540,6632,1.0,0,0,3,7,1070,470,1959,0,98178,47.4973,-122.252,2510,6618,5092,4108,42.85283474065139,0.027436065573770492,Very Cheap
20150128T000000,357000.0,4,2.5,1980,9757,2.0,0,0,5,7,1980,0,1995,0,98038,47.3675,-122.019,1610,6147,7777,4537,36.58911550681562,0.03698360655737705,Very Cheap
20140617T000000,854000.0,4,2.75,3150,38865,1.0,0,0,3,10,2480,670,1986,0,98052,47.7302,-122.106,3150,35880,35715,32730,21.97349800591792,0.10216393442622951,Cheap
20150114T000000,1175000.0,4,2.5,4700,49658,2.0,0,0,3,10,4700,0,1999,0,98075,47.5878,-122.022,2870,49658,44958,46788,23.66184703371058,0.14426229508196722,Cheap
20141008T000000,1000000.0,3,2.25,2300,15952,1.0,0,0,4,8,1150,1150,1963,0,98039,47.6322,-122.232,2200,14284,13652,12084,62.688064192577734,0.12131147540983607,Cheap
20141125T000000,616500.0,4,2.25,1880,3000,2.0,0,0,3,8,1760,120,1909,1977,98103,47.6864,-122.349,1880,3000,1120,1120,205.5,0.07101639344262295,Very Cheap
20141125T000000,750000.0,4,2.75,2640,3750,2.0,0,0,5,7,1840,800,1911,0,98117,47.6783,-122.363,1690,5000,1110,3310,200.0,0.08852459016393442,Very Cheap
20141007T000000,650000.0,6,4.5,3900,9100,2.0,0,0,3,8,2870,1030,1979,0,98052,47.6612,-122.137,2080,9216,5200,7136,71.42857142857143,0.07540983606557378,Very Cheap
20140715T000000,275000.0,4,2.25,2670,10050,1.0,0,0,4,8,1420,1250,1962,0,98032,47.3792,-122.28,2190,10050,7380,7860,27.36318407960199,0.02622950819672131,Very Cheap
20141003T000000,540000.0,4,1.75,1840,4280,1.0,0,0,4,7,920,920,1918,0,98105,47.6681,-122.32,1660,4280,2440,2620,126.16822429906541,0.06098360655737705,Very Cheap
20140814T000000,225000.0,3,1.0,1120,10665,1.0,0,0,4,6,1120,0,1961,0,98001,47.2886,-122.274,1240,10639,9545,9399,21.09704641350211,0.019672131147540985,Very Cheap
20150409T000000,845000.0,4,2.5,2970,9072,2.0,0,0,3,10,2970,0,1991,0,98006,47.562,-122.114,2740,8729,6102,5989,93.14373897707232,0.10098360655737705,Cheap
20150312T000000,490000.0,3,2.25,1410,7740,1.0,0,0,5,6,1410,0,1923,0,98126,47.523,-122.371,1220,7740,6330,6520,63.30749354005168,0.05442622950819672,Very Cheap
20141209T000000,753000.0,4,2.5,3060,8167,2.0,0,0,3,9,3060,0,2005,0,98029,47.5521,-121.989,2930,4800,5107,1870,92.20031835435289,0.08891803278688525,Very Cheap
20150209T000000,475000.0,3,1.75,2490,7210,1.0,0,0,3,7,1290,1200,1972,0,98034,47.726,-122.198,1610,7210,4720,5600,65.88072122052705,0.05245901639344262,Very Cheap
20141003T000000,124000.0,1,0.75,840,7203,1.5,0,0,3,6,840,0,1949,0,98168,47.4756,-122.301,1560,8603,6363,7043,17.21504928502013,0.006426229508196721,Very Cheap
20150424T000000,224000.0,1,0.75,840,7203,1.5,0,0,3,6,840,0,1949,0,98168,47.4756,-122.301,1560,8603,6363,7043,31.09815354713314,0.01954098360655738,Very Cheap
20140814T000000,485000.0,2,1.0,1130,3800,1.0,0,0,4,7,1130,0,1916,0,98117,47.6862,-122.378,1470,3800,2670,2330,127.63157894736842,0.05377049180327869,Very Cheap
20140624T000000,230000.0,4,1.75,1850,6000,1.0,0,0,4,6,1270,580,1944,0,98178,47.4923,-122.247,1270,6600,4150,5330,38.333333333333336,0.020327868852459016,Very Cheap
20141105T000000,372000.0,4,2.75,2330,14175,1.0,0,0,3,7,1800,530,1980,0,98031,47.4193,-122.194,1480,10125,11845,8645,26.243386243386244,0.03895081967213115,Very Cheap
20150507T000000,306000.0,4,2.5,1880,9426,2.0,0,0,4,7,1880,0,1990,0,98042,47.3584,-122.089,1760,7040,7546,5280,32.46339910884787,0.030295081967213113,Very Cheap
20140827T000000,905000.0,4,3.5,2980,3000,2.0,0,0,3,9,2340,640,2008,0,98115,47.6768,-122.326,1810,4545,20,2735,301.6666666666667,0.10885245901639344,Cheap
20150326T000000,440000.0,4,1.0,1440,6678,1.0,0,0,3,7,1040,400,1950,0,98116,47.571,-122.392,1320,6678,5238,5358,65.8879904162923,0.04786885245901639,Very Cheap
20150428T000000,280000.0,3,1.75,1630,10001,1.0,0,0,4,7,1100,530,1977,0,98042,47.3605,-122.12,1630,10001,8371,8371,27.997200279972002,0.026885245901639345,Very Cheap
20140729T000000,435000.0,3,2.5,1778,147823,2.0,0,0,3,7,1778,0,1999,0,98014,47.6811,-121.915,2840,43676,146045,40836,2.942708509501228,0.04721311475409836,Very Cheap
20140624T000000,425000.0,3,2.5,1930,4500,2.0,0,0,3,8,1930,0,1990,0,98029,47.5791,-122.001,1770,4500,2570,2730,94.44444444444444,0.04590163934426229,Very Cheap
20140826T000000,204950.0,2,0.75,1130,11429,1.0,0,0,3,7,1130,0,1956,0,98188,47.4526,-122.284,1550,10700,10299,9150,17.932452533030013,0.017042622950819673,Very Cheap
20140714T000000,670000.0,2,1.75,1650,7500,1.0,0,0,4,7,1000,650,1959,0,98033,47.6871,-122.207,2530,9000,5850,6470,89.33333333333333,0.0780327868852459,Very Cheap
20140507T000000,475000.0,2,1.0,820,2723,1.0,0,0,3,7,820,0,1921,0,98103,47.6623,-122.339,1370,3850,1903,2480,174.4399559309585,0.05245901639344262,Very Cheap
20150320T000000,352000.0,5,2.5,2900,6650,1.0,0,0,3,7,1450,1450,1964,0,98168,47.4935,-122.332,1600,8246,3750,6646,52.932330827067666,0.03632786885245902,Very Cheap
20150409T000000,575000.0,4,1.75,2330,8800,1.0,0,2,4,7,1260,1070,1961,0,98008,47.6148,-122.113,2270,8800,6470,6530,65.3409090909091,0.06557377049180328,Very Cheap
20141126T000000,1730000.0,4,3.5,4440,20668,2.0,0,2,5,10,3240,1200,1965,0,98040,47.5472,-122.235,4240,18650,16228,14410,83.7042771434101,0.21704918032786885,Cheap
20141013T000000,491000.0,3,2.0,1660,5070,2.0,0,3,3,8,1660,0,1950,1990,98108,47.5552,-122.296,2440,6664,3410,4224,96.84418145956607,0.05455737704918033,Very Cheap
20140709T000000,750000.0,4,2.5,3020,7465,2.0,0,0,3,9,3020,0,2004,0,98075,47.5982,-121.98,3100,5587,4445,2487,100.46885465505693,0.08852459016393442,Very Cheap
20140527T000000,830000.0,4,2.5,1850,50662,1.0,0,0,3,8,1430,420,1978,0,98052,47.6535,-122.119,2090,10599,48812,8509,16.383087915992263,0.09901639344262295,Very Cheap
20150109T000000,1140000.0,6,3.75,5960,20197,2.0,0,4,3,10,3900,2060,2005,0,98065,47.5398,-121.869,3860,12800,14237,8940,56.444026340545626,0.13967213114754098,Cheap
20140709T000000,137124.0,3,1.0,960,27442,1.0,0,0,4,6,960,0,1970,0,98058,47.4676,-122.134,1100,29019,26482,27919,4.99686611762991,0.008147409836065574,Very Cheap
20140813T000000,225000.0,4,1.0,1150,6000,1.5,0,0,3,6,1150,0,1907,0,98118,47.562,-122.283,840,3030,4850,2190,37.5,0.019672131147540985,Very Cheap
20140622T000000,732600.0,4,2.5,2130,7300,1.0,0,0,4,7,1230,900,1963,0,98005,47.605,-122.167,2130,7560,5170,5430,100.35616438356165,0.08624262295081968,Very Cheap
20150316T000000,818000.0,4,2.25,2460,8001,2.0,0,0,4,8,2460,0,1984,0,98006,47.548,-122.154,2460,9126,5541,6666,102.23722034745657,0.09744262295081967,Very Cheap
20140820T000000,431000.0,3,2.25,2360,14950,1.0,0,0,4,9,2360,0,1978,0,98042,47.3856,-122.158,2720,14388,12590,11668,28.82943143812709,0.046688524590163934,Very Cheap
20141002T000000,304000.0,2,2.25,1320,1034,3.0,0,0,3,7,1320,0,1996,0,98133,47.7039,-122.344,1330,1206,-286,-124,294.0038684719536,0.030032786885245903,Very Cheap
20141021T000000,650000.0,5,2.0,1910,4667,1.0,0,0,3,7,1010,900,1908,0,98112,47.6236,-122.306,1230,2545,2757,1315,139.27576601671308,0.07540983606557378,Very Cheap
20150410T000000,450000.0,2,2.0,1610,6160,2.0,0,0,4,8,1610,0,1977,0,98052,47.6644,-122.13,1750,6305,4550,4555,73.05194805194805,0.04918032786885246,Very Cheap
20140822T000000,269000.0,4,1.0,1610,8401,1.0,0,0,3,7,1610,0,1958,0,98056,47.5104,-122.165,1610,8401,6791,6791,32.01999761933103,0.02544262295081967,Very Cheap
20141231T000000,875000.0,3,1.0,1160,10732,1.0,0,0,3,7,1160,0,1953,0,98004,47.6391,-122.205,2390,13656,9572,11266,81.53186731270965,0.10491803278688525,Cheap
20150429T000000,890000.0,4,2.25,2870,8393,1.0,0,0,4,8,1480,1390,1977,0,98040,47.5787,-122.245,2930,9850,5523,6920,106.0407482425831,0.10688524590163935,Cheap
20141009T000000,565000.0,4,2.5,2280,9725,2.0,0,0,3,8,2280,0,1986,0,98072,47.7568,-122.141,2140,8780,7445,6640,58.09768637532134,0.06426229508196721,Very Cheap
20150313T000000,448175.0,2,2.0,1370,1339,2.0,0,0,4,8,1150,220,2006,0,98122,47.6021,-122.295,1370,1339,-31,-31,334.70873786407765,0.048940983606557374,Very Cheap
20141223T000000,235000.0,0,0.0,1470,4800,2.0,0,0,3,7,1470,0,1996,0,98065,47.5265,-121.828,1060,7200,3330,6140,48.958333333333336,0.02098360655737705,Very Cheap
20140911T000000,680000.0,5,3.0,2970,6500,2.0,0,0,3,9,2970,0,2000,0,98075,47.5973,-122.018,2970,6588,3530,3618,104.61538461538461,0.07934426229508197,Very Cheap
20150206T000000,629000.0,3,1.75,1460,12367,2.0,1,4,4,8,1120,340,1970,0,98023,47.3311,-122.375,1970,18893,10907,16923,50.86116277189294,0.07265573770491804,Very Cheap
20150422T000000,494000.0,3,3.5,1570,1486,2.5,0,0,3,8,1330,240,2000,0,98199,47.652,-122.384,1610,1486,-84,-124,332.43606998654104,0.05495081967213115,Very Cheap
20150127T000000,1100000.0,4,3.0,2880,5500,2.0,0,0,4,9,1920,960,1926,0,98102,47.6448,-122.317,2110,5500,2620,3390,200.0,0.13442622950819672,Cheap
20150116T000000,450000.0,5,2.5,1900,9460,1.0,0,0,3,7,1190,710,1969,0,98034,47.7096,-122.202,1940,8360,7560,6420,47.56871035940804,0.04918032786885246,Very Cheap
20141030T000000,330000.0,3,1.75,2020,11050,1.0,0,0,4,8,1320,700,1969,0,98059,47.4706,-122.119,1940,11050,9030,9110,29.86425339366516,0.03344262295081967,Very Cheap
20140820T000000,960000.0,4,2.5,3110,11397,2.0,0,3,4,10,3110,0,1984,0,98006,47.5623,-122.106,3110,11586,8287,8476,84.2326928138984,0.1160655737704918,Cheap
20141224T000000,360000.0,4,2.5,2390,7056,2.0,0,0,3,9,2390,0,1990,0,98001,47.3385,-122.264,2590,7801,4666,5211,51.02040816326531,0.037377049180327866,Very Cheap
20140810T000000,378000.0,3,2.5,2150,11672,2.0,0,0,3,8,2150,0,2004,0,98038,47.3515,-122.006,2150,5450,9522,3300,32.38519533927347,0.03973770491803279,Very Cheap
20140912T000000,499950.0,3,1.75,1340,6250,1.0,0,0,4,7,1090,250,1941,0,98136,47.5427,-122.386,1550,1755,4910,205,79.992,0.05573114754098361,Very Cheap
20140724T000000,450000.0,3,2.5,1990,12866,2.0,0,0,4,7,1990,0,1986,0,98072,47.7477,-122.17,2310,8803,10876,6493,34.97590548733095,0.04918032786885246,Very Cheap
20140825T000000,523500.0,2,2.0,1600,5969,1.0,0,0,4,7,800,800,1950,0,98116,47.5691,-122.394,1520,5969,4369,4449,87.70313285307422,0.05881967213114754,Very Cheap
20141208T000000,600000.0,3,2.5,2680,43995,2.0,0,0,3,9,2680,0,1986,0,98077,47.7655,-122.086,2520,37277,41315,34757,13.637913399249914,0.06885245901639345,Very Cheap
20140602T000000,290000.0,3,2.5,2080,4828,2.0,0,0,3,8,2080,0,2002,0,98042,47.3737,-122.132,2190,4620,2748,2430,60.06628003314002,0.02819672131147541,Very Cheap
20150206T000000,176000.0,3,3.25,1340,5434,2.0,0,0,3,7,1340,0,1986,0,98038,47.3779,-122.045,1670,6203,4094,4533,32.388663967611336,0.013245901639344262,Very Cheap
20140918T000000,885000.0,3,2.0,2590,3750,1.5,0,0,5,7,1790,800,1904,0,98109,47.635,-122.353,2440,4000,1160,1560,236.0,0.1062295081967213,Cheap
20140624T000000,483000.0,2,1.75,1240,3000,1.5,0,0,3,7,1240,0,1906,0,98105,47.6689,-122.326,1800,4080,1760,2280,161.0,0.05350819672131148,Very Cheap
20150508T000000,240000.0,3,1.0,1310,7125,1.0,0,0,4,7,1310,0,1978,0,98042,47.3739,-122.148,1650,7290,5815,5640,33.68421052631579,0.021639344262295083,Very Cheap
20140925T000000,720000.0,4,2.25,2530,5200,1.0,0,1,4,8,1530,1000,1957,0,98117,47.6985,-122.382,2240,5200,2670,2960,138.46153846153845,0.08459016393442623,Very Cheap
20141105T000000,311000.0,4,2.5,1780,5822,2.0,0,0,3,7,1780,0,2001,0,98058,47.4455,-122.169,1990,4092,4042,2102,53.418069391961524,0.030950819672131147,Very Cheap
20150102T000000,332500.0,3,2.0,1600,7995,1.0,0,0,3,7,1600,0,1950,1984,98118,47.5177,-122.257,2440,6900,6395,4460,41.588492808005,0.033770491803278686,Very Cheap
20140626T000000,164950.0,3,1.75,1570,15330,1.0,0,0,3,7,1080,490,1956,0,98166,47.4608,-122.34,1250,13330,13760,12080,10.759947814742334,0.01179672131147541,Very Cheap
20150323T000000,371000.0,3,1.75,1570,15330,1.0,0,0,3,7,1080,490,1956,0,98166,47.4608,-122.34,1250,13330,13760,12080,24.200913242009133,0.038819672131147544,Very Cheap
20150123T000000,264500.0,3,1.75,1650,16200,1.0,0,0,3,7,1650,0,1976,0,98031,47.3926,-122.168,1650,8680,14550,7030,16.32716049382716,0.024852459016393443,Very Cheap
20140705T000000,1738000.0,4,2.25,2920,6513,2.0,0,0,4,9,2260,660,1937,0,98112,47.638,-122.29,4510,9248,3593,4738,266.8509135575004,0.2180983606557377,Cheap
20150330T000000,503000.0,2,1.0,870,4280,1.0,0,2,4,6,870,0,1921,0,98105,47.6697,-122.29,1750,4280,3410,2530,117.5233644859813,0.056131147540983604,Very Cheap
20141029T000000,738000.0,4,2.5,2830,5010,2.0,0,0,3,9,2170,660,2000,0,98115,47.6952,-122.327,1880,5739,2180,3859,147.30538922155688,0.08695081967213114,Very Cheap
20140923T000000,393000.0,2,1.0,980,3350,1.0,0,0,4,7,980,0,1925,0,98103,47.6858,-122.352,1260,4000,2370,2740,117.31343283582089,0.041704918032786885,Very Cheap
20150412T000000,280000.0,2,1.0,990,45528,1.0,0,0,4,7,990,0,1992,0,98070,47.5013,-122.463,1730,45528,44538,43798,6.150061500615006,0.026885245901639345,Very Cheap
20150325T000000,260000.0,4,2.5,2360,9647,1.0,0,2,3,8,1530,830,1964,0,98003,47.3367,-122.332,2580,9680,7287,7100,26.951383849901525,0.024262295081967214,Very Cheap
20150409T000000,505000.0,2,1.0,1000,4640,1.0,0,2,3,7,1000,0,1915,0,98116,47.5659,-122.389,1940,5800,3640,3860,108.83620689655173,0.05639344262295082,Very Cheap
20150105T000000,241000.0,3,1.5,1660,8000,1.0,0,0,4,7,1120,540,1976,0,98030,47.353,-122.172,1900,7500,6340,5600,30.125,0.02177049180327869,Very Cheap
20150316T000000,530000.0,3,1.75,1520,9605,1.0,0,0,3,7,1520,0,1975,0,98052,47.667,-122.142,2040,9900,8085,7860,55.179593961478396,0.05967213114754098,Very Cheap
20140812T000000,713000.0,1,1.0,1180,4000,1.5,0,2,4,8,840,340,1910,0,98118,47.5561,-122.266,1420,4000,2820,2580,178.25,0.08367213114754099,Very Cheap
20140722T000000,487000.0,3,1.75,1770,10125,2.0,0,0,3,7,1770,0,1944,1978,98133,47.7289,-122.353,1680,9825,8355,8145,48.098765432098766,0.054032786885245904,Very Cheap
20141113T000000,128000.0,2,1.0,980,5393,1.0,0,0,3,6,980,0,1969,0,98042,47.3674,-122.081,980,5200,4413,4220,23.734470610050064,0.006950819672131147,Very Cheap
20141113T000000,210500.0,3,1.0,1840,10178,1.0,0,0,3,7,1040,800,1960,0,98198,47.3979,-122.317,2040,10660,8338,8620,20.681862841422678,0.01777049180327869,Very Cheap
20150115T000000,420000.0,3,2.5,1810,7210,1.0,0,0,5,7,1210,600,1968,0,98059,47.5067,-122.163,1770,7210,5400,5440,58.25242718446602,0.04524590163934426,Very Cheap
20141030T000000,679000.0,3,2.5,1780,4320,2.0,0,0,4,8,1780,0,1930,1986,98115,47.6809,-122.293,1690,4952,2540,3262,157.17592592592592,0.07921311475409835,Very Cheap
20141218T000000,784950.0,4,2.75,2840,4227,3.0,0,0,3,9,2840,0,2014,0,98052,47.7097,-122.107,2880,4227,1387,1347,185.69907735982966,0.09310819672131147,Very Cheap
20141119T000000,352000.0,4,2.5,2650,6366,2.0,0,0,3,9,2650,0,1998,0,98092,47.3325,-122.171,2650,6200,3716,3550,55.29374803644361,0.03632786885245902,Very Cheap
20140611T000000,386000.0,3,1.5,1270,1318,2.0,0,0,3,7,1080,190,2004,0,98199,47.6526,-122.384,1360,1488,48,128,292.8679817905918,0.04078688524590164,Very Cheap
20150430T000000,335000.0,3,1.75,1260,17000,1.0,0,0,3,7,1260,0,1994,0,98146,47.5114,-122.361,1540,7213,15740,5673,19.705882352941178,0.03409836065573771,Very Cheap
20140602T000000,472500.0,3,2.0,1750,15500,1.0,0,0,3,7,1490,260,1982,0,98075,47.5887,-122.065,2450,50094,13750,47644,30.483870967741936,0.05213114754098361,Very Cheap
20141103T000000,599950.0,5,2.25,2680,13292,1.0,0,0,3,8,1340,1340,1976,0,98028,47.7422,-122.257,2220,13181,10612,10961,45.1361721336142,0.06884590163934426,Very Cheap
20140724T000000,963990.0,4,3.25,3830,6765,2.0,0,0,3,9,3830,0,2014,0,98053,47.685,-122.016,3830,6507,2935,2677,142.49667405764967,0.11658885245901639,Cheap
20140925T000000,735000.0,3,2.0,1610,3600,2.0,0,2,5,8,1610,0,1925,0,98144,47.5969,-122.293,2540,6600,1990,4060,204.16666666666666,0.08655737704918033,Very Cheap
20150317T000000,858450.0,3,4.25,3840,9751,2.0,0,0,3,10,3840,0,1998,0,98074,47.6347,-122.064,3230,7189,5911,3959,88.03712439749769,0.10274754098360656,Cheap
20150507T000000,665000.0,5,2.75,2670,4000,2.0,0,0,4,7,1800,870,1914,0,98105,47.6711,-122.315,2460,4000,1330,1540,166.25,0.07737704918032787,Very Cheap
20140731T000000,290000.0,3,2.5,2000,7414,2.0,0,0,4,7,2000,0,1993,0,98038,47.3508,-122.057,2000,7414,5414,5414,39.115187483140005,0.02819672131147541,Very Cheap
20150413T000000,250000.0,2,1.0,860,4320,1.0,0,0,3,7,860,0,1925,0,98108,47.5263,-122.325,980,6000,3460,5020,57.870370370370374,0.022950819672131147,Very Cheap
20141008T000000,192500.0,3,1.75,1420,7205,1.0,0,0,3,7,1420,0,1986,0,98030,47.3555,-122.175,1690,7405,5785,5715,26.717557251908396,0.01540983606557377,Very Cheap
20140825T000000,350000.0,4,2.0,2060,13400,1.0,0,2,4,8,2060,0,1957,0,98166,47.4404,-122.34,1950,10370,11340,8420,26.119402985074625,0.036065573770491806,Very Cheap
20150319T000000,518000.0,4,2.5,2790,9910,2.0,0,0,3,8,2790,0,2003,0,98059,47.4891,-122.141,2590,9910,7120,7320,52.27043390514632,0.0580983606557377,Very Cheap
20140701T000000,563000.0,4,1.0,1410,3376,1.5,0,0,5,7,1410,0,1911,0,98107,47.6606,-122.365,1040,3600,1966,2560,166.7654028436019,0.064,Very Cheap
20141007T000000,375000.0,4,3.0,2420,9566,2.0,0,0,3,7,2420,0,2003,0,98188,47.4693,-122.266,2420,9135,7146,6715,39.20133807233954,0.03934426229508197,Very Cheap
20150227T000000,400000.0,3,2.5,1460,1319,3.0,0,0,3,8,1460,0,2002,0,98103,47.698,-122.349,1430,1530,-141,100,303.2600454890068,0.04262295081967213,Very Cheap
20141029T000000,240000.0,5,1.75,2460,16000,1.0,0,0,3,7,1230,1230,1957,0,98023,47.3305,-122.351,1990,16000,13540,14010,15.0,0.021639344262295083,Very Cheap
20140923T000000,317500.0,2,1.0,1000,5120,1.0,0,0,3,6,1000,0,1902,0,98122,47.6088,-122.307,1940,4300,4120,2360,62.01171875,0.03180327868852459,Very Cheap
20150213T000000,1315000.0,5,4.0,4420,36342,2.0,0,0,5,10,2740,1680,1982,0,98007,47.6468,-122.151,3720,37034,31922,33314,36.184029497551045,0.16262295081967212,Cheap
20141110T000000,234000.0,3,1.0,1240,239144,1.0,0,0,3,6,1240,0,1921,1992,98038,47.4303,-122.046,1990,109335,237904,107345,0.978489947479343,0.020852459016393442,Very Cheap
20140513T000000,645000.0,3,2.5,1740,13750,2.0,0,0,4,9,1740,0,1975,0,98008,47.6264,-122.092,2540,14300,12010,11760,46.90909090909091,0.07475409836065573,Very Cheap
20150309T000000,649000.0,2,1.0,1280,4840,1.0,0,0,3,7,1200,80,1908,0,98115,47.6762,-122.299,1860,5500,3560,3640,134.0909090909091,0.07527868852459016,Very Cheap
20150417T000000,605000.0,4,2.5,2520,3980,2.0,0,0,3,8,2520,0,2004,0,98027,47.5399,-122.07,2580,3980,1460,1400,152.01005025125627,0.06950819672131148,Very Cheap
20140821T000000,337900.0,3,3.5,1500,1471,3.0,0,0,3,7,1500,0,1999,0,98177,47.7034,-122.362,1500,1445,-29,-55,229.70768184908226,0.03447868852459016,Very Cheap
20150205T000000,535000.0,3,2.75,2490,3600,2.0,0,0,3,8,2290,200,1906,0,98122,47.6098,-122.292,1880,3600,1110,1720,148.61111111111111,0.06032786885245902,Very Cheap
20140922T000000,325000.0,4,1.0,1530,5684,1.0,0,0,3,7,1130,400,1957,0,98108,47.5507,-122.298,1540,6095,4154,4555,57.1780436312456,0.03278688524590164,Very Cheap
20141215T000000,429950.0,4,2.25,1740,10875,1.0,0,0,3,8,1740,0,1967,0,98059,47.5132,-122.157,1680,10701,9135,9021,39.53563218390805,0.04655081967213115,Very Cheap
20150416T000000,775000.0,3,2.5,3550,32807,2.0,0,0,3,9,3550,0,1989,0,98077,47.7292,-122.082,3270,35001,29257,31731,23.623007285030635,0.09180327868852459,Very Cheap
20140731T000000,650000.0,2,1.0,1280,6000,1.0,0,0,3,7,1280,0,1965,0,98112,47.6339,-122.282,2460,4800,4720,2340,108.33333333333333,0.07540983606557378,Very Cheap
20150501T000000,1200000.0,4,2.25,2320,13114,2.0,0,0,5,8,2320,0,1967,0,98040,47.5762,-122.239,2740,15000,10794,12260,91.50526155253927,0.14754098360655737,Cheap
20140910T000000,275000.0,2,1.0,1140,10404,1.0,0,0,3,5,1140,0,1935,0,98155,47.7497,-122.286,2200,11550,9264,9350,26.4321414840446,0.02622950819672131,Very Cheap
20140729T000000,575000.0,4,3.5,3930,16970,2.0,0,0,3,9,3930,0,1997,0,98019,47.7412,-121.966,2740,17219,13040,14479,33.88332351208014,0.06557377049180328,Very Cheap
20140806T000000,540000.0,3,2.5,2370,16455,1.0,0,0,5,7,1640,730,1959,0,98155,47.7634,-122.277,2170,15551,14085,13381,32.81677301731996,0.06098360655737705,Very Cheap
20140605T000000,640000.0,3,1.75,2340,4206,1.0,0,0,5,7,1170,1170,1917,0,98144,47.5759,-122.288,1360,4725,1866,3365,152.16357584403232,0.0740983606557377,Very Cheap
20140923T000000,275000.0,3,1.5,1240,9125,1.0,0,0,4,7,1240,0,1967,0,98058,47.4469,-122.155,1670,9125,7885,7455,30.136986301369863,0.02622950819672131,Very Cheap
20140724T000000,672800.0,4,2.5,2740,10533,2.0,0,0,3,9,2740,0,1997,0,98074,47.6095,-122.006,2760,8603,7793,5843,63.87543909617393,0.0784,Very Cheap
20140527T000000,495000.0,4,2.25,1940,9144,1.0,0,0,4,7,1430,510,1956,0,98007,47.5942,-122.135,1460,9437,7204,7977,54.13385826771653,0.05508196721311476,Very Cheap
20140926T000000,820000.0,3,2.5,2950,35108,1.5,0,0,3,10,2950,0,1995,0,98077,47.7316,-122.035,3810,35181,32158,31371,23.356499943032926,0.09770491803278689,Very Cheap
20140609T000000,475000.0,4,2.75,1980,11443,1.0,0,0,5,7,1980,0,1952,0,98155,47.7707,-122.273,2080,15700,9463,13620,41.51009350694748,0.05245901639344262,Very Cheap
20140520T000000,1275000.0,4,2.0,2850,7861,1.0,0,4,4,10,1450,1400,1970,0,98117,47.6995,-122.397,2810,8087,5011,5277,162.1931052029004,0.15737704918032788,Cheap
20150429T000000,380000.0,3,1.0,1160,9375,1.0,0,0,3,7,1160,0,1967,0,98077,47.7419,-122.073,1160,9650,8215,8490,40.53333333333333,0.04,Very Cheap
20140820T000000,397500.0,3,2.0,2130,8225,1.0,0,0,4,8,2130,0,1987,0,98058,47.4396,-122.162,2580,8225,6095,5645,48.328267477203646,0.04229508196721311,Very Cheap
20140507T000000,352000.0,5,2.5,2420,8560,1.0,0,2,3,7,1620,800,1978,0,98118,47.532,-122.285,2210,7040,6140,4830,41.12149532710281,0.03632786885245902,Very Cheap
20150413T000000,893880.0,6,2.5,2820,8600,1.0,0,0,5,8,1430,1390,1967,0,98006,47.565,-122.144,2070,8900,5780,6830,103.93953488372092,0.10739409836065573,Cheap
20140916T000000,635000.0,5,3.25,3710,34200,2.0,0,0,3,8,2510,1200,1986,0,98074,47.6101,-122.047,1720,23100,30490,21380,18.567251461988302,0.07344262295081967,Very Cheap
20140507T000000,420000.0,3,2.25,1770,8165,2.0,0,0,3,7,1770,0,1977,0,98034,47.7166,-122.236,1650,8165,6395,6515,51.43906919779547,0.04524590163934426,Very Cheap
20150321T000000,503000.0,3,2.0,1260,2500,1.0,0,0,4,7,750,510,1987,0,98107,47.6748,-122.371,1710,5000,1240,3290,201.2,0.056131147540983604,Very Cheap
20140909T000000,689000.0,2,1.75,2330,10143,1.0,0,2,4,7,1220,1110,1953,0,98146,47.4899,-122.359,2560,9750,7813,7190,67.92862072365178,0.08052459016393443,Very Cheap
20140902T000000,749500.0,4,2.75,2490,3840,1.5,0,0,4,7,1610,880,1922,0,98103,47.6551,-122.344,1420,4000,1350,2580,195.18229166666666,0.08845901639344263,Very Cheap
20141006T000000,1150000.0,6,3.75,4090,49542,2.0,0,0,3,9,3100,990,1984,0,98005,47.6408,-122.153,2980,43357,45452,40377,23.212627669452182,0.14098360655737704,Cheap
20140609T000000,563500.0,4,2.5,2800,12831,2.0,0,0,3,8,2800,0,2001,0,98019,47.7392,-121.966,2810,10235,10031,7425,43.91707583196945,0.06406557377049181,Very Cheap
20140630T000000,480000.0,4,3.0,2440,9664,2.0,0,0,3,8,1890,550,1981,0,98028,47.7649,-122.253,2380,9609,7224,7229,49.66887417218543,0.05311475409836065,Very Cheap
20150422T000000,374950.0,4,3.0,2540,8800,1.0,0,1,3,9,1620,920,1977,0,98023,47.3204,-122.387,2540,8800,6260,6260,42.60795454545455,0.03933770491803279,Very Cheap
20150410T000000,308950.0,3,2.5,1600,6250,2.0,0,0,3,7,1600,0,1995,0,98038,47.3675,-122.02,1760,6110,4650,4350,49.432,0.030681967213114753,Very Cheap
20140917T000000,445000.0,4,2.75,2680,16934,1.0,0,0,4,7,1340,1340,1958,0,98106,47.542,-122.364,1240,7000,14254,5760,26.27849297271761,0.04852459016393443,Very Cheap
20150421T000000,237200.0,3,1.5,1220,9000,1.0,0,0,4,7,1220,0,1968,0,98042,47.3642,-122.109,1220,9472,7780,8252,26.355555555555554,0.021272131147540983,Very Cheap
20140902T000000,453500.0,3,1.75,1550,7270,1.5,0,0,5,7,1550,0,1953,0,98125,47.72,-122.317,1050,7210,5720,6160,62.37964236588721,0.04963934426229508,Very Cheap
20150507T000000,616500.0,3,2.0,2080,4549,1.0,0,0,5,7,1040,1040,1954,0,98115,47.6886,-122.309,1620,4549,2469,2929,135.52429105297867,0.07101639344262295,Very Cheap
20140806T000000,1250000.0,5,5.0,5000,32909,2.0,0,0,3,10,5000,0,2000,0,98075,47.6012,-122.022,3030,12601,27909,9571,37.983530341244034,0.1540983606557377,Cheap
20150407T000000,396000.0,1,1.0,630,5150,1.0,0,0,4,5,630,0,1954,0,98117,47.6923,-122.369,1390,5150,4520,3760,76.89320388349515,0.0420983606557377,Very Cheap
20140708T000000,210000.0,3,1.0,1070,8179,1.0,0,0,3,6,1070,0,1949,0,98146,47.5015,-122.349,1050,8177,7109,7127,25.675510453600683,0.017704918032786884,Very Cheap
20141001T000000,539000.0,2,1.75,1900,5175,1.0,0,0,3,7,1200,700,1919,0,98116,47.5689,-122.386,1370,5175,3275,3805,104.15458937198068,0.06085245901639344,Very Cheap
20140825T000000,605000.0,3,2.5,2960,18600,2.0,0,0,3,8,2960,0,1979,0,98166,47.4358,-122.344,2740,15681,15640,12941,32.526881720430104,0.06950819672131148,Very Cheap
20140707T000000,437500.0,3,2.0,1490,4800,2.0,0,0,5,6,1490,0,1948,0,98117,47.6933,-122.361,1500,4800,3310,3300,91.14583333333333,0.047540983606557376,Very Cheap
20140716T000000,215000.0,3,1.5,1500,15000,1.0,0,0,3,7,1500,0,1952,0,98031,47.3926,-122.208,1790,13905,13500,12115,14.333333333333334,0.018360655737704918,Very Cheap
20140618T000000,440000.0,4,2.5,2410,4780,2.0,0,0,3,7,2410,0,2000,0,98065,47.5326,-121.879,2410,4025,2370,1615,92.05020920502092,0.04786885245901639,Very Cheap
20141117T000000,525000.0,3,1.0,2000,22500,1.0,0,0,3,7,1680,320,1939,0,98125,47.711,-122.308,2000,10000,20500,8000,23.333333333333332,0.05901639344262295,Very Cheap
20140821T000000,319900.0,3,1.5,1140,20383,1.0,0,0,3,7,840,300,1985,0,98045,47.4755,-121.758,1200,15625,19243,14425,15.694451258401608,0.03211803278688525,Very Cheap
20150106T000000,335000.0,3,1.0,1120,9075,1.0,0,0,3,7,1120,0,1977,0,98077,47.7551,-122.072,1120,9705,7955,8585,36.91460055096419,0.03409836065573771,Very Cheap
20141107T000000,485000.0,3,2.25,2900,35273,2.0,0,0,3,9,2900,0,1986,0,98038,47.4013,-122.03,2510,38487,32373,35977,13.749893686389022,0.05377049180327869,Very Cheap
20140925T000000,359999.0,4,2.25,3220,7700,2.0,0,0,4,8,3220,0,1976,0,98023,47.3188,-122.38,2570,7700,4480,5130,46.75311688311688,0.037376918032786886,Very Cheap
20140807T000000,799000.0,5,2.75,2500,19783,1.0,0,3,4,8,2500,0,1959,0,98005,47.5938,-122.174,1700,15375,17283,13675,40.388212101299096,0.09495081967213115,Very Cheap
20140912T000000,280000.0,3,2.25,1610,10454,1.0,0,0,3,7,1610,0,1977,0,98148,47.4517,-122.331,1720,9583,8844,7863,26.784006122058543,0.026885245901639345,Very Cheap
20140708T000000,1050000.0,4,2.75,2250,3433,1.5,0,0,3,8,1500,750,1927,2013,98112,47.6382,-122.307,1970,3484,1183,1514,305.85493737256047,0.12786885245901639,Cheap
20141119T000000,290000.0,1,2.0,1240,4800,2.0,0,0,3,6,1240,0,1910,0,98055,47.4778,-122.211,1030,4800,3560,3770,60.416666666666664,0.02819672131147541,Very Cheap
20141217T000000,235000.0,2,2.25,1660,2748,2.0,0,0,3,7,1660,0,1995,0,98055,47.4333,-122.212,1620,3167,1088,1547,85.51673944687045,0.02098360655737705,Very Cheap
20141001T000000,495000.0,3,1.75,2080,3000,1.0,0,0,4,7,1040,1040,1925,0,98103,47.6853,-122.35,1000,3193,920,2193,165.0,0.05508196721311476,Very Cheap
20150224T000000,290000.0,3,2.25,1880,7488,2.0,0,0,3,8,1880,0,1980,0,98032,47.3631,-122.277,2180,7344,5608,5164,38.72863247863248,0.02819672131147541,Very Cheap
20141028T000000,230000.0,4,1.5,1050,9516,1.0,0,0,4,7,1050,0,1969,0,98031,47.4151,-122.181,1390,9600,8466,8210,24.169819251786464,0.020327868852459016,Very Cheap
20150220T000000,234000.0,3,1.75,1480,8475,1.0,0,0,4,7,1480,0,1968,0,98023,47.3126,-122.361,1800,8800,6995,7000,27.61061946902655,0.020852459016393442,Very Cheap
20141003T000000,597400.0,4,2.5,2420,4500,2.0,0,0,3,7,2420,0,2001,0,98053,47.6874,-122.037,2280,4500,2080,2220,132.75555555555556,0.06851147540983607,Very Cheap
20140805T000000,370000.0,4,2.5,2190,17600,1.0,0,0,4,7,1110,1080,1966,0,98059,47.4712,-122.112,1820,17600,15410,15780,21.022727272727273,0.038688524590163934,Very Cheap
20140519T000000,755000.0,4,2.5,2660,10452,2.0,0,0,3,9,2660,0,1993,0,98052,47.6972,-122.104,2890,9025,7792,6135,72.23497895139687,0.08918032786885247,Very Cheap
20150403T000000,342000.0,3,2.5,2430,5715,2.0,0,0,3,7,2430,0,1999,0,98030,47.3718,-122.168,3040,5702,3285,2662,59.84251968503937,0.03501639344262295,Very Cheap
20140728T000000,497000.0,2,1.0,770,3325,1.0,0,0,3,7,770,0,1918,0,98122,47.6102,-122.299,960,4800,2555,3840,149.47368421052633,0.055344262295081964,Very Cheap
20150429T000000,835000.0,3,1.0,3060,30166,1.0,0,0,5,8,3060,0,1959,0,98027,47.5656,-122.093,1880,19602,27106,17722,27.68016972750779,0.09967213114754099,Very Cheap
20141015T000000,730000.0,4,2.75,2920,4500,2.0,0,0,3,9,2920,0,1999,0,98006,47.5646,-122.124,2920,4505,1580,1585,162.22222222222223,0.0859016393442623,Very Cheap
20141001T000000,655000.0,3,1.0,1370,5250,1.0,0,0,3,7,1070,300,1939,0,98109,47.6421,-122.348,2410,4200,3880,1790,124.76190476190476,0.0760655737704918,Very Cheap
20141120T000000,205000.0,3,2.5,1870,3118,2.0,0,0,3,8,1870,0,1993,0,98038,47.3739,-122.056,1580,3601,1248,2021,65.7472738935215,0.017049180327868854,Very Cheap
20150407T000000,632750.0,4,2.0,1800,4800,1.5,0,0,3,7,1800,0,1918,0,98112,47.6388,-122.302,1950,4800,3000,2850,131.82291666666666,0.07314754098360655,Very Cheap
20140512T000000,330000.0,5,3.0,2100,7715,1.0,0,0,3,7,1250,850,2013,0,98168,47.4866,-122.319,2100,7959,5615,5859,42.77381723914452,0.03344262295081967,Very Cheap
20141007T000000,527500.0,5,2.25,2530,8250,2.0,0,0,4,7,2530,0,1961,0,98007,47.6117,-122.134,2020,8250,5720,6230,63.93939393939394,0.05934426229508197,Very Cheap
20140508T000000,716500.0,4,2.5,3290,6465,2.0,0,0,3,9,3290,0,2002,0,98075,47.5981,-121.976,3100,5929,3175,2829,110.8275328692962,0.08413114754098361,Very Cheap
20141217T000000,388500.0,4,2.5,1890,5395,2.0,0,0,3,7,1890,0,2006,0,98065,47.5415,-121.883,2060,5395,3505,3335,72.01112140871177,0.041114754098360656,Very Cheap
20140904T000000,530000.0,3,1.75,1680,7770,1.0,0,0,4,7,1680,0,1967,0,98005,47.6028,-122.167,1880,7770,6090,5890,68.21106821106821,0.05967213114754098,Very Cheap
20150108T000000,419000.0,3,2.5,2170,4517,2.0,0,0,3,8,2170,0,2002,0,98059,47.4819,-122.14,2610,4770,2347,2160,92.76068186849679,0.04511475409836065,Very Cheap
20150309T000000,385000.0,3,1.75,1200,7360,1.0,0,0,4,7,1200,0,1978,0,98052,47.6979,-122.13,1200,7500,6160,6300,52.30978260869565,0.04065573770491803,Very Cheap
20140528T000000,655000.0,4,2.5,2990,5669,2.0,0,0,3,8,2990,0,2003,0,98074,47.6119,-122.011,3110,5058,2679,1948,115.54065972834715,0.0760655737704918,Very Cheap
20140701T000000,1695000.0,4,2.75,3770,10900,2.0,0,2,5,9,3070,700,1924,0,98144,47.5849,-122.29,3000,5000,7130,2000,155.5045871559633,0.2124590163934426,Cheap
20140926T000000,279000.0,2,1.0,1020,47044,1.0,0,0,5,7,1020,0,1904,1958,98042,47.4206,-122.155,1930,12139,46024,10209,5.930618144715585,0.02675409836065574,Very Cheap
20150209T000000,262000.0,3,1.5,1700,9579,1.0,0,0,4,7,1100,600,1962,0,98023,47.3209,-122.338,1700,9628,7879,7928,27.35149806869193,0.024524590163934427,Very Cheap
20140807T000000,533000.0,4,1.0,1550,4750,1.5,0,0,3,7,1550,0,1919,0,98117,47.6824,-122.389,1320,4750,3200,3430,112.21052631578948,0.060065573770491806,Very Cheap
20150402T000000,640000.0,3,1.75,1680,8100,1.0,0,2,3,8,1680,0,1950,0,98177,47.7212,-122.364,1880,7750,6420,5870,79.01234567901234,0.0740983606557377,Very Cheap
20140609T000000,285000.0,3,2.25,1680,35127,2.0,0,0,3,7,1680,0,1987,0,98092,47.3025,-122.067,1820,35166,33447,33346,8.113417029635324,0.02754098360655738,Very Cheap
20140708T000000,458400.0,4,2.5,1910,10300,1.0,0,0,3,8,1910,0,1921,1968,98177,47.7581,-122.359,1910,7750,8390,5840,44.50485436893204,0.05028196721311475,Very Cheap
20150318T000000,620000.0,5,3.25,3160,10587,1.0,0,0,5,7,2190,970,1960,0,98034,47.7238,-122.165,2200,7761,7427,5561,58.5623878341362,0.07147540983606557,Very Cheap
20140512T000000,465000.0,3,1.5,2020,11358,1.0,0,0,4,6,1190,830,1956,0,98033,47.6641,-122.185,2370,9520,9338,7150,40.94030639197042,0.051147540983606556,Very Cheap
20140804T000000,690000.0,4,3.75,3210,7054,2.0,0,0,4,8,3210,0,1985,0,98052,47.7268,-122.103,2350,8020,3844,5670,97.81684150836405,0.08065573770491803,Very Cheap
20140821T000000,462500.0,3,2.25,2350,51400,1.0,0,0,3,7,1390,960,1977,0,98077,47.7417,-122.053,2350,51400,49050,49050,8.998054474708171,0.05081967213114754,Very Cheap
20140820T000000,369950.0,4,2.5,1910,10221,2.0,0,0,3,8,1910,0,1994,0,98038,47.381,-122.035,2210,8705,8311,6495,36.19508854319538,0.03868196721311475,Very Cheap
20150326T000000,124500.0,2,1.0,840,6480,1.0,0,0,4,5,840,0,1954,0,98001,47.264,-122.258,1100,7300,5640,6200,19.212962962962962,0.0064918032786885245,Very Cheap
20140806T000000,950000.0,4,2.25,2620,10920,1.0,0,0,3,9,2620,0,1965,0,98005,47.6117,-122.164,2370,11907,8300,9537,86.99633699633699,0.11475409836065574,Cheap
20140616T000000,418000.0,4,1.5,1220,10580,1.0,0,0,3,7,1220,0,1965,0,98008,47.6205,-122.116,1350,7800,9360,6450,39.50850661625709,0.04498360655737705,Very Cheap
20141210T000000,160000.0,3,1.0,1060,8000,1.0,0,0,4,6,1060,0,1927,0,98002,47.305,-122.218,1060,4697,6940,3637,20.0,0.011147540983606558,Very Cheap
20150415T000000,457000.0,4,2.5,2200,10800,1.0,0,0,3,8,1500,700,1964,0,98155,47.7711,-122.288,2280,10800,8600,8520,42.31481481481482,0.0500983606557377,Very Cheap
20150129T000000,530000.0,2,1.75,2120,7680,1.0,0,0,5,6,1130,990,1948,0,98126,47.5304,-122.374,1220,7680,5560,6460,69.01041666666667,0.05967213114754098,Very Cheap
20140522T000000,385000.0,3,1.0,1250,7300,1.0,0,0,4,7,1250,0,1956,0,98008,47.6032,-122.125,1540,7400,6050,5860,52.73972602739726,0.04065573770491803,Very Cheap
20150318T000000,491000.0,3,1.75,1440,7800,1.0,0,0,4,7,1440,0,1958,0,98008,47.5996,-122.12,1440,7800,6360,6360,62.94871794871795,0.05455737704918033,Very Cheap
20140820T000000,521000.0,4,2.25,1890,8034,1.0,0,0,4,8,1890,0,1967,0,98008,47.6338,-122.117,1920,7210,6144,5290,64.84939009210854,0.058491803278688526,Very Cheap
20150410T000000,255000.0,3,1.0,1140,8528,1.0,0,0,5,7,1140,0,1967,0,98022,47.2098,-122.004,1140,8112,7388,6972,29.901500938086304,0.02360655737704918,Very Cheap
20140527T000000,292050.0,5,3.0,2840,7199,1.0,0,0,3,7,1710,1130,2003,0,98178,47.5065,-122.275,2210,10800,4359,8590,40.568134463119875,0.028465573770491803,Very Cheap
20140520T000000,326000.0,6,3.0,1880,7200,1.0,0,0,4,7,1880,0,1966,0,98056,47.5029,-122.188,1540,13022,5320,11482,45.27777777777778,0.032918032786885244,Very Cheap
20140624T000000,300000.0,2,1.0,750,5120,1.0,0,0,4,6,750,0,1941,0,98126,47.5312,-122.375,930,7200,4370,6270,58.59375,0.029508196721311476,Very Cheap
20150430T000000,291600.0,3,1.75,1630,7480,1.0,0,0,3,7,1330,300,1979,0,98058,47.4514,-122.159,1940,7480,5850,5540,38.98395721925134,0.02840655737704918,Very Cheap
20150219T000000,435000.0,5,1.5,1720,12551,1.0,0,0,3,7,1720,0,1967,0,98027,47.5241,-122.053,1560,12960,10831,11400,34.65859294080153,0.04721311475409836,Very Cheap
20141218T000000,465000.0,3,2.5,1600,1311,3.0,0,0,3,8,1600,0,2005,0,98117,47.6903,-122.394,1390,1321,-289,-69,354.6910755148741,0.051147540983606556,Very Cheap
20140620T000000,200000.0,3,2.25,1230,7420,1.5,0,0,5,7,1230,0,1913,0,98002,47.3184,-122.22,1260,7556,6190,6296,26.954177897574123,0.01639344262295082,Very Cheap
20140717T000000,238000.0,3,1.5,1610,6132,1.0,0,2,4,7,1090,520,1959,0,98056,47.5017,-122.174,1650,6132,4522,4482,38.81278538812786,0.02137704918032787,Very Cheap
20141103T000000,455000.0,4,2.5,1320,7000,1.0,0,0,4,7,1320,0,1956,0,98008,47.6007,-122.127,1550,8610,5680,7060,65.0,0.049836065573770495,Very Cheap
20141030T000000,230000.0,6,3.0,2180,7220,2.0,0,0,3,7,2180,0,1980,0,98003,47.3046,-122.305,2260,7344,5040,5084,31.85595567867036,0.020327868852459016,Very Cheap
20140911T000000,808000.0,4,2.25,2190,4104,2.0,0,0,5,8,1410,780,1928,0,98112,47.6419,-122.306,1990,3860,1914,1870,196.88109161793372,0.0961311475409836,Very Cheap
20141217T000000,578500.0,3,1.0,1490,5700,1.5,0,0,3,7,1490,0,1916,0,98103,47.6549,-122.331,2290,5700,4210,3410,101.49122807017544,0.0660327868852459,Very Cheap
20140605T000000,390000.0,3,2.0,1463,868,3.0,0,0,3,7,1463,0,2003,0,98115,47.6843,-122.317,1484,4320,-595,2836,449.3087557603687,0.04131147540983607,Very Cheap
20150505T000000,517500.0,3,2.5,1800,3933,2.0,0,0,3,8,1800,0,1989,0,98029,47.5746,-122.009,1800,4659,2133,2859,131.57894736842104,0.0580327868852459,Very Cheap
20140626T000000,755000.0,4,2.75,2880,4000,1.5,0,0,3,9,2100,780,1912,2000,98144,47.5843,-122.293,2110,4000,1120,1890,188.75,0.08918032786885247,Very Cheap
20141030T000000,579500.0,3,1.75,1250,4120,1.0,0,0,4,7,980,270,1925,0,98117,47.685,-122.36,1250,4120,2870,2870,140.65533980582524,0.0661639344262295,Very Cheap
20140929T000000,649950.0,3,2.75,1670,1350,3.0,0,0,3,9,1350,320,2014,0,98116,47.5764,-122.408,1520,4800,-320,3280,481.44444444444446,0.07540327868852459,Very Cheap
20140508T000000,228000.0,4,1.75,2000,6120,1.0,0,0,3,7,1100,900,1965,0,98178,47.5035,-122.258,1880,6120,4120,4240,37.254901960784316,0.020065573770491802,Very Cheap
20141202T000000,665000.0,4,1.75,2280,3680,1.5,0,0,5,7,1470,810,1926,0,98115,47.6754,-122.3,1850,3680,1400,1830,180.70652173913044,0.07737704918032787,Very Cheap
20150325T000000,689000.0,4,2.5,2110,6069,2.0,0,0,3,9,2110,0,1999,0,98052,47.6374,-122.111,2180,9000,3959,6820,113.52776404679518,0.08052459016393443,Very Cheap
20141022T000000,560000.0,4,2.5,2520,11240,1.0,0,0,3,8,1440,1080,1977,0,98052,47.6748,-122.144,2360,10345,8720,7985,49.8220640569395,0.06360655737704918,Very Cheap
20140529T000000,529000.0,3,1.0,1590,6420,1.0,0,0,3,7,1590,0,1944,0,98136,47.5355,-122.392,1780,5900,4830,4120,82.398753894081,0.05954098360655738,Very Cheap
20150108T000000,375000.0,5,2.5,2100,14858,1.0,0,0,5,8,2100,0,1970,0,98059,47.4721,-122.123,1980,11730,12758,9750,25.23892852335442,0.03934426229508197,Very Cheap
20140923T000000,325000.0,4,2.75,2090,9240,1.0,0,0,4,6,2090,0,1949,0,98146,47.4854,-122.343,1460,9240,7150,7780,35.17316017316017,0.03278688524590164,Very Cheap
20150115T000000,583000.0,4,2.5,3390,10519,2.0,0,2,3,10,3390,0,1990,0,98003,47.332,-122.334,2830,10519,7129,7689,55.42351934594543,0.06662295081967214,Very Cheap
20150429T000000,330000.0,2,1.0,790,9784,1.0,0,0,3,6,790,0,1932,0,98155,47.7634,-122.284,2350,10102,8994,7752,33.72853638593622,0.03344262295081967,Very Cheap
20150417T000000,262000.0,3,2.5,1970,8727,2.0,0,0,3,7,1970,0,1995,0,98092,47.3263,-122.189,1670,9168,6757,7498,30.021771513693135,0.024524590163934427,Very Cheap
20150313T000000,555000.0,4,2.5,2870,6776,2.0,0,0,3,8,2870,0,2004,0,98065,47.539,-121.878,2770,6658,3906,3888,81.90672963400236,0.06295081967213115,Very Cheap
20150302T000000,585000.0,2,1.0,1110,6000,1.0,0,0,3,7,1010,100,1951,0,98118,47.5632,-122.282,1410,3500,4890,2090,97.5,0.06688524590163934,Very Cheap
20150227T000000,425590.0,3,2.75,1940,3088,2.0,0,3,3,8,1770,170,2008,0,98065,47.5185,-121.878,1410,2335,1148,925,137.8205958549223,0.04597901639344262,Very Cheap
20140603T000000,235000.0,2,1.0,720,4840,1.0,0,0,4,6,720,0,1947,0,98126,47.5534,-122.375,1510,4840,4120,3330,48.553719008264466,0.02098360655737705,Very Cheap
20140724T000000,362362.0,2,1.0,710,4000,1.0,0,0,3,6,710,0,1909,0,98118,47.5535,-122.269,960,4000,3290,3040,90.5905,0.037686819672131146,Very Cheap
20150204T000000,252000.0,3,2.0,1370,7500,1.0,0,0,3,7,1370,0,1997,0,98038,47.3634,-122.046,1420,7500,6130,6080,33.6,0.02321311475409836,Very Cheap
20141224T000000,439000.0,4,2.5,2690,9551,2.0,0,0,3,9,2690,0,1992,0,98058,47.4343,-122.156,2890,9121,6861,6231,45.9637734268663,0.04773770491803279,Very Cheap
20140812T000000,465000.0,4,2.25,3360,10810,2.0,0,0,4,9,3360,0,1988,0,98092,47.3316,-122.203,2590,10810,7450,8220,43.015726179463456,0.051147540983606556,Very Cheap
20141003T000000,249900.0,4,2.0,1500,7854,1.5,0,0,3,7,1500,0,1983,0,98023,47.3127,-122.354,1500,7334,6354,5834,31.818181818181817,0.02293770491803279,Very Cheap
20140718T000000,665000.0,2,2.5,2600,5000,1.0,0,0,5,8,1300,1300,1926,0,98126,47.5806,-122.379,2260,5000,2400,2740,133.0,0.07737704918032787,Very Cheap
20141014T000000,370000.0,3,1.75,1160,8774,1.0,0,0,3,7,1160,0,1972,0,98034,47.7159,-122.165,1990,7908,7614,5918,42.17004786870299,0.038688524590163934,Very Cheap
20140612T000000,620000.0,2,1.0,1430,3000,1.5,0,0,3,7,1300,130,1929,0,98112,47.6415,-122.303,1750,4000,1570,2250,206.66666666666666,0.07147540983606557,Very Cheap
20140724T000000,375000.0,3,1.0,1870,7671,1.0,0,0,4,8,1720,150,1937,0,98177,47.7162,-122.36,1460,7679,5801,6219,48.88541259288228,0.03934426229508197,Very Cheap
20140827T000000,552625.0,4,2.0,2560,9390,1.0,0,0,5,8,1280,1280,1957,0,98133,47.7169,-122.329,1830,8169,6830,6339,58.85250266240681,0.06263934426229509,Very Cheap
20140930T000000,315500.0,3,1.0,1160,10500,1.0,0,0,4,7,1160,0,1966,0,98034,47.7267,-122.227,1520,10500,9340,8980,30.047619047619047,0.031540983606557375,Very Cheap
20140919T000000,620000.0,2,1.75,1680,8187,1.0,0,0,4,8,1680,0,1983,0,98027,47.5603,-122.081,2390,7801,6507,5411,75.72981556125565,0.07147540983606557,Very Cheap
20141125T000000,510000.0,4,2.5,2010,9075,1.0,0,0,4,8,1310,700,1959,0,98006,47.553,-122.182,1850,9220,7065,7370,56.19834710743802,0.057049180327868855,Very Cheap
20140627T000000,652500.0,4,2.5,2540,38677,2.0,0,0,3,9,2540,0,1987,0,98053,47.6694,-122.044,2560,36280,36137,33720,16.870491506580137,0.07573770491803279,Very Cheap
20141114T000000,574000.0,4,2.5,3240,22795,2.0,0,0,3,8,3240,0,1998,0,98053,47.6329,-121.969,2570,29761,19555,27191,25.18096073700373,0.06544262295081968,Very Cheap
20150224T000000,430000.0,3,2.5,2670,12806,2.0,0,0,3,9,2670,0,2010,0,98038,47.3686,-122.059,3010,7231,10136,4221,33.57801030766828,0.04655737704918033,Very Cheap
20140603T000000,390000.0,3,2.0,1080,7236,1.0,0,0,5,7,1080,0,1947,0,98125,47.7143,-122.32,1120,8008,6156,6888,53.89718076285241,0.04131147540983607,Very Cheap
20140605T000000,466500.0,3,1.0,1430,3840,1.0,0,0,3,7,950,480,1945,0,98117,47.6847,-122.381,1430,3840,2410,2410,121.484375,0.05134426229508197,Very Cheap
20141028T000000,315000.0,2,2.25,1290,2436,2.0,0,0,3,7,1290,0,1984,0,98052,47.6803,-122.156,1360,3088,1146,1728,129.31034482758622,0.031475409836065574,Very Cheap
20140505T000000,220000.0,4,1.5,1240,9600,1.0,0,0,3,7,1240,0,1971,0,98023,47.3206,-122.397,1240,9592,8360,8352,22.916666666666668,0.01901639344262295,Very Cheap
20150306T000000,325000.0,3,1.75,1840,17286,1.0,0,0,4,7,1440,400,1978,0,98030,47.371,-122.173,1840,14541,15446,12701,18.80134212657642,0.03278688524590164,Very Cheap
20150428T000000,365000.0,3,1.0,1120,8443,1.0,0,0,3,7,1120,0,1953,0,98133,47.7715,-122.336,1450,8433,7323,6983,43.23107900035532,0.0380327868852459,Very Cheap
20140514T000000,356000.0,3,3.5,2100,12384,2.0,0,0,3,9,2100,0,1980,0,98188,47.4687,-122.263,2400,7776,10284,5376,28.746770025839794,0.03685245901639344,Very Cheap
20140923T000000,380000.0,4,1.75,2030,12518,1.0,0,0,3,8,1610,420,1950,0,98125,47.7278,-122.297,1650,7872,10488,6222,30.35628694679661,0.04,Very Cheap
20140713T000000,579000.0,4,2.25,2030,8764,2.0,0,0,4,8,2030,0,1983,0,98052,47.7214,-122.11,1950,8750,6734,6800,66.06572341396623,0.06609836065573771,Very Cheap
20150501T000000,682000.0,2,1.0,890,5000,1.0,0,0,3,7,890,0,1943,0,98105,47.6666,-122.279,1680,5000,4110,3320,136.4,0.07960655737704918,Very Cheap
20140616T000000,499000.0,3,1.75,1750,12325,1.0,0,0,4,7,1470,280,1968,0,98052,47.6832,-122.118,1820,9750,10575,7930,40.4868154158215,0.05560655737704918,Very Cheap
20150423T000000,333760.0,3,1.0,1300,5880,1.0,0,0,3,7,1300,0,1968,0,98052,47.6937,-122.113,1300,7700,4580,6400,56.76190476190476,0.033935737704918034,Very Cheap
20140910T000000,745000.0,4,2.5,2650,18903,2.0,0,0,3,11,2650,0,1994,0,98075,47.5761,-121.989,3270,18843,16253,15573,39.41173358726128,0.08786885245901639,Very Cheap
20140722T000000,380000.0,3,1.75,1750,10870,1.0,0,0,5,7,1750,0,1968,0,98056,47.4989,-122.188,1230,10868,9120,9638,34.95860165593376,0.04,Very Cheap
20140801T000000,435000.0,3,3.0,1440,1350,3.5,0,2,3,8,1440,0,2005,0,98103,47.6525,-122.345,1440,1350,-90,-90,322.22222222222223,0.04721311475409836,Very Cheap
20150120T000000,520000.0,3,2.75,1700,3264,1.0,0,0,3,7,1060,640,1919,0,98115,47.6767,-122.311,1880,4080,1564,2200,159.31372549019608,0.058360655737704915,Very Cheap
20150427T000000,965000.0,4,2.5,3920,41206,2.0,0,0,4,10,3920,0,1988,0,98072,47.7325,-122.132,3780,36562,37286,32782,23.418919574819203,0.11672131147540983,Cheap
20140808T000000,270000.0,3,2.25,1470,16728,1.0,0,0,4,7,1350,120,1959,0,98168,47.4968,-122.302,1540,9000,15258,7460,16.140602582496413,0.025573770491803278,Very Cheap
20150313T000000,1100000.0,5,2.75,2520,4643,1.5,0,0,4,8,2120,400,1916,0,98112,47.6348,-122.301,2100,4564,2123,2464,236.9157872065475,0.13442622950819672,Cheap
20141008T000000,577500.0,3,1.75,2140,13286,1.0,0,0,4,8,1220,920,1964,0,98006,47.5722,-122.128,2250,13286,11146,11036,43.4668071654373,0.0659016393442623,Very Cheap
20140728T000000,650000.0,3,1.75,1550,5000,1.0,0,0,3,7,1250,300,1911,2011,98107,47.6722,-122.372,1110,5000,3450,3890,130.0,0.07540983606557378,Very Cheap
20141205T000000,1227500.0,4,2.5,3180,10319,2.0,0,0,4,11,3180,0,1986,0,98040,47.5372,-122.232,3130,12120,7139,8990,118.95532512840391,0.15114754098360655,Cheap
20140912T000000,1900000.0,5,4.25,6510,16471,2.0,0,3,4,11,3250,3260,1980,0,98040,47.5758,-122.242,4480,16471,9961,11991,115.35425900066784,0.23934426229508196,Cheap
20140721T000000,475000.0,2,2.0,1440,3720,1.5,0,0,3,7,1440,0,1983,0,98115,47.6902,-122.325,1490,4308,2280,2818,127.68817204301075,0.05245901639344262,Very Cheap
20150330T000000,200000.0,3,1.0,1150,10132,1.0,0,0,4,7,1150,0,1970,0,98023,47.3172,-122.372,1180,8713,8982,7533,19.739439399921043,0.01639344262295082,Very Cheap
20140620T000000,397000.0,4,2.5,2320,11717,2.0,0,0,3,8,2320,0,1997,0,98045,47.484,-121.78,2320,9714,9397,7394,33.88239310403687,0.04222950819672131,Very Cheap
20150219T000000,383610.0,3,2.0,1230,8450,1.0,0,0,3,7,1230,0,1989,0,98155,47.7548,-122.305,2110,8536,7220,6426,45.397633136094676,0.04047344262295082,Very Cheap
20140728T000000,275000.0,4,2.5,2060,5742,2.0,0,0,3,7,2060,0,1999,0,98030,47.3612,-122.185,1610,7298,3682,5688,47.89272030651341,0.02622950819672131,Very Cheap
20140709T000000,840000.0,3,2.0,2783,11177,2.0,0,0,3,8,2783,0,1910,1999,98126,47.538,-122.38,1730,8018,8394,6288,75.15433479466762,0.10032786885245902,Cheap
20140918T000000,365000.0,4,2.5,2140,7350,2.0,0,0,3,8,2140,0,1985,0,98058,47.4483,-122.124,2120,8395,5210,6275,49.65986394557823,0.0380327868852459,Very Cheap
20140904T000000,362000.0,3,2.75,1420,955,2.0,0,0,3,8,1160,260,2004,0,98029,47.5477,-122.003,1420,955,-465,-465,379.05759162303667,0.03763934426229508,Very Cheap
20141101T000000,350000.0,3,1.75,2090,6258,1.0,0,0,3,7,1390,700,1956,0,98108,47.5503,-122.301,1790,5793,4168,4003,55.92841163310962,0.036065573770491806,Very Cheap
20141111T000000,200000.0,2,1.75,1320,13052,1.5,0,0,3,7,1320,0,1980,0,98014,47.712,-121.352,1320,13052,11732,11732,15.323322096230463,0.01639344262295082,Very Cheap
20150506T000000,299000.0,4,2.5,2300,8100,1.0,0,0,4,8,1360,940,1979,0,98023,47.2979,-122.371,1910,7630,5800,5720,36.91358024691358,0.02937704918032787,Very Cheap
20141007T000000,555000.0,4,1.5,3050,82764,1.0,0,0,3,8,1650,1400,1966,0,98056,47.5266,-122.189,2930,10074,79714,7144,6.705814122082065,0.06295081967213115,Very Cheap
20150225T000000,1326000.0,3,2.25,2960,8330,1.0,0,3,4,10,2260,700,1953,0,98177,47.7035,-122.385,2960,8840,5370,5880,159.18367346938774,0.1640655737704918,Cheap
20140630T000000,896000.0,5,2.75,2520,16100,1.0,0,3,4,8,1570,950,1960,0,98040,47.528,-122.224,2760,16988,13580,14228,55.65217391304348,0.10767213114754098,Cheap
20141217T000000,550000.0,2,1.75,1740,7290,1.0,0,0,3,8,1280,460,1950,0,98199,47.6461,-122.397,1820,6174,5550,4354,75.44581618655693,0.06229508196721312,Very Cheap
20150508T000000,324500.0,2,1.0,1300,6617,1.0,0,0,3,7,1300,0,1986,0,98125,47.7238,-122.302,1820,7800,5317,5980,49.04035061205985,0.03272131147540984,Very Cheap
20150105T000000,312500.0,3,1.0,1170,7350,1.0,0,0,4,7,1170,0,1960,0,98008,47.625,-122.117,1170,7350,6180,6180,42.51700680272109,0.03114754098360656,Very Cheap
20150414T000000,485000.0,4,3.25,1946,17786,2.0,0,1,4,7,1946,0,1990,0,98070,47.359,-122.452,1460,16661,15840,15201,27.26863825480715,0.05377049180327869,Very Cheap
20141020T000000,511000.0,2,1.0,1250,5413,1.0,0,0,4,7,1250,0,1923,0,98115,47.6945,-122.315,1250,5413,4163,4163,94.40236467762793,0.05718032786885246,Very Cheap
20150324T000000,139500.0,2,1.5,1230,1561,2.0,0,0,3,7,1230,0,1983,0,98042,47.3768,-122.149,1660,2243,331,583,89.36579115951314,0.008459016393442624,Very Cheap
20140611T000000,464000.0,4,2.5,2180,7203,2.0,0,0,4,8,2180,0,1989,0,98059,47.5119,-122.151,2350,7334,5023,4984,64.41760377620436,0.05101639344262295,Very Cheap
20150429T000000,255000.0,3,1.75,1740,8800,1.0,0,0,3,7,1140,600,1978,0,98023,47.2968,-122.372,1690,7920,7060,6230,28.977272727272727,0.02360655737704918,Very Cheap
20150417T000000,679975.0,4,2.5,3830,4644,2.0,0,0,3,8,2900,930,2004,0,98065,47.5384,-121.88,3400,6163,814,2763,146.42011197243755,0.07934098360655738,Very Cheap
20140709T000000,624800.0,3,2.0,2250,14274,1.0,0,0,4,8,1500,750,1964,0,98040,47.5762,-122.217,2820,13813,12024,10993,43.771892952220824,0.07210491803278689,Very Cheap
20141120T000000,920000.0,3,2.75,2590,223027,2.0,0,0,3,9,2590,0,1983,0,98074,47.6145,-122.001,3410,212137,220437,208727,4.125061091258009,0.11081967213114755,Cheap
20140530T000000,1365000.0,3,2.5,2090,6000,1.5,0,0,4,9,2090,0,1928,0,98105,47.6567,-122.281,2730,6000,3910,3270,227.5,0.16918032786885245,Cheap
20141212T000000,510000.0,3,1.5,2400,10275,1.0,0,0,4,8,1540,860,1964,0,98052,47.6888,-122.126,2380,10125,7875,7745,49.63503649635037,0.057049180327868855,Very Cheap
20140626T000000,289659.0,4,2.25,2260,7200,2.0,0,0,4,7,2260,0,1984,0,98031,47.4121,-122.183,1720,7200,4940,5480,40.23041666666666,0.028152,Very Cheap
20150424T000000,585000.0,4,2.5,2910,6250,2.0,0,0,3,8,2910,0,1999,0,98065,47.538,-121.87,2550,6250,3340,3700,93.6,0.06688524590163934,Very Cheap
20140626T000000,555000.0,5,3.0,3640,6930,2.0,0,0,3,8,3640,0,2004,0,98038,47.3521,-122.012,3740,7182,3290,3442,80.08658008658008,0.06295081967213115,Very Cheap
20150313T000000,940000.0,4,2.75,3770,24897,2.0,0,2,4,8,2550,1220,1964,0,98075,47.5824,-122.078,2640,11502,21127,8862,37.75555287785677,0.11344262295081967,Cheap
20140909T000000,460000.0,3,2.0,1600,7350,1.0,0,0,4,7,1600,0,1979,0,98052,47.6977,-122.126,1600,7200,5750,5600,62.585034013605444,0.050491803278688525,Very Cheap
20141121T000000,319000.0,3,2.5,2110,7434,2.0,0,0,4,7,2110,0,1978,0,98031,47.3935,-122.169,2100,7749,5324,5649,42.91094969061071,0.032,Very Cheap
20140519T000000,280000.0,3,2.5,1720,1916,2.0,0,0,3,7,1720,0,2005,0,98059,47.4895,-122.166,1760,1916,196,156,146.13778705636744,0.026885245901639345,Very Cheap
20141118T000000,250000.0,3,1.0,1100,7470,1.0,0,0,4,5,1100,0,1917,0,98065,47.5242,-121.831,1280,7055,6370,5775,33.467202141900934,0.022950819672131147,Very Cheap
20150116T000000,749950.0,4,2.5,2620,8312,2.0,0,0,3,9,2620,0,1990,0,98074,47.6272,-122.033,2260,8515,5692,6255,90.22497593840231,0.08851803278688525,Very Cheap
20140530T000000,458000.0,5,2.5,3090,23265,1.0,0,0,3,8,2990,100,1957,0,98011,47.7709,-122.212,2560,18773,20175,16213,19.68622394154309,0.05022950819672131,Very Cheap
20150402T000000,465000.0,3,2.5,1890,4808,2.0,0,0,3,8,1890,0,2000,0,98065,47.5348,-121.866,2460,5348,2918,2888,96.71381031613977,0.051147540983606556,Very Cheap
20150413T000000,580000.0,3,1.75,1850,2797,1.0,0,0,3,8,1150,700,1977,0,98103,47.6871,-122.336,1450,4599,947,3149,207.36503396496246,0.06622950819672131,Very Cheap
20140806T000000,700000.0,4,2.5,3100,36562,2.0,0,0,3,10,3100,0,1994,0,98077,47.7646,-122.065,3080,39351,33462,36271,19.145560964936273,0.08196721311475409,Very Cheap
20141110T000000,350000.0,4,2.5,2506,7206,2.0,0,0,3,8,2506,0,2007,0,98023,47.3236,-122.337,2441,7220,4700,4779,48.5706355814599,0.036065573770491806,Very Cheap
20140905T000000,456000.0,4,1.0,1700,7689,1.0,0,0,3,7,1080,620,1977,0,98052,47.6955,-122.116,1700,7333,5989,5633,59.305501365587205,0.0499672131147541,Very Cheap
20150218T000000,290000.0,3,2.0,1550,18958,1.5,0,0,3,7,1550,0,1983,0,98198,47.3699,-122.319,1840,12826,17408,10986,15.296972254457222,0.02819672131147541,Very Cheap
20140711T000000,475000.0,4,2.75,2200,16288,1.0,0,0,3,7,1290,910,1980,0,98059,47.4793,-122.122,2650,6620,14088,3970,29.162573673870334,0.05245901639344262,Very Cheap
20140908T000000,285000.0,3,2.5,1890,3629,2.0,0,0,3,7,1890,0,2005,0,98038,47.3613,-122.041,1980,4000,1739,2020,78.53403141361257,0.02754098360655738,Very Cheap
20150227T000000,309000.0,3,1.0,1140,6400,1.0,0,0,3,7,1140,0,1962,0,98168,47.4902,-122.331,1340,6650,5260,5310,48.28125,0.030688524590163933,Very Cheap
20140506T000000,860000.0,4,2.0,3740,32417,2.0,0,0,3,9,3740,0,2000,0,98053,47.6728,-122.012,3180,32417,28677,29237,26.529290187247433,0.10295081967213114,Cheap
20150226T000000,219000.0,3,2.25,1940,6500,1.0,0,0,3,8,1440,500,1979,0,98042,47.3565,-122.149,1880,8991,4560,7111,33.69230769230769,0.018885245901639345,Very Cheap
20141009T000000,546500.0,3,2.5,2130,7199,2.0,0,0,3,8,2130,0,1990,0,98074,47.6331,-122.027,1890,7546,5069,5656,75.91332129462425,0.06183606557377049,Very Cheap
20150213T000000,338000.0,2,1.0,1470,5566,1.0,0,0,4,7,770,700,1919,0,98118,47.5348,-122.269,1410,5808,4096,4398,60.72583542939274,0.034491803278688525,Very Cheap
20150311T000000,505000.0,2,1.0,1070,8130,1.0,0,0,3,7,1070,0,1942,0,98117,47.697,-122.37,1360,7653,7060,6293,62.11562115621156,0.05639344262295082,Very Cheap
20141002T000000,340000.0,4,1.75,1680,15084,1.0,0,0,4,7,840,840,1979,0,98014,47.6895,-121.912,1800,15092,13404,13292,22.540440201538054,0.03475409836065574,Very Cheap
20140822T000000,678000.0,3,2.25,2730,10675,2.0,0,0,3,9,2730,0,1990,0,98074,47.6289,-122.042,2770,10570,7945,7800,63.51288056206089,0.07908196721311475,Very Cheap
20141208T000000,800000.0,3,1.75,1890,10292,1.0,0,0,4,8,1890,0,1969,0,98040,47.535,-122.234,2630,10625,8402,7995,77.7302759424796,0.09508196721311475,Very Cheap
20140725T000000,112000.0,1,1.0,1080,3230,1.0,0,0,3,6,1080,0,1963,0,98002,47.3075,-122.217,1210,5760,2150,4550,34.6749226006192,0.004852459016393443,Very Cheap
20150310T000000,252000.0,3,1.75,1440,16819,1.5,0,0,4,6,1440,0,1925,0,98023,47.3318,-122.373,1560,12376,15379,10816,14.98305487841132,0.02321311475409836,Very Cheap
20140604T000000,335000.0,4,2.75,2540,7210,1.0,0,0,4,7,1600,940,1979,0,98058,47.4601,-122.165,1820,7766,4670,5946,46.463245492371705,0.03409836065573771,Very Cheap
20140703T000000,610000.0,3,2.0,2300,13418,1.0,0,0,3,8,1430,870,1955,0,98004,47.6075,-122.2,2140,9380,11118,7240,45.461320614100465,0.07016393442622951,Very Cheap
20141028T000000,245000.0,3,2.0,1690,6790,1.0,0,0,3,7,1360,330,1979,0,98023,47.2981,-122.38,1740,6790,5100,5050,36.08247422680412,0.022295081967213116,Very Cheap
20150205T000000,493500.0,3,1.75,1800,16026,1.0,0,0,3,8,1390,410,1972,0,98008,47.5815,-122.121,2210,13959,14226,11749,30.793710220891054,0.054885245901639346,Very Cheap
20150107T000000,596500.0,4,2.25,1770,8505,2.0,0,0,3,8,1770,0,1986,0,98052,47.6904,-122.102,1880,8939,6735,7059,70.13521457965902,0.06839344262295081,Very Cheap
20140701T000000,245000.0,3,2.0,1190,4072,1.5,0,0,5,6,1190,0,1907,0,98118,47.5276,-122.274,1680,5850,2882,4170,60.16699410609037,0.022295081967213116,Very Cheap
20141027T000000,333500.0,3,1.75,1320,7200,1.0,0,0,4,7,1320,0,1977,0,98028,47.7341,-122.237,1750,7260,5880,5510,46.31944444444444,0.033901639344262297,Very Cheap
20141110T000000,373000.0,3,1.0,1290,8974,1.0,0,0,5,7,1290,0,1976,0,98072,47.74,-122.173,1540,7500,7684,5960,41.564519723646086,0.03908196721311476,Very Cheap
20140724T000000,759900.0,4,2.5,3000,5639,2.0,0,0,3,8,3000,0,2008,0,98052,47.7066,-122.115,3000,4587,2639,1587,134.7579358042206,0.08982295081967213,Very Cheap
20140826T000000,317000.0,3,2.25,1358,1204,3.0,0,0,3,7,1358,0,2007,0,98133,47.7054,-122.346,1358,1196,-154,-162,263.2890365448505,0.03173770491803279,Very Cheap
20150512T000000,670000.0,3,1.5,1220,4080,1.5,0,0,5,7,1220,0,1914,0,98144,47.5746,-122.289,1320,4080,2860,2760,164.2156862745098,0.0780327868852459,Very Cheap
20141106T000000,985000.0,2,2.5,2720,26761,2.0,1,4,3,7,2720,0,1990,0,98166,47.4499,-122.376,1870,12396,24041,10526,36.8072941967789,0.11934426229508197,Cheap
20150430T000000,310000.0,3,1.5,1060,6954,1.0,0,0,4,6,1060,0,1983,0,98106,47.5497,-122.355,1560,6372,5894,4812,44.57865976416451,0.03081967213114754,Very Cheap
20141015T000000,750000.0,4,2.5,3020,13122,2.0,0,0,3,9,2540,480,1997,0,98052,47.6989,-122.111,3020,10873,10102,7853,57.155921353452214,0.08852459016393442,Very Cheap
20140721T000000,408000.0,3,2.0,1640,3440,2.0,0,0,3,7,1640,0,1987,0,98052,47.6829,-122.097,1070,3549,1800,2479,118.6046511627907,0.04367213114754098,Very Cheap
20140617T000000,900000.0,5,3.75,3870,8225,2.0,0,0,3,10,3870,0,1998,0,98074,47.6078,-122.01,3600,9361,4355,5761,109.4224924012158,0.10819672131147541,Cheap
20150123T000000,460000.0,4,2.25,2860,15054,1.0,0,0,3,8,1460,1400,1957,0,98155,47.7655,-122.3,1730,18525,12194,16795,30.556662681015013,0.050491803278688525,Very Cheap
20150317T000000,339000.0,4,2.5,1740,6000,1.0,0,0,4,7,1740,0,1952,0,98178,47.5026,-122.236,1190,6000,4260,4810,56.5,0.03462295081967213,Very Cheap
20150413T000000,660000.0,3,2.0,1140,6000,1.0,0,0,3,7,1140,0,1909,0,98109,47.637,-122.355,1260,4000,4860,2740,110.0,0.07672131147540984,Very Cheap
20150422T000000,449950.0,4,3.0,3290,10783,2.0,0,0,3,9,3290,0,1990,0,98031,47.3904,-122.178,2810,10783,7493,7973,41.72771955856441,0.04917377049180328,Very Cheap
20140825T000000,235000.0,3,1.0,1210,6000,1.0,0,0,3,7,1210,0,1930,0,98178,47.4984,-122.224,1210,6000,4790,4790,39.166666666666664,0.02098360655737705,Very Cheap
20150113T000000,769000.0,5,2.25,3320,13138,1.0,0,2,4,9,1900,1420,1964,0,98028,47.759,-122.269,2820,13138,9818,10318,58.53250114172629,0.09101639344262295,Very Cheap
20140507T000000,428000.0,2,2.0,1350,3900,1.0,0,0,3,8,1350,0,2003,0,98053,47.7094,-122.03,1440,3900,2550,2460,109.74358974358974,0.04629508196721312,Very Cheap
20140516T000000,445000.0,3,2.25,1990,7340,2.0,0,0,3,8,1990,0,1984,0,98072,47.7579,-122.141,2180,11223,5350,9043,60.6267029972752,0.04852459016393443,Very Cheap
20150321T000000,462000.0,4,2.5,2060,6958,1.0,0,0,3,7,1220,840,1974,0,98034,47.7251,-122.168,1760,7350,4898,5590,66.39839034205231,0.05075409836065574,Very Cheap
20150506T000000,775000.0,3,1.0,1460,6198,1.5,0,0,4,7,1460,0,1916,0,98107,47.6626,-122.361,2280,5160,4738,2880,125.0403355921265,0.09180327868852459,Very Cheap
20141201T000000,605000.0,4,1.75,2250,10108,1.0,0,0,4,8,2250,0,1967,0,98008,47.5922,-122.118,2050,9750,7858,7700,59.853581321725365,0.06950819672131148,Very Cheap
20141016T000000,193500.0,2,1.0,950,15996,1.0,0,0,4,7,950,0,1946,1995,98045,47.4987,-121.787,950,25510,15046,24560,12.096774193548388,0.015540983606557377,Very Cheap
20140522T000000,389950.0,4,2.5,3140,8060,2.0,0,0,3,9,3140,0,1991,0,98023,47.3091,-122.343,3000,8060,4920,5060,48.38089330024814,0.04130491803278689,Very Cheap
20140711T000000,790000.0,4,3.5,3560,6098,2.0,0,0,3,10,3560,0,2006,0,98075,47.5828,-121.972,3660,6846,2538,3186,129.5506723515907,0.09377049180327869,Very Cheap
20150130T000000,442000.0,2,1.0,1410,5000,1.0,0,2,4,7,940,470,1918,0,98126,47.5531,-122.379,1450,5000,3590,3550,88.4,0.048131147540983604,Very Cheap
20140613T000000,890000.0,4,2.25,2770,13500,2.0,0,0,3,8,2770,0,1974,0,98040,47.543,-122.231,2300,13500,10730,11200,65.92592592592592,0.10688524590163935,Cheap
20150319T000000,235000.0,3,1.0,1864,6978,1.0,0,0,4,7,1864,0,1958,0,98002,47.285,-122.206,990,8000,5114,7010,33.67727142447693,0.02098360655737705,Very Cheap
20141217T000000,495000.0,4,1.75,1930,6720,1.0,0,2,3,8,1130,800,1959,0,98115,47.6935,-122.312,1850,6380,4790,4530,73.66071428571429,0.05508196721311476,Very Cheap
20150105T000000,600000.0,4,2.5,3870,50965,2.0,0,0,3,10,3870,0,2007,0,98010,47.3109,-122.045,2170,65843,47095,63673,11.772785244775827,0.06885245901639345,Very Cheap
20140618T000000,1400000.0,3,2.0,2020,5500,1.5,0,3,3,10,1790,230,1937,0,98199,47.6388,-122.409,2580,5500,3480,2920,254.54545454545453,0.1737704918032787,Cheap
20140826T000000,251000.0,3,2.0,1300,8400,1.0,0,0,4,7,1300,0,1967,0,98198,47.368,-122.315,1300,7500,7100,6200,29.88095238095238,0.023081967213114753,Very Cheap
20150326T000000,471000.0,4,2.25,3410,57063,2.0,0,0,4,8,2410,1000,1978,0,98059,47.505,-122.11,2870,145490,53653,142620,8.25403501393197,0.051934426229508196,Very Cheap
20150323T000000,597000.0,4,2.5,2370,41338,2.0,0,0,3,8,2370,0,1995,0,98077,47.7379,-122.052,2340,46661,38968,44321,14.441917847984906,0.06845901639344262,Very Cheap
20140923T000000,804000.0,5,3.5,2770,9305,2.0,0,0,3,9,2770,0,1985,0,98006,47.5628,-122.114,2520,9773,6535,7253,86.40515851692638,0.09560655737704918,Very Cheap
20141013T000000,357000.0,3,1.75,1250,17493,1.0,0,0,3,7,1250,0,1972,0,98155,47.7613,-122.274,2180,19553,16243,17373,20.408163265306122,0.03698360655737705,Very Cheap
20140821T000000,419990.0,3,2.5,1690,1689,2.0,0,0,3,8,1150,540,2014,0,98029,47.5528,-121.999,1540,1689,-1,149,248.66193013617524,0.04524459016393442,Very Cheap
20141110T000000,725000.0,4,2.5,3040,35201,2.0,0,0,4,10,3040,0,1987,0,98027,47.4872,-122.066,2990,35416,32161,32426,20.596005795289905,0.08524590163934426,Very Cheap
20150209T000000,275000.0,3,2.5,2710,5733,2.0,0,0,3,7,2710,0,2003,0,98092,47.3357,-122.171,2720,5733,3023,3013,47.96790511076225,0.02622950819672131,Very Cheap
20140925T000000,445000.0,3,2.25,1190,13630,1.0,0,0,3,7,1190,0,1984,0,98045,47.4813,-121.735,1630,14405,12440,12775,32.6485693323551,0.04852459016393443,Very Cheap
20140912T000000,510000.0,3,2.5,2300,27566,2.0,0,0,3,9,2300,0,1995,0,98019,47.7369,-121.96,2480,16650,25266,14170,18.501052020605094,0.057049180327868855,Very Cheap
20140527T000000,330000.0,4,1.0,1360,13372,1.0,0,0,3,7,1360,0,1955,0,98028,47.7622,-122.263,1540,10283,12012,8743,24.67843254561771,0.03344262295081967,Very Cheap
20140818T000000,270000.0,3,1.0,1500,5605,1.0,0,0,5,6,750,750,1942,0,98106,47.5456,-122.359,1050,9100,4105,8050,48.17127564674398,0.025573770491803278,Very Cheap
20150403T000000,495000.0,4,2.0,1610,4770,1.0,0,0,4,7,1230,380,1941,0,98126,47.5333,-122.381,1180,6120,3160,4940,103.77358490566037,0.05508196721311476,Very Cheap
20150306T000000,225000.0,4,1.75,1420,10300,2.0,0,0,3,7,1420,0,1950,2001,98002,47.3121,-122.215,1420,10300,8880,8880,21.844660194174757,0.019672131147540985,Very Cheap
20150504T000000,716528.0,3,1.5,1750,5400,1.0,0,0,4,7,1050,700,1952,0,98115,47.6799,-122.279,1750,5400,3650,3650,132.69037037037037,0.08413481967213114,Very Cheap
20141014T000000,260000.0,3,2.5,1510,6095,2.0,0,0,4,7,1510,0,1991,0,98038,47.3498,-122.037,1520,6000,4585,4480,42.65791632485644,0.024262295081967214,Very Cheap
20140609T000000,471000.0,4,2.5,2330,9928,2.0,0,0,3,8,2330,0,1998,0,98045,47.4836,-121.783,2430,8175,7598,5745,47.44157937147462,0.051934426229508196,Very Cheap
20150226T000000,690000.0,5,3.5,2690,4800,2.0,0,2,3,8,1930,760,1919,1984,98118,47.5592,-122.269,2080,4900,2110,2820,143.75,0.08065573770491803,Very Cheap
20150428T000000,548000.0,5,1.5,1700,7200,1.5,0,0,3,7,1700,0,1937,0,98011,47.7614,-122.203,1460,7194,5500,5734,76.11111111111111,0.062032786885245904,Very Cheap
20140726T000000,505000.0,3,1.0,1020,5410,1.0,0,0,4,7,880,140,1928,0,98115,47.6924,-122.31,1580,5376,4390,3796,93.3456561922366,0.05639344262295082,Very Cheap
20141217T000000,325000.0,3,1.0,1160,11799,1.0,0,0,3,7,1160,0,1966,0,98034,47.7263,-122.229,1220,10500,10639,9280,27.544707178574455,0.03278688524590164,Very Cheap
20141105T000000,682000.0,4,2.25,2450,34092,2.0,0,0,4,8,2450,0,1980,0,98075,47.5751,-122.049,2410,35378,31642,32968,20.004693183151474,0.07960655737704918,Very Cheap
20140617T000000,605000.0,3,2.25,2010,10760,2.0,0,0,3,8,2010,0,1985,0,98052,47.7276,-122.103,2240,9357,8750,7117,56.226765799256505,0.06950819672131148,Very Cheap
20150505T000000,276200.0,2,1.75,1370,4495,1.0,0,0,4,8,1370,0,1975,0,98198,47.3794,-122.317,1370,4686,3125,3316,61.446051167964406,0.026386885245901638,Very Cheap
20140724T000000,530000.0,3,1.0,1370,4040,1.5,0,0,3,7,1370,0,1906,0,98103,47.6867,-122.354,1220,3030,2670,1810,131.1881188118812,0.05967213114754098,Very Cheap
20140902T000000,245000.0,3,3.0,1990,9600,1.0,0,0,3,7,1440,550,1988,0,98003,47.3499,-122.296,1670,9600,7610,7930,25.520833333333332,0.022295081967213116,Very Cheap
20140603T000000,654950.0,4,2.5,2790,45902,2.0,0,0,3,9,2790,0,1987,0,98077,47.7674,-122.086,2890,42421,43112,39531,14.268441462245654,0.07605901639344262,Very Cheap
20141015T000000,221900.0,2,1.0,780,6727,1.0,0,0,3,6,780,0,1939,0,98168,47.4733,-122.281,1860,10124,5947,8264,32.98647242455775,0.019265573770491803,Very Cheap
20150429T000000,466000.0,4,2.0,2240,4508,1.0,0,2,4,8,1340,900,1926,0,98178,47.5096,-122.25,1930,5250,2268,3320,103.3717834960071,0.051278688524590166,Very Cheap
20150213T000000,383150.0,3,2.0,2210,6387,1.0,0,0,3,8,2210,0,2003,0,98003,47.265,-122.302,2570,6497,4177,3927,59.9890402379834,0.04041311475409836,Very Cheap
20140505T000000,657100.0,4,1.0,1390,4240,1.0,0,0,3,7,1050,340,1924,0,98103,47.6596,-122.338,1810,4240,2850,2430,154.97641509433961,0.07634098360655737,Very Cheap
20150312T000000,539000.0,3,2.0,1800,43995,2.0,0,0,3,8,1800,0,1988,0,98077,47.7585,-122.022,2290,51400,42195,49110,12.251392203659506,0.06085245901639344,Very Cheap
20140905T000000,400000.0,6,3.0,3320,15600,1.0,0,0,4,8,1660,1660,1977,0,98092,47.2983,-122.166,2330,15360,12280,13030,25.641025641025642,0.04262295081967213,Very Cheap
20140620T000000,215000.0,4,2.5,1960,11600,1.0,0,0,5,6,980,980,1931,0,98002,47.2898,-122.222,1160,7685,9640,6525,18.53448275862069,0.018360655737704918,Very Cheap
20141124T000000,489000.0,2,1.0,850,2850,1.0,0,0,4,7,850,0,1927,0,98115,47.6875,-122.309,1450,4015,2000,2565,171.57894736842104,0.05429508196721312,Very Cheap
20141105T000000,649000.0,4,2.5,2980,12764,2.0,0,0,3,10,2980,0,1994,0,98075,47.5857,-122.027,3080,9810,9784,6730,50.84612973989345,0.07527868852459016,Very Cheap
20150512T000000,700000.0,4,1.75,1980,10800,1.0,0,0,4,8,1320,660,1953,0,98005,47.5899,-122.173,2310,10800,8820,8490,64.81481481481481,0.08196721311475409,Very Cheap
20140520T000000,268500.0,2,1.0,790,8424,1.0,0,0,4,6,790,0,1953,0,98133,47.7511,-122.352,1470,8424,7634,6954,31.873219373219374,0.02537704918032787,Very Cheap
20140610T000000,515000.0,3,2.5,1800,5001,2.0,0,0,3,7,1800,0,1996,0,98034,47.7126,-122.231,2106,5618,3201,3512,102.97940411917617,0.057704918032786885,Very Cheap
20150223T000000,685000.0,4,2.0,2260,10800,1.0,0,0,3,9,2260,0,1978,0,98007,47.6124,-122.153,2650,9900,8540,7250,63.425925925925924,0.08,Very Cheap
20141016T000000,305000.0,2,1.5,800,2142,2.0,0,0,3,7,800,0,2006,0,98144,47.5917,-122.297,1320,2742,1342,1422,142.39028944911297,0.03016393442622951,Very Cheap
20150112T000000,950000.0,4,2.0,2490,4600,1.5,0,2,3,8,2090,400,1926,0,98105,47.6557,-122.278,2910,5000,2110,2090,206.52173913043478,0.11475409836065574,Cheap
20150326T000000,292500.0,4,2.5,1610,4568,2.0,0,0,3,7,1610,0,2006,0,98001,47.3351,-122.289,1834,4604,2958,2770,64.0323992994746,0.028524590163934428,Very Cheap
20140814T000000,270000.0,4,1.75,1850,7730,1.0,0,0,5,7,1100,750,1956,0,98133,47.7481,-122.355,2260,8581,5880,6321,34.92884864165589,0.025573770491803278,Very Cheap
20141204T000000,450000.0,4,1.75,1850,7730,1.0,0,0,5,7,1100,750,1956,0,98133,47.7481,-122.355,2260,8581,5880,6321,58.214747736093145,0.04918032786885246,Very Cheap
20141027T000000,535000.0,4,1.0,1920,6480,1.5,0,0,3,7,1920,0,1920,0,98117,47.6897,-122.374,1600,6470,4560,4870,82.56172839506173,0.06032786885245902,Very Cheap
20150306T000000,550000.0,3,2.5,1740,3082,2.0,0,0,3,8,1740,0,2000,0,98029,47.5489,-122.006,1910,3075,1342,1165,178.45554834523037,0.06229508196721312,Very Cheap
20140624T000000,457500.0,3,2.25,1430,2003,2.0,0,0,3,8,980,450,1996,0,98144,47.5908,-122.292,2210,4000,573,1790,228.40738891662505,0.05016393442622951,Very Cheap
20140506T000000,136500.0,3,1.5,1420,8580,1.0,0,0,3,6,1420,0,1962,0,98023,47.3076,-122.362,1200,8580,7160,7380,15.909090909090908,0.008065573770491804,Very Cheap
20141008T000000,224097.0,3,1.5,1420,8580,1.0,0,0,3,6,1420,0,1962,0,98023,47.3076,-122.362,1200,8580,7160,7380,26.11853146853147,0.019553704918032787,Very Cheap
20140922T000000,254000.0,3,2.5,1560,10608,2.0,0,0,3,7,1560,0,1994,0,98042,47.3572,-122.161,1360,10608,9048,9248,23.94419306184012,0.023475409836065574,Very Cheap
20140611T000000,335000.0,4,2.25,2030,13500,1.0,0,0,3,7,1230,800,1963,0,98059,47.4596,-122.066,1830,13800,11470,11970,24.814814814814813,0.03409836065573771,Very Cheap
20150402T000000,594950.0,5,2.5,3280,6553,2.0,0,0,3,9,3280,0,2012,0,98045,47.475,-121.737,3360,7242,3273,3882,90.79047764382726,0.06819016393442623,Very Cheap
20140827T000000,350000.0,3,1.75,1360,18123,1.0,0,0,3,8,1360,0,1983,0,98045,47.4716,-121.756,1570,16817,16763,15247,19.312475859405176,0.036065573770491806,Very Cheap
20140916T000000,169950.0,3,1.0,1180,9832,1.0,0,0,3,7,1180,0,1970,0,98042,47.3845,-122.085,1220,9894,8652,8674,17.28539462978031,0.012452459016393443,Very Cheap
20141006T000000,432500.0,3,2.5,1940,10800,1.0,0,0,3,8,1340,600,1979,0,98077,47.7471,-122.075,2080,9600,8860,7520,40.0462962962963,0.046885245901639346,Very Cheap
20140520T000000,440000.0,2,1.75,1300,4000,2.0,0,0,3,7,1300,0,1948,0,98105,47.6687,-122.288,1350,4013,2700,2663,110.0,0.04786885245901639,Very Cheap
20140918T000000,233703.0,3,2.25,1650,3788,2.0,0,0,3,7,1650,0,1985,0,98031,47.3908,-122.167,1510,3994,2138,2484,61.695617740232315,0.02081350819672131,Very Cheap
20141114T000000,310000.0,3,1.5,1140,3292,2.0,0,0,3,7,1140,0,1988,0,98029,47.5701,-122.017,1150,3592,2152,2442,94.16767922235724,0.03081967213114754,Very Cheap
20150402T000000,735000.0,3,2.5,2540,6762,2.0,0,0,3,10,2540,0,1998,0,98007,47.6239,-122.144,2870,6631,4222,3761,108.69565217391305,0.08655737704918033,Very Cheap
20141217T000000,730000.0,4,2.75,3440,8150,2.0,0,0,3,10,3440,0,2014,0,98056,47.5168,-122.189,2560,8315,4710,5755,89.57055214723927,0.0859016393442623,Very Cheap
20141024T000000,257000.0,3,1.75,1800,9000,1.0,0,0,3,7,1200,600,1961,0,98178,47.4932,-122.278,980,6000,7200,5020,28.555555555555557,0.023868852459016394,Very Cheap
20140519T000000,485000.0,2,2.25,1260,1240,3.0,0,0,3,8,1260,0,2004,0,98103,47.6531,-122.352,1330,1300,-20,-30,391.1290322580645,0.05377049180327869,Very Cheap
20140619T000000,899000.0,4,2.25,2370,6000,1.0,0,2,3,8,1440,930,1959,0,98177,47.7023,-122.388,3280,8843,3630,5563,149.83333333333334,0.10806557377049181,Cheap
20141118T000000,279000.0,3,1.0,1520,8055,1.5,0,0,3,7,1520,0,1952,0,98125,47.7222,-122.305,1560,8160,6535,6600,34.63687150837989,0.02675409836065574,Very Cheap
20141211T000000,225000.0,4,2.0,1750,7245,1.0,0,0,4,7,1050,700,1974,0,98092,47.3164,-122.196,1640,7245,5495,5605,31.055900621118013,0.019672131147540985,Very Cheap
20140625T000000,1355000.0,3,1.5,2680,4775,2.0,0,2,5,8,1880,800,1913,0,98109,47.6333,-122.347,2280,5947,2095,3667,283.7696335078534,0.1678688524590164,Cheap
20140811T000000,355000.0,3,2.5,1590,4242,2.0,0,0,3,7,1590,0,2000,0,98065,47.5309,-121.876,1590,3702,2652,2112,83.68694012258369,0.036721311475409836,Very Cheap
20140502T000000,382500.0,4,1.75,1560,8700,1.0,0,0,4,7,1560,0,1967,0,98034,47.7274,-122.181,2080,8000,7140,5920,43.96551724137931,0.040327868852459016,Very Cheap
20141107T000000,324360.0,3,2.5,2000,9669,2.0,0,0,4,8,2000,0,1992,0,98022,47.1964,-122.009,1930,9202,7669,7272,33.546385355259076,0.03270295081967213,Very Cheap
20150324T000000,315000.0,3,1.75,2380,10450,1.5,0,0,3,8,2380,0,1966,0,98023,47.3143,-122.37,2320,8500,8070,6180,30.14354066985646,0.031475409836065574,Very Cheap
20140716T000000,426000.0,2,1.0,2230,11472,2.0,0,0,3,7,2230,0,1951,0,98133,47.7372,-122.35,1870,8649,9242,6779,37.13389121338912,0.046032786885245904,Very Cheap
20150406T000000,395000.0,5,2.5,2820,6305,2.0,0,0,3,8,2820,0,2003,0,98003,47.2616,-122.296,2610,6306,3485,3696,62.648691514670894,0.0419672131147541,Very Cheap
20141121T000000,212644.0,3,1.0,1570,9650,1.5,0,0,5,5,1570,0,1922,0,98010,47.3531,-121.982,1330,9650,8080,8320,22.035647668393782,0.018051672131147542,Very Cheap
20141009T000000,510000.0,3,3.0,1845,5100,2.0,0,2,5,8,1845,0,1947,0,98056,47.5204,-122.208,2100,7650,3255,5550,100.0,0.057049180327868855,Very Cheap
20140915T000000,85000.0,2,1.0,830,9000,1.0,0,0,3,6,830,0,1939,0,98032,47.3813,-122.243,1160,7680,8170,6520,9.444444444444445,0.0013114754098360656,Very Cheap
20141230T000000,235000.0,2,1.0,830,9000,1.0,0,0,3,6,830,0,1939,0,98032,47.3813,-122.243,1160,7680,8170,6520,26.11111111111111,0.02098360655737705,Very Cheap
20150408T000000,295000.0,4,2.5,2030,5754,2.0,0,0,3,8,2030,0,2001,0,98042,47.3542,-122.137,2030,5784,3724,3754,51.26868265554397,0.028852459016393443,Very Cheap
20140810T000000,720001.0,3,2.5,1430,2200,1.5,0,0,4,7,1430,0,1910,0,98103,47.6601,-122.331,1740,4275,770,2535,327.2731818181818,0.0845902950819672,Very Cheap
20140506T000000,313950.0,3,1.0,1510,6083,1.0,0,0,4,6,860,650,1940,0,98115,47.6966,-122.324,1510,5712,4573,4202,51.611047180667434,0.03133770491803279,Very Cheap
20141008T000000,415000.0,3,1.0,1510,6083,1.0,0,0,4,6,860,650,1940,0,98115,47.6966,-122.324,1510,5712,4573,4202,68.22291632418215,0.04459016393442623,Very Cheap
20140519T000000,305000.0,3,1.75,1610,12247,1.0,0,0,3,8,1610,0,1981,0,98058,47.4476,-122.124,2010,9271,10637,7261,24.904058136686537,0.03016393442622951,Very Cheap
20141001T000000,625000.0,3,1.5,1600,4128,1.5,0,0,3,8,1250,350,1906,0,98122,47.6122,-122.297,1540,3976,2528,2436,151.40503875968992,0.07213114754098361,Very Cheap
20150414T000000,490000.0,3,1.0,1420,11040,1.0,0,0,4,7,1420,0,1961,0,98007,47.5969,-122.14,1530,8208,9620,6678,44.38405797101449,0.05442622950819672,Very Cheap
20140722T000000,269950.0,3,2.0,1660,8641,2.0,0,0,4,8,1660,0,1987,0,98042,47.3663,-122.088,1490,8641,6981,7151,31.24059715310728,0.025567213114754097,Very Cheap
20140813T000000,2700000.0,5,4.0,4230,27295,2.0,1,4,3,8,3230,1000,1949,1985,98033,47.6803,-122.214,2660,27295,23065,24635,98.91921597362155,0.3442622950819672,Medium
20140813T000000,829000.0,4,3.0,3310,4500,2.5,0,0,5,9,2910,400,1900,0,98103,47.6594,-122.345,1440,3750,1190,2310,184.22222222222223,0.09888524590163934,Very Cheap
20140829T000000,635000.0,4,2.5,2470,77550,1.0,0,0,4,7,2470,0,1987,0,98075,47.5888,-122.011,2490,40894,75080,38404,8.188265635074146,0.07344262295081967,Very Cheap
20150312T000000,217500.0,3,1.0,1040,9750,1.0,0,0,3,7,1040,0,1959,0,98188,47.4553,-122.274,1510,11100,8710,9590,22.307692307692307,0.018688524590163933,Very Cheap
20140716T000000,270000.0,4,1.75,1850,7350,1.0,0,0,3,7,1050,800,1965,0,98001,47.3413,-122.277,1450,7250,5500,5800,36.734693877551024,0.025573770491803278,Very Cheap
20140926T000000,1245000.0,3,3.0,4610,8400,2.0,0,2,3,8,2790,1820,1947,1999,98144,47.5854,-122.292,2160,5000,3790,2840,148.21428571428572,0.15344262295081967,Cheap
20150127T000000,480000.0,4,2.5,2480,5100,2.0,0,0,3,8,2480,0,2007,0,98019,47.7383,-121.969,2270,5115,2620,2845,94.11764705882354,0.05311475409836065,Very Cheap
20140506T000000,575000.0,3,1.75,2130,6500,1.0,0,2,3,8,1170,960,1954,0,98199,47.6424,-122.386,2020,5000,4370,2980,88.46153846153847,0.06557377049180328,Very Cheap
20141103T000000,426950.0,4,2.75,2350,5589,2.0,0,0,3,7,2350,0,2001,0,98059,47.5098,-122.155,2014,6365,3239,4351,76.39112542494185,0.046157377049180326,Very Cheap
20140905T000000,125000.0,3,1.0,920,7314,1.0,0,0,3,6,920,0,1960,0,98002,47.2892,-122.22,1010,7420,6394,6410,17.090511348099536,0.006557377049180328,Very Cheap
20150316T000000,208000.0,3,1.0,920,7314,1.0,0,0,3,6,920,0,1960,0,98002,47.2892,-122.22,1010,7420,6394,6410,28.438610883237626,0.01744262295081967,Very Cheap
20140924T000000,325000.0,4,2.0,1780,10622,1.0,0,0,4,7,900,880,1976,0,98058,47.4573,-122.158,1550,8900,8842,7350,30.59687441159857,0.03278688524590164,Very Cheap
20140922T000000,597157.0,7,4.0,2690,10880,1.0,0,0,4,8,2690,0,1960,0,98033,47.6787,-122.168,1840,10836,8190,8996,54.885753676470586,0.06847960655737705,Very Cheap
20150107T000000,728725.0,4,2.5,3010,3120,2.5,0,2,3,8,3010,0,2006,0,98029,47.5539,-121.996,2140,3840,110,1700,233.56570512820514,0.08573442622950819,Very Cheap
20140818T000000,708000.0,5,2.0,3180,10800,1.0,0,0,3,8,1910,1270,1968,0,98052,47.6354,-122.103,2440,9750,7620,7310,65.55555555555556,0.08301639344262295,Very Cheap
20140723T000000,1300000.0,4,3.0,4120,14021,2.0,0,0,3,11,4120,0,2005,0,98075,47.5985,-122.026,4390,14684,9901,10294,92.7180657585051,0.16065573770491803,Cheap
20150424T000000,405000.0,3,1.0,1280,11625,1.0,0,0,4,7,1280,0,1977,0,98053,47.6827,-122.059,1320,10875,10345,9555,34.83870967741935,0.043278688524590166,Very Cheap
20141028T000000,550000.0,4,2.75,1690,6090,1.5,0,0,3,7,1400,290,1945,0,98115,47.6814,-122.269,1820,6090,4400,4270,90.311986863711,0.06229508196721312,Very Cheap
20150409T000000,451000.0,4,2.5,2320,5375,2.0,0,0,3,7,2320,0,2006,0,98065,47.5415,-121.883,2060,5395,3055,3335,83.90697674418605,0.04931147540983607,Very Cheap
20140619T000000,540500.0,5,3.75,3090,7415,2.0,0,0,3,8,3090,0,2014,0,98166,47.435,-122.329,2790,7425,4325,4635,72.89278489548214,0.06104918032786885,Very Cheap
20141007T000000,1025000.0,5,3.5,5050,16500,2.0,0,2,3,11,5050,0,2001,0,98075,47.5863,-121.967,4570,16500,11450,11930,62.121212121212125,0.12459016393442623,Cheap
20141125T000000,218000.0,4,1.0,1640,10455,1.0,0,0,3,7,950,690,1963,0,98023,47.2974,-122.366,1360,9750,8815,8390,20.851267336202774,0.018754098360655738,Very Cheap
20141020T000000,562000.0,4,2.25,2170,7007,1.0,0,0,3,8,1540,630,1974,0,98033,47.672,-122.169,2040,7700,4837,5660,80.20550877693735,0.0638688524590164,Very Cheap
20140812T000000,401500.0,4,2.5,3140,94525,2.0,0,0,4,8,2280,860,1977,0,98042,47.4155,-122.163,1910,14300,91385,12390,4.247553557259984,0.04281967213114754,Very Cheap
20141112T000000,196700.0,2,1.0,1090,9994,1.0,0,0,3,7,1090,0,1954,0,98168,47.4761,-122.287,1090,11700,8904,10610,19.68180908545127,0.01596065573770492,Very Cheap
20140822T000000,583000.0,3,1.75,1930,10183,1.0,0,0,4,8,1480,450,1975,0,98006,47.5624,-122.135,2320,10000,8253,7680,57.25228321712658,0.06662295081967214,Very Cheap
20141204T000000,309900.0,5,2.5,2100,17825,1.0,0,0,4,7,1400,700,1974,0,98092,47.3094,-122.191,2200,14602,15725,12402,17.38569424964937,0.030806557377049182,Very Cheap
20141016T000000,485000.0,4,3.0,3110,18843,2.0,0,0,3,9,3110,0,1995,0,98058,47.4619,-122.154,3080,14735,15733,11655,25.73900122061243,0.05377049180327869,Very Cheap
20150424T000000,465000.0,3,1.0,930,3348,1.0,0,0,4,6,930,0,1926,0,98118,47.5532,-122.277,1210,3348,2418,2138,138.88888888888889,0.051147540983606556,Very Cheap
20140812T000000,595000.0,4,2.25,2050,8372,2.0,0,0,4,8,2050,0,1984,0,98052,47.7234,-122.107,2010,8037,6322,6027,71.07023411371237,0.06819672131147542,Very Cheap
20140718T000000,254000.0,3,1.0,1160,7560,1.0,0,0,4,6,1160,0,1958,0,98058,47.45,-122.179,1160,7560,6400,6400,33.597883597883595,0.023475409836065574,Very Cheap
20141030T000000,488500.0,3,2.75,1820,9490,2.0,0,0,3,7,1820,0,1994,0,98011,47.7481,-122.178,1950,8851,7670,6901,51.475237091675446,0.05422950819672131,Very Cheap
20141027T000000,260000.0,4,2.5,2110,8990,2.0,0,0,3,8,2110,0,1977,0,98058,47.4457,-122.127,2040,8800,6880,6760,28.9210233592881,0.024262295081967214,Very Cheap
20150102T000000,166000.0,2,1.0,870,8487,1.0,0,0,4,6,870,0,1944,0,98178,47.4955,-122.239,1350,6850,7617,5500,19.55932602804289,0.011934426229508197,Very Cheap
20141107T000000,440000.0,2,1.5,1080,6760,1.0,0,2,3,6,1080,0,1923,0,98117,47.7008,-122.386,2080,5800,5680,3720,65.08875739644971,0.04786885245901639,Very Cheap
20150202T000000,375000.0,3,2.0,1260,7560,2.0,0,0,5,6,1260,0,1943,0,98133,47.7225,-122.351,1260,7595,6300,6335,49.6031746031746,0.03934426229508197,Very Cheap
20150225T000000,529500.0,2,1.0,900,4800,1.0,0,0,4,6,780,120,1944,0,98199,47.6575,-122.4,1270,5520,3900,4250,110.3125,0.05960655737704918,Very Cheap
20141014T000000,338000.0,2,1.0,750,6439,1.0,0,0,4,6,750,0,1934,0,98103,47.6995,-122.354,1470,6374,5689,4904,52.49262307811772,0.034491803278688525,Very Cheap
20150316T000000,335620.0,3,2.25,1800,15903,1.0,0,0,3,8,1340,460,1986,0,98038,47.3813,-122.043,2000,15233,14103,13233,21.104194177199272,0.03417967213114754,Very Cheap
20150205T000000,464000.0,4,2.25,2220,15232,1.0,0,0,3,9,1690,530,1978,0,98072,47.7449,-122.103,2110,15280,13012,13170,30.462184873949578,0.05101639344262295,Very Cheap
20141003T000000,354000.0,2,1.0,1390,7740,1.0,0,0,4,6,1390,0,1925,0,98126,47.5232,-122.371,1290,7740,6350,6450,45.736434108527135,0.03659016393442623,Very Cheap
20140814T000000,601000.0,4,3.5,2160,3600,2.0,0,0,3,8,1660,500,1998,0,98122,47.6103,-122.297,1230,3840,1440,2610,166.94444444444446,0.06898360655737705,Very Cheap
20150424T000000,285000.0,3,2.25,1840,9040,1.0,0,0,3,8,1370,470,1979,0,98023,47.3144,-122.339,1870,8992,7200,7122,31.52654867256637,0.02754098360655738,Very Cheap
20140930T000000,462500.0,2,2.0,1690,4200,2.0,0,0,3,7,1690,0,1906,0,98112,47.621,-122.303,1540,4200,2510,2660,110.11904761904762,0.05081967213114754,Very Cheap
20140711T000000,350000.0,4,2.5,2650,10459,2.0,0,0,4,8,2650,0,1989,0,98003,47.2739,-122.293,2340,8777,7809,6437,33.464002294674444,0.036065573770491806,Very Cheap
20141224T000000,329000.0,4,1.0,1120,3844,1.0,0,0,3,7,1120,0,1972,0,98133,47.7038,-122.352,1480,3844,2724,2364,85.5879292403746,0.03331147540983607,Very Cheap
20150411T000000,312500.0,4,2.5,2500,11983,1.0,0,0,3,7,1320,1180,1984,2008,98058,47.4292,-122.148,1460,9005,9483,7545,26.078611366101978,0.03114754098360656,Very Cheap
20140613T000000,370000.0,4,2.5,2220,5338,2.0,0,0,3,7,2220,0,2001,0,98059,47.4887,-122.15,2220,5338,3118,3118,69.31434994379917,0.038688524590163934,Very Cheap
20150311T000000,399900.0,3,1.75,1260,12750,1.0,0,0,3,7,1260,0,1979,0,98034,47.7289,-122.233,1460,7865,11490,6405,31.36470588235294,0.042609836065573774,Very Cheap
20141120T000000,398000.0,3,1.0,1480,6550,1.5,0,0,4,6,1480,0,1925,0,98126,47.5498,-122.381,1200,6550,5070,5350,60.76335877862596,0.042360655737704915,Very Cheap
20150304T000000,550500.0,2,1.5,930,7400,1.0,0,2,4,7,830,100,1909,0,98116,47.5691,-122.408,1920,4152,6470,2232,74.39189189189189,0.06236065573770492,Very Cheap
20150224T000000,709000.0,3,2.75,2780,7200,1.5,0,0,4,8,1870,910,1913,0,98118,47.5632,-122.27,1700,7200,4420,5500,98.47222222222223,0.08314754098360656,Very Cheap
20141212T000000,402000.0,5,2.75,2770,7620,1.0,0,0,3,7,1700,1070,1965,0,98106,47.5188,-122.348,1720,7620,4850,5900,52.75590551181102,0.04288524590163934,Very Cheap
20140626T000000,450000.0,3,1.5,1530,23660,1.0,0,0,3,7,1530,0,1952,0,98155,47.7467,-122.295,1800,11407,22130,9607,19.01944209636517,0.04918032786885246,Very Cheap
20141120T000000,524000.0,3,2.25,2140,6720,1.0,0,0,3,8,1440,700,1961,0,98117,47.6949,-122.396,2060,6720,4580,4660,77.97619047619048,0.05888524590163934,Very Cheap
20141217T000000,800000.0,4,2.75,4600,322188,1.0,0,4,3,10,2400,2200,1989,0,98045,47.4626,-121.739,3740,114562,317588,110822,2.4830223347859013,0.09508196721311475,Very Cheap
20140923T000000,185000.0,4,1.0,1760,8906,1.0,0,0,3,7,1230,530,1966,0,98055,47.4288,-122.198,1180,10407,7146,9227,20.772512912643162,0.014426229508196721,Very Cheap
20150220T000000,365000.0,4,1.0,1760,8906,1.0,0,0,3,7,1230,530,1966,0,98055,47.4288,-122.198,1180,10407,7146,9227,40.98360655737705,0.0380327868852459,Very Cheap
20140909T000000,925000.0,4,2.5,3110,11422,2.0,0,0,3,9,3110,0,1989,0,98115,47.6833,-122.271,2850,7254,8312,4404,80.98406583785676,0.11147540983606558,Cheap
20150402T000000,714000.0,3,1.75,2260,11781,1.0,0,0,4,8,1520,740,1968,0,98008,47.5982,-122.128,2530,10176,9521,7646,60.60606060606061,0.0838032786885246,Very Cheap
20141016T000000,495000.0,3,2.0,1460,9759,1.0,0,0,5,7,1460,0,1972,0,98052,47.6644,-122.144,1620,8421,8299,6801,50.722410083000305,0.05508196721311476,Very Cheap
20150420T000000,535000.0,3,2.25,2050,6648,1.0,0,0,3,7,1230,820,1990,0,98133,47.7258,-122.332,1760,7200,4598,5440,80.47533092659447,0.06032786885245902,Very Cheap
20141024T000000,880000.0,4,2.5,2340,10800,1.0,0,0,3,8,2340,0,1953,2007,98040,47.5715,-122.225,2650,13500,8460,10850,81.48148148148148,0.10557377049180328,Cheap
20140616T000000,150000.0,3,1.5,1230,8056,1.0,0,0,4,6,1230,0,1949,0,98168,47.4878,-122.314,850,6714,6826,5864,18.61966236345581,0.009836065573770493,Very Cheap
20150327T000000,554500.0,3,2.25,1880,6565,1.0,0,0,4,8,1420,460,1972,0,98008,47.6396,-122.113,2060,7280,4685,5220,84.46306169078446,0.06288524590163934,Very Cheap
20150408T000000,520000.0,3,1.75,1280,3880,1.5,0,0,5,7,1280,0,1916,0,98117,47.6871,-122.391,980,3880,2600,2900,134.02061855670104,0.058360655737704915,Very Cheap
20140822T000000,839990.0,4,2.75,3660,5637,2.0,0,0,3,9,3660,0,2014,0,98053,47.6845,-122.017,3625,5639,1977,2014,149.01365974809295,0.10032655737704918,Cheap
20140822T000000,500000.0,3,2.5,1650,5683,2.0,0,0,3,7,1650,0,2003,0,98053,47.683,-122.035,1650,4193,4033,2543,87.98169980644026,0.05573770491803279,Very Cheap
20150107T000000,305000.0,2,1.0,1960,186872,1.5,0,0,4,6,1960,0,1936,0,98001,47.2681,-122.267,1650,19200,184912,17550,1.6321332248812022,0.03016393442622951,Very Cheap
20140802T000000,247800.0,3,2.5,1580,2170,2.0,0,0,3,7,1580,0,2003,0,98118,47.5418,-122.289,1610,1917,590,307,114.19354838709677,0.022662295081967213,Very Cheap
20140711T000000,344200.0,4,2.5,2490,5812,2.0,0,0,3,8,2490,0,2000,0,98042,47.3875,-122.155,2690,6012,3322,3322,59.22229869236063,0.03530491803278688,Very Cheap
20140623T000000,459950.0,4,2.5,2000,6107,2.0,0,0,3,8,2000,0,2003,0,98011,47.7557,-122.221,2040,6520,4107,4480,75.3152120517439,0.050485245901639345,Very Cheap
20140915T000000,229900.0,4,1.75,1550,9899,1.0,0,0,4,7,1550,0,1967,0,98030,47.3583,-122.183,1500,11272,8349,9772,23.224568138195778,0.020314754098360657,Very Cheap
20150219T000000,750000.0,4,2.25,2820,9602,1.0,0,1,3,8,1950,870,1974,0,98008,47.5881,-122.113,2890,9602,6782,6712,78.10872734846907,0.08852459016393442,Very Cheap
20141024T000000,509000.0,4,2.5,2600,9355,1.0,0,0,3,9,1840,760,1983,0,98028,47.7446,-122.249,2250,7691,6755,5441,54.40940673436665,0.056918032786885245,Very Cheap
20150325T000000,680000.0,4,1.0,2200,12137,1.0,0,4,4,8,1640,560,1956,0,98028,47.7473,-122.261,3250,17153,9937,13903,56.027024800197744,0.07934426229508197,Very Cheap
20140627T000000,661500.0,5,2.5,2500,7200,1.0,0,0,4,7,1490,1010,1977,0,98052,47.6964,-122.12,1960,8325,4700,6365,91.875,0.07691803278688525,Very Cheap
20141125T000000,370000.0,2,1.0,1270,1399,3.0,0,0,3,7,1270,0,2000,0,98136,47.5552,-122.381,1140,1442,129,302,264.4746247319514,0.038688524590163934,Very Cheap
20140717T000000,785000.0,4,2.75,2900,17400,1.0,0,0,4,8,2410,490,1978,0,98052,47.6431,-122.108,2620,12240,14500,9620,45.11494252873563,0.09311475409836066,Very Cheap
20140818T000000,355000.0,2,1.0,840,6720,1.0,0,0,3,7,840,0,1952,0,98116,47.5707,-122.396,1250,6720,5880,5470,52.82738095238095,0.036721311475409836,Very Cheap
20140731T000000,446000.0,4,2.0,1940,6350,1.0,0,0,4,7,970,970,1951,0,98103,47.6948,-122.357,960,6350,4410,5390,70.23622047244095,0.04865573770491803,Very Cheap
20150128T000000,830000.0,5,3.5,3490,21780,2.0,0,0,3,8,3490,0,1996,0,98052,47.6707,-122.144,3070,7829,18290,4759,38.10835629017447,0.09901639344262295,Very Cheap
20141028T000000,324000.0,3,2.5,1940,8347,2.0,0,0,3,8,1940,0,1990,0,98042,47.3654,-122.164,1940,7131,6407,5191,38.816341200431296,0.03265573770491803,Very Cheap
20141008T000000,500000.0,4,2.25,2490,23478,2.0,0,0,3,8,2490,0,1981,0,98072,47.7547,-122.094,2030,12611,20988,10581,21.2965329244399,0.05573770491803279,Very Cheap
20141017T000000,745000.0,3,1.0,1390,9112,1.0,0,0,4,7,1390,0,1951,0,98004,47.6071,-122.197,2290,9112,7722,6822,81.7603160667252,0.08786885245901639,Very Cheap
20141110T000000,1197000.0,4,2.5,3940,4407,2.0,0,0,4,8,2620,1320,1921,0,98112,47.6374,-122.299,1790,4407,467,2617,271.6133424098026,0.14714754098360655,Cheap
20141215T000000,385000.0,2,2.5,1760,3710,1.0,0,0,3,8,1130,630,1988,0,98072,47.7335,-122.16,1760,4200,1950,2440,103.77358490566037,0.04065573770491803,Very Cheap
20141211T000000,565000.0,3,2.25,2560,8040,1.0,0,0,3,8,1510,1050,1958,0,98125,47.7124,-122.303,1980,8040,5480,6060,70.27363184079601,0.06426229508196721,Very Cheap
20141119T000000,465000.0,4,2.5,2300,7314,1.0,0,0,4,8,1420,880,1979,0,98133,47.7671,-122.33,2010,7314,5014,5304,63.57670221493027,0.051147540983606556,Very Cheap
20140827T000000,401000.0,3,3.25,1770,1977,3.0,0,0,3,8,1770,0,2001,0,98125,47.7186,-122.314,1860,2210,207,350,202.83257460799192,0.04275409836065574,Very Cheap
20140619T000000,385000.0,3,1.75,2310,11200,1.0,0,0,4,8,1630,680,1978,0,98030,47.3637,-122.21,2350,13300,8890,10950,34.375,0.04065573770491803,Very Cheap
20141017T000000,395000.0,3,2.5,2310,4930,2.0,0,0,4,8,2310,0,1989,0,98055,47.4512,-122.208,2230,5324,2620,3094,80.12170385395538,0.0419672131147541,Very Cheap
20150414T000000,245000.0,5,1.5,2000,8100,1.5,0,0,3,6,2000,0,1946,0,98168,47.4945,-122.304,960,9239,6100,8279,30.246913580246915,0.022295081967213116,Very Cheap
20150325T000000,500000.0,3,2.0,1540,3600,1.0,0,0,3,7,890,650,1994,0,98122,47.6103,-122.296,1540,3600,2060,2060,138.88888888888889,0.05573770491803279,Very Cheap
20141103T000000,334000.0,5,1.75,2590,6720,1.0,0,0,4,7,1750,840,1979,0,98055,47.435,-122.192,1820,7521,4130,5701,49.70238095238095,0.0339672131147541,Very Cheap
20150501T000000,550000.0,3,1.0,980,10960,1.0,0,0,4,7,980,0,1953,0,98005,47.5908,-122.173,2100,10960,9980,8860,50.18248175182482,0.06229508196721312,Very Cheap
20141124T000000,216000.0,3,1.0,1730,7950,1.0,0,0,4,7,1180,550,1961,0,98198,47.3644,-122.312,1830,8890,6220,7060,27.169811320754718,0.018491803278688525,Very Cheap
20141030T000000,340500.0,3,2.5,3070,5871,3.0,0,0,4,8,2510,560,1928,0,98178,47.5007,-122.223,2220,4000,2801,1780,57.99693408277977,0.03481967213114754,Very Cheap
20140813T000000,375000.0,4,2.25,2100,12738,2.0,0,0,4,8,2100,0,1975,0,98059,47.4698,-122.118,2000,12090,10638,10090,29.43947244465379,0.03934426229508197,Very Cheap
20150109T000000,600000.0,3,2.75,2080,16740,1.0,0,3,3,8,1580,500,1966,0,98198,47.3632,-122.324,2175,7568,14660,5393,35.842293906810035,0.06885245901639345,Very Cheap
20140515T000000,375000.0,4,1.75,1890,8000,1.0,0,0,4,7,1250,640,1960,0,98133,47.7576,-122.333,1870,8270,6110,6400,46.875,0.03934426229508197,Very Cheap
20140509T000000,536500.0,4,1.75,2000,4000,1.5,0,0,5,7,1450,550,1926,0,98126,47.5659,-122.375,1430,4000,2000,2570,134.125,0.060524590163934425,Very Cheap
20140924T000000,599900.0,3,3.0,3030,35123,2.0,0,0,4,8,1760,1270,1984,0,98027,47.4694,-122.006,2810,36205,32093,33395,17.07997608404749,0.06883934426229509,Very Cheap
20150304T000000,750000.0,2,1.5,1110,3600,1.0,0,0,5,7,1110,0,1904,0,98119,47.6382,-122.359,1670,5400,2490,3730,208.33333333333334,0.08852459016393442,Very Cheap
20150211T000000,355000.0,3,1.0,1650,10075,1.0,0,0,3,7,1170,480,1955,0,98177,47.7695,-122.359,1690,8125,8425,6435,35.235732009925556,0.036721311475409836,Very Cheap
20140701T000000,590000.0,3,2.0,1410,6413,1.0,0,0,4,7,910,500,1947,0,98115,47.6826,-122.298,1330,6050,5003,4720,92.00062373304226,0.06754098360655737,Very Cheap
20150507T000000,680000.0,2,1.0,2140,6000,1.0,0,0,4,7,1070,1070,1946,0,98199,47.651,-122.399,1560,6000,3860,4440,113.33333333333333,0.07934426229508197,Very Cheap
20141006T000000,429000.0,3,2.5,1860,11122,2.0,0,0,3,8,1860,0,1994,0,98059,47.5062,-122.151,2420,8542,9262,6122,38.572199244740155,0.04642622950819672,Very Cheap
20150502T000000,581000.0,2,1.0,1170,4080,1.0,0,0,4,7,1170,0,1909,0,98117,47.6784,-122.386,1560,4586,2910,3026,142.40196078431373,0.06636065573770492,Very Cheap
20150331T000000,463800.0,3,1.5,980,7770,1.0,0,0,4,7,980,0,1968,0,98033,47.6923,-122.201,1470,7350,6790,5880,59.69111969111969,0.05099016393442623,Very Cheap
20141212T000000,2983000.0,5,5.5,7400,18898,2.0,0,3,3,13,6290,1110,2001,0,98006,47.5431,-122.112,6110,26442,11498,20332,157.84739125833423,0.3813770491803279,Medium
20140707T000000,443000.0,5,1.75,1650,3000,1.5,0,0,3,8,1650,0,1902,0,98144,47.5955,-122.306,1740,4000,1350,2260,147.66666666666666,0.048262295081967214,Very Cheap
20140925T000000,276200.0,3,2.5,1480,7210,1.0,0,0,3,7,1180,300,1986,0,98023,47.3124,-122.351,1690,7396,5730,5706,38.30790568654646,0.026386885245901638,Very Cheap
20150423T000000,630000.0,5,3.5,4060,8309,2.0,0,0,3,9,2960,1100,2001,0,98028,47.757,-122.228,1730,11711,4249,9981,75.82139848357203,0.07278688524590164,Very Cheap
20141222T000000,570000.0,3,1.75,1370,3300,2.0,0,0,5,7,1370,0,1927,0,98105,47.6714,-122.32,1560,3927,1930,2367,172.72727272727272,0.06491803278688525,Very Cheap
20141013T000000,979700.0,4,2.25,2480,6000,2.0,0,2,3,10,2380,100,1929,0,98199,47.6392,-122.406,3030,5600,3520,2570,163.28333333333333,0.11864918032786885,Cheap
20141211T000000,730000.0,4,2.5,2030,4080,1.5,0,0,4,8,1730,300,1921,0,98115,47.6753,-122.311,1980,4080,2050,2100,178.92156862745097,0.0859016393442623,Very Cheap
20141204T000000,268450.0,5,2.25,2200,9600,1.0,0,0,4,7,1100,1100,1963,0,98023,47.3263,-122.364,1780,9680,7400,7900,27.963541666666668,0.02537049180327869,Very Cheap
20150304T000000,490000.0,3,1.75,1770,7508,1.0,0,0,3,7,1270,500,1962,0,98133,47.7354,-122.343,1690,8880,5738,7190,65.26371870005327,0.05442622950819672,Very Cheap
20140827T000000,808000.0,3,2.5,2550,6240,1.0,0,3,5,8,1750,800,1957,0,98117,47.6992,-122.387,2180,5200,3690,3020,129.48717948717947,0.0961311475409836,Very Cheap
20150430T000000,350000.0,3,1.0,1250,9786,1.0,0,0,4,7,1250,0,1969,0,98072,47.7622,-122.163,1660,9621,8536,7961,35.7653791130186,0.036065573770491806,Very Cheap
20141028T000000,695000.0,4,1.75,2390,5880,1.0,0,2,3,8,1390,1000,1957,0,98117,47.6956,-122.399,2210,6260,3490,4050,118.19727891156462,0.08131147540983606,Very Cheap
20140612T000000,1228000.0,4,2.5,5730,44947,2.0,0,4,3,11,4280,1450,1991,0,98074,47.6052,-122.064,3310,17628,39217,14318,27.32106703450731,0.15121311475409835,Cheap
20140813T000000,309950.0,1,1.0,1120,11800,1.5,0,0,3,7,1120,0,1950,0,98168,47.5123,-122.331,2330,9290,10680,6960,26.266949152542374,0.03081311475409836,Very Cheap
20141030T000000,134000.0,3,1.0,1270,8508,1.0,0,0,4,6,650,620,1942,0,98168,47.4961,-122.322,1200,9415,7238,8215,15.749882463563704,0.007737704918032787,Very Cheap
20141118T000000,645500.0,4,2.5,2390,9638,2.0,0,0,3,10,2390,0,1988,0,98029,47.5598,-122.018,2630,9258,7248,6628,66.97447603237187,0.07481967213114754,Very Cheap
20150309T000000,750000.0,3,2.0,1760,5488,1.5,0,0,3,7,1540,220,1927,0,98119,47.6479,-122.367,1760,5943,3728,4183,136.66180758017492,0.08852459016393442,Very Cheap
20141010T000000,1399000.0,3,2.5,2560,3600,2.0,0,0,3,9,2110,450,1967,2003,98112,47.632,-122.279,2690,4800,1040,2110,388.6111111111111,0.17363934426229508,Cheap
20140925T000000,344900.0,4,1.75,1820,7700,1.0,0,0,4,7,1100,720,1955,0,98177,47.7545,-122.357,1700,8500,5880,6800,44.79220779220779,0.03539672131147541,Very Cheap
20141008T000000,601450.0,2,3.25,1840,1500,3.0,0,0,3,8,1840,0,2001,0,98103,47.6595,-122.354,1910,2500,-340,590,400.96666666666664,0.06904262295081967,Very Cheap
20150107T000000,575000.0,4,2.0,1810,4400,2.0,0,0,3,8,1700,110,1909,0,98122,47.6132,-122.292,1470,4400,2590,2930,130.6818181818182,0.06557377049180328,Very Cheap
20140521T000000,405000.0,3,1.75,2470,9620,1.0,0,1,4,7,1570,900,1962,0,98198,47.3996,-122.32,2600,9620,7150,7020,42.0997920997921,0.043278688524590166,Very Cheap
20140624T000000,518000.0,4,2.75,2520,14021,2.0,0,0,3,9,2520,0,1999,0,98019,47.7344,-121.957,2330,14007,11501,11677,36.94458312531203,0.0580983606557377,Very Cheap
20140717T000000,265000.0,2,1.0,1600,7936,1.0,0,0,3,7,1600,0,1947,0,98155,47.7411,-122.322,1580,7440,6336,5860,33.39213709677419,0.024918032786885248,Very Cheap
20140925T000000,180000.0,3,1.0,1280,4875,1.0,0,0,5,6,1280,0,1969,0,98042,47.3686,-122.081,1060,4875,3595,3815,36.92307692307692,0.01377049180327869,Very Cheap
20150318T000000,285000.0,3,2.5,1590,9736,2.0,0,0,3,7,1590,0,1985,0,98001,47.33,-122.278,1580,7500,8146,5920,29.27280197206245,0.02754098360655738,Very Cheap
20150316T000000,433000.0,3,2.75,2000,7200,1.0,0,0,3,7,1000,1000,1954,2014,98166,47.4531,-122.352,1440,7200,5200,5760,60.138888888888886,0.04695081967213115,Very Cheap
20150223T000000,399000.0,3,1.75,1780,11440,1.0,0,0,3,8,1350,430,1977,0,98059,47.474,-122.139,2180,11440,9660,9260,34.87762237762238,0.042491803278688525,Very Cheap
20140802T000000,565000.0,3,2.5,1700,7210,2.0,0,0,5,7,1700,0,1966,0,98052,47.6688,-122.161,1700,7566,5510,5866,78.36338418862691,0.06426229508196721,Very Cheap
20150224T000000,406500.0,3,1.5,1970,10080,1.0,0,0,3,7,1970,0,1966,0,98168,47.4703,-122.276,2240,10080,8110,7840,40.32738095238095,0.04347540983606557,Very Cheap
20140807T000000,420000.0,4,1.75,1940,11500,1.0,0,0,4,7,1090,850,1955,0,98006,47.5774,-122.147,1700,8360,9560,6660,36.52173913043478,0.04524590163934426,Very Cheap
20150220T000000,965000.0,4,3.5,3290,5559,1.5,0,0,3,8,2290,1000,1906,2004,98103,47.6788,-122.346,1790,6000,2269,4210,173.5923727289081,0.11672131147540983,Cheap
20141024T000000,1375000.0,4,3.5,3500,9523,2.0,0,0,3,10,2460,1040,1996,0,98033,47.6848,-122.208,3160,5997,6023,2837,144.38727291819805,0.17049180327868851,Cheap
20141007T000000,353950.0,5,2.25,3260,7969,2.0,0,0,4,8,3260,0,1982,0,98023,47.314,-122.344,2070,7962,4709,5892,44.41586146316978,0.03658360655737705,Very Cheap
20140710T000000,847700.0,5,3.25,4230,10260,2.0,0,0,3,10,3860,370,1996,0,98027,47.5503,-122.081,2980,10997,6030,8017,82.62183235867447,0.10133770491803279,Cheap
20140702T000000,185000.0,5,1.0,1590,6700,1.5,0,0,3,6,1090,500,1942,0,98146,47.5075,-122.35,1370,8040,5110,6670,27.611940298507463,0.014426229508196721,Very Cheap
20141119T000000,269000.0,2,1.5,1010,6000,1.0,0,0,4,7,1010,0,1923,0,98178,47.498,-122.222,1290,6000,4990,4710,44.833333333333336,0.02544262295081967,Very Cheap
20141224T000000,422800.0,3,1.75,1820,8400,1.0,0,0,3,7,1340,480,1976,0,98072,47.734,-122.17,1900,8112,6580,6212,50.333333333333336,0.04561311475409836,Very Cheap
20141215T000000,379950.0,2,1.0,870,7500,1.0,0,0,3,7,870,0,1947,0,98136,47.5465,-122.384,1240,5709,6630,4469,50.66,0.03999344262295082,Very Cheap
20141226T000000,525000.0,3,2.0,1620,7800,1.0,0,0,3,7,1200,420,1969,0,98034,47.7288,-122.171,1540,7565,6180,6025,67.3076923076923,0.05901639344262295,Very Cheap
20140718T000000,810000.0,4,3.5,3980,209523,2.0,0,2,3,9,3980,0,2006,0,98024,47.5574,-121.89,2220,65775,205543,63555,3.8659240274337425,0.09639344262295083,Very Cheap
20140722T000000,209950.0,4,1.0,1630,8400,1.0,0,0,3,6,1630,0,1962,0,98023,47.3052,-122.362,1190,8989,6770,7799,24.99404761904762,0.017698360655737704,Very Cheap
20141204T000000,439950.0,3,2.0,1230,1613,2.0,0,0,3,8,1010,220,2003,0,98107,47.6661,-122.37,1610,1873,383,263,272.75263484190947,0.04786229508196721,Very Cheap
20140523T000000,554820.0,4,2.0,3510,12905,1.0,0,2,3,8,2210,1300,1965,1982,98166,47.4466,-122.36,2530,16143,9395,13613,42.99263851220457,0.0629272131147541,Very Cheap
20150423T000000,359000.0,4,2.5,2160,4500,2.0,0,0,3,7,2160,0,2002,0,98056,47.4819,-122.182,2160,4496,2340,2336,79.77777777777777,0.03724590163934426,Very Cheap
20140910T000000,242500.0,3,1.0,1020,5870,1.0,0,0,3,6,1020,0,1941,0,98155,47.741,-122.314,1160,6901,4850,5741,41.311754684838164,0.021967213114754098,Very Cheap
20140926T000000,330000.0,3,1.75,1590,9417,1.0,0,0,4,7,1590,0,1954,0,98177,47.7617,-122.36,1600,9272,7827,7672,35.04300732717426,0.03344262295081967,Very Cheap
20141105T000000,740000.0,3,2.25,3440,44374,2.0,0,3,4,10,2190,1250,1979,0,98006,47.547,-122.111,3470,40185,40934,36715,16.676432144949747,0.08721311475409836,Very Cheap
20141218T000000,630000.0,5,1.0,3020,4800,2.0,0,0,3,7,3020,0,1901,0,98122,47.6025,-122.313,1350,1307,1780,-43,131.25,0.07278688524590164,Very Cheap
20140815T000000,750000.0,3,1.75,2280,7800,1.0,0,3,4,8,1360,920,1941,0,98117,47.6985,-122.387,2280,5200,5520,2920,96.15384615384616,0.08852459016393442,Very Cheap
20141013T000000,695000.0,4,2.5,2790,6540,2.0,0,0,3,9,2790,0,1999,0,98074,47.6087,-122.016,2790,6270,3750,3480,106.2691131498471,0.08131147540983606,Very Cheap
20150114T000000,109000.0,2,0.5,580,6900,1.0,0,0,3,5,580,0,1941,0,98118,47.5135,-122.262,1570,5040,6320,3470,15.797101449275363,0.004459016393442623,Very Cheap
20150225T000000,389000.0,3,1.5,2030,10075,1.0,0,0,5,7,1080,950,1961,0,98055,47.4713,-122.197,2210,10075,8045,7865,38.61042183622829,0.04118032786885246,Very Cheap
20141023T000000,447000.0,2,1.0,850,2700,1.0,0,0,5,6,850,0,1924,0,98105,47.6684,-122.316,1630,3000,1850,1370,165.55555555555554,0.04878688524590164,Very Cheap
20141230T000000,1200000.0,3,2.0,2480,13310,1.0,0,0,2,7,2480,0,1955,0,98052,47.6759,-122.114,2400,11340,10830,8940,90.15777610818932,0.14754098360655737,Cheap
20141210T000000,315000.0,3,1.75,1010,12000,1.0,0,0,4,7,1010,0,1977,0,98011,47.77,-122.207,1080,10619,10990,9539,26.25,0.031475409836065574,Very Cheap
20150414T000000,640000.0,3,2.5,2420,8244,2.0,0,0,3,10,2420,0,1988,0,98029,47.5595,-122.019,2500,9320,5824,6820,77.63221737020864,0.0740983606557377,Very Cheap
20141119T000000,570000.0,3,2.25,2180,9246,2.0,0,0,3,9,2180,0,1984,0,98074,47.6215,-122.031,2300,9298,7066,6998,61.64828033744322,0.06491803278688525,Very Cheap
20140805T000000,495000.0,3,2.75,1830,208216,2.0,0,0,3,8,1830,0,1997,0,98070,47.4377,-122.464,1530,16988,206386,15458,2.377338917278211,0.05508196721311476,Very Cheap
20140603T000000,449500.0,5,2.75,2040,7488,1.0,0,0,4,7,1200,840,1969,0,98034,47.7289,-122.172,1530,7488,5448,5958,60.02938034188034,0.049114754098360656,Very Cheap
20150317T000000,1084500.0,4,2.75,2640,5000,2.0,0,0,3,9,1840,800,1943,2004,98105,47.6619,-122.275,2010,5000,2360,2990,216.9,0.13239344262295083,Cheap
20150311T000000,294950.0,2,1.0,1060,7868,1.0,0,0,3,7,1060,0,1952,0,98155,47.7414,-122.295,1530,10728,6808,9198,37.48729028978139,0.028845901639344262,Very Cheap
20140923T000000,170500.0,3,1.0,1640,13939,1.0,0,0,3,7,1040,600,1960,0,98198,47.3947,-122.313,2080,13000,12299,10920,12.231867422340196,0.012524590163934425,Very Cheap
20141208T000000,312000.0,4,1.0,1190,7620,1.5,0,0,3,6,1190,0,1926,0,98106,47.5281,-122.348,1060,7320,6430,6260,40.94488188976378,0.031081967213114754,Very Cheap
20141027T000000,350000.0,3,2.5,2180,15484,1.0,0,0,3,8,2180,0,1992,0,98003,47.2688,-122.309,2090,10775,13304,8685,22.60397830018083,0.036065573770491806,Very Cheap
20140728T000000,690000.0,4,2.5,2120,8448,2.0,0,0,4,9,2120,0,1989,0,98029,47.5654,-122.01,2140,8122,6328,5982,81.67613636363636,0.08065573770491803,Very Cheap
20140610T000000,375000.0,4,2.5,2210,9427,2.0,0,0,3,7,2210,0,1999,0,98148,47.4323,-122.327,1770,8770,7217,7000,39.7793571655882,0.03934426229508197,Very Cheap
20140806T000000,575000.0,4,2.5,2510,47044,2.0,0,0,3,9,2510,0,1987,0,98077,47.7699,-122.085,2600,42612,44534,40012,12.222600119037496,0.06557377049180328,Very Cheap
20140604T000000,646000.0,4,2.25,2500,8500,1.0,0,0,4,8,1600,900,1978,0,98006,47.5615,-122.131,2290,8927,6000,6637,76.0,0.07488524590163935,Very Cheap
20150327T000000,239950.0,3,2.5,1560,4800,2.0,0,0,4,7,1560,0,1974,0,98001,47.2653,-122.285,1510,12240,3240,10730,49.989583333333336,0.021632786885245902,Very Cheap
20140729T000000,400000.0,5,2.5,2510,7525,1.5,0,0,4,7,1710,800,1929,0,98106,47.5422,-122.359,1270,6741,5015,5471,53.15614617940199,0.04262295081967213,Very Cheap
20150121T000000,455000.0,4,1.75,3060,94089,1.0,0,0,3,8,3060,0,1958,0,98072,47.744,-122.087,2180,43995,91029,41815,4.8358469109035065,0.049836065573770495,Very Cheap
20140904T000000,240000.0,3,2.0,1310,8069,1.0,0,0,3,7,1310,0,1990,0,98042,47.3694,-122.083,1310,8392,6759,7082,29.743462634775064,0.021639344262295083,Very Cheap
20150508T000000,3400000.0,4,4.0,4260,11765,2.0,0,0,3,11,3280,980,1939,2010,98112,47.638,-122.288,4260,10408,7505,6148,288.99277518062047,0.4360655737704918,High
20140701T000000,695000.0,3,2.0,2500,4080,1.5,0,0,5,7,1680,820,1922,0,98103,47.6813,-122.346,1550,3060,1580,1510,170.34313725490196,0.08131147540983606,Very Cheap
20140924T000000,304950.0,2,1.0,670,6720,1.0,0,0,5,6,670,0,1942,0,98126,47.5151,-122.372,710,6720,6050,6010,45.379464285714285,0.03015737704918033,Very Cheap
20140805T000000,650000.0,3,1.75,1840,2310,1.0,0,2,4,8,1140,700,1914,0,98109,47.6462,-122.351,1670,4000,470,2330,281.38528138528136,0.07540983606557378,Very Cheap
20140715T000000,402500.0,3,1.75,1480,2211,2.0,0,0,3,7,1480,0,1995,0,98103,47.6966,-122.35,1480,2197,731,717,182.0443238353686,0.04295081967213115,Very Cheap
20140625T000000,482000.0,3,2.5,2420,7307,2.0,0,0,3,7,2420,0,1998,0,98065,47.5361,-121.871,2420,5577,4887,3157,65.96414397153414,0.05337704918032787,Very Cheap
20141031T000000,655000.0,3,2.0,1820,4480,1.0,0,0,5,7,1120,700,1923,0,98105,47.6717,-122.295,1920,4480,2660,2560,146.20535714285714,0.0760655737704918,Very Cheap
20140926T000000,577000.0,5,2.75,1940,5000,2.0,0,0,5,7,1940,0,1951,0,98107,47.6704,-122.362,1940,4230,3060,2290,115.4,0.06583606557377049,Very Cheap
20141020T000000,350000.0,3,2.5,1630,5996,2.0,0,0,3,7,1630,0,1986,0,98055,47.4738,-122.19,1660,4504,4366,2844,58.37224816544363,0.036065573770491806,Very Cheap
20140908T000000,415000.0,4,2.25,2520,8000,1.0,0,2,3,8,1680,840,1970,0,98023,47.3202,-122.383,2300,8000,5480,5700,51.875,0.04459016393442623,Very Cheap
20140730T000000,396400.0,4,2.5,2120,215186,2.0,0,0,2,7,2120,0,1983,0,98014,47.701,-121.857,2000,215186,213066,213186,1.8421272759380256,0.04215081967213115,Very Cheap
20150409T000000,654300.0,3,2.5,2490,8582,2.0,0,0,3,9,2490,0,2000,0,98074,47.625,-122.042,2870,7598,6092,4728,76.24096947098579,0.07597377049180327,Very Cheap
20141124T000000,774950.0,4,2.5,3410,179419,2.0,0,0,3,10,3410,0,2004,0,98010,47.3602,-121.986,3350,175421,176009,172071,4.31921925771518,0.09179672131147541,Very Cheap
20140902T000000,855000.0,4,2.0,2380,10800,2.0,0,2,3,8,2380,0,1925,0,98118,47.5682,-122.275,2112,6600,8420,4488,79.16666666666667,0.10229508196721311,Cheap
20140626T000000,1145000.0,3,2.5,2490,4000,2.0,0,0,5,8,1670,820,1918,0,98109,47.6403,-122.35,2310,4000,1510,1690,286.25,0.14032786885245901,Cheap
20140530T000000,330000.0,2,2.5,1240,1546,2.0,0,0,3,7,1240,0,2007,0,98108,47.5634,-122.298,1520,2468,306,948,213.45407503234154,0.03344262295081967,Very Cheap
20140923T000000,290000.0,4,2.25,1900,10950,1.0,0,0,4,7,1400,500,1959,0,98032,47.3582,-122.284,1700,11850,9050,10150,26.484018264840184,0.02819672131147541,Very Cheap
20141119T000000,519500.0,3,3.0,2390,19454,1.5,0,0,3,8,2390,0,2008,0,98166,47.4545,-122.336,1540,26979,17064,25439,26.70401973887118,0.058295081967213114,Very Cheap
20140814T000000,450000.0,3,1.75,1810,12600,1.0,0,0,3,7,1400,410,1977,0,98034,47.7143,-122.233,1934,12600,10790,10666,35.714285714285715,0.04918032786885246,Very Cheap
20141124T000000,3120000.0,3,3.5,4490,56609,2.0,1,4,3,12,4490,0,1993,0,98034,47.6997,-122.24,2710,51330,52119,48620,55.11491105654578,0.39934426229508196,Medium
20140623T000000,265000.0,3,1.0,1620,9450,1.5,0,0,3,7,1620,0,1928,0,98168,47.5136,-122.313,2070,11970,7830,9900,28.04232804232804,0.024918032786885248,Very Cheap
20150506T000000,359000.0,4,2.5,2640,7883,2.0,0,0,3,8,2640,0,1990,0,98092,47.3124,-122.188,2150,7683,5243,5533,45.54103767601167,0.03724590163934426,Very Cheap
20150302T000000,2000000.0,4,3.75,2870,4500,2.0,0,3,3,10,2510,360,2012,0,98119,47.6291,-122.363,2870,6354,1630,3484,444.44444444444446,0.25245901639344265,Cheap
20150210T000000,1050000.0,4,2.5,3250,48037,1.0,0,2,3,8,2030,1220,1985,0,98074,47.6326,-122.07,2970,48037,44787,45067,21.858151008597538,0.12786885245901639,Cheap
20140701T000000,402500.0,2,1.0,800,2280,1.0,0,0,5,6,800,0,1946,0,98107,47.6588,-122.362,1310,4200,1480,2890,176.53508771929825,0.04295081967213115,Very Cheap
20140825T000000,450000.0,3,1.75,1360,5445,1.0,0,0,4,7,1360,0,1957,0,98008,47.6071,-122.123,1570,7840,4085,6270,82.64462809917356,0.04918032786885246,Very Cheap
20150306T000000,262500.0,5,2.25,1950,8086,1.0,0,0,3,7,1130,820,1980,0,98003,47.3179,-122.331,1670,8550,6136,6880,32.463517190205295,0.02459016393442623,Very Cheap
20150225T000000,285000.0,4,2.25,1970,7200,2.0,0,0,3,8,1970,0,1979,0,98092,47.3132,-122.182,1790,7500,5230,5710,39.583333333333336,0.02754098360655738,Very Cheap
20150304T000000,290000.0,3,2.5,2020,4861,2.0,0,0,3,7,2020,0,2005,0,98058,47.4659,-122.144,2170,4600,2841,2430,59.65850648014812,0.02819672131147541,Very Cheap
20140807T000000,752500.0,2,2.5,2280,6230,1.0,0,0,3,8,2280,0,2005,0,98053,47.7065,-122.013,1640,5931,3950,4291,120.78651685393258,0.08885245901639344,Very Cheap
20141208T000000,820000.0,4,2.75,3540,13515,2.0,0,0,3,10,3540,0,1998,0,98075,47.5945,-121.982,3540,11538,9975,7998,60.67332593414724,0.09770491803278689,Very Cheap
20140811T000000,292000.0,3,2.5,1560,2740,2.0,0,0,3,8,1560,0,1999,0,98059,47.4909,-122.154,1310,2698,1180,1388,106.56934306569343,0.028459016393442622,Very Cheap
20141003T000000,213000.0,2,1.0,750,6089,1.0,0,2,3,6,750,0,1937,0,98055,47.475,-122.199,1430,6451,5339,5021,34.981113483330596,0.018098360655737705,Very Cheap
20141117T000000,400000.0,4,3.0,2240,7035,2.0,0,0,3,7,2240,0,1942,1993,98146,47.5124,-122.374,1060,6300,4795,5240,56.85856432125089,0.04262295081967213,Very Cheap
20140714T000000,202000.0,1,0.75,590,5650,1.0,0,0,3,6,590,0,1944,0,98118,47.5181,-122.267,980,5650,5060,4670,35.75221238938053,0.016655737704918034,Very Cheap
20140918T000000,484000.0,1,0.0,690,23244,1.0,0,0,4,7,690,0,1948,0,98053,47.6429,-121.955,1690,19290,22554,17600,20.822577869557737,0.05363934426229508,Very Cheap
20150504T000000,617450.0,3,2.0,1580,14398,1.0,0,0,3,7,1080,500,1981,0,98005,47.6328,-122.174,1650,14407,12818,12757,42.88442839283234,0.07114098360655738,Very Cheap
20150114T000000,250000.0,3,1.0,1040,8000,1.0,0,0,4,7,1040,0,1956,0,98166,47.4711,-122.35,1170,9450,6960,8280,31.25,0.022950819672131147,Very Cheap
20140529T000000,405000.0,5,1.75,1880,10000,1.0,0,0,3,7,960,920,1963,0,98034,47.7182,-122.201,1580,10000,8120,8420,40.5,0.043278688524590166,Very Cheap
20150331T000000,325000.0,2,1.0,1070,8750,1.0,0,0,3,7,1070,0,1951,0,98055,47.4734,-122.198,1300,9670,7680,8370,37.142857142857146,0.03278688524590164,Very Cheap
20140522T000000,301350.0,3,3.0,1860,7440,1.0,0,0,5,7,1040,820,1954,0,98178,47.5035,-122.255,1490,8160,5580,6670,40.50403225806452,0.029685245901639346,Very Cheap
20150303T000000,425000.0,2,1.75,1550,7800,1.0,0,0,3,7,1050,500,1940,0,98136,47.5436,-122.39,1370,5000,6250,3630,54.48717948717949,0.04590163934426229,Very Cheap
20140905T000000,460000.0,3,1.0,1860,6360,1.0,0,0,3,8,1470,390,1954,0,98136,47.5327,-122.392,1770,6175,4500,4405,72.32704402515724,0.050491803278688525,Very Cheap
20150419T000000,938000.0,3,2.5,3090,10940,2.0,0,2,3,10,3090,0,1992,0,98006,47.5492,-122.119,3410,12157,7850,8747,85.74040219378428,0.11318032786885246,Cheap
20140729T000000,348000.0,3,1.75,1720,8867,1.0,0,0,3,8,1320,400,1985,0,98058,47.44,-122.136,2200,9170,7147,6970,39.246644862975074,0.03580327868852459,Very Cheap
20140606T000000,435000.0,2,1.0,1260,4080,1.5,0,0,5,7,1260,0,1926,0,98115,47.687,-122.32,1720,4080,2820,2360,106.61764705882354,0.04721311475409836,Very Cheap
20141113T000000,227950.0,3,1.5,1120,11430,1.0,0,0,4,7,1120,0,1963,0,98031,47.4105,-122.194,1790,8760,10310,6970,19.943132108486438,0.020059016393442625,Very Cheap
20150330T000000,425000.0,2,1.0,1250,5880,1.0,0,0,3,6,900,350,1948,0,98117,47.6908,-122.391,1520,5020,4630,3500,72.27891156462584,0.04590163934426229,Very Cheap
20140602T000000,550000.0,3,2.0,1810,4064,1.5,0,0,3,7,1810,0,1925,0,98103,47.6859,-122.339,1518,2945,2254,1427,135.33464566929135,0.06229508196721312,Very Cheap
20140721T000000,347500.0,3,2.5,1890,7053,2.0,0,0,4,8,1890,0,1992,0,98031,47.3967,-122.183,2000,7226,5163,5226,49.269814263434,0.035737704918032784,Very Cheap
20140930T000000,397000.0,4,1.75,2020,6000,1.0,0,0,3,7,1620,400,1959,0,98144,47.577,-122.302,1870,4000,3980,2130,66.16666666666667,0.04222950819672131,Very Cheap
20140602T000000,410000.0,4,1.75,1790,11875,1.0,0,0,4,7,1490,300,1969,0,98027,47.522,-122.047,1870,11760,10085,9890,34.526315789473685,0.043934426229508196,Very Cheap
20140711T000000,780000.0,3,3.5,3190,6776,2.0,0,0,3,10,3190,0,1998,0,98074,47.6348,-122.064,3230,7189,3586,3959,115.11216056670602,0.09245901639344262,Very Cheap
20140909T000000,1350000.0,4,3.25,3030,5164,1.5,0,0,5,9,2700,330,1925,0,98112,47.6394,-122.299,1890,4415,2134,2525,261.42525174283503,0.16721311475409836,Cheap
20141028T000000,476000.0,3,2.25,1630,3070,2.0,0,0,3,7,1630,0,2004,0,98053,47.6785,-122.03,1690,3200,1440,1510,155.04885993485343,0.052590163934426226,Very Cheap
20140708T000000,390000.0,3,1.75,1180,16552,1.0,0,0,4,7,1180,0,1967,0,98072,47.7426,-122.116,2780,45302,15372,42522,23.562107298211696,0.04131147540983607,Very Cheap
20141230T000000,226500.0,3,2.0,1560,7000,1.0,0,0,4,7,1560,0,1968,0,98001,47.3355,-122.284,1560,7200,5440,5640,32.357142857142854,0.019868852459016394,Very Cheap
20140731T000000,495000.0,3,2.0,1340,2550,2.0,0,0,3,7,1340,0,1984,0,98117,47.6793,-122.38,1370,5100,1210,3730,194.11764705882354,0.05508196721311476,Very Cheap
20150319T000000,1500000.0,5,3.25,2590,11500,1.0,0,2,4,9,2590,0,1968,0,98040,47.545,-122.229,2780,11989,8910,9209,130.43478260869566,0.18688524590163935,Cheap
20150422T000000,385000.0,3,1.0,1020,5950,1.0,0,0,3,6,880,140,1950,0,98106,47.5436,-122.357,1800,5950,4930,4150,64.70588235294117,0.04065573770491803,Very Cheap
20150309T000000,535950.0,3,2.5,2370,5344,2.0,0,0,3,9,2370,0,2003,0,98065,47.54,-121.863,2990,5418,2974,2428,100.29004491017965,0.06045245901639344,Very Cheap
20141022T000000,910000.0,4,2.5,3170,32430,2.5,0,0,3,10,3170,0,1989,0,98053,47.6903,-122.056,3360,35610,29260,32250,28.060437866173295,0.10950819672131147,Cheap
20150326T000000,465000.0,2,1.0,1120,4000,1.0,0,0,3,7,1120,0,1926,0,98105,47.6567,-122.327,1620,4000,2880,2380,116.25,0.051147540983606556,Very Cheap
20140626T000000,495000.0,3,1.75,1440,11787,1.0,0,0,3,8,1440,0,1983,0,98074,47.6276,-122.033,2190,11787,10347,9597,41.99541868159837,0.05508196721311476,Very Cheap
20150210T000000,250000.0,4,2.0,2170,5404,1.5,0,0,5,6,1470,700,1920,0,98002,47.3046,-122.22,1030,5477,3234,4447,46.2620281273131,0.022950819672131147,Very Cheap
20140506T000000,1225000.0,4,2.25,3490,6906,2.0,0,0,4,10,2280,1210,1928,0,98199,47.6424,-122.407,2540,6223,3416,3683,177.3819866782508,0.15081967213114755,Cheap
20150217T000000,400000.0,4,2.25,1970,8941,2.0,0,0,3,7,1970,0,1973,0,98034,47.7223,-122.172,1880,7793,6971,5913,44.73772508667934,0.04262295081967213,Very Cheap
20140821T000000,715000.0,4,2.5,2780,13521,2.0,0,0,3,10,2780,0,1987,0,98074,47.6374,-122.042,2980,11454,10741,8474,52.88070408993418,0.0839344262295082,Very Cheap
20150223T000000,342000.0,3,2.0,2250,7757,1.0,0,0,3,8,2250,0,1992,0,98003,47.2684,-122.308,1970,6866,5507,4896,44.08920974603584,0.03501639344262295,Very Cheap
20150430T000000,420000.0,4,1.75,1340,8400,1.0,0,0,5,7,1340,0,1967,0,98056,47.5382,-122.173,1980,8400,7060,6420,50.0,0.04524590163934426,Very Cheap
20140708T000000,148226.0,3,1.0,1400,7360,1.0,0,0,4,7,1400,0,1968,0,98092,47.3123,-122.186,1600,8030,5960,6430,20.139402173913044,0.009603409836065573,Very Cheap
20141103T000000,313000.0,3,1.0,1510,10369,1.0,0,0,4,7,1010,500,1968,0,98059,47.4808,-122.099,1510,16057,8859,14547,30.186131738836917,0.03121311475409836,Very Cheap
20140603T000000,150000.0,3,1.0,1320,8220,1.0,0,0,3,7,1320,0,1959,0,98198,47.3697,-122.309,1320,7920,6900,6600,18.248175182481752,0.009836065573770493,Very Cheap
20140522T000000,150000.0,2,1.0,820,10270,1.0,0,0,3,7,820,0,1954,0,98168,47.5119,-122.329,1670,10086,9450,8416,14.605647517039921,0.009836065573770493,Very Cheap
20140618T000000,230000.0,2,1.0,1080,9435,1.0,0,0,3,6,1080,0,1958,0,98058,47.459,-122.181,1200,9210,8355,8010,24.377318494965554,0.020327868852459016,Very Cheap
20140902T000000,389100.0,2,1.0,840,5400,1.0,0,0,4,7,840,0,1948,0,98118,47.5489,-122.271,1340,5400,4560,4060,72.05555555555556,0.04119344262295082,Very Cheap
20141216T000000,645000.0,4,2.25,2070,8720,1.0,0,0,5,8,1360,710,1974,0,98033,47.6678,-122.182,2180,8510,6650,6330,73.96788990825688,0.07475409836065573,Very Cheap
20150302T000000,310000.0,3,1.0,1520,6500,1.0,0,0,3,7,990,530,1958,0,98198,47.4164,-122.332,1500,7500,4980,6000,47.69230769230769,0.03081967213114754,Very Cheap
20141004T000000,351358.0,2,1.75,1210,1189,2.0,0,0,3,8,1210,0,2014,0,98029,47.5526,-121.998,1540,1672,-21,132,295.50714886459207,0.03624367213114754,Very Cheap
20150310T000000,1700000.0,5,2.75,3810,9360,2.0,0,0,3,10,3810,0,2014,0,98004,47.6039,-122.194,2110,9870,5550,7760,181.6239316239316,0.21311475409836064,Cheap
20150407T000000,1565000.0,4,3.5,5370,323215,2.0,0,0,3,10,5370,0,2002,0,98075,47.6003,-122.076,3780,9891,317845,6111,4.841978249771824,0.19540983606557377,Cheap
20141020T000000,850000.0,3,2.0,1540,3600,2.0,0,0,3,8,1540,0,1900,1988,98112,47.6343,-122.283,2970,3600,2060,630,236.11111111111111,0.10163934426229508,Cheap
20140514T000000,470000.0,4,2.5,2310,14023,2.0,0,0,3,9,2310,0,1991,0,98019,47.7351,-121.964,2410,14007,11713,11597,33.51636597019183,0.05180327868852459,Very Cheap
20141118T000000,770000.0,3,2.25,1870,1900,3.0,0,0,3,8,1870,0,2008,0,98103,47.6537,-122.34,1690,1694,30,4,405.2631578947368,0.09114754098360656,Very Cheap
20140624T000000,366000.0,3,1.75,1840,11440,1.0,0,0,4,8,1340,500,1977,0,98059,47.474,-122.14,1940,11440,9600,9500,31.993006993006993,0.03816393442622951,Very Cheap
20140710T000000,545000.0,3,2.5,2060,7184,2.0,0,0,3,8,2060,0,1987,0,98029,47.567,-122.012,2230,7788,5124,5558,75.8630289532294,0.06163934426229508,Very Cheap
20140909T000000,205000.0,3,1.0,1010,8800,1.0,0,0,4,7,1010,0,1968,0,98002,47.2761,-122.208,1550,7700,7790,6150,23.295454545454547,0.017049180327868854,Very Cheap
20140508T000000,405000.0,2,1.0,1020,8155,1.0,0,0,4,7,1020,0,1948,0,98177,47.7257,-122.361,1430,8157,7135,6727,49.66278356836297,0.043278688524590166,Very Cheap
20150410T000000,467000.0,4,2.5,2220,7210,1.0,0,0,3,7,1270,950,1973,0,98011,47.7428,-122.183,2220,7313,4990,5093,64.77115117891817,0.05140983606557377,Very Cheap
20140926T000000,392500.0,2,1.0,1050,4125,1.0,0,0,4,7,1050,0,1909,0,98144,47.5736,-122.307,1650,4125,3075,2475,95.15151515151516,0.04163934426229508,Very Cheap
20141027T000000,901000.0,4,2.75,3030,18400,1.5,0,3,3,9,2360,670,1973,0,98034,47.7019,-122.243,3030,12486,15370,9456,48.96739130434783,0.10832786885245901,Cheap
20141203T000000,500000.0,3,1.75,1800,7199,1.0,0,0,3,7,1300,500,1972,0,98125,47.7264,-122.307,1800,8100,5399,6300,69.45409084595083,0.05573770491803279,Very Cheap
20140530T000000,384950.0,3,2.5,1860,3690,2.0,0,0,3,7,1860,0,2000,0,98028,47.776,-122.239,1870,4394,1830,2524,104.32249322493224,0.04064918032786885,Very Cheap
20150312T000000,1700000.0,4,3.5,4070,336283,2.0,0,0,3,11,4070,0,2006,0,98027,47.478,-122.038,3020,44613,332213,41593,5.0552659515943414,0.21311475409836064,Cheap
20140717T000000,245000.0,2,1.0,860,6120,1.0,0,0,3,7,860,0,1948,0,98155,47.7503,-122.328,1100,6860,5260,5760,40.032679738562095,0.022295081967213116,Very Cheap
20150209T000000,1165000.0,4,2.25,3080,10487,2.0,0,0,4,9,3080,0,1968,0,98040,47.5344,-122.224,2480,10607,7407,8127,111.08992085439115,0.14295081967213114,Cheap
20150421T000000,184500.0,3,1.5,1280,3640,2.0,0,0,3,6,1280,0,1983,0,98002,47.334,-122.214,1150,4105,2360,2955,50.68681318681319,0.014360655737704918,Very Cheap
20150414T000000,269000.0,2,2.0,1540,5000,1.5,0,0,3,8,1540,0,1986,0,98023,47.319,-122.394,1590,5000,3460,3410,53.8,0.02544262295081967,Very Cheap
20140721T000000,570000.0,3,2.5,1530,3296,2.0,0,0,3,8,1530,0,1998,0,98007,47.6181,-122.138,1530,4099,1766,2569,172.9368932038835,0.06491803278688525,Very Cheap
20140512T000000,850000.0,4,1.75,2350,11914,1.0,0,0,4,8,2350,0,1961,0,98040,47.5392,-122.228,2240,10706,9564,8466,71.34463656202787,0.10163934426229508,Cheap
20150202T000000,209000.0,3,1.0,920,5200,1.0,0,0,4,6,920,0,1969,0,98042,47.3647,-122.082,920,4875,4280,3955,40.19230769230769,0.017573770491803278,Very Cheap
20140806T000000,327000.0,4,1.75,1840,5100,1.0,0,0,4,5,1840,0,1933,0,98056,47.5209,-122.205,2160,5400,3260,3240,64.11764705882354,0.033049180327868855,Very Cheap
20140613T000000,369500.0,3,1.5,1650,9957,1.0,0,0,4,7,1100,550,1961,0,98125,47.7303,-122.298,1650,7957,8307,6307,37.10957115597068,0.03862295081967213,Very Cheap
20150226T000000,440000.0,3,1.75,1760,8025,1.0,0,0,4,7,1230,530,1976,0,98034,47.7287,-122.192,1590,7543,6265,5953,54.82866043613707,0.04786885245901639,Very Cheap
20140512T000000,947500.0,4,2.25,3290,12329,1.5,0,0,4,10,3290,0,1968,0,98040,47.5639,-122.216,3170,12329,9039,9159,76.85132614161732,0.11442622950819673,Cheap
20150317T000000,510000.0,2,1.0,1270,4500,1.5,0,0,4,7,1270,0,1919,0,98122,47.6059,-122.295,2140,4550,3230,2410,113.33333333333333,0.057049180327868855,Very Cheap
20150428T000000,385000.0,3,2.0,1600,10318,1.0,0,0,3,7,930,670,1941,0,98133,47.7466,-122.347,1590,7040,8718,5450,37.3134328358209,0.04065573770491803,Very Cheap
20140820T000000,370000.0,5,3.0,2670,9920,1.0,0,0,3,8,1400,1270,1990,0,98001,47.3211,-122.277,1890,10341,7250,8451,37.29838709677419,0.038688524590163934,Very Cheap
20141201T000000,660000.0,4,1.5,1960,4500,1.5,0,2,3,7,1960,0,1922,0,98117,47.6797,-122.359,1960,4500,2540,2540,146.66666666666666,0.07672131147540984,Very Cheap
20150115T000000,729000.0,3,4.25,3300,308080,2.0,0,2,4,9,2520,780,1976,0,98070,47.3979,-122.416,2130,90604,304780,88474,2.3662685016878733,0.08577049180327868,Very Cheap
20140819T000000,440000.0,3,1.75,2000,11880,2.0,0,0,3,8,2000,0,1979,0,98075,47.5882,-122.052,1820,15120,9880,13300,37.03703703703704,0.04786885245901639,Very Cheap
20140910T000000,445000.0,4,2.5,2360,81892,1.0,0,0,3,8,2360,0,2000,0,98042,47.369,-122.156,1730,18096,79532,16366,5.4339862257607585,0.04852459016393443,Very Cheap
20141201T000000,460000.0,2,1.0,1430,12092,1.0,0,0,4,7,1430,0,1938,0,98125,47.7023,-122.276,2320,10800,10662,8480,38.04168044988422,0.050491803278688525,Very Cheap
20141202T000000,516000.0,3,3.0,2330,7304,1.0,0,0,3,9,1300,1030,1971,0,98005,47.5982,-122.172,2330,9518,4974,7188,70.6462212486309,0.05783606557377049,Very Cheap
20140815T000000,343888.0,4,2.5,2060,5607,2.0,0,0,3,7,2060,0,2002,0,98058,47.4365,-122.144,2060,5367,3547,3307,61.33190654538969,0.035264,Very Cheap
20140609T000000,500000.0,4,1.75,2240,9886,1.5,0,0,4,7,2240,0,1965,0,98008,47.6294,-122.116,1540,8040,7646,6500,50.57657293141817,0.05573770491803279,Very Cheap
20150508T000000,465000.0,5,1.75,2330,6450,1.0,0,1,3,8,1330,1000,1958,0,98146,47.4959,-122.367,2330,8258,4120,5928,72.09302325581395,0.051147540983606556,Very Cheap
20140512T000000,302000.0,5,2.25,2180,7813,2.0,0,0,3,7,2180,0,1986,0,98038,47.3651,-122.051,1880,8649,5633,6769,38.653526174324845,0.02977049180327869,Very Cheap
20141107T000000,195000.0,2,1.0,1280,7861,1.0,0,0,4,6,1280,0,1913,0,98002,47.3007,-122.228,1020,6480,6581,5460,24.806004325149473,0.015737704918032787,Very Cheap
20140609T000000,640000.0,3,2.5,2140,8925,2.0,0,0,3,8,2140,0,1991,0,98074,47.6314,-122.027,2310,8956,6785,6646,71.70868347338936,0.0740983606557377,Very Cheap
20140623T000000,502000.0,6,2.5,2890,8122,1.0,0,0,3,8,1630,1260,1977,0,98008,47.5886,-122.113,2730,9915,5232,7185,61.80743659197242,0.056,Very Cheap
20150417T000000,360000.0,3,2.5,1480,3851,2.0,0,0,3,8,1480,0,1998,0,98072,47.7732,-122.163,1650,4716,2371,3066,93.48221241236043,0.037377049180327866,Very Cheap
20150325T000000,290500.0,4,2.5,1680,3000,2.0,0,0,3,7,1680,0,2003,0,98178,47.494,-122.279,1420,5500,1320,4080,96.83333333333333,0.028262295081967214,Very Cheap
20140509T000000,248000.0,4,3.0,2163,5883,2.0,0,0,3,7,2163,0,2006,0,98001,47.2734,-122.251,1700,10143,3720,8443,42.155362910079894,0.022688524590163933,Very Cheap
20140516T000000,433000.0,4,2.5,2280,7568,2.0,0,0,4,7,2280,0,2001,0,98056,47.5115,-122.194,2280,5312,5288,3032,57.21458773784355,0.04695081967213115,Very Cheap
20150413T000000,480000.0,2,1.0,820,4200,1.0,0,0,3,7,820,0,1980,0,98112,47.6249,-122.298,1290,4000,3380,2710,114.28571428571429,0.05311475409836065,Very Cheap
20150421T000000,410000.0,3,1.0,1330,5000,1.0,0,0,3,7,1120,210,1957,0,98125,47.7211,-122.308,1920,7790,3670,5870,82.0,0.043934426229508196,Very Cheap
20140505T000000,309950.0,4,2.75,2310,5000,2.0,0,0,3,7,2310,0,2006,0,98038,47.3614,-122.035,1980,5000,2690,3020,61.99,0.03081311475409836,Very Cheap
20141201T000000,253000.0,3,2.0,1290,7372,1.0,0,0,5,7,1290,0,1990,0,98042,47.3658,-122.085,1290,7366,6082,6076,34.31904503526859,0.023344262295081967,Very Cheap
20140506T000000,280000.0,3,1.75,1630,11800,1.0,0,0,4,7,1630,0,1971,0,98045,47.4863,-121.73,2090,57428,10170,55338,23.728813559322035,0.026885245901639345,Very Cheap
20150424T000000,440000.0,3,1.0,1410,8925,1.0,0,0,3,7,1410,0,1958,0,98052,47.6782,-122.162,1330,8925,7515,7595,49.299719887955185,0.04786885245901639,Very Cheap
20141118T000000,333000.0,5,1.75,1240,8936,1.0,0,0,3,7,1240,0,1954,0,98006,47.5738,-122.136,1600,9341,7696,7741,37.26499552372426,0.033836065573770495,Very Cheap
20140616T000000,759950.0,3,2.5,3100,23790,2.0,0,0,3,9,3100,0,2002,0,98075,47.5882,-122.011,2250,40854,20690,38604,31.944094157208912,0.08982950819672131,Very Cheap
20141224T000000,345000.0,3,2.25,2020,9000,2.0,0,0,3,7,2020,0,1979,0,98045,47.4487,-121.775,1460,9680,6980,8220,38.333333333333336,0.03540983606557377,Very Cheap
20140926T000000,350000.0,4,2.5,2500,5831,2.0,0,0,3,8,2500,0,2007,0,98038,47.3454,-122.039,2500,5188,3331,2688,60.024009603841534,0.036065573770491806,Very Cheap
20140807T000000,198000.0,2,1.0,790,14200,1.0,0,0,3,7,790,0,1951,0,98188,47.459,-122.285,1430,10000,13410,8570,13.943661971830986,0.016131147540983607,Very Cheap
20140725T000000,730000.0,3,1.75,2040,11294,1.0,0,0,4,7,1340,700,1952,0,98004,47.5923,-122.197,2120,9587,9254,7467,64.63608995927041,0.0859016393442623,Very Cheap
20140528T000000,266200.0,3,1.5,1430,9600,1.0,0,0,4,7,1430,0,1966,0,98059,47.4737,-122.15,1590,10240,8170,8650,27.729166666666668,0.025075409836065574,Very Cheap
20150316T000000,1060000.0,4,2.5,2250,10160,2.0,0,0,5,8,2250,0,1967,0,98040,47.5645,-122.219,2660,10125,7910,7465,104.33070866141732,0.12918032786885245,Cheap
20140919T000000,95000.0,2,1.0,1070,20450,1.0,0,0,2,6,1070,0,1948,0,98058,47.4338,-122.183,1360,15581,19380,14221,4.645476772616137,0.002622950819672131,Very Cheap
20140623T000000,430000.0,3,1.75,1300,12731,1.0,0,0,3,8,1300,0,1981,0,98074,47.6236,-122.04,1700,13556,11431,11856,33.77582279475296,0.04655737704918033,Very Cheap
20140610T000000,650000.0,4,2.25,2560,9731,2.0,0,0,4,7,2560,0,1973,0,98034,47.7261,-122.246,1860,9731,7171,7871,66.79683485767136,0.07540983606557378,Very Cheap
20150317T000000,379900.0,3,2.5,2190,5071,2.0,0,0,3,8,2190,0,2004,0,98038,47.3506,-122.04,2300,5654,2881,3354,74.91619010057188,0.03998688524590164,Very Cheap
20150427T000000,325000.0,2,1.5,940,1222,2.0,0,0,3,7,860,80,2004,0,98125,47.7178,-122.318,1302,1840,282,538,265.9574468085106,0.03278688524590164,Very Cheap
20140606T000000,455000.0,4,2.25,1740,8449,1.0,0,0,4,7,1170,570,1958,0,98008,47.6079,-122.123,1980,11175,6709,9195,53.852526926263465,0.049836065573770495,Very Cheap
20140915T000000,392000.0,4,3.75,2220,3797,1.5,0,0,4,6,1330,890,1917,0,98108,47.5574,-122.315,1490,4340,1577,2850,103.23939952594154,0.04157377049180328,Very Cheap
20140904T000000,373000.0,3,1.75,1310,7811,1.0,0,0,3,7,1310,0,1976,0,98034,47.7319,-122.167,1530,7800,6501,6270,47.75316860837281,0.03908196721311476,Very Cheap
20141016T000000,951250.0,5,3.0,2710,8227,1.0,0,2,3,8,1910,800,1953,0,98199,47.6505,-122.39,2060,5400,5517,3340,115.62537984684575,0.11491803278688524,Cheap
20140624T000000,502000.0,3,2.0,1300,14350,1.0,0,0,3,7,1300,0,1955,2013,98006,47.5736,-122.152,1520,10670,13050,9150,34.98257839721254,0.056,Very Cheap
20150427T000000,362500.0,3,2.0,1940,40588,1.0,0,0,3,7,1940,0,2000,0,98058,47.4252,-122.159,1860,9657,38648,7797,8.93121119542722,0.03770491803278689,Very Cheap
20140623T000000,525000.0,2,1.0,1080,3500,1.0,0,3,3,7,1080,0,1924,0,98103,47.6667,-122.356,1790,4000,2420,2210,150.0,0.05901639344262295,Very Cheap
20150225T000000,580000.0,4,2.5,2110,11680,1.0,0,0,4,7,1420,690,1977,0,98052,47.6964,-122.118,1890,9600,9570,7710,49.657534246575345,0.06622950819672131,Very Cheap
20141222T000000,278000.0,3,2.25,1590,9425,1.0,0,0,3,7,1170,420,1985,0,98058,47.4291,-122.16,1590,9394,7835,7804,29.49602122015915,0.02662295081967213,Very Cheap
20141216T000000,422500.0,2,1.0,910,4800,1.0,0,0,4,7,910,0,1923,0,98126,47.5536,-122.377,1450,5000,3890,3550,88.02083333333333,0.04557377049180328,Very Cheap
20140909T000000,783200.0,4,2.0,1590,5400,1.0,0,2,3,7,990,600,1900,0,98119,47.637,-122.367,2190,4800,3810,2610,145.03703703703704,0.09287868852459016,Very Cheap
20140620T000000,715000.0,4,2.5,3290,6628,2.0,0,0,3,9,3290,0,2003,0,98075,47.5994,-121.975,3240,5831,3338,2591,107.87567893783947,0.0839344262295082,Very Cheap
20140804T000000,472217.0,3,2.5,2010,2212,2.0,0,0,3,8,1390,620,2014,0,98029,47.5523,-121.998,1690,1619,202,-71,213.47965641952985,0.05209403278688524,Very Cheap
20140528T000000,244615.0,3,2.5,2060,4030,2.0,0,0,3,7,2060,0,1999,0,98032,47.3909,-122.238,2060,4029,1970,1969,60.6985111662531,0.022244590163934427,Very Cheap
20141212T000000,385000.0,3,1.75,1560,14288,1.0,0,0,3,6,780,780,1944,0,98125,47.7183,-122.306,1320,8928,12728,7608,26.945688689809632,0.04065573770491803,Very Cheap
20140725T000000,549995.0,3,1.0,1120,6600,1.0,0,0,3,7,1120,0,1943,0,98105,47.6712,-122.267,1300,6600,5480,5300,83.33257575757575,0.0622944262295082,Very Cheap
20140816T000000,959900.0,4,3.75,3550,15151,2.0,0,0,3,11,3550,0,2004,0,98075,47.5888,-121.971,4340,15151,11601,10811,63.35555408883902,0.11605245901639344,Cheap
20140723T000000,510000.0,6,4.5,3300,7200,2.0,0,0,3,8,3300,0,1980,0,98052,47.6798,-122.104,2470,7561,3900,5091,70.83333333333333,0.057049180327868855,Very Cheap
20140813T000000,367000.0,3,1.75,2000,12669,1.0,0,3,4,7,1200,800,1965,0,98070,47.3579,-122.446,1580,12055,10669,10475,28.968347935906543,0.03829508196721312,Very Cheap
20141008T000000,375000.0,5,3.0,2680,8410,2.0,0,0,3,8,1810,870,1990,0,98058,47.4401,-122.126,1860,8410,5730,6550,44.589774078478,0.03934426229508197,Very Cheap
20140512T000000,500000.0,2,2.25,1290,1334,3.0,0,0,3,8,1290,0,2007,0,98107,47.6719,-122.382,1350,1334,44,-16,374.8125937031484,0.05573770491803279,Very Cheap
20150113T000000,489000.0,2,2.25,1290,1334,3.0,0,0,3,8,1290,0,2007,0,98107,47.6719,-122.382,1350,1334,44,-16,366.56671664167914,0.05429508196721312,Very Cheap
20150427T000000,340000.0,3,2.0,1150,700,2.0,0,0,3,7,800,350,2000,0,98136,47.5552,-122.381,1060,1910,-450,850,485.7142857142857,0.03475409836065574,Very Cheap
20150501T000000,562000.0,3,1.75,1880,5978,1.0,0,0,5,7,940,940,1957,0,98144,47.5793,-122.294,1930,4770,4098,2840,94.01137504182,0.0638688524590164,Very Cheap
20140912T000000,489950.0,3,2.5,2400,7478,2.0,0,0,3,9,2400,0,2002,0,98019,47.7362,-121.974,2980,8182,5078,5202,65.51885530890613,0.05441967213114754,Very Cheap
20141003T000000,652000.0,3,2.25,1920,9600,1.0,0,0,4,8,1560,360,1968,0,98052,47.6341,-122.103,2040,9600,7680,7560,67.91666666666667,0.07567213114754098,Very Cheap
20141024T000000,472000.0,4,3.25,4350,7090,2.0,0,0,3,8,2870,1480,1999,0,98042,47.3747,-122.156,2490,7266,2740,4776,66.57263751763047,0.052065573770491806,Very Cheap
20140612T000000,333000.0,4,2.5,1910,9244,1.0,0,0,4,6,1910,0,1963,0,98059,47.4918,-122.141,2590,9286,7334,6696,36.02336650800519,0.033836065573770495,Very Cheap
20140530T000000,560000.0,3,1.5,2000,7350,1.0,0,0,3,8,2000,0,1953,0,98177,47.7061,-122.368,1890,6960,5350,5070,76.19047619047619,0.06360655737704918,Very Cheap
20141201T000000,799000.0,4,3.5,3290,20107,2.0,0,4,3,10,2220,1070,1990,0,98198,47.355,-122.319,2990,16988,16817,13998,39.737404883871285,0.09495081967213115,Very Cheap
20140710T000000,860000.0,5,2.25,3480,9200,2.0,0,0,3,8,3480,0,1979,0,98006,47.5585,-122.153,3130,9200,5720,6070,93.47826086956522,0.10295081967213114,Cheap
20150430T000000,449500.0,4,2.5,2410,55931,2.0,0,0,3,9,2410,0,1989,0,98092,47.3109,-122.097,2780,55931,53521,53151,8.036688062076488,0.049114754098360656,Very Cheap
20141205T000000,692500.0,4,3.0,2820,11500,2.0,0,0,3,10,2820,0,1991,0,98075,47.5826,-122.028,2770,9694,8680,6924,60.21739130434783,0.08098360655737705,Very Cheap
20140812T000000,925000.0,4,1.75,2710,11400,1.0,0,0,4,9,1430,1280,1976,0,98006,47.561,-122.153,2640,11000,8690,8360,81.14035087719299,0.11147540983606558,Cheap
20141021T000000,267500.0,3,2.25,2080,2856,1.5,0,0,3,7,1550,530,2003,0,98042,47.4198,-122.158,2080,2275,776,195,93.6624649859944,0.025245901639344263,Very Cheap
20140714T000000,396800.0,4,2.5,2200,6018,2.0,0,0,3,8,2200,0,2010,0,98019,47.7338,-121.966,2480,5899,3818,3419,65.93552675307411,0.04220327868852459,Very Cheap
20150409T000000,220000.0,4,1.5,1180,8058,1.0,0,0,5,7,1180,0,1969,0,98092,47.2966,-122.19,1800,9348,6878,7548,27.302060064532142,0.01901639344262295,Very Cheap
20140822T000000,892500.0,3,1.75,2120,56192,1.0,0,1,3,9,1720,400,1959,0,98177,47.7665,-122.372,2240,20500,54072,18260,15.883043849658314,0.10721311475409837,Cheap
20140527T000000,455500.0,3,2.0,1460,10311,1.0,0,0,4,7,1460,0,1975,0,98052,47.6771,-122.156,1690,9679,8851,7989,44.176122587527885,0.0499016393442623,Very Cheap
20140612T000000,743000.0,3,1.75,2110,11250,1.0,0,0,4,8,2110,0,1961,0,98040,47.5402,-122.216,2560,10992,9140,8432,66.04444444444445,0.08760655737704919,Very Cheap
20141205T000000,338000.0,4,1.5,1790,17925,1.0,0,0,4,6,1790,0,1951,0,98155,47.7501,-122.302,1660,15165,16135,13505,18.85634588563459,0.034491803278688525,Very Cheap
20141003T000000,332000.0,3,1.75,1340,13115,1.0,0,0,3,7,1340,0,1978,0,98045,47.5021,-121.77,1370,10800,11775,9430,25.31452535264964,0.033704918032786885,Very Cheap
20150123T000000,563225.0,3,1.0,2460,4000,1.5,0,0,4,7,1370,1090,1918,0,98112,47.6268,-122.297,1680,4000,1540,2320,140.80625,0.0640295081967213,Very Cheap
20150427T000000,1150000.0,4,3.5,3760,20609,2.0,0,0,3,11,3760,0,1990,0,98077,47.7255,-122.059,3360,15761,16849,12401,55.8008637003251,0.14098360655737704,Cheap
20141013T000000,645000.0,2,1.0,1240,5000,1.0,0,0,3,7,1000,240,1920,0,98103,47.6634,-122.351,1480,3500,3760,2020,129.0,0.07475409836065573,Very Cheap
20141230T000000,739000.0,3,2.5,2750,16000,2.0,0,0,4,9,2560,190,1981,0,98033,47.693,-122.187,2370,11279,13250,8909,46.1875,0.08708196721311476,Very Cheap
20140701T000000,435000.0,3,2.5,2530,13446,2.0,0,0,3,9,2530,0,1993,0,98019,47.7345,-121.961,2450,13446,10916,10996,32.351628737170905,0.04721311475409836,Very Cheap
20140729T000000,995000.0,3,2.25,3200,3800,2.0,0,0,5,9,2650,550,1914,0,98102,47.638,-122.317,2400,3900,600,1500,261.8421052631579,0.12065573770491804,Cheap
20150320T000000,520000.0,4,2.75,2020,7357,1.0,0,0,3,7,1350,670,1986,0,98034,47.7145,-122.225,1690,7804,5337,6114,70.68098409677857,0.058360655737704915,Very Cheap
20150429T000000,400000.0,4,2.5,3030,180263,2.0,0,0,3,7,2030,1000,1987,0,98092,47.2953,-122.097,2600,182509,177233,179909,2.218980045821938,0.04262295081967213,Very Cheap
20141007T000000,440000.0,3,1.75,2350,7641,1.0,0,0,3,7,1510,840,1978,0,98034,47.7307,-122.219,2190,7500,5291,5310,57.58408585263709,0.04786885245901639,Very Cheap
20140917T000000,440000.0,3,1.5,1690,6010,1.0,0,0,3,7,1230,460,1946,0,98115,47.6955,-122.291,1690,5418,4320,3728,73.21131447587355,0.04786885245901639,Very Cheap
20150324T000000,738000.0,3,1.0,1280,3900,1.0,0,0,4,7,1280,0,1921,0,98103,47.6545,-122.336,2020,4560,2620,2540,189.23076923076923,0.08695081967213114,Very Cheap
20150403T000000,250000.0,3,1.5,1170,9848,1.0,0,0,3,7,1170,0,1963,0,98028,47.7612,-122.234,2220,5542,8678,3322,25.38586515028432,0.022950819672131147,Very Cheap
20140902T000000,338150.0,4,2.25,2700,8580,2.0,0,0,3,8,2700,0,1992,0,98022,47.2087,-122.009,2420,8580,5880,6160,39.41142191142191,0.03451147540983607,Very Cheap
20140902T000000,425000.0,3,2.25,1800,7371,1.0,0,0,3,7,1280,520,1979,0,98072,47.7584,-122.145,1960,7675,5571,5715,57.658390991724325,0.04590163934426229,Very Cheap
20140613T000000,883000.0,4,2.5,3670,54450,2.0,0,0,3,10,3670,0,1999,0,98074,47.6211,-122.016,2900,49658,50780,46758,16.216712580348943,0.1059672131147541,Cheap
20141202T000000,510000.0,3,2.0,2350,266151,1.5,0,0,3,7,2350,0,1983,0,98014,47.6609,-121.892,2270,222156,263801,219886,1.9162054623127474,0.057049180327868855,Very Cheap
20140913T000000,950000.0,4,1.75,3100,21303,1.0,0,1,4,9,3100,0,1962,0,98075,47.5847,-122.081,3480,9697,18203,6217,44.594658029385535,0.11475409836065574,Cheap
20141013T000000,435000.0,3,1.0,1120,9656,1.0,0,0,5,7,1120,0,1955,0,98006,47.567,-122.139,1720,9908,8536,8188,45.04971002485501,0.04721311475409836,Very Cheap
20140527T000000,415000.0,5,1.5,1900,10226,1.0,0,0,3,7,1130,770,1961,0,98034,47.7226,-122.227,1690,10227,8326,8537,40.58282808527284,0.04459016393442623,Very Cheap
20141006T000000,439000.0,2,2.5,1350,944,2.0,0,0,3,9,870,480,2004,0,98116,47.5591,-122.385,1440,1350,-406,-90,465.04237288135596,0.04773770491803279,Very Cheap
20140527T000000,295832.0,5,1.0,1410,6400,1.0,0,0,5,7,960,450,1955,0,98198,47.4207,-122.334,1400,6500,4990,5100,46.22375,0.028961573770491803,Very Cheap
20141031T000000,285000.0,3,1.75,1560,9514,1.0,0,0,4,7,1560,0,1967,0,98031,47.4088,-122.21,1550,9600,7954,8050,29.95585453016607,0.02754098360655738,Very Cheap
20150430T000000,350000.0,3,1.5,1090,5003,1.0,0,0,3,7,1090,0,1962,0,98125,47.703,-122.321,1540,5279,3913,3739,69.95802518488907,0.036065573770491806,Very Cheap
20141021T000000,489000.0,2,2.75,1465,972,2.0,0,0,3,7,1050,415,2006,0,98112,47.621,-122.298,1480,1430,-493,-50,503.08641975308643,0.05429508196721312,Very Cheap
20141124T000000,304500.0,3,2.25,1790,6930,1.0,0,0,3,7,1390,400,1974,0,98003,47.3536,-122.317,1810,7420,5140,5610,43.93939393939394,0.030098360655737705,Very Cheap
20150317T000000,288000.0,3,1.5,1300,7313,1.0,0,0,4,7,1300,0,1968,0,98055,47.4568,-122.21,1770,8075,6013,6305,39.38192260358266,0.027934426229508195,Very Cheap
20150211T000000,417000.0,3,1.75,1920,9512,1.0,0,0,3,8,1440,480,1980,0,98011,47.7606,-122.167,1820,9512,7592,7692,43.83936080740118,0.04485245901639344,Very Cheap
20150401T000000,615000.0,3,3.0,1420,991,2.0,0,0,3,8,1040,380,2005,0,98102,47.6408,-122.327,1500,1301,-429,-199,620.5852674066599,0.07081967213114754,Very Cheap
20140918T000000,730000.0,5,3.5,3760,4857,2.0,0,3,3,9,2820,940,2004,0,98072,47.7398,-122.167,3000,5693,1097,2693,150.2985381922998,0.0859016393442623,Very Cheap
20140821T000000,178500.0,2,1.0,930,3447,1.0,0,0,4,8,930,0,1978,0,98198,47.3822,-122.318,1160,3447,2517,2287,51.784160139251526,0.01357377049180328,Very Cheap
20140815T000000,300000.0,4,2.0,1580,9600,1.0,0,0,5,7,1050,530,1965,0,98198,47.4091,-122.313,1710,9600,8020,7890,31.25,0.029508196721311476,Very Cheap
20140623T000000,415000.0,4,2.5,2170,8518,1.0,0,3,3,7,1350,820,1955,0,98178,47.5073,-122.234,1880,7680,6348,5800,48.720356891289036,0.04459016393442623,Very Cheap
20140822T000000,452500.0,3,1.75,2040,15695,1.0,0,0,4,8,2040,0,1959,0,98166,47.4155,-122.339,2280,14400,13655,12120,28.830837846447913,0.04950819672131147,Very Cheap
20140814T000000,1010000.0,4,2.75,3430,15877,1.0,0,4,3,11,3430,0,2005,0,98065,47.5364,-121.856,4080,14577,12447,10497,63.61403287774768,0.12262295081967213,Cheap
20141201T000000,653000.0,4,2.5,2160,7000,2.0,0,0,4,9,2160,0,1989,0,98029,47.5659,-122.013,2300,7440,4840,5140,93.28571428571429,0.07580327868852459,Very Cheap
20140514T000000,715000.0,4,2.25,2060,5649,1.0,0,0,5,8,1360,700,1941,0,98199,47.6496,-122.407,2060,5626,3589,3566,126.57107452646486,0.0839344262295082,Very Cheap
20140828T000000,541000.0,3,1.75,1410,4080,1.5,0,0,4,7,1410,0,1927,0,98105,47.6695,-122.32,1820,4080,2670,2260,132.59803921568627,0.06111475409836065,Very Cheap
20141209T000000,245000.0,4,1.5,1850,7547,1.5,0,0,4,7,1850,0,1960,0,98198,47.3714,-122.309,1730,7577,5697,5847,32.46323042268451,0.022295081967213116,Very Cheap
20150217T000000,547000.0,2,1.0,1370,10038,1.5,0,0,4,7,1370,0,1922,0,98133,47.719,-122.339,1610,8822,8668,7212,54.492926877864114,0.061901639344262294,Very Cheap
20150402T000000,750000.0,5,2.75,3330,12408,1.0,0,0,3,10,1740,1590,1976,0,98074,47.6318,-122.058,2780,12000,9078,9220,60.44487427466151,0.08852459016393442,Very Cheap
20150126T000000,575000.0,5,2.5,1970,12375,1.0,0,0,3,8,1570,400,1959,0,98133,47.7412,-122.354,1970,8941,10405,6971,46.464646464646464,0.06557377049180328,Very Cheap
20140813T000000,216000.0,3,1.75,1310,8670,1.0,0,0,4,6,1310,0,1984,0,98092,47.3156,-122.186,2622,7191,7360,4569,24.913494809688583,0.018491803278688525,Very Cheap
20140922T000000,443000.0,3,1.75,1640,4579,1.0,0,0,4,6,1640,0,1916,0,98133,47.7061,-122.352,1580,5040,2939,3460,96.74601441362744,0.048262295081967214,Very Cheap
20141103T000000,257700.0,4,2.25,1600,6202,2.0,0,0,4,7,1600,0,1986,0,98038,47.3784,-122.046,1530,6298,4602,4768,41.55111254434053,0.02396065573770492,Very Cheap
20150414T000000,278000.0,3,1.0,1230,9440,1.0,0,0,3,7,1230,0,1978,0,98045,47.4657,-121.747,1230,10296,8210,9066,29.449152542372882,0.02662295081967213,Very Cheap
20141105T000000,300000.0,3,2.5,2240,3691,2.0,0,0,3,7,2240,0,2003,0,98092,47.3364,-122.169,2619,3691,1451,1072,81.2787862367922,0.029508196721311476,Very Cheap
20150213T000000,269100.0,3,2.5,2190,7904,2.0,0,0,3,8,2190,0,1995,0,98092,47.2617,-122.21,2190,7669,5714,5479,34.046052631578945,0.025455737704918033,Very Cheap
20140818T000000,402500.0,3,1.0,990,10752,1.5,0,0,4,7,990,0,1929,0,98133,47.7648,-122.35,1820,7600,9762,5780,37.434895833333336,0.04295081967213115,Very Cheap
20140610T000000,306888.0,2,1.5,1010,7719,2.0,0,0,3,7,1010,0,1981,0,98056,47.5128,-122.189,1210,7719,6709,6509,39.75748153905946,0.030411540983606558,Very Cheap
20141226T000000,795000.0,4,2.5,2920,14210,2.0,0,0,4,10,2920,0,1978,0,98007,47.6196,-122.15,2840,13702,11290,10862,55.94651653764954,0.09442622950819672,Very Cheap
20140804T000000,525000.0,4,2.5,2310,5573,2.0,0,0,4,9,2310,0,2003,0,98056,47.5197,-122.2,2310,6189,3263,3879,94.20419881571864,0.05901639344262295,Very Cheap
20140720T000000,1050000.0,3,2.5,3470,12076,2.0,0,3,3,10,2560,910,1988,0,98040,47.5319,-122.238,3590,17677,8606,14087,86.94932096720768,0.12786885245901639,Cheap
20140829T000000,452000.0,2,1.0,1220,6000,1.0,0,0,3,6,880,340,1938,0,98118,47.5647,-122.27,1220,6840,4780,5620,75.33333333333333,0.04944262295081967,Very Cheap
20150413T000000,350000.0,3,2.25,1550,5401,2.0,0,0,3,7,1550,0,2000,0,98019,47.737,-121.967,1740,4485,3851,2745,64.80281429364932,0.036065573770491806,Very Cheap
20150409T000000,410000.0,4,2.5,2070,6180,2.0,0,0,3,8,2070,0,2007,0,98056,47.4915,-122.183,1250,6018,4110,4768,66.34304207119742,0.043934426229508196,Very Cheap
20141113T000000,595000.0,3,1.75,2060,3600,1.5,0,0,3,7,1180,880,1905,1985,98119,47.6389,-122.371,1730,2475,1540,745,165.27777777777777,0.06819672131147542,Very Cheap
20150407T000000,499000.0,3,2.5,1690,4851,2.0,0,0,3,7,1690,0,2004,0,98053,47.6795,-122.034,2330,4851,3161,2521,102.86538857967429,0.05560655737704918,Very Cheap
20141022T000000,340000.0,4,2.5,2550,7555,2.0,0,0,3,8,2550,0,2001,0,98001,47.2614,-122.29,2550,6800,5005,4250,45.00330906684315,0.03475409836065574,Very Cheap
20140625T000000,1065000.0,5,3.25,3370,7947,2.0,0,0,3,10,3370,0,2001,0,98033,47.6906,-122.202,2040,7900,4577,5860,134.0128350320876,0.1298360655737705,Cheap
20140528T000000,460000.0,4,3.0,2230,52983,2.0,0,0,3,8,2230,0,1991,0,98030,47.3577,-122.195,2060,8755,50753,6695,8.682030085121642,0.050491803278688525,Very Cheap
20140819T000000,345000.0,4,2.5,2382,5899,2.0,0,0,3,8,2382,0,2011,0,98003,47.2793,-122.295,2382,5897,3517,3515,58.48448889642312,0.03540983606557377,Very Cheap
20150218T000000,280500.0,3,2.25,1620,7566,2.0,0,0,3,7,1620,0,1990,0,98038,47.3566,-122.039,1470,7566,5946,6096,37.07375099127677,0.026950819672131147,Very Cheap
20150225T000000,704000.0,3,1.0,1140,6120,1.5,0,0,3,7,1140,0,1926,0,98115,47.6822,-122.309,1800,4080,4980,2280,115.0326797385621,0.08249180327868852,Very Cheap
20141007T000000,545000.0,3,2.5,2140,40173,2.0,0,0,4,8,2140,0,1990,0,98027,47.4786,-122.066,2380,43016,38033,40636,13.566325641600079,0.06163934426229508,Very Cheap
20140807T000000,335000.0,3,1.5,1900,7584,1.0,0,0,5,7,1900,0,1962,0,98056,47.5091,-122.19,1410,7584,5684,6174,44.17194092827004,0.03409836065573771,Very Cheap
20140523T000000,1325000.0,4,3.0,3370,7920,1.0,0,3,3,10,1860,1510,1988,0,98117,47.6773,-122.403,2730,7380,4550,4650,167.2979797979798,0.16393442622950818,Cheap
20140811T000000,420000.0,3,2.75,2300,8000,1.0,0,0,3,7,1430,870,1965,0,98003,47.3293,-122.306,2070,10200,5700,8130,52.5,0.04524590163934426,Very Cheap
20150220T000000,705000.0,4,2.0,2040,5050,1.0,0,0,5,7,1160,880,1937,0,98115,47.6885,-122.324,2040,5050,3010,3010,139.6039603960396,0.08262295081967214,Very Cheap
20141104T000000,274900.0,4,1.75,1840,10528,1.0,0,0,3,7,1210,630,1990,0,98023,47.2987,-122.385,1620,9331,8688,7711,26.111322188449847,0.02621639344262295,Very Cheap
20140502T000000,499950.0,4,2.5,2860,3345,2.0,0,0,3,8,2190,670,2004,0,98072,47.7735,-122.158,2860,3596,485,736,149.46188340807174,0.05573114754098361,Very Cheap
20150318T000000,415250.0,3,1.5,1400,7550,1.0,0,0,4,7,1400,0,1953,0,98133,47.7566,-122.337,1730,7562,6150,5832,55.0,0.04462295081967213,Very Cheap
20150317T000000,222000.0,3,1.0,990,7520,1.0,0,0,4,7,990,0,1958,0,98002,47.285,-122.207,990,7440,6530,6450,29.52127659574468,0.019278688524590165,Very Cheap
20140814T000000,375000.0,3,2.0,3120,42247,1.0,0,0,4,7,2150,970,1980,0,98042,47.3925,-122.137,2100,43416,39127,41316,8.876369919757616,0.03934426229508197,Very Cheap
20150430T000000,300000.0,3,2.5,1640,5707,2.0,0,0,3,7,1640,0,1995,0,98031,47.4016,-122.209,1850,5827,4067,3977,52.56702295426669,0.029508196721311476,Very Cheap
20141118T000000,456700.0,3,1.75,2820,8879,1.0,0,0,5,7,1540,1280,1920,1957,98146,47.5094,-122.376,1640,7850,6059,6210,51.435972519427864,0.050059016393442624,Very Cheap
20150319T000000,925500.0,3,2.75,1970,5200,1.5,0,3,3,8,1970,0,1915,2002,98136,47.5374,-122.388,2140,5200,3230,3060,177.98076923076923,0.11154098360655738,Cheap
20140723T000000,375000.0,5,2.5,2840,15598,1.0,0,0,4,8,1470,1370,1975,0,98059,47.4693,-122.117,2570,14930,12758,12360,24.041543787665084,0.03934426229508197,Very Cheap
20141014T000000,420000.0,3,2.5,2370,15375,2.0,0,2,3,9,2370,0,1993,0,98042,47.3803,-122.147,2450,9800,13005,7350,27.317073170731707,0.04524590163934426,Very Cheap
20141017T000000,575000.0,3,2.5,2610,7301,2.0,0,0,3,8,2610,0,2004,0,98072,47.7614,-122.139,2460,7181,4691,4721,78.75633474866457,0.06557377049180328,Very Cheap
20150428T000000,335000.0,3,2.0,1340,1951,1.0,0,0,3,6,670,670,1915,0,98144,47.5763,-122.309,1520,2248,611,728,171.7068170169144,0.03409836065573771,Very Cheap
20150218T000000,428000.0,4,2.0,1300,7200,1.0,0,0,3,7,1300,0,1958,0,98122,47.6169,-122.294,1540,6600,5900,5060,59.44444444444444,0.04629508196721312,Very Cheap
20141001T000000,655000.0,4,2.5,3340,34238,1.0,0,0,4,8,2060,1280,1977,0,98077,47.7654,-122.076,2400,36590,30898,34190,19.130790349903616,0.0760655737704918,Very Cheap
20140627T000000,738000.0,3,3.0,2630,4896,2.0,0,0,3,9,2630,0,2006,0,98052,47.6932,-122.133,2880,4972,2266,2092,150.73529411764707,0.08695081967213114,Very Cheap
20140819T000000,415000.0,5,1.75,1960,3748,1.0,0,0,3,7,980,980,1965,0,98133,47.7027,-122.349,1410,3844,1788,2434,110.7257203842049,0.04459016393442623,Very Cheap
20140825T000000,392000.0,3,1.0,1090,6125,1.0,0,0,4,6,790,300,1945,0,98126,47.5343,-122.37,1050,6125,5035,5075,64.0,0.04157377049180328,Very Cheap
20141106T000000,555000.0,2,1.0,1550,4600,1.0,0,0,4,7,1050,500,1941,0,98117,47.686,-122.384,1550,4600,3050,3050,120.65217391304348,0.06295081967213115,Very Cheap
20150306T000000,260000.0,3,2.5,1770,2677,2.0,0,0,3,7,1770,0,2005,0,98055,47.4339,-122.194,1550,1798,907,248,97.12364587224505,0.024262295081967214,Very Cheap
20150309T000000,392500.0,3,1.0,1390,10500,1.5,0,0,3,6,1390,0,1940,0,98024,47.567,-121.893,1350,9800,9110,8450,37.38095238095238,0.04163934426229508,Very Cheap
20140801T000000,912000.0,3,2.5,2979,17313,2.0,0,2,3,11,2979,0,1993,0,98006,47.5503,-122.118,3890,14797,14334,10907,52.677178998440475,0.10977049180327869,Cheap
20141118T000000,135000.0,2,1.0,830,7609,1.0,0,0,3,6,830,0,1943,0,98146,47.5057,-122.348,1170,7609,6779,6439,17.742147456958865,0.007868852459016393,Very Cheap
20140813T000000,500000.0,3,2.75,1560,77536,1.0,0,0,3,7,1400,160,1978,0,98072,47.7695,-122.126,2210,41449,75976,39239,6.448617416425918,0.05573770491803279,Very Cheap
20141229T000000,238000.0,3,1.5,1360,7488,1.0,0,0,4,7,1050,310,1975,0,98001,47.3314,-122.275,1580,7508,6128,5928,31.784188034188034,0.02137704918032787,Very Cheap
20141001T000000,251000.0,4,2.0,1650,5974,1.0,0,0,5,7,860,790,1972,0,98178,47.5008,-122.257,1940,6001,4324,4061,42.015400066956815,0.023081967213114753,Very Cheap
20140714T000000,406500.0,2,1.75,1510,5319,2.0,0,0,4,8,1510,0,1978,0,98052,47.6647,-122.13,1740,6160,3809,4420,76.42413987591652,0.04347540983606557,Very Cheap
20150312T000000,433495.0,4,2.25,3010,10925,2.0,0,0,4,9,3010,0,1988,0,98092,47.3326,-122.201,2690,10925,7915,8235,39.679176201373,0.047015737704918036,Very Cheap
20141224T000000,265000.0,3,2.25,1510,6071,1.0,0,0,4,7,1150,360,1985,0,98042,47.3619,-122.077,1510,7271,4561,5761,43.65014000988305,0.024918032786885248,Very Cheap
20150206T000000,360000.0,3,1.75,1950,7260,1.0,0,0,3,8,1520,430,1957,0,98133,47.7187,-122.33,1950,7548,5310,5598,49.586776859504134,0.037377049180327866,Very Cheap
20140717T000000,425000.0,4,1.0,1800,12485,1.0,0,0,5,7,950,850,1955,0,98006,47.5729,-122.147,1290,9840,10685,8550,34.040849018822584,0.04590163934426229,Very Cheap
20150327T000000,450000.0,2,2.75,2810,11205,1.0,0,0,3,7,1510,1300,1968,0,98178,47.4869,-122.243,2520,13000,8395,10480,40.16064257028113,0.04918032786885246,Very Cheap
20150316T000000,449900.0,3,1.75,1760,8266,1.0,0,0,5,7,1760,0,1954,0,98133,47.7708,-122.339,1400,8519,6506,7119,54.427776433583354,0.049167213114754096,Very Cheap
20141017T000000,345000.0,4,2.5,2040,5875,2.0,0,0,3,8,2040,0,2004,0,98056,47.5051,-122.17,2230,5459,3835,3229,58.723404255319146,0.03540983606557377,Very Cheap
20141009T000000,612500.0,4,2.0,1690,35346,1.0,0,0,3,7,1690,0,1967,0,98008,47.6149,-122.124,2050,37846,33656,35796,17.32869348724042,0.07049180327868852,Very Cheap
20140805T000000,317000.0,3,1.75,1530,7650,1.0,0,0,4,8,1530,0,1977,0,98058,47.4435,-122.128,1850,6804,6120,4954,41.43790849673203,0.03173770491803279,Very Cheap
20150507T000000,585000.0,3,1.5,1810,3880,1.5,0,0,4,8,1310,500,1929,0,98117,47.6835,-122.392,1400,3880,2070,2480,150.77319587628867,0.06688524590163934,Very Cheap
20140618T000000,455000.0,3,1.75,1180,14292,1.0,0,0,3,7,1180,0,1981,0,98045,47.4818,-121.733,1480,14400,13112,12920,31.835992163448083,0.049836065573770495,Very Cheap
20141201T000000,1035000.0,4,4.0,4090,51908,2.0,0,0,3,11,4090,0,1991,0,98077,47.7226,-122.039,4290,41655,47818,37365,19.939123063882253,0.1259016393442623,Cheap
20140820T000000,497000.0,4,2.25,2250,3463,2.0,0,0,4,8,2250,0,1968,0,98052,47.6324,-122.106,1850,2811,1213,961,143.51718163442104,0.055344262295081964,Very Cheap
20150422T000000,226750.0,3,1.75,1070,6315,1.0,0,0,3,7,1070,0,1992,0,98023,47.2803,-122.356,1520,5707,5245,4187,35.906571654790184,0.019901639344262295,Very Cheap
20140819T000000,385000.0,4,2.0,1820,7102,1.0,0,0,3,7,1220,600,1950,0,98155,47.7447,-122.324,1650,8184,5282,6534,54.210081667136016,0.04065573770491803,Very Cheap
20141211T000000,205000.0,3,0.75,1080,5025,1.0,0,0,3,5,1080,0,1948,0,98146,47.4936,-122.335,1370,6000,3945,4630,40.79601990049751,0.017049180327868854,Very Cheap
20140929T000000,745000.0,4,2.5,2760,13093,2.0,0,0,4,9,2760,0,1989,0,98075,47.5845,-122.06,2810,13545,10333,10735,56.90063392652562,0.08786885245901639,Very Cheap
20140620T000000,371000.0,4,2.5,2550,4770,2.0,0,0,3,8,2550,0,2005,0,98038,47.3526,-122.0,2380,4590,2220,2210,77.77777777777777,0.038819672131147544,Very Cheap
20140829T000000,545000.0,4,2.5,2080,8504,2.0,0,0,3,8,2080,0,1991,0,98029,47.5703,-121.998,2000,6773,6424,4773,64.08748824082785,0.06163934426229508,Very Cheap
20150508T000000,443000.0,3,1.0,1280,5460,1.5,0,0,4,7,1280,0,1931,0,98133,47.7321,-122.334,1390,5500,4180,4110,81.13553113553114,0.048262295081967214,Very Cheap
20150318T000000,287000.0,2,1.0,950,6350,1.0,0,0,3,7,950,0,1951,0,98106,47.528,-122.352,1080,7620,5400,6540,45.196850393700785,0.02780327868852459,Very Cheap
20140624T000000,194000.0,3,1.0,1050,7577,1.0,0,0,3,7,1050,0,1983,0,98023,47.2891,-122.357,1430,7245,6527,5815,25.603800976639832,0.01560655737704918,Very Cheap
20140629T000000,265000.0,3,1.0,1800,7650,1.0,0,0,5,7,1800,0,1957,0,98056,47.4922,-122.178,1230,7650,5850,6420,34.64052287581699,0.024918032786885248,Very Cheap
20150408T000000,1135000.0,4,2.75,3840,10004,1.0,0,2,4,9,2110,1730,1963,0,98040,47.5606,-122.225,3500,12118,6164,8618,113.4546181527389,0.13901639344262295,Cheap
20150508T000000,699950.0,4,3.25,3674,12793,2.0,0,1,3,9,3674,0,1987,0,98166,47.4357,-122.343,3220,13100,9119,9880,54.71351520362698,0.08196065573770492,Very Cheap
20141015T000000,433000.0,4,1.0,1710,7000,1.5,0,0,3,7,1710,0,1950,0,98125,47.7037,-122.293,2030,7938,5290,5908,61.857142857142854,0.04695081967213115,Very Cheap
20141016T000000,200000.0,2,1.75,910,2693,1.0,0,0,3,6,910,0,2003,0,98038,47.3493,-122.025,1360,2693,1783,1333,74.26661715558856,0.01639344262295082,Very Cheap
20150409T000000,289571.0,3,1.5,1340,25160,1.0,0,0,3,7,1340,0,1968,0,98059,47.475,-122.111,1440,23680,23820,22240,11.509181240063594,0.028140459016393442,Very Cheap
20140602T000000,440000.0,4,2.75,2340,11034,1.0,0,0,3,8,1720,620,1967,0,98155,47.7686,-122.278,2370,11941,8694,9571,39.87674460757658,0.04786885245901639,Very Cheap
20141113T000000,400000.0,3,1.5,1510,8360,1.0,0,0,3,7,1120,390,1960,0,98007,47.6119,-122.133,1700,8360,6850,6660,47.84688995215311,0.04262295081967213,Very Cheap
20141014T000000,589000.0,4,2.5,2630,15000,2.0,0,0,5,8,2630,0,1962,0,98027,47.5262,-122.028,1770,8700,12370,6930,39.266666666666666,0.06740983606557377,Very Cheap
20150324T000000,850000.0,5,2.25,3100,97661,2.0,0,0,3,9,3100,0,1986,0,98053,47.6624,-122.062,2370,53993,94561,51623,8.703576658031354,0.10163934426229508,Cheap
20150102T000000,520000.0,3,1.0,940,3000,1.5,0,0,3,7,940,0,1903,0,98122,47.6033,-122.3,1210,3500,2060,2290,173.33333333333334,0.058360655737704915,Very Cheap
20150423T000000,555000.0,2,2.25,1370,1248,2.0,0,0,3,7,1200,170,2000,0,98102,47.6399,-122.32,1800,3360,-122,1560,444.71153846153845,0.06295081967213115,Very Cheap
20150309T000000,470000.0,3,2.5,2480,5082,2.0,0,0,3,7,2480,0,2004,0,98065,47.5297,-121.846,2480,5874,2602,3394,92.48327430145612,0.05180327868852459,Very Cheap
20141229T000000,207000.0,2,1.5,1068,1158,2.0,0,0,3,7,1068,0,1990,0,98028,47.753,-122.244,1078,1278,90,200,178.75647668393782,0.017311475409836064,Very Cheap
20141113T000000,379750.0,4,2.75,2390,9650,1.0,0,2,3,8,1620,770,1976,0,98003,47.3438,-122.322,2390,10000,7260,7610,39.35233160621762,0.0399672131147541,Very Cheap
20150507T000000,709000.0,4,1.75,2170,4600,1.0,0,0,3,7,1270,900,1950,0,98117,47.6894,-122.384,1750,4000,2430,2250,154.1304347826087,0.08314754098360656,Very Cheap
20140923T000000,240000.0,3,2.5,1520,9864,1.0,0,0,3,7,1160,360,1993,0,98092,47.3186,-122.171,1580,7425,8344,5845,24.330900243309003,0.021639344262295083,Very Cheap
20150204T000000,445500.0,4,1.5,2210,10497,1.0,0,0,4,8,1650,560,1953,0,98166,47.4321,-122.347,1840,12697,8287,10857,42.44069734209774,0.04859016393442623,Very Cheap
20140909T000000,1308000.0,5,2.5,3200,7863,1.0,0,3,5,8,1600,1600,1959,0,98199,47.6398,-122.39,2640,7680,4663,5040,166.34872186188477,0.1617049180327869,Cheap
20150324T000000,210000.0,3,1.5,1160,10125,1.0,0,0,4,7,1160,0,1959,0,98059,47.4919,-122.151,1440,10018,8965,8578,20.74074074074074,0.017704918032786884,Very Cheap
20140811T000000,603000.0,4,2.5,2670,5895,2.0,0,0,3,8,2670,0,1999,0,98074,47.6066,-122.016,2820,6531,3225,3711,102.29007633587786,0.06924590163934426,Very Cheap
20150407T000000,720000.0,3,2.5,2520,10012,2.0,0,0,3,10,2520,0,1987,0,98074,47.6295,-122.051,2680,10071,7492,7391,71.91370355573312,0.08459016393442623,Very Cheap
20140616T000000,92000.0,2,1.0,760,5500,1.5,0,0,3,5,760,0,1947,0,98168,47.5045,-122.329,1040,5515,4740,4475,16.727272727272727,0.0022295081967213114,Very Cheap
20150126T000000,600000.0,3,1.75,1310,5000,2.0,0,0,4,7,1310,0,1901,0,98107,47.6722,-122.379,1270,4750,3690,3480,120.0,0.06885245901639345,Very Cheap
20150408T000000,725000.0,4,2.5,2750,13950,1.0,0,3,4,8,1380,1370,1948,0,98146,47.4938,-122.364,2460,13950,11200,11490,51.971326164874554,0.08524590163934426,Very Cheap
20141210T000000,409950.0,5,2.25,1790,10300,1.0,0,0,3,7,1270,520,1961,0,98155,47.7718,-122.292,1790,10300,8510,8510,39.800970873786405,0.043927868852459015,Very Cheap
20140506T000000,515000.0,3,2.5,1790,7167,2.0,0,0,3,8,1790,0,1989,0,98074,47.6176,-122.045,1680,7418,5377,5738,71.85712292451514,0.057704918032786885,Very Cheap
20150512T000000,495000.0,4,2.5,2400,11640,1.0,0,0,5,8,1800,600,1968,0,98058,47.4485,-122.139,2440,10823,9240,8383,42.52577319587629,0.05508196721311476,Very Cheap
20140624T000000,998000.0,4,2.25,2420,10200,2.0,0,0,4,9,2420,0,1973,0,98040,47.5336,-122.225,2390,10200,7780,7810,97.84313725490196,0.12104918032786885,Cheap
20140709T000000,630000.0,3,1.75,1710,8767,1.0,0,0,4,8,1710,0,1986,0,98033,47.6945,-122.188,2050,9200,7057,7150,71.86038553667161,0.07278688524590164,Very Cheap
20140801T000000,410000.0,3,1.75,2000,7480,1.0,0,0,3,8,1320,680,1972,0,98177,47.7734,-122.359,2000,8610,5480,6610,54.81283422459893,0.043934426229508196,Very Cheap
20140819T000000,602000.0,3,2.25,1580,11580,1.0,0,0,4,8,1580,0,1979,0,98006,47.5503,-122.155,2630,10009,10000,7379,51.98618307426597,0.06911475409836065,Very Cheap
20141112T000000,750000.0,4,2.75,2310,10232,1.0,0,0,5,8,1310,1000,1980,0,98006,47.5515,-122.153,2820,9886,7922,7066,73.29945269741987,0.08852459016393442,Very Cheap
20140708T000000,711600.0,4,3.0,3580,9316,2.5,0,0,3,10,2370,1210,1991,0,98007,47.595,-122.133,2580,9242,5736,6662,76.3847144697295,0.08348852459016394,Very Cheap
20140825T000000,1050000.0,4,4.0,4320,8709,2.0,0,0,3,11,3190,1130,2006,0,98027,47.5369,-122.07,4010,8321,4389,4311,120.56493282810885,0.12786885245901639,Cheap
20141217T000000,700500.0,3,2.5,2560,35265,2.0,0,0,3,9,2560,0,1981,0,98072,47.7354,-122.095,2820,35496,32705,32676,19.863887707358572,0.0820327868852459,Very Cheap
20150204T000000,710000.0,4,2.5,3220,18618,2.0,0,1,3,10,3220,0,1991,0,98056,47.5326,-122.181,2650,11896,15398,9246,38.135138038457406,0.08327868852459017,Very Cheap
20141204T000000,250000.0,3,2.0,1660,13085,1.0,0,0,3,7,1010,650,1985,0,98001,47.3298,-122.277,1660,7778,11425,6118,19.105846388995033,0.022950819672131147,Very Cheap
20141015T000000,350000.0,4,1.75,2420,8400,1.0,0,0,5,7,1620,800,1964,0,98056,47.5017,-122.165,1660,8400,5980,6740,41.666666666666664,0.036065573770491806,Very Cheap
20140515T000000,475000.0,7,3.5,2870,29699,1.0,0,0,3,7,1520,1350,1961,0,98125,47.7153,-122.327,1380,7555,26829,6175,15.993804505202196,0.05245901639344262,Very Cheap
20150116T000000,200000.0,2,1.0,830,7200,1.0,0,0,2,6,830,0,1920,0,98118,47.5604,-122.275,1150,6600,6370,5450,27.77777777777778,0.01639344262295082,Very Cheap
20141030T000000,450000.0,4,2.25,1710,7000,1.0,0,0,4,7,1040,670,1972,0,98034,47.719,-122.217,1780,6500,5290,4720,64.28571428571429,0.04918032786885246,Very Cheap
20140801T000000,316000.0,5,2.5,2600,4641,2.0,0,0,3,7,2600,0,2005,0,98058,47.4325,-122.146,2330,4589,2041,2259,68.08877397112691,0.03160655737704918,Very Cheap
20141016T000000,310000.0,1,1.0,670,4920,1.0,0,0,3,5,670,0,1920,0,98126,47.5342,-122.373,1050,4920,4250,3870,63.00813008130081,0.03081967213114754,Very Cheap
20150223T000000,392000.0,3,1.5,1500,11975,1.0,0,0,4,7,1500,0,1970,0,98045,47.4658,-121.758,1510,13875,10475,12365,32.734864300626306,0.04157377049180328,Very Cheap
20141006T000000,521000.0,3,3.25,1460,1254,3.0,0,0,3,8,1460,0,2000,0,98103,47.6535,-122.353,1400,1255,-206,-145,415.4704944178628,0.058491803278688526,Very Cheap
20140822T000000,495000.0,2,2.0,1540,7110,1.0,0,0,3,7,960,580,1949,0,98117,47.6932,-122.395,1860,7065,5570,5205,69.62025316455696,0.05508196721311476,Very Cheap
20141121T000000,209000.0,3,1.75,1250,8084,1.0,0,0,4,7,1250,0,1967,0,98001,47.3364,-122.276,1340,7680,6834,6340,25.853537852548243,0.017573770491803278,Very Cheap
20140606T000000,809950.0,4,2.0,2230,9900,1.5,0,0,5,9,2230,0,1959,0,98005,47.5979,-122.173,2510,11041,7670,8531,81.81313131313131,0.09638688524590164,Very Cheap
20140917T000000,400000.0,2,1.75,1800,224769,1.0,0,0,3,7,1420,380,1950,2008,98038,47.4327,-122.06,1620,112384,222969,110764,1.7796048387455565,0.04262295081967213,Very Cheap
20150312T000000,415000.0,4,2.5,2400,7292,1.0,0,0,3,8,1530,870,1980,0,98133,47.7749,-122.339,1710,7909,4892,6199,56.91168403730115,0.04459016393442623,Very Cheap
20140702T000000,411000.0,4,2.0,2370,76665,2.0,0,0,4,8,2370,0,1978,0,98001,47.2831,-122.279,2110,19334,74295,17224,5.360986108393661,0.044065573770491806,Very Cheap
20140911T000000,825000.0,2,2.0,1830,3600,1.0,0,0,4,7,1230,600,1926,0,98109,47.6359,-122.351,2020,3600,1770,1580,229.16666666666666,0.09836065573770492,Very Cheap
20150223T000000,436000.0,3,2.25,1480,1384,3.0,0,0,3,8,1480,0,2008,0,98103,47.691,-122.342,1310,1329,-96,19,315.02890173410407,0.047344262295081964,Very Cheap
20140708T000000,460000.0,4,2.5,2620,8331,2.0,0,0,3,9,2620,0,1991,0,98058,47.4357,-122.159,2760,8174,5711,5414,55.21546032889209,0.050491803278688525,Very Cheap
20140714T000000,281000.0,3,1.0,1300,5782,1.0,0,0,4,6,1300,0,1959,0,98065,47.524,-121.821,1020,7200,4482,6180,48.599100657212034,0.027016393442622952,Very Cheap
20140825T000000,976000.0,4,1.5,3120,7680,1.0,0,3,3,8,1660,1460,1956,0,98199,47.646,-122.39,2900,7680,4560,4780,127.08333333333333,0.11816393442622951,Cheap
20150420T000000,485000.0,4,2.5,2400,10364,2.0,0,0,3,8,2400,0,1995,0,98045,47.4832,-121.799,2390,9918,7964,7528,46.79660362794288,0.05377049180327869,Very Cheap
20140725T000000,429000.0,3,2.5,1430,9240,2.0,0,0,3,7,1430,0,1984,0,98074,47.6258,-122.058,1480,8125,7810,6645,46.42857142857143,0.04642622950819672,Very Cheap
20150304T000000,729000.0,3,2.5,2480,7428,2.0,0,0,3,9,2480,0,1990,0,98006,47.5489,-122.185,2600,8322,4948,5722,98.1421647819063,0.08577049180327868,Very Cheap
20150409T000000,625000.0,3,2.5,2280,4757,2.0,0,0,3,8,2280,0,2003,0,98075,47.5901,-122.018,2280,4534,2477,2254,131.3853268866933,0.07213114754098361,Very Cheap
20150116T000000,218500.0,3,1.75,1390,9328,1.0,0,0,4,7,1390,0,1987,0,98092,47.2766,-122.146,1550,8374,7938,6824,23.42409948542024,0.01881967213114754,Very Cheap
20150206T000000,175000.0,3,1.0,1030,8395,1.0,0,0,4,7,1030,0,1960,0,98023,47.3322,-122.337,1370,9380,7365,8010,20.84574151280524,0.013114754098360656,Very Cheap
20150205T000000,442500.0,3,1.0,1120,8200,1.0,0,0,4,7,1120,0,1938,0,98125,47.7254,-122.29,1820,7205,7080,5385,53.96341463414634,0.04819672131147541,Very Cheap
20150321T000000,480000.0,3,2.0,1300,3000,2.0,0,0,3,7,1300,0,1986,0,98115,47.6728,-122.325,1670,4500,1700,2830,160.0,0.05311475409836065,Very Cheap
20141008T000000,715500.0,3,2.25,2410,9668,1.0,0,1,4,8,1540,870,1965,0,98117,47.6996,-122.391,2510,5250,7258,2740,74.00703351261895,0.084,Very Cheap
20141120T000000,432500.0,3,1.75,1470,7350,1.0,0,0,3,8,1470,0,1963,0,98052,47.6687,-122.154,1470,7350,5880,5880,58.843537414965986,0.046885245901639346,Very Cheap
20140731T000000,875000.0,5,4.25,4720,18741,2.0,0,0,3,11,3210,1510,2005,0,98053,47.6347,-122.013,3880,37328,14021,33448,46.689077423830106,0.10491803278688525,Cheap
20141114T000000,605000.0,5,2.75,2910,13332,2.0,0,0,4,8,2910,0,1940,1991,98146,47.4977,-122.359,1760,8900,10422,7140,45.37953795379538,0.06950819672131148,Very Cheap
20150113T000000,1688000.0,4,4.0,5000,12941,3.0,0,2,3,12,5000,0,2002,0,98006,47.55,-122.103,4560,12941,7941,8381,130.4381423383046,0.21154098360655738,Cheap
20150210T000000,318000.0,3,2.25,1690,12662,1.0,0,0,5,7,1090,600,1982,0,98178,47.4972,-122.264,1950,9642,10972,7692,25.11451587426947,0.03186885245901639,Very Cheap
20141016T000000,311300.0,2,1.0,1000,7228,1.0,0,0,4,7,1000,0,1947,0,98133,47.7294,-122.352,1100,7228,6228,6128,43.068622025456555,0.03099016393442623,Very Cheap
20150415T000000,325000.0,5,2.75,2400,7904,1.0,0,0,3,7,1450,950,1992,0,98188,47.4683,-122.263,2400,7475,5504,5075,41.11842105263158,0.03278688524590164,Very Cheap
20141117T000000,795000.0,5,3.5,3330,3705,2.0,0,0,3,9,2610,720,2008,0,98006,47.5567,-122.124,2810,3971,375,1161,214.5748987854251,0.09442622950819672,Very Cheap
20140619T000000,558000.0,4,2.25,2060,10358,1.0,0,0,4,8,1320,740,1962,0,98006,47.5478,-122.174,2060,9676,8298,7616,53.87140374589689,0.06334426229508197,Very Cheap
20140528T000000,370000.0,4,2.5,3090,18645,2.0,0,0,3,9,3090,0,1995,0,98023,47.2902,-122.342,3610,20114,15555,16504,19.84446232233843,0.038688524590163934,Very Cheap
20141118T000000,598850.0,4,2.5,2350,7245,2.0,0,0,3,8,2350,0,1993,0,98074,47.6318,-122.023,2350,9419,4895,7069,82.65700483091787,0.0687016393442623,Very Cheap
20141023T000000,515700.0,3,2.5,2180,9722,2.0,0,0,3,8,2180,0,1994,0,98056,47.527,-122.173,2440,9722,7542,7282,53.04464102036618,0.05779672131147541,Very Cheap
20140620T000000,458000.0,3,2.5,1870,5013,2.0,0,0,3,8,1870,0,2003,0,98011,47.7552,-122.221,2040,5555,3143,3515,91.36245761021344,0.05022950819672131,Very Cheap
20150224T000000,583500.0,3,2.25,3530,13000,2.5,0,0,4,10,3530,0,1985,0,98042,47.3823,-122.159,2960,13000,9470,10040,44.88461538461539,0.06668852459016393,Very Cheap
20140723T000000,653750.0,4,2.5,2460,4166,2.0,0,0,3,9,2460,0,2003,0,98034,47.7072,-122.232,2460,4964,1706,2504,156.92510801728275,0.07590163934426229,Very Cheap
20140711T000000,299000.0,3,2.5,1650,4725,2.0,0,0,3,8,1650,0,2011,0,98038,47.3548,-122.055,2000,4725,3075,2725,63.28042328042328,0.02937704918032787,Very Cheap
20140509T000000,532000.0,5,3.0,3480,57499,1.0,0,0,4,8,2340,1140,1976,0,98027,47.4574,-122.024,2020,40946,54019,38926,9.252334823214317,0.059934426229508196,Very Cheap
20140708T000000,819000.0,3,2.75,3176,13391,2.0,0,3,4,9,2726,450,1985,0,98198,47.3429,-122.33,3470,12779,10215,9309,61.16048092002091,0.09757377049180328,Very Cheap
20140718T000000,945000.0,4,2.25,2420,9000,1.0,0,4,5,9,2000,420,1967,0,98146,47.4884,-122.363,2400,9035,6580,6635,105.0,0.11409836065573771,Cheap
20141106T000000,608700.0,4,2.5,2260,9696,1.0,0,0,3,9,2260,0,1983,0,98074,47.643,-122.066,2400,12111,7436,9711,62.77846534653465,0.06999344262295082,Very Cheap
20150509T000000,812000.0,4,2.0,2380,6122,1.0,0,2,4,8,1310,1070,1949,0,98199,47.6506,-122.405,1810,5202,3742,3392,132.63639333551126,0.09665573770491803,Very Cheap
20140513T000000,464000.0,5,2.5,3400,8970,1.0,0,0,4,8,1700,1700,1959,0,98133,47.7358,-122.335,1890,8475,5570,6585,51.727982162764775,0.05101639344262295,Very Cheap
20140613T000000,950000.0,4,2.5,3770,35081,2.0,0,0,3,10,3770,0,1989,0,98053,47.6908,-122.051,4000,35492,31311,31492,27.080185855591346,0.11475409836065574,Cheap
20141203T000000,700000.0,4,2.5,2672,4297,2.0,0,0,3,8,2020,652,2005,0,98115,47.6955,-122.289,1720,6120,1625,4400,162.90435187340006,0.08196721311475409,Very Cheap
20141016T000000,435000.0,3,1.0,1180,4219,1.0,0,0,3,7,1060,120,1939,0,98117,47.6867,-122.378,1630,4219,3039,2589,103.10500118511496,0.04721311475409836,Very Cheap
20141007T000000,229500.0,3,1.5,1810,14400,1.0,0,0,4,7,1810,0,1954,0,98001,47.2887,-122.269,1710,12000,12590,10290,15.9375,0.020262295081967214,Very Cheap
20141117T000000,1575000.0,3,3.0,2610,22672,1.5,1,4,4,8,2610,0,1952,0,98166,47.4414,-122.354,2810,22672,20062,19862,69.46894848270995,0.19672131147540983,Cheap
20141103T000000,265000.0,3,2.25,1450,13439,1.0,0,0,4,7,1180,270,1963,0,98003,47.2811,-122.299,1520,12348,11989,10828,19.718729072103578,0.024918032786885248,Very Cheap
20140828T000000,995000.0,2,2.0,1600,64468,1.0,0,0,3,7,1600,0,1950,0,98072,47.7344,-122.143,1950,64468,62868,62518,15.43401377427561,0.12065573770491804,Cheap
20140709T000000,590000.0,3,2.5,2650,9380,1.0,0,0,5,8,1680,970,1975,0,98155,47.7756,-122.273,2310,9600,6730,7290,62.89978678038379,0.06754098360655737,Very Cheap
20140611T000000,740000.0,4,2.75,2490,17833,2.0,0,2,3,9,1490,1000,1979,0,98125,47.7206,-122.284,2640,16943,15343,14303,41.49610273089217,0.08721311475409836,Very Cheap
20140521T000000,360000.0,2,0.75,850,7710,1.0,0,2,5,6,550,300,1909,0,98108,47.5588,-122.301,2500,6022,6860,3522,46.69260700389105,0.037377049180327866,Very Cheap
20150406T000000,548500.0,4,2.0,1820,7200,1.0,0,0,3,7,1300,520,1976,0,98136,47.5161,-122.388,1770,8149,5380,6379,76.18055555555556,0.062098360655737705,Very Cheap
20140507T000000,599000.0,3,1.75,1960,4788,1.0,0,0,4,7,1090,870,1920,0,98115,47.6746,-122.312,1960,3960,2828,2000,125.10442773600668,0.06872131147540983,Very Cheap
20140613T000000,615000.0,3,1.75,2350,20820,1.0,0,0,4,8,1800,550,1978,0,98074,47.6095,-122.059,2040,10800,18470,8760,29.538904899135446,0.07081967213114754,Very Cheap
20141208T000000,292000.0,3,1.75,1320,6600,1.0,0,0,3,7,1320,0,1988,0,98168,47.4838,-122.33,1070,6594,5280,5524,44.24242424242424,0.028459016393442622,Very Cheap
20141023T000000,899000.0,4,2.5,3720,30649,2.0,0,0,3,10,3720,0,1988,0,98053,47.6651,-122.056,3220,29434,26929,26214,29.332115240301476,0.10806557377049181,Cheap
20141208T000000,500000.0,3,1.5,2210,6500,1.0,0,0,4,7,1030,1180,1912,0,98136,47.5434,-122.388,1750,6370,4290,4620,76.92307692307692,0.05573770491803279,Very Cheap
20141113T000000,580000.0,3,2.5,1910,11550,1.5,0,0,3,8,1910,0,2003,0,98074,47.6213,-122.064,2230,11550,9640,9320,50.21645021645022,0.06622950819672131,Very Cheap
20140509T000000,580000.0,4,2.5,2840,6268,2.0,0,0,3,9,2840,0,1998,0,98028,47.7386,-122.235,2790,6526,3428,3736,92.53350350989152,0.06622950819672131,Very Cheap
20141118T000000,594000.0,3,1.0,1320,5000,1.0,0,0,4,7,1090,230,1920,0,98107,47.6674,-122.365,1700,5000,3680,3300,118.8,0.0680655737704918,Very Cheap
20150409T000000,500000.0,3,2.5,2440,7600,1.0,0,0,3,7,1420,1020,1981,0,98052,47.6966,-122.127,2060,7700,5160,5640,65.78947368421052,0.05573770491803279,Very Cheap
20141006T000000,550000.0,4,2.5,2420,8056,1.0,0,0,3,8,1680,740,1988,0,98029,47.5748,-122.013,2160,6807,5636,4647,68.2720953326713,0.06229508196721312,Very Cheap
20150429T000000,275000.0,3,1.75,1180,6260,1.0,0,0,4,8,1180,0,1993,0,98038,47.3531,-122.048,1580,7272,5080,5692,43.9297124600639,0.02622950819672131,Very Cheap
20150430T000000,390000.0,3,2.25,1820,7420,2.0,0,0,4,8,1820,0,1983,0,98058,47.4368,-122.162,1900,7526,5600,5626,52.56064690026954,0.04131147540983607,Very Cheap
20140626T000000,1250000.0,3,3.0,3760,8500,2.5,0,3,4,10,3060,700,1910,0,98116,47.5815,-122.398,2610,5500,4740,2890,147.05882352941177,0.1540983606557377,Cheap
20140826T000000,250000.0,3,2.25,1560,15340,2.0,0,0,3,7,1560,0,1997,0,98168,47.4989,-122.322,1560,8260,13780,6700,16.297262059973924,0.022950819672131147,Very Cheap
20140929T000000,405000.0,2,2.5,1790,5400,2.0,0,0,4,8,1790,0,1979,0,98052,47.6606,-122.128,1700,5760,3610,4060,75.0,0.043278688524590166,Very Cheap
20140813T000000,213950.0,3,1.0,1430,7000,1.0,0,0,3,6,1430,0,1968,0,98023,47.3018,-122.369,1050,7700,5570,6650,30.564285714285713,0.01822295081967213,Very Cheap
20141222T000000,232000.0,3,1.5,1390,11340,1.0,0,0,4,7,1390,0,1963,0,98031,47.3984,-122.186,1740,11340,9950,9600,20.458553791887127,0.02059016393442623,Very Cheap
20150411T000000,207000.0,3,1.0,990,10800,1.0,0,0,4,6,990,0,1959,0,98002,47.293,-122.215,1060,10364,9810,9304,19.166666666666668,0.017311475409836064,Very Cheap
20141211T000000,310000.0,3,1.75,1880,30346,1.0,0,0,3,8,1880,0,1988,0,98001,47.3515,-122.291,2260,5883,28466,3623,10.215514400579977,0.03081967213114754,Very Cheap
20140903T000000,540000.0,3,2.5,2520,5000,3.0,0,0,3,9,2520,0,1990,0,98106,47.5664,-122.359,1130,5000,2480,3870,108.0,0.06098360655737705,Very Cheap
20150507T000000,750000.0,4,1.5,2060,4000,1.5,0,2,3,7,1580,480,1920,1990,98103,47.6857,-122.353,1160,4000,1940,2840,187.5,0.08852459016393442,Very Cheap
20140604T000000,392500.0,4,2.5,2150,7303,2.0,0,0,3,8,2150,0,2005,0,98056,47.5109,-122.183,1940,9569,5153,7629,53.74503628645762,0.04163934426229508,Very Cheap
20150204T000000,305000.0,5,2.5,2500,12220,1.0,0,0,3,8,1690,810,1962,0,98003,47.3335,-122.325,2130,12000,9720,9870,24.95908346972177,0.03016393442622951,Very Cheap
20140523T000000,735000.0,3,2.5,2390,9157,2.0,0,0,3,9,2390,0,1984,0,98052,47.6617,-122.15,2360,8250,6767,5890,80.26646281533253,0.08655737704918033,Very Cheap
20140707T000000,575000.0,4,2.5,2400,6137,2.0,0,0,3,8,2400,0,1990,0,98074,47.6187,-122.04,2120,7468,3737,5348,93.69398729020695,0.06557377049180328,Very Cheap
20140618T000000,175000.0,2,1.0,660,5000,1.0,0,0,3,6,660,0,1915,0,98106,47.5664,-122.364,1000,5000,4340,4000,35.0,0.013114754098360656,Very Cheap
20141203T000000,291000.0,4,2.5,1580,6633,2.0,0,0,4,7,1580,0,1984,0,98042,47.3768,-122.118,1590,6633,5053,5043,43.8715513342379,0.028327868852459016,Very Cheap
20140804T000000,791500.0,4,2.5,3250,8970,2.0,0,0,3,10,3250,0,1994,0,98075,47.5862,-122.037,3240,8449,5720,5209,88.23857302118172,0.0939672131147541,Very Cheap
20140710T000000,475000.0,3,2.0,1880,9659,1.0,0,0,3,8,1180,700,1951,0,98155,47.7497,-122.284,1780,9659,7779,7879,49.17693342996169,0.05245901639344262,Very Cheap
20141113T000000,238950.0,2,1.0,1190,11400,1.0,0,0,3,7,1190,0,1951,0,98178,47.5012,-122.265,1410,11400,10210,9990,20.960526315789473,0.021501639344262295,Very Cheap
20141020T000000,470000.0,3,3.5,1280,1257,2.0,0,0,3,8,1040,240,2000,0,98107,47.6721,-122.374,1280,1249,-23,-31,373.9061256961018,0.05180327868852459,Very Cheap
20150427T000000,420000.0,4,1.75,2380,15324,1.0,0,0,3,8,1610,770,1978,0,98074,47.6262,-122.049,2540,12608,12944,10068,27.4079874706343,0.04524590163934426,Very Cheap
20150420T000000,440000.0,3,2.5,2040,7605,2.0,0,0,3,8,2040,0,1996,0,98045,47.4876,-121.779,2150,7545,5565,5395,57.856673241288625,0.04786885245901639,Very Cheap
20140820T000000,656000.0,4,1.75,1440,4300,1.5,0,0,4,8,1290,150,1929,0,98117,47.6846,-122.372,1640,5000,2860,3360,152.5581395348837,0.07619672131147541,Very Cheap
20140714T000000,559950.0,3,2.5,2120,4310,2.0,0,0,3,7,2120,0,2001,0,98053,47.687,-122.037,2280,4380,2190,2100,129.9187935034803,0.0636,Very Cheap
20141113T000000,600000.0,2,2.0,990,5416,1.0,0,0,3,6,990,0,1935,0,98122,47.604,-122.311,1650,3360,4426,1710,110.78286558345643,0.06885245901639345,Very Cheap
20140804T000000,255000.0,3,1.0,1710,12000,1.0,0,0,4,7,1710,0,1972,0,98001,47.2616,-122.281,1310,9600,10290,8290,21.25,0.02360655737704918,Very Cheap
20150401T000000,210750.0,4,1.5,1840,7076,1.5,0,0,3,7,1840,0,1957,0,98106,47.5185,-122.345,1510,7320,5236,5810,29.78377614471453,0.01780327868852459,Very Cheap
20140718T000000,485000.0,4,1.0,1150,2560,1.5,0,0,3,7,1150,0,1909,0,98109,47.6368,-122.355,1890,3000,1410,1110,189.453125,0.05377049180327869,Very Cheap
20141020T000000,390000.0,3,2.5,2250,8076,2.0,0,0,3,8,2250,0,1995,0,98038,47.3667,-122.041,2180,7244,5826,5064,48.29123328380386,0.04131147540983607,Very Cheap
20150323T000000,405000.0,3,2.5,2460,12600,1.0,0,0,4,8,1810,650,1970,0,98059,47.473,-122.118,1820,11180,10140,9360,32.142857142857146,0.043278688524590166,Very Cheap
20140910T000000,462500.0,4,1.0,1540,4500,1.5,0,0,2,7,1540,0,1905,0,98116,47.587,-122.384,1920,6000,2960,4080,102.77777777777777,0.05081967213114754,Very Cheap
20150210T000000,435000.0,4,2.25,2210,14073,1.0,0,0,3,8,1630,580,1978,0,98059,47.4774,-122.142,2340,11340,11863,9000,30.910253677254317,0.04721311475409836,Very Cheap
20141119T000000,440000.0,3,2.5,1440,5434,2.0,0,0,3,7,1440,0,2003,0,98053,47.6818,-122.034,1560,3770,3994,2210,80.97165991902834,0.04786885245901639,Very Cheap
20140625T000000,299950.0,3,1.75,1790,7650,1.0,0,3,3,9,1790,0,1978,0,98023,47.3213,-122.385,2540,7600,5860,5060,39.209150326797385,0.029501639344262295,Very Cheap
20150504T000000,440000.0,2,1.5,1120,1024,2.0,0,0,3,8,1120,0,1970,1998,98122,47.6175,-122.298,1120,1549,-96,429,429.6875,0.04786885245901639,Very Cheap
20141113T000000,312620.0,3,2.5,1260,11877,1.0,0,0,3,7,1260,0,1975,0,98045,47.4442,-121.762,1430,9790,10617,8360,26.32146164856445,0.03116327868852459,Very Cheap
20140605T000000,372500.0,3,1.5,1180,12324,1.0,0,0,3,7,800,380,1981,0,98074,47.6337,-122.032,1280,11371,11144,10091,30.22557611165206,0.03901639344262295,Very Cheap
20150209T000000,297262.0,3,2.5,1730,8076,2.0,0,0,3,8,1730,0,1994,0,98003,47.2619,-122.308,1780,6930,6346,5150,36.80807330361565,0.02914911475409836,Very Cheap
20150210T000000,735000.0,4,3.0,2250,7245,1.0,0,0,4,7,1250,1000,1963,0,98005,47.6045,-122.169,1960,7245,4995,5285,101.44927536231884,0.08655737704918033,Very Cheap
20140826T000000,430000.0,3,1.5,1550,5034,2.0,0,0,4,7,1550,0,1922,0,98177,47.7072,-122.36,1820,7200,3484,5380,85.4191497814859,0.04655737704918033,Very Cheap
20141022T000000,241000.0,2,1.75,1070,9750,1.5,0,0,3,7,1070,0,1995,0,98014,47.7131,-121.319,970,9750,8680,8780,24.71794871794872,0.02177049180327869,Very Cheap
20140512T000000,201000.0,3,1.0,1460,9750,1.0,0,0,4,7,1460,0,1969,0,98042,47.3242,-122.144,1270,9750,8290,8480,20.615384615384617,0.016524590163934427,Very Cheap
20150420T000000,570000.0,2,1.0,1060,4000,1.0,0,0,4,7,1060,0,1910,0,98115,47.6731,-122.315,1770,4000,2940,2230,142.5,0.06491803278688525,Very Cheap
20140508T000000,538000.0,4,1.75,1840,9600,1.0,0,0,3,7,1220,620,1967,0,98052,47.6579,-122.125,1770,9720,7760,7950,56.041666666666664,0.06072131147540984,Very Cheap
20150512T000000,729000.0,3,2.5,2440,4244,2.0,0,0,3,8,2440,0,2011,0,98052,47.7057,-122.112,2690,4556,1804,1866,171.77191328934967,0.08577049180327868,Very Cheap
20150108T000000,331500.0,4,1.75,1700,14756,1.0,0,0,3,7,850,850,1955,0,98006,47.5762,-122.143,1680,10250,13056,8570,22.465437788018434,0.03363934426229508,Very Cheap
20140519T000000,110700.0,2,1.0,680,8064,1.0,0,0,3,6,680,0,1941,0,98188,47.469,-122.298,1340,10800,7384,9460,13.727678571428571,0.004681967213114754,Very Cheap
20141002T000000,245000.0,3,2.0,1700,8448,1.0,0,0,3,7,1700,0,1996,0,98022,47.2077,-122.011,1350,8587,6748,7237,29.00094696969697,0.022295081967213116,Very Cheap
20140721T000000,427000.0,3,1.75,2000,7111,1.0,0,0,4,7,1360,640,1956,0,98177,47.7676,-122.373,1830,9000,5111,7170,60.04781324708198,0.04616393442622951,Very Cheap
20140806T000000,650500.0,4,1.75,2340,5940,1.0,0,0,3,8,1290,1050,1953,0,98115,47.6789,-122.281,1930,5940,3600,4010,109.51178451178451,0.07547540983606557,Very Cheap
20140814T000000,335900.0,2,1.0,1120,7440,1.0,0,0,4,7,1120,0,1939,0,98155,47.7405,-122.323,1170,7440,6320,6270,45.14784946236559,0.03421639344262295,Very Cheap
20140903T000000,535000.0,2,2.0,1510,5133,1.5,0,0,3,7,1510,0,1939,0,98199,47.6415,-122.401,1470,6000,3623,4530,104.22754724332749,0.06032786885245902,Very Cheap
20150122T000000,360000.0,5,2.0,2120,2400,1.0,0,0,4,6,1080,1040,1906,0,98144,47.5979,-122.297,1690,4400,280,2710,150.0,0.037377049180327866,Very Cheap
20150204T000000,294900.0,3,2.25,1500,8100,1.0,0,0,3,7,1210,290,1968,0,98055,47.4632,-122.19,1600,7896,6600,6296,36.407407407407405,0.02883934426229508,Very Cheap
20150311T000000,460000.0,2,1.0,1030,5934,1.0,0,0,4,7,1030,0,1928,0,98115,47.6828,-122.287,1420,5588,4904,4168,77.51937984496124,0.050491803278688525,Very Cheap
20140915T000000,1769000.0,4,3.5,5440,38900,2.0,0,0,3,12,5440,0,1990,0,98053,47.6605,-122.069,4830,41313,33460,36483,45.47557840616967,0.2221639344262295,Cheap
20140509T000000,463000.0,2,1.0,1150,4400,1.0,0,0,4,7,1150,0,1905,0,98112,47.6226,-122.292,1240,4400,3250,3160,105.22727272727273,0.05088524590163934,Very Cheap
20141222T000000,332000.0,5,1.5,2420,43560,1.0,0,2,3,8,1500,920,1962,0,98022,47.208,-121.963,1620,17331,41140,15711,7.621671258034894,0.033704918032786885,Very Cheap
20140909T000000,199500.0,4,2.0,1750,8116,1.0,0,0,4,5,1750,0,1943,0,98056,47.5097,-122.181,1440,7865,6366,6425,24.581074420896993,0.016327868852459015,Very Cheap
20141124T000000,247000.0,4,2.0,1750,8116,1.0,0,0,4,5,1750,0,1943,0,98056,47.5097,-122.181,1440,7865,6366,6425,30.43371118777723,0.022557377049180326,Very Cheap
20140609T000000,442500.0,4,2.5,2170,14024,2.0,0,0,3,8,2170,0,1992,0,98019,47.7346,-121.97,2240,14029,11854,11789,31.553051911009696,0.04819672131147541,Very Cheap
20140619T000000,600000.0,3,2.0,2540,237402,1.0,0,0,3,9,2540,0,2007,0,98022,47.2688,-122.024,2200,229125,234862,226925,2.527358657467081,0.06885245901639345,Very Cheap
20140903T000000,449000.0,3,2.5,1690,3827,2.0,0,0,3,7,1690,0,2005,0,98053,47.6768,-122.029,1690,3129,2137,1439,117.32427488894696,0.049049180327868855,Very Cheap
20150306T000000,725000.0,4,1.0,1600,4500,1.5,0,0,4,7,1600,0,1926,0,98115,47.6804,-122.316,1720,4500,2900,2780,161.11111111111111,0.08524590163934426,Very Cheap
20150205T000000,215000.0,3,1.0,1060,7900,1.0,0,0,3,7,1060,0,1961,2001,98058,47.4604,-122.18,1310,7900,6840,6590,27.21518987341772,0.018360655737704918,Very Cheap
20141218T000000,582500.0,2,1.75,1990,6549,1.0,0,0,3,7,1170,820,1948,0,98115,47.7,-122.296,1640,7202,4559,5562,88.9448770804703,0.06655737704918033,Very Cheap
20140624T000000,305000.0,4,2.25,2210,9371,2.0,0,0,4,8,2210,0,1968,0,98032,47.3634,-122.279,2300,11584,7161,9284,32.547220147262834,0.03016393442622951,Very Cheap
20140923T000000,734000.0,4,2.75,3090,7650,2.0,0,2,3,8,2340,750,1959,1989,98042,47.3622,-122.157,2760,10370,4560,7610,95.94771241830065,0.08642622950819673,Very Cheap
20140505T000000,300000.0,3,2.0,1050,10072,1.0,0,0,3,7,1050,0,1986,0,98019,47.7341,-121.976,1130,10087,9022,8957,29.78554408260524,0.029508196721311476,Very Cheap
20140505T000000,525888.0,5,1.75,2550,71874,1.0,0,0,5,7,1810,740,1960,0,98027,47.4845,-122.08,2170,51400,69324,49230,7.316804407713499,0.059132852459016394,Very Cheap
20140911T000000,711000.0,4,2.5,2095,4400,1.5,0,0,5,8,1295,800,1910,0,98116,47.5838,-122.39,1980,4400,2305,2420,161.5909090909091,0.08340983606557377,Very Cheap
20140716T000000,360000.0,3,1.75,1520,12282,1.0,0,0,3,8,1220,300,1978,0,98155,47.7516,-122.299,1860,13500,10762,11640,29.311187103077675,0.037377049180327866,Very Cheap
20141210T000000,357000.0,5,2.5,2750,12350,2.0,0,0,3,8,2750,0,1987,0,98031,47.419,-122.206,1650,9810,9600,8160,28.90688259109312,0.03698360655737705,Very Cheap
20140930T000000,235000.0,3,1.75,1200,9266,1.0,0,0,4,7,1200,0,1960,0,98002,47.314,-122.208,1200,9266,8066,8066,25.36153680120872,0.02098360655737705,Very Cheap
20140808T000000,550000.0,3,1.75,1830,9720,1.0,0,1,3,7,1150,680,1928,1976,98040,47.5511,-122.23,3380,10854,7890,7474,56.584362139917694,0.06229508196721312,Very Cheap
20141205T000000,324000.0,3,1.0,1160,7202,1.0,0,0,4,7,1160,0,1957,0,98133,47.7675,-122.334,1620,8598,6042,6978,44.98750347125798,0.03265573770491803,Very Cheap
20150428T000000,420000.0,3,2.0,1750,9239,1.0,0,0,3,8,1410,340,1989,0,98133,47.7583,-122.339,1720,7874,7489,6154,45.459465310098494,0.04524590163934426,Very Cheap
20140619T000000,450000.0,4,2.5,2400,7693,2.0,0,0,3,8,2400,0,2003,0,98059,47.4881,-122.142,2400,8038,5293,5638,58.49473547380736,0.04918032786885246,Very Cheap
20150420T000000,825000.0,5,3.5,4140,6770,2.0,0,0,3,9,3030,1110,2004,0,98027,47.5381,-122.069,3960,5431,2630,1471,121.86115214180207,0.09836065573770492,Very Cheap
20140722T000000,272000.0,4,2.25,2115,6234,2.0,0,0,3,7,2115,0,1998,0,98002,47.285,-122.201,2440,6366,4119,3926,43.631697144690406,0.02583606557377049,Very Cheap
20141022T000000,481000.0,3,2.0,2580,15653,1.5,0,0,3,9,2580,0,1990,0,98166,47.4561,-122.361,1920,9840,13073,7920,30.728933750718713,0.05324590163934426,Very Cheap
20140805T000000,500000.0,3,1.0,1220,3400,1.0,0,0,3,7,1060,160,1927,0,98117,47.6775,-122.363,1350,3750,2180,2400,147.05882352941177,0.05573770491803279,Very Cheap
20140612T000000,448000.0,2,1.5,1630,3780,1.0,0,0,4,7,890,740,1940,0,98107,47.6711,-122.403,1770,6400,2150,4630,118.51851851851852,0.048918032786885245,Very Cheap
20150319T000000,480000.0,2,2.0,1350,4220,1.0,0,0,3,8,1350,0,2004,0,98053,47.718,-122.034,1350,4409,2870,3059,113.74407582938389,0.05311475409836065,Very Cheap
20140908T000000,475000.0,3,2.5,1690,2890,2.0,0,0,3,7,1690,0,2004,0,98053,47.6802,-122.031,1690,2730,1200,1040,164.3598615916955,0.05245901639344262,Very Cheap
20141021T000000,472500.0,2,2.25,1700,2383,2.0,0,0,3,8,1700,0,2005,0,98029,47.547,-121.997,1700,2700,683,1000,198.27947964750314,0.05213114754098361,Very Cheap
20140923T000000,291000.0,4,2.25,1890,7616,1.0,0,0,4,8,1260,630,1979,0,98003,47.3275,-122.329,1890,7420,5726,5530,38.20903361344538,0.028327868852459016,Very Cheap
20140722T000000,294000.0,2,1.0,850,5250,1.0,0,0,4,7,850,0,1950,0,98133,47.731,-122.342,1440,5250,4400,3810,56.0,0.028721311475409836,Very Cheap
20140730T000000,1013050.0,4,2.5,2480,12688,1.0,0,0,4,9,1820,660,1967,0,98004,47.6344,-122.205,2910,11979,10208,9069,79.84315889029004,0.12302295081967213,Cheap
20141017T000000,442500.0,3,2.5,1690,3129,2.0,0,0,3,7,1690,0,2002,0,98053,47.6875,-122.043,1690,3129,1439,1439,141.4189837008629,0.04819672131147541,Very Cheap
20140627T000000,170000.0,2,1.0,810,8424,1.0,0,0,4,6,810,0,1959,0,98023,47.3286,-122.346,820,8424,7614,7604,20.180436847103515,0.012459016393442624,Very Cheap
20150428T000000,1582500.0,4,2.5,3980,16304,1.0,0,1,3,10,2480,1500,1968,0,98004,47.639,-122.21,3980,16304,12324,12324,97.06207065750736,0.1977049180327869,Cheap
20150218T000000,665000.0,3,2.25,2580,6000,2.0,0,0,3,8,1780,800,1925,0,98144,47.5778,-122.289,2300,5995,3420,3695,110.83333333333333,0.07737704918032787,Very Cheap
20140828T000000,1610000.0,5,4.5,6085,142725,3.0,0,0,3,11,6085,0,2000,0,98014,47.6085,-121.952,4830,128457,136640,123627,11.280434401821685,0.20131147540983607,Cheap
20140714T000000,675000.0,2,1.75,2140,5000,1.0,0,0,3,7,1000,1140,1930,1991,98112,47.6284,-122.291,2250,4000,2860,1750,135.0,0.07868852459016394,Very Cheap
20150204T000000,279900.0,2,1.75,1360,10000,1.0,0,0,3,6,1360,0,1957,1989,98019,47.7421,-121.982,1430,10000,8640,8570,27.99,0.026872131147540983,Very Cheap
20140630T000000,875000.0,4,1.5,1800,3245,1.5,0,0,4,8,1800,0,1929,0,98103,47.6605,-122.331,1800,4275,1445,2475,269.6456086286595,0.10491803278688525,Cheap
20140804T000000,571000.0,3,2.5,1920,3867,2.0,0,0,3,8,1920,0,2005,0,98029,47.5538,-121.994,2190,3841,1947,1651,147.65968450995604,0.06504918032786886,Very Cheap
20140617T000000,320000.0,3,1.0,860,5060,1.5,0,0,3,7,860,0,1927,0,98133,47.7062,-122.341,880,5060,4200,4180,63.241106719367586,0.032131147540983604,Very Cheap
20140826T000000,525000.0,3,2.5,2340,35021,1.0,0,0,3,9,2340,0,1986,0,98038,47.3988,-122.028,2630,35190,32681,32560,14.991005396761944,0.05901639344262295,Very Cheap
20140711T000000,1650000.0,8,2.75,4040,20666,1.0,0,0,4,9,2020,2020,1962,0,98004,47.634,-122.221,3670,20500,16626,16830,79.84128520274848,0.20655737704918034,Cheap
20150401T000000,137900.0,3,1.75,1160,5082,1.0,0,0,3,6,580,580,1942,0,98178,47.503,-122.262,1730,6000,3922,4270,27.134986225895318,0.008249180327868852,Very Cheap
20140603T000000,440000.0,3,2.25,1680,57063,2.0,0,0,4,8,1680,0,1989,0,98045,47.4669,-121.765,1910,57063,55383,55153,7.710775809193348,0.04786885245901639,Very Cheap
20150304T000000,360000.0,3,1.0,1280,3870,1.0,0,0,3,7,640,640,1945,0,98122,47.6163,-122.294,1280,4800,2590,3520,93.02325581395348,0.037377049180327866,Very Cheap
20150205T000000,271000.0,4,1.5,1800,9576,1.0,0,0,4,7,1800,0,1977,0,98045,47.4664,-121.747,1370,9576,7776,8206,28.299916457811193,0.025704918032786885,Very Cheap
20140528T000000,465000.0,6,3.25,4250,23326,1.0,0,3,3,10,2150,2100,1967,0,98003,47.34,-122.327,3370,15983,19076,12613,19.934836662951213,0.051147540983606556,Very Cheap
20140926T000000,280000.0,4,2.5,2400,4596,2.0,0,0,3,8,2400,0,2004,0,98001,47.3358,-122.265,2230,4763,2196,2533,60.92254134029591,0.026885245901639345,Very Cheap
20150428T000000,283000.0,2,1.0,940,6350,1.0,0,0,4,5,940,0,1942,0,98103,47.698,-122.357,1490,6350,5410,4860,44.56692913385827,0.027278688524590165,Very Cheap
20150213T000000,411500.0,3,1.0,1110,7208,1.0,0,0,3,7,1110,0,1980,0,98052,47.6979,-122.124,1440,7210,6098,5770,57.089345172031074,0.04413114754098361,Very Cheap
20140917T000000,282000.0,3,2.25,2420,7548,1.0,0,0,4,8,1370,1050,1967,0,98023,47.3112,-122.376,2150,8000,5128,5850,37.36089030206677,0.02714754098360656,Very Cheap
20141209T000000,535000.0,3,2.5,1850,1499,2.5,0,0,3,9,1790,60,2005,0,98199,47.6475,-122.396,1770,1539,-351,-231,356.90460306871245,0.06032786885245902,Very Cheap
20140703T000000,554729.0,4,2.5,2020,4350,2.0,0,0,5,9,1730,290,1943,0,98199,47.6503,-122.41,1620,5800,2330,4180,127.52390804597701,0.06291527868852459,Very Cheap
20150224T000000,868000.0,4,2.5,2020,4350,2.0,0,0,5,9,1730,290,1943,0,98199,47.6503,-122.41,1620,5800,2330,4180,199.54022988505747,0.104,Cheap
20140616T000000,427000.0,3,2.5,1830,65340,1.0,0,0,3,8,1520,310,1991,0,98045,47.4553,-121.75,2100,84942,63510,82842,6.535047444138353,0.04616393442622951,Very Cheap
20141117T000000,455000.0,4,1.75,1920,6000,1.0,0,0,4,7,960,960,1954,0,98125,47.7137,-122.315,1850,7200,4080,5350,75.83333333333333,0.049836065573770495,Very Cheap
20141029T000000,595000.0,2,1.75,1280,8500,1.0,0,0,3,7,1280,0,1953,2010,98033,47.6553,-122.19,1950,10356,7220,8406,70.0,0.06819672131147542,Very Cheap
20150320T000000,400000.0,4,2.5,3130,5240,2.0,0,0,3,8,3130,0,2004,0,98038,47.3446,-122.042,2470,5240,2110,2770,76.33587786259542,0.04262295081967213,Very Cheap
20140625T000000,770000.0,4,2.5,3920,12415,2.0,0,0,3,10,3920,0,1997,0,98075,47.5658,-122.032,3639,12805,8495,9166,62.02174788562223,0.09114754098360656,Very Cheap
20140509T000000,742500.0,4,2.75,3100,3773,2.0,0,0,3,8,2000,1100,1919,1996,98122,47.6158,-122.291,2130,3777,673,1647,196.7930029154519,0.08754098360655738,Very Cheap
20140624T000000,1250000.0,4,2.5,3220,15600,1.0,0,0,5,9,1680,1540,1973,0,98006,47.5697,-122.182,2990,15600,12380,12610,80.12820512820512,0.1540983606557377,Cheap
20140812T000000,375000.0,3,2.0,1670,13775,1.0,0,0,3,8,1670,0,1968,0,98045,47.4873,-121.783,2130,14500,12105,12370,27.22323049001815,0.03934426229508197,Very Cheap
20150407T000000,1557600.0,4,2.5,2700,17853,2.0,0,0,4,9,2700,0,1960,0,98004,47.6463,-122.219,3790,16672,15153,12882,87.24584103512015,0.1944393442622951,Cheap
20150128T000000,545000.0,4,2.0,5461,22880,1.0,0,0,4,9,3265,2196,1964,0,98032,47.3557,-122.29,1940,10995,17419,9055,23.81993006993007,0.06163934426229508,Very Cheap
20140513T000000,1050000.0,4,3.25,4400,16625,2.0,0,0,3,11,4400,0,2003,0,98075,47.5868,-121.968,4440,15523,12225,11083,63.1578947368421,0.12786885245901639,Cheap
20141217T000000,1565000.0,3,1.75,2190,8500,1.0,0,0,4,9,2190,0,1957,0,98112,47.64,-122.285,2850,8868,6310,6018,184.11764705882354,0.19540983606557377,Cheap
20150318T000000,178000.0,4,1.5,1200,11163,1.5,0,0,4,6,1200,0,1970,0,98092,47.3024,-122.106,1200,11163,9963,9963,15.945534354564185,0.013508196721311476,Very Cheap
20141009T000000,262500.0,3,1.75,1470,10390,1.0,0,0,3,7,1470,0,1989,0,98031,47.4192,-122.201,1770,7507,8920,5737,25.26467757459095,0.02459016393442623,Very Cheap
20150415T000000,730000.0,3,1.75,1650,5000,1.5,0,0,4,8,1650,0,1900,0,98107,47.6743,-122.371,1630,5000,3350,3370,146.0,0.0859016393442623,Very Cheap
20140703T000000,395000.0,5,1.75,1840,10453,1.0,0,2,3,8,1360,480,1948,0,98166,47.4508,-122.368,2250,11250,8613,9000,37.78819477661915,0.0419672131147541,Very Cheap
20141024T000000,355000.0,3,1.0,1210,6650,1.0,0,0,3,6,1210,0,1959,0,98008,47.6214,-122.12,990,7590,5440,6600,53.38345864661654,0.036721311475409836,Very Cheap
20140908T000000,299990.0,3,2.5,1870,8541,2.0,0,0,3,8,1870,0,1989,0,98023,47.2925,-122.346,2150,7789,6671,5639,35.1235218358506,0.02950688524590164,Very Cheap
20150327T000000,1125000.0,4,3.25,3890,422096,1.5,0,0,3,9,3150,740,2001,0,98038,47.4125,-121.982,2180,229996,418206,227816,2.665270459800614,0.1377049180327869,Cheap
20141118T000000,425000.0,4,2.25,2660,11200,2.0,0,0,4,8,2660,0,1972,0,98059,47.4722,-122.131,2090,11120,8540,9030,37.94642857142857,0.04590163934426229,Very Cheap
20150107T000000,349000.0,2,1.0,1150,7552,1.0,0,0,3,7,1150,0,1951,0,98125,47.7215,-122.323,1150,7346,6402,6196,46.21292372881356,0.035934426229508196,Very Cheap
20141111T000000,554950.0,4,1.75,1740,4816,1.0,0,0,5,7,870,870,1942,0,98116,47.5758,-122.382,1210,5074,3076,3864,115.23048172757476,0.06294426229508197,Very Cheap
20141116T000000,326000.0,6,3.0,2580,8064,1.5,0,0,3,7,1880,700,1913,0,98118,47.5549,-122.287,1510,6084,5484,4574,40.426587301587304,0.032918032786885244,Very Cheap
20140626T000000,580000.0,4,1.75,1720,6975,1.0,0,0,3,8,1420,300,1975,0,98052,47.6506,-122.121,2210,7875,5255,5665,83.15412186379929,0.06622950819672131,Very Cheap
20140827T000000,699000.0,3,2.5,2740,18455,2.0,0,1,4,10,1510,1230,1977,0,98040,47.5585,-122.215,2840,16438,15715,13598,37.875914386345165,0.08183606557377049,Very Cheap
20141125T000000,757000.0,3,2.75,2610,11290,1.0,0,0,3,7,1630,980,1985,0,98033,47.6632,-122.201,2570,9125,8680,6555,67.0504871567759,0.08944262295081967,Very Cheap
20140723T000000,335000.0,3,1.75,1400,7920,1.0,0,0,3,7,1400,0,1965,0,98034,47.7312,-122.202,1310,7876,6520,6566,42.2979797979798,0.03409836065573771,Very Cheap
20140701T000000,660000.0,3,2.0,2570,28500,1.0,0,0,3,9,1970,600,1983,0,98052,47.7318,-122.138,3070,32400,25930,29330,23.157894736842106,0.07672131147540984,Very Cheap
20150417T000000,540000.0,4,2.75,2830,7334,2.0,0,0,3,8,2830,0,2005,0,98059,47.4868,-122.141,2830,7378,4504,4548,73.62967002999727,0.06098360655737705,Very Cheap
20141010T000000,320000.0,5,2.25,2630,8625,2.0,0,0,3,8,2630,0,1966,0,98032,47.3619,-122.287,1880,8670,5995,6790,37.10144927536232,0.032131147540983604,Very Cheap
20150421T000000,280000.0,3,2.5,1580,7918,2.0,0,0,3,7,1580,0,1994,0,98055,47.4431,-122.19,1650,7916,6338,6266,35.36246526900732,0.026885245901639345,Very Cheap
20140723T000000,324000.0,3,2.0,1540,10931,1.0,0,3,3,7,1540,0,1989,0,98045,47.495,-121.776,1570,10485,9391,8915,29.64047205196231,0.03265573770491803,Very Cheap
20140520T000000,300000.0,3,1.0,2120,7735,1.0,0,0,4,7,1060,1060,1967,0,98059,47.4869,-122.123,1010,8570,5615,7560,38.784744667097605,0.029508196721311476,Very Cheap
20140828T000000,360000.0,3,1.75,1830,10000,2.0,0,0,4,7,1830,0,1913,1964,98019,47.741,-121.979,1480,10000,8170,8520,36.0,0.037377049180327866,Very Cheap
20140623T000000,600000.0,3,2.5,2260,10153,2.0,0,0,3,10,2260,0,1987,0,98074,47.641,-122.068,2740,10153,7893,7413,59.095833743721066,0.06885245901639345,Very Cheap
20140530T000000,950000.0,4,1.75,2500,92347,1.0,0,0,4,8,1500,1000,1970,0,98040,47.5345,-122.216,3750,20267,89847,16517,10.287285997379449,0.11475409836065574,Cheap
20140709T000000,599950.0,3,3.25,1830,1804,3.0,0,0,3,8,1830,0,2014,0,98117,47.6945,-122.377,1830,1804,-26,-26,332.56651884700665,0.06884590163934426,Very Cheap
20150325T000000,190000.0,4,1.0,1190,7920,1.0,0,0,3,6,890,300,1951,0,98126,47.5305,-122.371,1140,7920,6730,6780,23.98989898989899,0.015081967213114755,Very Cheap
20150330T000000,350000.0,4,1.75,2310,9002,1.0,0,0,3,7,1780,530,1970,0,98034,47.731,-122.166,2090,8814,6692,6724,38.88024883359253,0.036065573770491806,Very Cheap
20150410T000000,522000.0,3,1.0,1230,4600,1.5,0,0,3,7,1230,0,1929,0,98116,47.5616,-122.392,1230,4600,3370,3370,113.47826086956522,0.05862295081967213,Very Cheap
20150318T000000,850000.0,3,2.5,2940,10809,2.0,0,0,3,10,2940,0,1992,0,98006,47.5418,-122.136,3090,10348,7869,7258,78.6381718937922,0.10163934426229508,Cheap
20140630T000000,308000.0,3,1.0,1010,8800,1.0,0,0,4,7,1010,0,1954,0,98118,47.5483,-122.278,1400,4095,7790,2695,35.0,0.030557377049180327,Very Cheap
20141202T000000,1020000.0,6,2.25,2550,5000,2.0,0,0,4,7,2550,0,1907,0,98117,47.6785,-122.396,1480,5000,2450,3520,204.0,0.12393442622950819,Cheap
20141028T000000,397500.0,3,1.0,1480,5100,1.5,0,0,3,7,1480,0,1938,1959,98103,47.6915,-122.348,1300,5100,3620,3800,77.94117647058823,0.04229508196721311,Very Cheap
20150127T000000,186000.0,3,1.75,1460,7967,1.0,0,0,3,7,1040,420,1977,0,98023,47.3199,-122.374,1460,6835,6507,5375,23.346303501945524,0.014557377049180328,Very Cheap
20140620T000000,436500.0,5,3.0,3110,12429,1.0,0,0,3,8,1790,1320,1977,0,98011,47.7463,-122.213,3050,11902,9319,8852,35.11947863866763,0.04740983606557377,Very Cheap
20140603T000000,710000.0,3,2.0,2140,4923,1.0,0,0,4,8,1070,1070,1928,0,98103,47.6902,-122.339,1470,4923,2783,3453,144.22100345317895,0.08327868852459017,Very Cheap
20150114T000000,1378600.0,5,3.25,3450,6360,2.0,0,0,5,9,1860,1590,1905,0,98122,47.6133,-122.287,2310,5000,2910,2690,216.76100628930817,0.1709639344262295,Cheap
20150428T000000,450000.0,3,2.25,1960,10682,1.0,0,0,3,7,1960,0,1957,0,98008,47.6319,-122.124,1540,10682,8722,9142,42.126942520127315,0.04918032786885246,Very Cheap
20150121T000000,375000.0,4,2.75,1890,5240,1.0,0,0,3,7,980,910,1981,0,98106,47.5528,-122.356,1600,5240,3350,3640,71.56488549618321,0.03934426229508197,Very Cheap
20141113T000000,315000.0,2,1.0,2080,14659,1.0,0,0,3,7,1040,1040,1960,0,98178,47.4858,-122.231,1920,15208,12579,13288,21.48850535507197,0.031475409836065574,Very Cheap
20150213T000000,467500.0,3,1.0,1700,4165,1.5,0,0,3,7,1700,0,1918,0,98118,47.5569,-122.277,1400,4165,2465,2765,112.24489795918367,0.05147540983606557,Very Cheap
20150227T000000,330000.0,3,1.0,1140,7316,1.0,0,0,3,6,1140,0,1959,0,98106,47.527,-122.362,1140,7440,6176,6300,45.106615636960086,0.03344262295081967,Very Cheap
20140725T000000,665000.0,3,2.5,3136,54450,1.5,0,0,5,8,3136,0,1910,0,98070,47.3999,-122.472,2300,54450,51314,52150,12.213039485766759,0.07737704918032787,Very Cheap
20150324T000000,760000.0,4,3.25,2590,3889,3.0,0,0,3,9,2590,0,2013,0,98007,47.6259,-122.142,2590,4062,1299,1472,195.42298791463102,0.0898360655737705,Very Cheap
20141230T000000,469000.0,3,1.75,1480,800,2.0,0,0,3,8,1000,480,2014,0,98136,47.5493,-122.387,1480,1143,-680,-337,586.25,0.05167213114754098,Very Cheap
20140813T000000,408000.0,3,3.0,1500,1473,2.0,0,0,3,8,1120,380,2000,0,98122,47.6063,-122.305,1720,1976,-27,256,276.9857433808554,0.04367213114754098,Very Cheap
20141003T000000,851000.0,3,2.75,2660,10350,1.0,0,4,4,8,1330,1330,1971,0,98008,47.5868,-122.116,2820,10043,7690,7223,82.22222222222223,0.10177049180327868,Cheap
20140725T000000,410000.0,2,2.0,1350,3926,1.0,0,0,3,8,1350,0,2007,0,98053,47.7192,-122.024,1440,3926,2576,2486,104.43199184921039,0.043934426229508196,Very Cheap
20150313T000000,235000.0,2,1.0,860,10500,1.0,0,0,3,6,860,0,1943,0,98024,47.5662,-121.886,950,10500,9640,9550,22.38095238095238,0.02098360655737705,Very Cheap
20140828T000000,207100.0,2,1.0,1000,4500,1.0,0,0,3,6,1000,0,1916,0,98055,47.4896,-122.204,980,4837,3500,3857,46.022222222222226,0.017324590163934426,Very Cheap
20140626T000000,560000.0,4,2.5,2480,16360,1.0,0,0,5,7,1510,970,1959,0,98028,47.7638,-122.265,1770,15205,13880,13435,34.229828850855746,0.06360655737704918,Very Cheap
20141031T000000,903000.0,3,2.75,3860,12786,2.0,0,0,4,10,3860,0,1984,0,98006,47.549,-122.141,2820,14636,8926,11816,70.62412013139371,0.10859016393442623,Cheap
20150107T000000,998500.0,3,1.75,2140,4800,2.0,0,0,3,8,1690,450,1905,0,98112,47.6311,-122.312,2440,4800,2660,2360,208.02083333333334,0.12111475409836066,Cheap
20140730T000000,268500.0,4,1.75,1820,13600,1.5,0,0,3,7,1120,700,1959,0,98032,47.3743,-122.295,1810,11970,11780,10160,19.74264705882353,0.02537704918032787,Very Cheap
20141015T000000,494950.0,2,1.75,2220,33000,1.0,0,0,4,8,2220,0,1970,0,98072,47.7403,-122.129,2220,33000,30780,30780,14.998484848484848,0.05507540983606558,Very Cheap
20140801T000000,1130000.0,4,2.5,2660,11200,2.0,0,0,3,9,2660,0,1999,0,98004,47.5894,-122.197,3290,11275,8540,7985,100.89285714285714,0.13836065573770492,Cheap
20141118T000000,250000.0,3,2.0,1470,12096,1.0,0,0,4,6,1470,0,1942,0,98030,47.3734,-122.193,1470,10966,10626,9496,20.667989417989418,0.022950819672131147,Very Cheap
20150320T000000,449000.0,4,1.75,2350,54450,1.0,0,0,4,7,1250,1100,1971,0,98027,47.4816,-122.005,2180,50529,52100,48349,8.246097337006429,0.049049180327868855,Very Cheap
20150112T000000,1225000.0,3,2.25,2980,7700,1.0,0,0,3,9,2530,450,1964,0,98112,47.6336,-122.29,3020,8234,4720,5214,159.0909090909091,0.15081967213114755,Cheap
20150317T000000,325000.0,4,2.0,1870,7700,1.0,0,0,3,8,1870,0,1966,0,98055,47.4619,-122.196,2270,8580,5830,6310,42.20779220779221,0.03278688524590164,Very Cheap
20140615T000000,506000.0,5,3.0,2430,8000,1.0,0,0,4,7,1370,1060,1957,0,98008,47.603,-122.12,1770,8000,5570,6230,63.25,0.05652459016393443,Very Cheap
20150325T000000,751000.0,4,2.5,2790,6538,2.0,0,0,3,9,2790,0,2003,0,98027,47.5349,-122.066,2990,6538,3748,3548,114.86693178342,0.08865573770491804,Very Cheap
20140812T000000,280000.0,3,2.5,1370,22326,2.0,0,0,3,7,1370,0,1993,0,98045,47.4469,-121.775,1580,10920,20956,9340,12.541431514825764,0.026885245901639345,Very Cheap
20140514T000000,1120000.0,4,2.25,4470,60373,2.0,0,0,3,11,4470,0,1988,0,98072,47.7289,-122.127,3210,40450,55903,37240,18.55133917479668,0.13704918032786886,Cheap
20140919T000000,580000.0,3,1.75,2040,81021,1.0,0,0,3,8,2040,0,1980,0,98053,47.6536,-122.045,2260,39280,78981,37020,7.1586378840053815,0.06622950819672131,Very Cheap
20150423T000000,665000.0,4,2.25,2340,5300,1.0,0,0,5,8,1700,640,1963,0,98008,47.6202,-122.112,1890,8250,2960,6360,125.47169811320755,0.07737704918032787,Very Cheap
20140527T000000,450000.0,4,2.5,2520,8515,2.0,0,0,3,7,2520,0,1999,0,98019,47.7233,-121.959,2130,6930,5995,4800,52.84791544333529,0.04918032786885246,Very Cheap
20140910T000000,389900.0,4,1.0,1710,117176,1.5,0,0,4,6,1710,0,1942,0,98055,47.4497,-122.212,1940,12223,115466,10283,3.3274732027036253,0.041298360655737706,Very Cheap
20141117T000000,427000.0,3,1.0,1200,5252,1.0,0,0,3,7,1200,0,1962,0,98007,47.6075,-122.134,1800,7920,4052,6120,81.3023610053313,0.04616393442622951,Very Cheap
20150416T000000,265000.0,3,1.75,1330,12618,1.0,0,3,3,7,1330,0,1983,0,98188,47.4403,-122.271,1870,8429,11288,6559,21.001743540973212,0.024918032786885248,Very Cheap
20141105T000000,398000.0,3,1.5,1310,2996,2.0,0,0,3,7,1310,0,1998,0,98144,47.5879,-122.299,1310,2997,1686,1687,132.8437917222964,0.042360655737704915,Very Cheap
20141104T000000,354000.0,6,3.5,3020,4500,2.0,0,0,3,7,3020,0,1941,1992,98178,47.498,-122.225,900,6000,1480,5100,78.66666666666667,0.03659016393442623,Very Cheap
20150413T000000,339950.0,4,2.5,2260,6086,2.0,0,0,3,8,2260,0,1999,0,98030,47.3642,-122.174,2260,6218,3826,3958,55.85770621097601,0.03474754098360656,Very Cheap
20141112T000000,399000.0,2,1.0,790,4000,1.0,0,0,3,6,790,0,1948,0,98115,47.6844,-122.289,990,5000,3210,4010,99.75,0.042491803278688525,Very Cheap
20141010T000000,325000.0,2,2.0,970,5000,1.0,0,0,3,7,970,0,1983,0,98034,47.7223,-122.16,1540,5000,4030,3460,65.0,0.03278688524590164,Very Cheap
20140819T000000,998800.0,3,2.0,2250,8000,1.0,0,2,4,9,2250,0,1955,0,98177,47.7077,-122.378,2880,10960,5750,8080,124.85,0.12115409836065574,Cheap
20140919T000000,350000.0,4,2.5,1530,2248,1.5,0,0,3,7,1530,0,1914,0,98144,47.5766,-122.309,1340,3700,718,2360,155.69395017793593,0.036065573770491806,Very Cheap
20140805T000000,1000000.0,4,1.75,1780,11436,1.0,0,0,5,9,1780,0,1967,0,98004,47.6273,-122.194,2100,12052,9656,9952,87.44316194473592,0.12131147540983607,Cheap
20150318T000000,561000.0,3,2.5,2120,5277,2.0,0,0,3,7,2120,0,2005,0,98053,47.6811,-122.034,2370,5257,3157,2887,106.31040363843093,0.06373770491803278,Very Cheap
20140707T000000,245000.0,2,1.0,1500,6685,1.0,0,0,3,7,1190,310,1926,0,98133,47.7186,-122.354,1420,6561,5185,5141,36.64921465968586,0.022295081967213116,Very Cheap
20150213T000000,570000.0,2,1.0,1500,6685,1.0,0,0,3,7,1190,310,1926,0,98133,47.7186,-122.354,1420,6561,5185,5141,85.26551982049364,0.06491803278688525,Very Cheap
20141030T000000,845000.0,4,3.0,2390,4000,1.5,0,0,5,8,1460,930,1931,0,98103,47.6857,-122.331,1670,4000,1610,2330,211.25,0.10098360655737705,Cheap
20140929T000000,314500.0,4,2.5,2390,9600,2.0,0,0,3,7,2390,0,1996,0,98010,47.3289,-122.001,1900,9603,7210,7703,32.760416666666664,0.03140983606557377,Very Cheap
20140618T000000,650000.0,3,1.75,2920,9370,1.0,0,0,4,8,1620,1300,1981,0,98006,47.5491,-122.151,2890,9609,6450,6719,69.37033084311634,0.07540983606557378,Very Cheap
20150506T000000,298000.0,2,1.0,850,5000,1.0,0,0,3,5,850,0,1907,0,98055,47.4874,-122.207,910,4815,4150,3905,59.6,0.029245901639344263,Very Cheap
20150409T000000,500000.0,2,1.0,930,3200,1.0,0,0,3,7,930,0,1904,0,98122,47.609,-122.314,1690,3840,2270,2150,156.25,0.05573770491803279,Very Cheap
20140610T000000,870000.0,4,2.5,3340,12248,2.0,0,1,3,9,2470,870,1998,0,98126,47.5858,-122.379,2110,5679,8908,3569,71.03200522534291,0.10426229508196722,Cheap
20150406T000000,299000.0,2,1.0,710,6732,1.0,0,0,5,6,710,0,1942,0,98126,47.5151,-122.372,710,6720,6022,6010,44.41473559120618,0.02937704918032787,Very Cheap
20140812T000000,527000.0,3,2.25,2240,6450,1.0,0,0,3,7,1440,800,1979,0,98125,47.7034,-122.315,1390,6450,4210,5060,81.70542635658914,0.059278688524590166,Very Cheap
20141106T000000,420000.0,3,1.0,1060,7638,1.0,0,0,5,7,1060,0,1966,0,98007,47.5941,-122.142,1470,8097,6578,6627,54.988216810683426,0.04524590163934426,Very Cheap
20150212T000000,290000.0,3,2.5,2360,8764,2.0,0,0,3,8,2360,0,1991,0,98022,47.2114,-122.009,2360,8746,6404,6386,33.08991328160657,0.02819672131147541,Very Cheap
20141015T000000,1662000.0,4,2.75,3520,19200,1.0,1,4,4,9,1950,1570,1951,0,98136,47.525,-122.393,2450,7000,15680,4550,86.5625,0.2081311475409836,Cheap
20140815T000000,499990.0,3,1.75,1730,9334,1.0,0,0,3,8,1220,510,1977,0,98052,47.6478,-122.113,2020,10000,7604,7980,53.56653096207414,0.05573639344262295,Very Cheap
20141027T000000,315000.0,3,1.75,1170,4000,1.0,0,0,3,6,720,450,1943,2013,98106,47.5306,-122.354,1130,4000,2830,2870,78.75,0.031475409836065574,Very Cheap
20141020T000000,425000.0,4,2.25,3680,26266,2.0,0,0,4,9,3680,0,1981,0,98042,47.3219,-122.085,2340,19939,22586,17599,16.180613721160437,0.04590163934426229,Very Cheap
20150217T000000,630000.0,3,2.5,2900,46609,2.0,0,0,3,9,2900,0,1987,0,98077,47.7731,-122.086,2570,42188,43709,39618,13.516702782724366,0.07278688524590164,Very Cheap
20141118T000000,365000.0,3,1.75,1290,7205,1.5,0,0,3,7,1290,0,1971,0,98034,47.7329,-122.237,1340,7214,5915,5874,50.65926439972242,0.0380327868852459,Very Cheap
20141106T000000,774000.0,4,2.75,2010,7000,2.0,0,0,5,8,2010,0,1901,0,98199,47.6607,-122.396,1420,4400,4990,2980,110.57142857142857,0.09167213114754098,Very Cheap
20150406T000000,368888.0,3,1.5,1490,12186,1.0,0,0,4,7,1490,0,1950,0,98155,47.7739,-122.322,1180,14285,10696,13105,30.271459051370424,0.03854268852459016,Very Cheap
20141002T000000,339500.0,4,2.5,1930,7862,2.0,0,0,3,7,1930,0,1994,0,98038,47.3644,-122.04,1640,9145,5932,7505,43.18239633680997,0.03468852459016394,Very Cheap
20140923T000000,344950.0,4,1.75,2240,7500,1.0,0,0,4,7,1120,1120,1956,0,98133,47.7466,-122.34,1440,7500,5260,6060,45.99333333333333,0.03540327868852459,Very Cheap
20141112T000000,450000.0,3,2.0,2320,17688,1.0,0,0,3,8,2320,0,1952,1994,98166,47.4519,-122.363,1610,14482,15368,12872,25.440976933514246,0.04918032786885246,Very Cheap
20141118T000000,814950.0,4,2.75,2990,6626,2.0,0,0,3,9,2990,0,2014,0,98052,47.7107,-122.11,2910,5533,3636,2623,122.99275581044371,0.09704262295081967,Very Cheap
20140905T000000,299900.0,4,2.5,2200,5730,2.0,0,0,3,8,2200,0,2003,0,98042,47.3482,-122.153,2200,5772,3530,3572,52.338568935427574,0.029495081967213115,Very Cheap
20150227T000000,315000.0,3,2.0,1500,7828,1.0,0,0,4,7,1500,0,1967,0,98058,47.4484,-122.158,1500,7700,6328,6200,40.24016351558508,0.031475409836065574,Very Cheap
20141216T000000,880000.0,3,1.75,3860,9000,1.0,0,2,3,9,1930,1930,1970,0,98155,47.7431,-122.29,2960,9000,5140,6040,97.77777777777777,0.10557377049180328,Cheap
20141229T000000,195000.0,3,1.5,1430,5200,1.0,0,0,4,7,1030,400,1977,0,98042,47.3644,-122.094,1190,5200,3770,4010,37.5,0.015737704918032787,Very Cheap
20141208T000000,910000.0,5,2.75,3750,8279,2.0,0,0,3,9,3750,0,2001,0,98074,47.6039,-122.06,3450,8279,4529,4829,109.91665660103877,0.10950819672131147,Cheap
20140827T000000,540000.0,5,2.5,3100,10189,2.0,0,0,3,8,3100,0,2002,0,98019,47.738,-121.965,2840,10189,7089,7349,52.998331534007264,0.06098360655737705,Very Cheap
20140516T000000,306000.0,3,2.5,1870,5874,2.0,0,0,3,7,1870,0,2005,0,98042,47.3992,-122.163,2090,4060,4004,1970,52.093973442288046,0.030295081967213113,Very Cheap
20141016T000000,272000.0,4,2.25,2040,7600,1.0,0,0,4,8,1580,460,1978,0,98023,47.3169,-122.365,2130,7200,5560,5070,35.78947368421053,0.02583606557377049,Very Cheap
20141209T000000,1295000.0,5,3.5,3700,8504,2.0,0,0,3,8,2750,950,1950,2014,98105,47.669,-122.275,2370,6246,4804,3876,152.28127939793038,0.16,Cheap
20141017T000000,450000.0,3,1.75,3150,9258,1.0,0,1,3,8,2370,780,1970,0,98027,47.5571,-122.08,2740,10274,6108,7534,48.606610499027866,0.04918032786885246,Very Cheap
20140707T000000,450000.0,3,2.5,1990,12793,2.0,0,0,3,8,1990,0,1993,0,98028,47.7347,-122.226,2290,9035,10803,6745,35.175486594231224,0.04918032786885246,Very Cheap
20140610T000000,310000.0,4,1.0,1740,11075,1.5,0,0,3,7,1740,0,1965,0,98133,47.7458,-122.334,1580,7684,9335,6104,27.99097065462754,0.03081967213114754,Very Cheap
20150512T000000,530000.0,2,2.25,2080,11285,1.0,0,0,4,8,1180,900,1954,0,98042,47.3628,-122.147,2590,13048,9205,10458,46.96499778466992,0.05967213114754098,Very Cheap
20150112T000000,435000.0,4,2.5,2060,10125,2.0,0,0,4,7,1560,500,1979,0,98028,47.764,-122.262,1760,9876,8065,8116,42.96296296296296,0.04721311475409836,Very Cheap
20150505T000000,485000.0,3,2.0,1590,11222,1.0,0,0,4,7,1590,0,1948,0,98177,47.7762,-122.367,2160,16300,9632,14140,43.21867759757619,0.05377049180327869,Very Cheap
20140702T000000,690000.0,3,1.5,1760,4000,2.0,0,0,3,8,1760,0,1922,0,98102,47.6401,-122.32,1760,4000,2240,2240,172.5,0.08065573770491803,Very Cheap
20150401T000000,305000.0,4,2.5,1620,4000,2.0,0,0,3,7,1620,0,2008,0,98038,47.3661,-122.02,1580,3780,2380,2200,76.25,0.03016393442622951,Very Cheap
20141105T000000,300000.0,3,1.75,1210,7000,1.0,0,0,3,7,1210,0,1975,0,98058,47.4572,-122.169,1670,7000,5790,5330,42.857142857142854,0.029508196721311476,Very Cheap
20150122T000000,289950.0,4,3.0,2040,5050,1.0,0,0,3,8,1490,550,1993,0,98092,47.3266,-122.175,2020,6118,3010,4098,57.415841584158414,0.028190163934426228,Very Cheap
20141105T000000,575000.0,3,2.5,2270,9600,2.0,0,0,3,9,2270,0,1990,0,98011,47.7388,-122.206,2580,9617,7330,7037,59.895833333333336,0.06557377049180328,Very Cheap
20140627T000000,1820000.0,4,4.5,6640,53330,2.0,0,0,3,12,6640,0,1993,0,98077,47.7283,-122.046,4620,68625,46690,64005,34.127132945809116,0.22885245901639345,Cheap
20140715T000000,219000.0,3,1.5,1060,9600,1.0,0,0,4,7,1060,0,1962,0,98023,47.3229,-122.348,1440,9600,8540,8160,22.8125,0.018885245901639345,Very Cheap
20140702T000000,265000.0,4,3.0,1940,8170,1.0,0,0,4,7,1940,0,1948,0,98155,47.7381,-122.302,1310,8169,6230,6859,32.43574051407589,0.024918032786885248,Very Cheap
20140714T000000,1105000.0,5,3.25,3070,5000,2.0,0,0,3,9,2050,1020,2006,0,98103,47.6742,-122.356,2070,5000,1930,2930,221.0,0.13508196721311475,Cheap
20150309T000000,200000.0,3,1.0,930,7590,1.0,0,0,3,6,820,110,1943,0,98166,47.4802,-122.335,1220,7590,6660,6370,26.350461133069828,0.01639344262295082,Very Cheap
20150424T000000,545000.0,4,2.75,2180,8480,1.0,0,3,4,7,1210,970,1959,0,98146,47.4961,-122.366,2240,8497,6300,6257,64.26886792452831,0.06163934426229508,Very Cheap
20150319T000000,378000.0,3,2.5,2130,8404,2.0,0,0,3,8,2130,0,1991,0,98058,47.4623,-122.13,2130,8404,6274,6274,44.97858162779629,0.03973770491803279,Very Cheap
20150326T000000,388000.0,2,1.75,800,4800,1.0,0,0,4,6,800,0,1922,0,98136,47.5559,-122.396,1090,5000,4000,3910,80.83333333333333,0.041049180327868855,Very Cheap
20141126T000000,425000.0,4,2.25,2200,8384,1.0,0,0,3,7,1250,950,1959,0,98155,47.753,-122.317,1750,8384,6184,6634,50.69179389312977,0.04590163934426229,Very Cheap
20140707T000000,536000.0,2,1.5,1130,746,2.0,0,0,3,8,1030,100,2009,0,98107,47.6684,-122.363,1520,1519,-384,-1,718.4986595174263,0.06045901639344262,Very Cheap
20140528T000000,1175000.0,3,2.5,1970,23180,1.0,1,4,3,8,1100,870,1937,1998,98136,47.5495,-122.398,3030,34689,21210,31659,50.690250215703195,0.14426229508196722,Cheap
20150324T000000,629950.0,3,2.5,1680,1620,2.0,0,0,3,9,1120,560,2014,0,98119,47.6425,-122.374,1610,1618,-60,8,388.858024691358,0.07278032786885245,Very Cheap
20140611T000000,465000.0,4,1.75,1470,5350,1.0,0,0,3,7,980,490,1955,0,98125,47.7048,-122.315,1970,6138,3880,4168,86.91588785046729,0.051147540983606556,Very Cheap
20140827T000000,545000.0,4,2.25,2390,40510,1.0,0,0,4,8,2390,0,1969,0,98072,47.7566,-122.113,3200,36989,38120,33789,13.453468279437176,0.06163934426229508,Very Cheap
20150128T000000,592000.0,4,2.5,2300,11165,2.0,0,0,4,8,2300,0,1979,0,98008,47.5794,-122.118,2170,11165,8865,8995,53.02283922973578,0.06780327868852459,Very Cheap
20140818T000000,446000.0,4,2.0,2280,43692,1.0,0,0,3,7,1140,1140,1957,1984,98038,47.4067,-122.03,2580,37938,41412,35358,10.207818364918063,0.04865573770491803,Very Cheap
20140716T000000,375000.0,3,2.5,1330,816,3.0,0,0,3,8,1330,0,2004,0,98117,47.6836,-122.387,1330,1113,-514,-217,459.55882352941177,0.03934426229508197,Very Cheap
20140616T000000,632500.0,5,2.5,2640,7096,2.0,0,0,3,7,2640,0,2003,0,98053,47.6827,-122.038,2640,4850,4456,2210,89.13472378804961,0.07311475409836066,Very Cheap
20140808T000000,459950.0,4,1.75,2430,9747,1.0,0,0,3,8,1780,650,1974,0,98155,47.7687,-122.276,2340,10296,7317,7956,47.18887862932184,0.050485245901639345,Very Cheap
20140612T000000,485000.0,4,2.5,2470,35073,2.0,0,0,3,9,2470,0,1989,0,98092,47.3064,-122.108,2990,35259,32603,32269,13.828300972257862,0.05377049180327869,Very Cheap
20150115T000000,255000.0,3,1.0,1440,11330,1.0,0,0,3,7,1440,0,1965,0,98168,47.4742,-122.265,1580,10100,9890,8520,22.506619593998234,0.02360655737704918,Very Cheap
20140610T000000,251750.0,3,2.0,1320,7200,1.0,0,0,5,7,1320,0,1975,0,98031,47.3947,-122.174,1540,7200,5880,5660,34.96527777777778,0.02318032786885246,Very Cheap
20150501T000000,725000.0,3,2.5,2810,6300,2.0,0,0,3,8,2810,0,2001,0,98074,47.6077,-122.02,2860,6630,3490,3770,115.07936507936508,0.08524590163934426,Very Cheap
20141016T000000,460000.0,3,3.25,1370,1194,3.0,0,0,3,8,1370,0,2005,0,98107,47.6704,-122.391,1320,1217,-176,-103,385.2596314907873,0.050491803278688525,Very Cheap
20140828T000000,625000.0,3,2.5,2000,6341,1.0,0,0,5,8,1040,960,1981,0,98116,47.5639,-122.401,2030,6341,4341,4311,98.56489512695158,0.07213114754098361,Very Cheap
20140508T000000,530000.0,3,1.75,1980,6760,1.0,0,0,4,8,1980,0,1973,0,98008,47.6398,-122.113,2120,7280,4780,5160,78.40236686390533,0.05967213114754098,Very Cheap
20150427T000000,394950.0,3,2.5,2050,8172,2.0,0,0,3,8,2050,0,2002,0,98168,47.4808,-122.28,2140,5664,6122,3524,48.32966226138032,0.04196065573770492,Very Cheap
20140814T000000,324950.0,4,1.75,2320,9240,1.0,0,0,3,7,1160,1160,1959,2014,98178,47.4909,-122.257,2130,7320,6920,5190,35.167748917748916,0.03278032786885246,Very Cheap
20150506T000000,330000.0,3,2.25,1960,1985,2.0,0,0,3,7,1750,210,2003,0,98118,47.5417,-122.289,1760,1985,25,225,166.2468513853904,0.03344262295081967,Very Cheap
20150217T000000,220000.0,4,1.75,1910,8171,1.0,0,0,3,7,1910,0,1986,0,98030,47.35,-122.168,1910,7542,6261,5632,26.92448904662832,0.01901639344262295,Very Cheap
20140707T000000,685000.0,3,3.25,2030,11070,2.0,0,0,4,8,2030,0,1980,0,98052,47.6478,-122.117,2450,11070,9040,8620,61.878952122854564,0.08,Very Cheap
20150224T000000,500000.0,3,2.25,2210,7680,1.0,0,2,3,8,1730,480,1972,0,98177,47.7729,-122.389,2390,7680,5470,5290,65.10416666666667,0.05573770491803279,Very Cheap
20140904T000000,368000.0,4,2.75,2610,9426,1.0,0,0,3,7,1360,1250,1965,0,98188,47.4435,-122.279,1600,9426,6816,7826,39.04095056227456,0.03842622950819672,Very Cheap
20141103T000000,825000.0,3,2.25,2520,7975,2.0,0,0,4,9,1550,970,1990,0,98033,47.6704,-122.183,2520,9900,5455,7380,103.44827586206897,0.09836065573770492,Very Cheap
20140616T000000,660000.0,6,1.75,1840,2774,1.0,0,0,3,7,1060,780,1900,0,98122,47.6041,-122.31,1680,4292,934,2612,237.9235760634463,0.07672131147540984,Very Cheap
20140929T000000,253000.0,3,1.75,1570,7416,1.0,0,0,4,7,1570,0,1971,0,98031,47.4117,-122.174,1900,7416,5846,5516,34.11542610571737,0.023344262295081967,Very Cheap
20150307T000000,392500.0,4,2.75,2400,19923,1.0,0,0,5,7,1320,1080,1953,0,98042,47.3616,-122.144,2470,10736,17523,8266,19.70084826582342,0.04163934426229508,Very Cheap
20150214T000000,605000.0,3,1.75,1930,5400,2.0,0,2,3,9,1930,0,1978,0,98177,47.77,-122.391,2100,6840,3470,4740,112.03703703703704,0.06950819672131148,Very Cheap
20140515T000000,215000.0,3,1.0,1160,10384,1.0,0,0,4,6,1160,0,1969,0,98038,47.3634,-122.027,1200,9880,9224,8680,20.704930662557782,0.018360655737704918,Very Cheap
20140925T000000,650000.0,4,2.5,2820,15000,2.0,0,0,4,9,2820,0,1985,0,98052,47.7255,-122.101,2440,15000,12180,12560,43.333333333333336,0.07540983606557378,Very Cheap
20150219T000000,877500.0,4,2.0,3060,8000,2.0,0,0,4,8,2040,1020,1922,0,98144,47.5795,-122.29,2730,5800,4940,3070,109.6875,0.10524590163934426,Cheap
20140619T000000,232500.0,3,1.0,1320,8450,1.0,0,0,3,6,880,440,1961,0,98023,47.3278,-122.337,1320,8450,7130,7130,27.514792899408285,0.020655737704918034,Very Cheap
20141202T000000,234000.0,2,2.0,1200,3624,2.0,0,0,3,6,1200,0,2003,0,98038,47.349,-122.025,1360,2693,2424,1333,64.56953642384106,0.020852459016393442,Very Cheap
20150413T000000,380000.0,3,1.75,1560,104108,1.0,0,0,3,7,1250,310,1970,0,98042,47.4016,-122.131,2000,110957,102548,108957,3.6500557113766474,0.04,Very Cheap
20140916T000000,420000.0,5,2.25,3070,64033,1.0,0,0,3,9,2730,340,1983,0,98001,47.3238,-122.292,1560,28260,60963,26700,6.559117954804554,0.04524590163934426,Very Cheap
20141229T000000,399950.0,3,1.0,1040,9600,1.0,0,0,3,7,1040,0,1978,0,98053,47.6738,-122.063,1370,10889,8560,9519,41.661458333333336,0.04261639344262295,Very Cheap
20140521T000000,256750.0,3,2.5,1990,8991,1.0,0,0,3,7,1570,420,1969,0,98042,47.3939,-122.164,1920,8991,7001,7071,28.55633411188967,0.023836065573770493,Very Cheap
20140602T000000,535000.0,3,2.5,1690,9626,2.0,0,0,3,8,1690,0,1984,0,98027,47.5647,-122.092,1860,8958,7936,7098,55.578641180137126,0.06032786885245902,Very Cheap
20141107T000000,515000.0,3,2.0,1810,2738,2.0,0,0,4,9,1810,0,1979,0,98008,47.6112,-122.115,1760,2754,928,994,188.0934989043097,0.057704918032786885,Very Cheap
20150212T000000,770000.0,4,1.75,2520,8442,1.0,0,0,4,7,1640,880,1953,0,98004,47.6317,-122.205,2110,8442,5922,6332,91.2106135986733,0.09114754098360656,Very Cheap
20150102T000000,256000.0,3,2.5,1570,5113,1.0,0,0,3,7,1090,480,1996,0,98001,47.3327,-122.29,1570,5150,3543,3580,50.0684529630354,0.023737704918032787,Very Cheap
20140821T000000,489900.0,3,1.0,1680,8910,1.0,0,0,4,7,1680,0,1940,0,98117,47.7011,-122.375,1620,7182,7230,5562,54.98316498316498,0.05441311475409836,Very Cheap
20140820T000000,165000.0,3,1.5,1250,7200,1.0,0,0,4,7,1250,0,1978,0,98032,47.3678,-122.282,1250,7560,5950,6310,22.916666666666668,0.01180327868852459,Very Cheap
20150318T000000,220000.0,3,1.5,1280,7742,1.0,0,0,4,7,1280,0,1962,0,98031,47.3947,-122.197,1450,8316,6462,6866,28.416429863084474,0.01901639344262295,Very Cheap
20140624T000000,575000.0,4,2.5,4620,20793,2.0,0,0,4,11,4620,0,1991,0,98023,47.2929,-122.342,3640,20793,16173,17153,27.653537248112347,0.06557377049180328,Very Cheap
20141030T000000,375000.0,3,2.5,1580,5725,2.0,0,0,3,7,1580,0,2004,0,98072,47.7611,-122.161,1510,5725,4145,4215,65.50218340611353,0.03934426229508197,Very Cheap
20150122T000000,422250.0,3,1.75,1650,7145,2.0,0,0,5,8,1300,350,1977,0,98155,47.7733,-122.324,1760,7206,5495,5446,59.097270818754374,0.045540983606557374,Very Cheap
20140603T000000,420000.0,3,1.75,1660,9600,1.0,0,0,3,8,1380,280,1981,0,98011,47.7601,-122.167,2030,9500,7940,7470,43.75,0.04524590163934426,Very Cheap
20140923T000000,608000.0,4,2.5,2410,7140,2.0,0,0,3,8,2410,0,1993,0,98074,47.6329,-122.021,2350,7140,4730,4790,85.15406162464986,0.0699016393442623,Very Cheap
20140516T000000,620000.0,3,2.25,1720,4000,1.5,0,0,4,7,1450,270,1921,0,98105,47.6683,-122.286,1410,4000,2280,2590,155.0,0.07147540983606557,Very Cheap
20150217T000000,850000.0,3,2.5,3120,12406,2.0,0,2,3,9,1940,1180,1983,0,98006,47.5507,-122.141,3240,13141,9286,9901,68.51523456392069,0.10163934426229508,Cheap
20150116T000000,463000.0,4,2.5,2680,9928,1.0,0,0,4,8,1340,1340,1974,0,98027,47.5219,-122.052,2180,10478,7248,8298,46.63577759871072,0.05088524590163934,Very Cheap
20150127T000000,750000.0,5,1.75,2640,13290,1.0,1,4,4,8,1400,1240,1954,0,98178,47.5022,-122.223,2400,11942,10650,9542,56.433408577878104,0.08852459016393442,Very Cheap
20150325T000000,1070000.0,3,3.25,3730,13264,2.0,0,0,3,9,3730,0,1989,0,98077,47.7246,-122.059,3730,14933,9534,11203,80.66948130277443,0.13049180327868853,Cheap
20140909T000000,290000.0,3,2.0,1700,6498,1.0,0,0,3,7,1700,0,1986,0,98038,47.3781,-122.044,1700,6654,4798,4954,44.629116651277315,0.02819672131147541,Very Cheap
20140710T000000,525000.0,4,1.75,2280,5959,1.0,0,0,3,7,1250,1030,1947,0,98116,47.5655,-122.395,1640,5911,3679,4271,88.10203054203726,0.05901639344262295,Very Cheap
20150217T000000,319000.0,3,2.25,1220,2980,2.0,0,0,3,7,1220,0,1986,0,98034,47.7151,-122.203,1220,2140,1760,920,107.04697986577182,0.032,Very Cheap
20150202T000000,592500.0,6,4.5,3500,8504,2.0,0,0,3,7,3500,0,1980,0,98155,47.7349,-122.295,1550,8460,5004,6910,69.67309501411101,0.06786885245901639,Very Cheap
20140513T000000,350000.0,3,2.5,2010,14298,2.0,0,0,3,7,2010,0,1977,0,98070,47.5069,-122.472,2010,14298,12288,12288,24.478948104630017,0.036065573770491806,Very Cheap
20150226T000000,454900.0,3,1.75,2130,9775,1.0,0,0,4,8,1430,700,1973,0,98027,47.5326,-122.049,2130,11250,7645,9120,46.53708439897698,0.049822950819672134,Very Cheap
20150415T000000,272000.0,4,2.25,1800,9018,2.0,0,0,3,7,1800,0,1992,0,98022,47.2126,-121.984,1670,9380,7218,7710,30.16189842537148,0.02583606557377049,Very Cheap
20140716T000000,357500.0,3,1.0,1070,10125,1.0,0,0,3,7,1070,0,1961,0,98033,47.7012,-122.167,1540,10200,9055,8660,35.30864197530864,0.03704918032786885,Very Cheap
20140828T000000,285000.0,3,1.75,1020,5000,1.0,0,0,5,6,1020,0,1954,0,98118,47.5332,-122.29,1360,5000,3980,3640,57.0,0.02754098360655738,Very Cheap
20150326T000000,280000.0,4,2.0,1600,6861,1.0,0,0,3,7,1600,0,1994,0,98003,47.2701,-122.313,1870,7455,5261,5585,40.81037749599184,0.026885245901639345,Very Cheap
20140903T000000,477000.0,4,1.5,1380,7800,1.0,0,0,3,7,1080,300,1928,0,98125,47.7093,-122.306,1770,7503,6420,5733,61.15384615384615,0.052721311475409836,Very Cheap
20140722T000000,750000.0,3,2.25,3270,168000,2.0,0,0,4,10,3270,0,1982,0,98056,47.5197,-122.191,3220,7963,164730,4743,4.464285714285714,0.08852459016393442,Very Cheap
20141119T000000,595000.0,4,2.5,2100,3125,2.0,0,2,3,7,1400,700,1907,1993,98107,47.6634,-122.358,2060,5040,1025,2980,190.4,0.06819672131147542,Very Cheap
20140717T000000,525000.0,3,2.25,2110,2850,3.0,0,0,3,8,2110,0,2001,0,98103,47.6915,-122.339,1340,5001,740,3661,184.21052631578948,0.05901639344262295,Very Cheap
20140711T000000,319000.0,3,1.75,1640,53400,1.0,0,0,4,7,1640,0,1966,0,98070,47.3944,-122.506,1850,380279,51760,378429,5.97378277153558,0.032,Very Cheap
20140827T000000,225000.0,3,2.0,1320,5665,1.0,0,0,3,7,1320,0,1986,0,98023,47.3096,-122.357,1336,7080,4345,5744,39.71756398940865,0.019672131147540985,Very Cheap
20140723T000000,485000.0,4,2.5,2420,10603,1.0,0,0,5,7,1210,1210,1958,0,98028,47.7397,-122.259,1750,10800,8183,9050,45.74177119683109,0.05377049180327869,Very Cheap
20140703T000000,341000.0,3,1.0,1390,4814,1.5,0,0,3,6,1390,0,1908,0,98115,47.6881,-122.32,1730,3990,3424,2260,70.83506439551309,0.03488524590163934,Very Cheap
20150116T000000,674000.0,3,3.25,2320,6744,2.0,0,0,3,9,1930,390,2014,0,98125,47.7132,-122.293,1700,6744,4424,5044,99.94068801897983,0.07855737704918032,Very Cheap
20150127T000000,442250.0,3,2.5,2170,8169,2.0,0,0,3,8,2170,0,2003,0,98059,47.4833,-122.139,2240,6733,5999,4493,54.13759334067817,0.04816393442622951,Very Cheap
20140513T000000,591000.0,4,2.25,2710,38180,2.0,0,0,4,8,2710,0,1977,0,98077,47.77,-122.097,2590,38180,35470,35590,15.479308538501833,0.06767213114754099,Very Cheap
20141113T000000,276000.0,3,2.0,1450,8928,1.0,0,0,3,7,1450,0,1998,0,98042,47.3637,-122.075,2050,8523,7478,6473,30.913978494623656,0.026360655737704918,Very Cheap
20140822T000000,394000.0,3,2.5,1370,4400,1.0,0,0,3,8,1370,0,1988,0,98034,47.7139,-122.203,1630,4400,3030,2770,89.54545454545455,0.041836065573770495,Very Cheap
20141119T000000,355000.0,3,2.5,1810,3192,1.0,0,0,3,7,1070,740,2001,0,98019,47.7364,-121.969,1740,3720,1382,1980,111.2155388471178,0.036721311475409836,Very Cheap
20140509T000000,260000.0,3,2.5,1420,14850,1.0,0,0,4,7,1020,400,1963,0,98032,47.3661,-122.29,2060,8800,13430,6740,17.50841750841751,0.024262295081967214,Very Cheap
20140701T000000,300000.0,3,2.75,2090,9620,1.0,0,0,3,8,1340,750,1987,0,98023,47.2741,-122.337,2150,9660,7530,7510,31.185031185031185,0.029508196721311476,Very Cheap
20150324T000000,310000.0,3,2.75,2090,9620,1.0,0,0,3,8,1340,750,1987,0,98023,47.2741,-122.337,2150,9660,7530,7510,32.224532224532226,0.03081967213114754,Very Cheap
20141202T000000,209000.0,3,1.0,1330,6900,1.0,0,0,3,7,1330,0,1976,0,98023,47.3033,-122.381,1530,7000,5570,5470,30.28985507246377,0.017573770491803278,Very Cheap
20141211T000000,344950.0,3,2.0,1330,7419,1.0,0,0,3,7,1330,0,1985,0,98034,47.7322,-122.236,1330,7297,6089,5967,46.49548456665319,0.03540327868852459,Very Cheap
20140611T000000,230000.0,5,2.0,1910,7200,1.0,0,0,4,6,1110,800,1951,0,98178,47.4975,-122.261,1150,5948,5290,4798,31.944444444444443,0.020327868852459016,Very Cheap
20150424T000000,336950.0,3,1.75,2310,7680,1.0,0,0,4,8,1410,900,1978,0,98032,47.3743,-122.285,2080,7680,5370,5600,43.873697916666664,0.03435409836065574,Very Cheap
20140611T000000,700000.0,3,2.75,2500,7378,1.0,0,0,5,7,1390,1110,1948,0,98177,47.7032,-122.37,2040,7140,4878,5100,94.87666034155598,0.08196721311475409,Very Cheap
20140904T000000,230000.0,3,2.0,1310,7332,1.0,0,0,3,7,1310,0,1987,0,98038,47.3597,-122.051,1530,7362,6022,5832,31.369339879978178,0.020327868852459016,Very Cheap
20140620T000000,443500.0,4,2.5,2040,21781,2.0,0,0,3,8,2040,0,1994,0,98014,47.6458,-121.904,2410,21781,19741,19371,20.361783205546118,0.048327868852459016,Very Cheap
20150414T000000,471000.0,4,2.5,2040,21781,2.0,0,0,3,8,2040,0,1994,0,98014,47.6458,-121.904,2410,21781,19741,19371,21.624351499012903,0.051934426229508196,Very Cheap
20141210T000000,595000.0,3,2.25,2400,16301,1.0,0,0,3,8,1400,1000,1962,0,98115,47.6901,-122.282,1720,9828,13901,8108,36.500828170050916,0.06819672131147542,Very Cheap
20141121T000000,470000.0,3,1.0,1400,4914,1.5,0,0,3,7,1400,0,1929,0,98117,47.681,-122.364,1400,3744,3514,2344,95.64509564509565,0.05180327868852459,Very Cheap
20141212T000000,600000.0,4,1.75,1700,7800,1.0,0,0,4,8,1700,0,1975,0,98052,47.651,-122.119,2430,8342,6100,5912,76.92307692307692,0.06885245901639345,Very Cheap
20140527T000000,1381000.0,4,3.75,3160,9525,2.5,0,0,3,10,3160,0,1997,0,98040,47.5623,-122.221,2400,9525,6365,7125,144.98687664041995,0.17127868852459016,Cheap
20141114T000000,427800.0,3,1.75,1340,13241,1.0,0,2,3,7,1340,0,1985,0,98034,47.7268,-122.213,2090,9704,11901,7614,32.30873801072426,0.046268852459016394,Very Cheap
20140606T000000,445000.0,4,2.0,1470,8395,1.0,0,0,4,7,1470,0,1965,0,98008,47.631,-122.117,1760,7976,6925,6216,53.00774270399047,0.04852459016393443,Very Cheap
20140716T000000,382000.0,3,1.75,1790,7679,1.0,0,0,4,7,1790,0,1953,0,98133,47.7442,-122.338,1560,7680,5889,6120,49.746060684985025,0.040262295081967214,Very Cheap
20141111T000000,577000.0,3,1.5,1560,20251,1.0,0,0,5,7,1200,360,1989,0,98074,47.619,-122.054,1560,19119,18691,17559,28.492420127401115,0.06583606557377049,Very Cheap
20150506T000000,427000.0,3,2.5,2620,108464,2.0,0,0,4,8,2620,0,1990,0,98038,47.4583,-122.036,3190,105850,105844,102660,3.936790087033486,0.04616393442622951,Very Cheap
20141224T000000,255000.0,3,1.0,1580,8206,1.0,0,0,3,7,1100,480,1962,0,98198,47.3676,-122.312,1600,8196,6626,6596,31.074823300024374,0.02360655737704918,Very Cheap
20140721T000000,240000.0,3,1.0,1090,10000,1.0,0,0,3,6,1090,0,1961,0,98014,47.6503,-121.911,1040,7500,8910,6460,24.0,0.021639344262295083,Very Cheap
20140620T000000,1234580.0,5,3.25,3240,6551,1.5,0,4,4,9,2500,740,1939,0,98115,47.6792,-122.273,2740,9300,3311,6560,188.45672416424972,0.15207606557377049,Cheap
20150213T000000,435000.0,4,1.75,2520,7200,1.0,0,2,5,7,1260,1260,1955,0,98056,47.4835,-122.192,2360,7300,4680,4940,60.416666666666664,0.04721311475409836,Very Cheap
20150327T000000,1450000.0,3,1.75,2230,13529,1.0,0,0,3,9,2230,0,1949,0,98004,47.6204,-122.217,2230,11900,11299,9670,107.1771749574987,0.18032786885245902,Cheap
20150506T000000,425000.0,4,3.0,2430,5502,2.0,0,0,3,8,2430,0,2002,0,98038,47.356,-122.014,2000,5702,3072,3702,77.2446383133406,0.04590163934426229,Very Cheap
20141216T000000,393000.0,2,1.0,1020,4200,1.0,0,0,5,6,1020,0,1923,0,98136,47.5319,-122.391,1660,4200,3180,2540,93.57142857142857,0.041704918032786885,Very Cheap
20140620T000000,264950.0,4,1.0,1810,7500,1.0,0,0,2,7,1410,400,1959,0,98168,47.4935,-122.333,1250,6255,5690,5005,35.32666666666667,0.024911475409836067,Very Cheap
20150412T000000,746500.0,4,2.5,3460,9699,2.0,0,0,3,10,3460,0,1987,0,98074,47.637,-122.04,3140,10631,6239,7491,76.96669759769048,0.0880655737704918,Very Cheap
20141124T000000,450000.0,3,1.0,2020,8100,1.0,0,0,3,7,1170,850,1956,0,98125,47.7136,-122.288,1480,7620,6080,6140,55.55555555555556,0.04918032786885246,Very Cheap
20140617T000000,229950.0,3,2.0,1410,7466,1.0,0,0,3,7,1410,0,1983,0,98058,47.427,-122.147,1410,7610,6056,6200,30.799624966514866,0.020321311475409835,Very Cheap
20150113T000000,425000.0,2,1.0,750,4000,1.0,0,0,2,6,750,0,1933,0,98108,47.54,-122.32,1160,4000,3250,2840,106.25,0.04590163934426229,Very Cheap
20140513T000000,2555000.0,4,2.5,5300,26211,2.0,1,2,2,10,4570,730,1923,0,98105,47.661,-122.269,3890,19281,20911,15391,97.47815802525658,0.32524590163934425,Medium
20150427T000000,1400000.0,4,3.5,4380,66613,1.5,0,0,3,11,4380,0,1993,0,98077,47.7279,-122.048,4010,70109,62233,66099,21.01691861948869,0.1737704918032787,Cheap
20141031T000000,753000.0,3,2.25,2290,9047,2.0,0,0,4,8,2290,0,1984,0,98006,47.5545,-122.163,2120,9275,6757,7155,83.23201061125235,0.08891803278688525,Very Cheap
20141006T000000,310000.0,2,1.0,720,5750,1.0,0,0,2,6,720,0,1943,0,98136,47.5535,-122.393,980,6125,5030,5145,53.91304347826087,0.03081967213114754,Very Cheap
20141219T000000,395000.0,2,1.0,1200,6014,1.0,0,0,4,6,600,600,1949,0,98118,47.5357,-122.28,1270,4652,4814,3382,65.68007981376788,0.0419672131147541,Very Cheap
20141211T000000,725000.0,3,2.5,2620,28703,1.0,0,0,3,10,2620,0,1985,0,98052,47.7238,-122.114,2950,30290,26083,27340,25.258683761279308,0.08524590163934426,Very Cheap
20140828T000000,295000.0,4,3.0,2120,7650,2.0,0,0,3,8,2120,0,1964,0,98007,47.6214,-122.14,2260,7885,5530,5625,38.56209150326797,0.028852459016393443,Very Cheap
20140623T000000,225000.0,3,1.75,1580,8820,1.0,0,0,4,7,1580,0,1967,0,98003,47.317,-122.325,1280,8500,7240,7220,25.510204081632654,0.019672131147540985,Very Cheap
20140814T000000,1699000.0,3,3.25,4160,35153,3.0,0,2,3,12,3690,470,2001,0,98040,47.5749,-122.214,3290,11533,30993,8243,48.331579097089865,0.21298360655737705,Cheap
20150202T000000,431000.0,3,2.25,1830,8831,1.0,0,0,3,7,1460,370,1979,0,98034,47.7286,-122.215,2330,8064,7001,5734,48.80534480806251,0.046688524590163934,Very Cheap
20150326T000000,358500.0,3,2.5,2000,8057,1.0,0,0,3,8,1360,640,1998,0,98042,47.3724,-122.107,2530,8964,6057,6434,44.49546977783294,0.03718032786885246,Very Cheap
20150428T000000,595000.0,2,1.0,980,3600,1.0,0,0,3,6,980,0,1907,0,98119,47.6366,-122.365,1690,3600,2620,1910,165.27777777777777,0.06819672131147542,Very Cheap
20150319T000000,468000.0,4,2.5,3040,20682,2.0,0,0,3,7,3040,0,2000,0,98019,47.7245,-121.959,2670,9742,17642,7072,22.628372497824195,0.05154098360655738,Very Cheap
20141203T000000,260000.0,4,1.0,1740,8100,1.0,0,0,4,7,1020,720,1962,0,98058,47.467,-122.185,1600,8949,6360,7349,32.098765432098766,0.024262295081967214,Very Cheap
20140917T000000,375000.0,3,2.0,1450,7300,1.5,0,0,5,7,1450,0,1955,0,98133,47.7517,-122.342,1660,9069,5850,7409,51.36986301369863,0.03934426229508197,Very Cheap
20140525T000000,295000.0,3,2.5,1560,4200,2.0,0,0,3,7,1560,0,2003,0,98038,47.3838,-122.026,1560,4200,2640,2640,70.23809523809524,0.028852459016393443,Very Cheap
20140731T000000,403900.0,4,2.5,2050,8909,1.0,0,2,4,8,1690,360,1986,0,98198,47.398,-122.31,2190,8912,6859,6722,45.33617689976428,0.043134426229508194,Very Cheap
20140722T000000,269950.0,3,1.75,1760,12823,1.0,0,0,4,7,1460,300,1956,0,98002,47.2868,-122.21,1450,10800,11063,9350,21.05201590891367,0.025567213114754097,Very Cheap
20150218T000000,640000.0,3,3.5,1740,1975,2.0,0,3,3,8,1310,430,1998,0,98122,47.6085,-122.311,1740,1975,235,235,324.0506329113924,0.0740983606557377,Very Cheap
20140627T000000,221000.0,3,1.0,910,8789,1.0,0,0,3,7,910,0,1966,0,98148,47.4345,-122.326,1160,8789,7879,7629,25.145067698259187,0.01914754098360656,Very Cheap
20140617T000000,255000.0,3,1.75,1700,7532,1.0,0,0,3,7,1700,0,1987,0,98030,47.355,-122.176,1690,7405,5832,5715,33.85554965480616,0.02360655737704918,Very Cheap
20140623T000000,300000.0,4,2.5,2620,4469,2.0,0,0,3,7,2620,0,2008,0,98042,47.3663,-122.115,2250,4500,1849,2250,67.12911165808906,0.029508196721311476,Very Cheap
20150320T000000,270000.0,3,2.25,1500,7410,1.0,0,0,4,7,1500,0,1973,0,98058,47.4597,-122.162,1750,7990,5910,6240,36.43724696356275,0.025573770491803278,Very Cheap
20150303T000000,575000.0,4,1.75,1630,5750,1.0,0,0,3,7,1160,470,1947,0,98116,47.5674,-122.384,1640,5750,4120,4110,100.0,0.06557377049180328,Very Cheap
20150211T000000,246900.0,3,1.5,1370,9800,1.0,0,0,5,7,1370,0,1968,0,98001,47.3068,-122.27,1370,9800,8430,8430,25.193877551020407,0.022544262295081968,Very Cheap
20150406T000000,635000.0,2,2.5,1390,1132,2.0,0,0,3,8,1130,260,2006,0,98102,47.6228,-122.319,1400,1237,-258,-163,560.9540636042403,0.07344262295081967,Very Cheap
20150317T000000,450000.0,3,2.0,1540,67756,1.0,0,0,3,7,1540,0,1900,1973,98077,47.721,-122.078,2060,67756,66216,65696,6.6414782454690355,0.04918032786885246,Very Cheap
20140910T000000,215000.0,3,1.0,1190,7500,1.0,0,0,5,7,1190,0,1968,0,98042,47.3248,-122.142,1200,9750,6310,8550,28.666666666666668,0.018360655737704918,Very Cheap
20140611T000000,785000.0,3,3.5,4500,21870,2.0,0,0,3,10,4500,0,2004,0,98092,47.3043,-122.159,4670,23058,17370,18388,35.89391860996799,0.09311475409836066,Very Cheap
20150220T000000,522500.0,4,3.0,2370,8154,1.0,0,0,3,7,1380,990,1977,0,98125,47.7258,-122.306,2100,8148,5784,6048,64.07897964189355,0.05868852459016394,Very Cheap
20140722T000000,150000.0,2,1.5,1360,1934,2.0,0,0,4,7,1360,0,1978,0,98092,47.2857,-122.189,1360,1898,574,538,77.55946225439503,0.009836065573770493,Very Cheap
20141215T000000,199950.0,2,1.75,870,18537,1.0,0,0,4,6,870,0,1946,0,98001,47.275,-122.278,1300,22800,17667,21500,10.786535038032044,0.01638688524590164,Very Cheap
20140618T000000,3000000.0,4,4.25,4850,12445,2.0,1,4,5,10,3850,1000,1989,0,98034,47.7011,-122.244,3350,12210,7595,8860,241.06066693451186,0.3836065573770492,Medium
20140710T000000,379900.0,3,2.0,3110,44967,2.0,0,0,3,9,3020,90,1999,0,98058,47.4343,-122.082,2150,44967,41857,42817,8.448417728556498,0.03998688524590164,Very Cheap
20141121T000000,950000.0,4,2.5,3700,7051,2.0,0,0,3,11,3700,0,2006,0,98029,47.5427,-121.995,3580,6175,3351,2595,134.73266203375408,0.11475409836065574,Cheap
20141203T000000,865000.0,6,2.75,3500,5150,2.0,0,0,5,8,2430,1070,1909,0,98117,47.6842,-122.363,1430,3860,1650,2430,167.96116504854368,0.10360655737704919,Cheap
20140604T000000,785000.0,3,1.75,1670,9600,1.0,0,0,5,8,1670,0,1961,0,98040,47.5754,-122.233,1900,9600,7930,7700,81.77083333333333,0.09311475409836066,Very Cheap
20140625T000000,245700.0,3,2.25,1640,8400,1.0,0,0,3,8,1180,460,1968,0,98032,47.3733,-122.289,1600,8120,6760,6520,29.25,0.022386885245901638,Very Cheap
20150415T000000,951000.0,3,2.25,3400,12825,1.0,0,1,3,9,3400,0,1961,0,98118,47.5435,-122.26,2510,11574,9425,9064,74.15204678362574,0.11488524590163934,Cheap
20150402T000000,499950.0,3,1.75,2060,3500,1.0,0,0,5,7,1030,1030,1951,0,98118,47.5635,-122.282,1110,6000,1440,4890,142.84285714285716,0.05573114754098361,Very Cheap
20150211T000000,257000.0,3,1.75,1330,36537,1.0,0,0,4,7,1330,0,1989,0,98092,47.3126,-122.129,1650,35100,35207,33450,7.033965569149082,0.023868852459016394,Very Cheap
20140917T000000,549000.0,3,2.0,2330,3600,1.5,0,0,4,7,1580,750,1900,0,98122,47.6025,-122.303,1750,3600,1270,1850,152.5,0.06216393442622951,Very Cheap
20150209T000000,1600000.0,3,2.75,3040,21052,2.0,0,0,4,10,3040,0,1980,0,98004,47.638,-122.225,2950,21052,18012,18102,76.00228006840206,0.2,Cheap
20141211T000000,1400000.0,5,3.75,3700,7920,3.0,0,4,3,9,2900,800,1983,0,98115,47.6865,-122.266,2860,6360,4220,3500,176.76767676767676,0.1737704918032787,Cheap
20140820T000000,619000.0,3,2.0,1990,3000,1.5,0,2,5,8,1430,560,1927,0,98144,47.5891,-122.293,1780,5000,1010,3220,206.33333333333334,0.07134426229508196,Very Cheap
20141009T000000,311000.0,5,3.0,2020,5917,1.0,0,0,3,7,1220,800,1993,0,98108,47.5482,-122.294,2130,5529,3897,3399,52.56041913131654,0.030950819672131147,Very Cheap
20140701T000000,600000.0,5,2.25,2980,7781,1.0,0,0,3,9,1580,1400,1960,0,98125,47.7048,-122.279,2310,7781,4801,5471,77.11091119393394,0.06885245901639345,Very Cheap
20140626T000000,1080000.0,4,3.5,3990,5267,2.0,0,0,3,10,3990,0,2008,0,98006,47.5641,-122.124,3230,6481,1277,3251,205.05031327131195,0.1318032786885246,Cheap
20140619T000000,436000.0,2,1.0,790,6600,1.0,0,0,3,6,790,0,1949,0,98122,47.6149,-122.293,1520,4400,5810,2880,66.06060606060606,0.047344262295081964,Very Cheap
20140715T000000,205000.0,2,1.0,1060,8000,1.0,0,0,3,6,1060,0,1941,0,98168,47.5088,-122.333,1390,8000,6940,6610,25.625,0.017049180327868854,Very Cheap
20140903T000000,514000.0,3,2.25,2260,54014,1.0,0,0,3,7,1450,810,1962,0,98072,47.7657,-122.131,2140,44431,51754,42291,9.516051394083016,0.05757377049180328,Very Cheap
20140903T000000,530000.0,2,2.5,1900,2983,2.0,0,0,3,8,1900,0,2006,0,98053,47.7029,-122.015,1510,3876,1083,2366,177.67348307073416,0.05967213114754098,Very Cheap
20140811T000000,511000.0,5,2.5,3361,6983,2.0,0,0,3,10,3361,0,2006,0,98092,47.3427,-122.169,3112,6920,3622,3808,73.17771731347558,0.05718032786885246,Very Cheap
20140515T000000,2100000.0,4,1.75,3550,19865,2.0,0,0,3,9,3550,0,1962,2002,98039,47.6236,-122.235,3000,19862,16315,16862,105.71356657437704,0.26557377049180325,Cheap
20150310T000000,370000.0,5,2.5,2740,5460,2.0,0,0,3,8,2740,0,2005,0,98031,47.4042,-122.204,2900,5971,2720,3071,67.76556776556777,0.038688524590163934,Very Cheap
20141216T000000,500000.0,4,1.75,2040,6000,1.0,0,0,5,7,1020,1020,1943,0,98136,47.5507,-122.383,1440,6000,3960,4560,83.33333333333333,0.05573770491803279,Very Cheap
20141105T000000,710000.0,4,2.5,4070,129808,2.0,0,0,3,10,4070,0,1998,0,98038,47.4433,-122.016,4070,102366,125738,98296,5.46961666461235,0.08327868852459017,Very Cheap
20140908T000000,270000.0,1,1.0,720,5196,1.0,0,0,3,7,720,0,1911,0,98103,47.6928,-122.337,1580,5762,4476,4182,51.96304849884527,0.025573770491803278,Very Cheap
20140805T000000,415000.0,3,1.75,2000,8400,1.5,0,0,4,8,2000,0,1959,0,98133,47.7535,-122.334,2000,8400,6400,6400,49.404761904761905,0.04459016393442623,Very Cheap
20140605T000000,1800000.0,5,4.5,4400,15580,2.0,0,0,3,11,3390,1010,2003,0,98004,47.6232,-122.207,2150,14249,11180,12099,115.53273427471117,0.2262295081967213,Cheap
20141217T000000,236000.0,3,1.75,1300,8976,1.0,0,0,3,7,1300,0,1967,0,98003,47.3357,-122.305,1430,9750,7676,8320,26.292335115864528,0.021114754098360656,Very Cheap
20141208T000000,278000.0,2,2.5,1420,2229,2.0,0,0,3,7,1420,0,2004,0,98059,47.4871,-122.165,1500,2230,809,730,124.7196052041274,0.02662295081967213,Very Cheap
20140603T000000,312000.0,3,2.25,1540,5338,1.0,0,0,5,7,770,770,1954,0,98115,47.6942,-122.304,1680,6525,3798,4845,58.44885724990633,0.031081967213114754,Very Cheap
20150304T000000,539000.0,3,2.25,1540,5338,1.0,0,0,5,7,770,770,1954,0,98115,47.6942,-122.304,1680,6525,3798,4845,100.97414762083177,0.06085245901639344,Very Cheap
20140910T000000,498000.0,3,3.0,2360,2750,2.0,0,1,3,7,1780,580,1983,0,98125,47.7142,-122.281,1970,5800,390,3830,181.0909090909091,0.055475409836065574,Very Cheap
20140527T000000,857000.0,4,3.0,3720,29043,2.0,0,0,3,9,3720,0,1991,0,98033,47.6907,-122.161,1610,23000,25323,21390,29.507970939641222,0.10255737704918033,Cheap
20150225T000000,780000.0,3,1.75,1690,13500,1.0,0,0,4,7,1690,0,1978,0,98040,47.5897,-122.233,1950,10500,11810,8550,57.77777777777778,0.09245901639344262,Very Cheap
20140923T000000,650000.0,3,2.0,2300,5000,1.0,0,0,4,8,1150,1150,1938,0,98199,47.6521,-122.413,2300,5000,2700,2700,130.0,0.07540983606557378,Very Cheap
20150409T000000,559500.0,4,1.75,1650,7088,1.0,0,0,3,8,1650,0,1973,0,98027,47.5688,-122.087,1850,7523,5438,5673,78.936230248307,0.06354098360655738,Very Cheap
20140724T000000,219950.0,2,1.0,990,6448,1.0,0,0,3,7,990,0,1948,0,98178,47.5031,-122.245,1130,7200,5458,6070,34.1113523573201,0.01900983606557377,Very Cheap
20140725T000000,671500.0,4,2.25,2130,8410,2.0,0,0,4,8,2130,0,1977,0,98006,47.5589,-122.128,2170,8400,6280,6230,79.84542211652794,0.07822950819672131,Very Cheap
20140903T000000,813000.0,4,2.5,3320,52707,2.0,0,0,3,10,3320,0,1999,0,98074,47.6247,-122.016,3040,54450,49387,51410,15.424896123854516,0.09678688524590164,Very Cheap
20140728T000000,182000.0,3,2.25,1960,8875,1.0,0,0,3,7,1290,670,1965,0,98003,47.3344,-122.301,1890,8700,6915,6810,20.507042253521128,0.014032786885245901,Very Cheap
20140822T000000,203700.0,2,1.0,770,2500,1.0,0,0,3,6,770,0,1913,1960,98072,47.7534,-122.172,1500,8286,1730,6786,81.48,0.016878688524590162,Very Cheap
20140505T000000,740000.0,4,1.75,2010,3600,1.5,0,0,3,7,2010,0,1902,0,98119,47.6337,-122.371,2010,3600,1590,1590,205.55555555555554,0.08721311475409836,Very Cheap
20150311T000000,230000.0,2,1.0,800,17965,1.0,0,0,4,5,800,0,1942,0,98058,47.4693,-122.161,1500,8925,17165,7425,12.8026718619538,0.020327868852459016,Very Cheap
20141009T000000,128000.0,3,1.0,910,11117,1.0,0,0,3,7,910,0,1955,0,98003,47.3432,-122.309,1490,8416,10207,6926,11.513897634253846,0.006950819672131147,Very Cheap
20140822T000000,345000.0,3,1.0,1200,6628,1.0,0,0,4,7,1200,0,1952,0,98155,47.7367,-122.319,1330,6768,5428,5438,52.051901025950514,0.03540983606557377,Very Cheap
20150427T000000,663000.0,4,2.5,3570,6246,2.0,0,0,3,7,3570,0,2005,0,98075,47.5927,-122.006,2260,5231,2676,2971,106.14793467819405,0.07711475409836066,Very Cheap
20140620T000000,329950.0,3,2.5,1820,8085,2.0,0,0,3,7,1820,0,1983,0,98055,47.4575,-122.204,1860,8625,6265,6765,40.81014223871367,0.03343606557377049,Very Cheap
20140811T000000,1047500.0,3,2.25,2930,7005,3.0,0,2,3,9,2670,260,1999,0,98117,47.6763,-122.404,2450,6460,4075,4010,149.53604568165596,0.12754098360655738,Cheap
20141112T000000,402300.0,3,1.75,1480,4050,1.0,0,0,3,7,870,610,1926,0,98115,47.681,-122.304,1350,4500,2570,3150,99.33333333333333,0.04292459016393443,Very Cheap
20140507T000000,492000.0,4,2.5,3305,16164,1.5,0,0,5,7,2245,1060,1922,1956,98133,47.7563,-122.338,1620,8883,12859,7263,30.438010393466964,0.054688524590163934,Very Cheap
20150507T000000,448000.0,4,2.5,2230,5000,1.0,0,0,3,7,1650,580,2006,0,98059,47.4799,-122.129,2090,4637,2770,2547,89.6,0.048918032786885245,Very Cheap
20150225T000000,273000.0,3,1.0,1560,7800,1.0,0,0,3,7,1560,0,1955,0,98188,47.4549,-122.287,1468,9375,6240,7907,35.0,0.025967213114754098,Very Cheap
20141003T000000,335000.0,3,1.0,1030,7200,1.0,0,0,3,6,880,150,1948,0,98126,47.5255,-122.376,1030,7200,6170,6170,46.52777777777778,0.03409836065573771,Very Cheap
20140905T000000,695000.0,3,3.75,2380,3600,1.5,0,0,3,7,1690,690,1927,0,98112,47.6374,-122.307,1990,3520,1220,1530,193.05555555555554,0.08131147540983606,Very Cheap
20150503T000000,279000.0,3,1.0,1010,7903,1.0,0,0,3,6,1010,0,1948,0,98155,47.766,-122.32,1010,7903,6893,6893,35.303049474882954,0.02675409836065574,Very Cheap
20141205T000000,485000.0,2,1.75,2060,2700,1.0,0,0,3,7,1030,1030,1929,0,98115,47.6856,-122.312,1390,2700,640,1310,179.62962962962962,0.05377049180327869,Very Cheap
20140812T000000,383000.0,4,2.5,2370,10580,2.0,0,0,3,8,2370,0,1966,0,98055,47.464,-122.192,1590,8584,8210,6994,36.20037807183365,0.04039344262295082,Very Cheap
20141216T000000,490000.0,4,2.5,2242,37451,2.0,0,0,3,8,2242,0,1995,0,98028,47.7443,-122.228,2242,13125,35209,10883,13.08376278337027,0.05442622950819672,Very Cheap
20141119T000000,240000.0,2,1.5,1078,1263,2.0,0,0,3,7,1078,0,1990,0,98028,47.7532,-122.244,1078,1263,185,185,190.02375296912115,0.021639344262295083,Very Cheap
20150224T000000,285000.0,2,1.0,890,7250,1.0,0,0,3,7,890,0,1943,0,98125,47.7118,-122.314,900,7000,6360,6100,39.310344827586206,0.02754098360655738,Very Cheap
20150225T000000,524950.0,3,1.5,2700,24539,2.0,0,0,3,7,2120,580,1977,2014,98019,47.7348,-121.984,1830,11000,21839,9170,21.3924772810628,0.05900983606557377,Very Cheap
20150407T000000,729000.0,4,2.5,2450,27081,2.0,0,0,3,8,2450,0,1985,0,98052,47.7177,-122.104,2630,12025,24631,9395,26.91924227318046,0.08577049180327868,Very Cheap
20140905T000000,460000.0,3,1.75,1420,8250,1.0,0,0,4,7,1420,0,1960,0,98007,47.6112,-122.133,2020,8250,6830,6230,55.75757575757576,0.050491803278688525,Very Cheap
20141014T000000,687500.0,3,1.5,1280,2114,1.5,0,0,3,8,1280,0,1904,0,98122,47.6174,-122.308,1540,1456,834,-84,325.2128666035951,0.08032786885245902,Very Cheap
20140814T000000,1168000.0,5,2.75,2910,15118,1.0,0,0,5,9,1780,1130,1972,0,98006,47.5696,-122.183,2880,15253,12208,12373,77.25889667945495,0.14334426229508196,Cheap
20141015T000000,825000.0,4,2.25,2430,10050,2.0,0,0,4,8,2430,0,1979,0,98006,47.5563,-122.163,2390,10250,7620,7860,82.08955223880596,0.09836065573770492,Very Cheap
20140729T000000,314950.0,2,2.5,1860,6359,2.0,0,0,3,7,1860,0,2003,0,98038,47.3847,-122.029,1860,6359,4499,4499,49.52822770875924,0.03146885245901639,Very Cheap
20140604T000000,470000.0,3,2.0,1800,12669,1.0,0,0,3,7,1800,0,1956,1990,98033,47.6935,-122.173,1970,9775,10869,7805,37.098429236719554,0.05180327868852459,Very Cheap
20140818T000000,500000.0,3,1.5,1960,8815,1.0,0,0,4,7,1020,940,1958,0,98006,47.5765,-122.159,1760,9534,6855,7774,56.72149744753261,0.05573770491803279,Very Cheap
20141117T000000,313000.0,3,1.5,1550,7260,1.5,0,0,2,6,1550,0,1925,0,98166,47.4693,-122.349,1190,7620,5710,6430,43.112947658402206,0.03121311475409836,Very Cheap
20140710T000000,445000.0,2,1.0,840,3840,1.0,0,0,4,7,840,0,1926,0,98117,47.684,-122.378,1310,3840,3000,2530,115.88541666666667,0.04852459016393443,Very Cheap
20140828T000000,300000.0,4,1.75,2080,8750,1.0,0,0,4,8,1330,750,1967,0,98032,47.3749,-122.291,1790,8750,6670,6960,34.285714285714285,0.029508196721311476,Very Cheap
20141014T000000,619500.0,4,2.5,2210,5077,1.5,0,0,4,8,1480,730,1912,0,98126,47.5719,-122.377,1740,5000,2867,3260,122.02087847153831,0.07140983606557377,Very Cheap
20140613T000000,305000.0,3,1.5,1210,5240,1.0,0,0,4,7,610,600,1983,0,98106,47.5524,-122.356,1560,5240,4030,3680,58.20610687022901,0.03016393442622951,Very Cheap
20150401T000000,874000.0,3,2.5,1350,941,3.0,0,0,3,9,1350,0,2007,0,98119,47.6265,-122.364,1640,1369,-409,-271,928.7991498405951,0.10478688524590164,Cheap
20150313T000000,477500.0,3,2.0,1860,5146,2.0,0,0,3,8,1860,0,1991,0,98029,47.5706,-121.999,1950,5146,3286,3196,92.79051690633501,0.05278688524590164,Very Cheap
20141110T000000,700000.0,3,2.0,1940,4500,1.0,0,3,3,7,1090,850,1926,0,98107,47.6659,-122.359,1700,4500,2560,2800,155.55555555555554,0.08196721311475409,Very Cheap
20150306T000000,515000.0,4,3.5,3400,5222,2.0,0,0,3,9,3400,0,2005,0,98038,47.3559,-122.0,3190,5326,1822,2136,98.62121792416698,0.057704918032786885,Very Cheap
20141016T000000,590000.0,4,2.5,2240,9385,2.0,0,0,3,8,2240,0,1991,0,98133,47.7125,-122.332,2010,9000,7145,6990,62.866275972296215,0.06754098360655737,Very Cheap
20140701T000000,205000.0,3,1.75,1170,8239,1.0,0,0,3,7,1170,0,1981,0,98042,47.3679,-122.088,1180,7866,7069,6686,24.881660395679088,0.017049180327868854,Very Cheap
20141022T000000,310000.0,3,3.25,3130,9302,2.0,0,0,3,8,2190,940,1987,0,98023,47.3078,-122.338,2350,7949,6172,5599,33.32616641582455,0.03081967213114754,Very Cheap
20140821T000000,442500.0,2,2.25,1510,7280,2.0,0,0,3,7,1510,0,1987,0,98074,47.6264,-122.058,1510,8120,5770,6610,60.782967032967036,0.04819672131147541,Very Cheap
20141106T000000,1078500.0,4,3.5,3740,41458,2.0,0,2,3,11,3740,0,2000,0,98072,47.7375,-122.139,3750,38325,37718,34575,26.01427951179507,0.13160655737704918,Cheap
20140825T000000,530000.0,4,2.5,2690,46609,2.0,0,0,3,8,2690,0,1980,1991,98038,47.3843,-122.006,1500,34800,43919,33300,11.37119440451415,0.05967213114754098,Very Cheap
20140624T000000,343500.0,4,1.75,1760,6204,1.0,0,2,4,7,1180,580,1950,0,98178,47.5045,-122.24,1990,6240,4444,4250,55.36750483558994,0.035213114754098364,Very Cheap
20150423T000000,334900.0,4,1.75,2180,4066,1.5,0,0,3,6,1270,910,1911,0,98118,47.5487,-122.277,1400,1343,1886,-57,82.3659616330546,0.03408524590163935,Very Cheap
20141105T000000,544300.0,4,1.75,1560,9000,1.0,0,0,5,7,1560,0,1969,0,98052,47.6707,-122.149,1510,8848,7440,7338,60.477777777777774,0.061547540983606555,Very Cheap
20140526T000000,370000.0,3,2.5,1780,4050,2.0,0,0,3,7,1780,0,2001,0,98155,47.7346,-122.308,1571,4976,2270,3405,91.35802469135803,0.038688524590163934,Very Cheap
20140524T000000,245000.0,3,1.75,1260,6908,1.0,0,0,3,7,1260,0,1994,0,98038,47.385,-122.031,1810,7159,5648,5349,35.46612623045744,0.022295081967213116,Very Cheap
20150210T000000,535000.0,4,1.75,1570,3250,1.5,0,0,5,8,1570,0,1928,0,98136,47.5405,-122.393,1570,5720,1680,4150,164.6153846153846,0.06032786885245902,Very Cheap
20150406T000000,202000.0,2,1.0,740,6550,1.0,0,0,4,5,740,0,1946,0,98168,47.4807,-122.332,1080,8515,5810,7435,30.83969465648855,0.016655737704918034,Very Cheap
20141118T000000,490000.0,4,2.25,2020,4960,2.0,0,0,3,7,1710,310,1938,0,98117,47.6867,-122.369,1590,4550,2940,2960,98.79032258064517,0.05442622950819672,Very Cheap
20141216T000000,651500.0,4,1.5,1500,3075,2.0,0,0,5,7,1420,80,1929,0,98103,47.6893,-122.35,1480,3774,1575,2294,211.869918699187,0.07560655737704917,Very Cheap
20150114T000000,270000.0,4,2.5,1670,8056,1.0,0,0,3,7,1170,500,1961,0,98168,47.4884,-122.319,1360,8056,6386,6696,33.51539225422046,0.025573770491803278,Very Cheap
20150407T000000,1164000.0,3,3.5,3620,8072,2.0,0,0,3,10,2920,700,1999,0,98006,47.5646,-122.127,3680,9624,4452,5944,144.2021803766105,0.14281967213114755,Cheap
20140716T000000,289000.0,2,1.5,1010,1309,2.0,0,0,3,7,860,150,2007,0,98118,47.5659,-122.286,1190,3060,299,1870,220.7792207792208,0.028065573770491802,Very Cheap
20150417T000000,240000.0,3,1.5,1460,13503,1.0,0,0,4,6,1460,0,1977,0,98010,47.3119,-122.015,1460,13394,12043,11934,17.77382803821373,0.021639344262295083,Very Cheap
20140515T000000,790000.0,3,1.75,1790,6117,1.0,0,2,3,8,1350,440,1940,0,98199,47.6366,-122.401,1960,5554,4327,3594,129.14827529834886,0.09377049180327869,Very Cheap
20141222T000000,350000.0,3,2.25,1760,9621,2.0,0,0,3,7,1760,0,1995,0,98019,47.7466,-121.979,1810,6589,7861,4779,36.3787548071926,0.036065573770491806,Very Cheap
20141029T000000,246950.0,3,3.5,1790,1682,2.0,0,0,3,7,1480,310,2006,0,98108,47.542,-122.321,1150,4000,-108,2850,146.8192627824019,0.02255081967213115,Very Cheap
20150105T000000,400000.0,3,1.0,1050,6000,1.0,0,0,3,7,1050,0,1952,0,98116,47.5709,-122.401,1720,6000,4950,4280,66.66666666666667,0.04262295081967213,Very Cheap
20150225T000000,533000.0,4,2.5,2590,6394,2.0,0,0,3,8,2590,0,2003,0,98028,47.7599,-122.233,2500,5328,3804,2828,83.35939943697217,0.060065573770491806,Very Cheap
20141021T000000,198400.0,3,1.0,1040,8645,1.0,0,0,4,7,1040,0,1962,0,98042,47.3631,-122.116,1290,8645,7605,7355,22.94968189705032,0.01618360655737705,Very Cheap
20141029T000000,495000.0,4,2.5,4060,8547,2.0,0,0,3,9,2790,1270,2007,0,98038,47.3694,-122.056,2810,8313,4487,5503,57.915057915057915,0.05508196721311476,Very Cheap
20140616T000000,862000.0,4,2.5,3190,14565,2.0,0,0,3,11,3190,0,1990,0,98077,47.713,-122.072,3420,20475,11375,17055,59.18297288019224,0.10321311475409836,Cheap
20140819T000000,870000.0,4,2.5,3190,14565,2.0,0,0,3,11,3190,0,1990,0,98077,47.713,-122.072,3420,20475,11375,17055,59.73223480947477,0.10426229508196722,Cheap
20150224T000000,875000.0,4,1.75,2180,9726,1.0,0,0,4,9,2180,0,1966,0,98040,47.5359,-122.233,2560,10244,7546,7684,89.96504215504832,0.10491803278688525,Cheap
20140903T000000,317000.0,6,3.5,2120,5840,2.0,0,0,5,7,2120,0,1979,0,98055,47.4788,-122.227,1860,8000,3720,6140,54.28082191780822,0.03173770491803279,Very Cheap
20140725T000000,325000.0,4,2.75,2110,6838,2.0,0,0,4,8,2110,0,1991,0,98031,47.3877,-122.171,2100,7280,4728,5180,47.52851711026616,0.03278688524590164,Very Cheap
20140920T000000,615000.0,2,1.5,1210,5000,1.5,0,0,5,6,1210,0,1907,0,98117,47.6793,-122.397,1570,5000,3790,3430,123.0,0.07081967213114754,Very Cheap
20140721T000000,334950.0,4,2.5,2410,7846,2.0,0,0,3,8,2410,0,1992,0,98003,47.2641,-122.312,2380,7914,5436,5534,42.690542951822586,0.03409180327868853,Very Cheap
20140821T000000,775000.0,3,2.5,1980,7807,2.0,0,0,4,9,1980,0,1989,0,98033,47.6884,-122.204,1590,7579,5827,5989,99.26988599974382,0.09180327868852459,Very Cheap
20140822T000000,600000.0,4,2.5,2370,9135,1.0,0,0,4,8,1600,770,1967,0,98006,47.5564,-122.177,2050,9468,6765,7418,65.68144499178982,0.06885245901639345,Very Cheap
20140728T000000,565000.0,3,1.75,1720,2218,1.5,0,0,3,7,1270,450,1931,2003,98103,47.649,-122.335,1130,1600,498,470,254.73399458972048,0.06426229508196721,Very Cheap
20141028T000000,292500.0,2,1.0,750,5026,1.0,0,0,4,6,750,0,1942,0,98126,47.5368,-122.374,1260,5040,4276,3780,58.197373656983686,0.028524590163934428,Very Cheap
20150429T000000,825000.0,3,2.25,2510,10418,1.0,0,0,3,8,1810,700,1968,0,98115,47.7003,-122.285,2510,9435,7908,6925,79.18986369744673,0.09836065573770492,Very Cheap
20150415T000000,495000.0,3,2.5,2577,156816,2.0,0,0,3,8,2577,0,2000,0,98092,47.2935,-122.108,2090,156816,154239,154726,3.1565656565656566,0.05508196721311476,Very Cheap
20140520T000000,525000.0,3,1.5,1540,4773,2.0,0,0,3,8,1540,0,1941,2009,98126,47.5678,-122.378,1540,5750,3233,4210,109.99371464487743,0.05901639344262295,Very Cheap
20150511T000000,438600.0,1,1.0,720,2500,1.0,0,0,3,7,720,0,1910,0,98103,47.6597,-122.345,1520,3750,1780,2230,175.44,0.04768524590163935,Very Cheap
20140814T000000,507000.0,3,2.25,1810,8158,1.0,0,0,3,8,1450,360,1984,0,98074,47.6258,-122.038,1740,9532,6348,7792,62.14758519244913,0.05665573770491803,Very Cheap
20150429T000000,275900.0,3,1.75,1380,8400,1.0,0,0,3,7,1380,0,1967,0,98003,47.3117,-122.321,1540,8400,7020,6860,32.845238095238095,0.026347540983606556,Very Cheap
20140617T000000,1170000.0,4,2.5,2570,6251,2.0,0,0,3,9,2570,0,2000,0,98004,47.593,-122.197,2570,9588,3681,7018,187.17005279155336,0.1436065573770492,Cheap
20141209T000000,275000.0,4,1.75,1690,6000,1.0,0,0,3,7,1690,0,1957,0,98178,47.497,-122.227,1350,6000,4310,4650,45.833333333333336,0.02622950819672131,Very Cheap
20141027T000000,355000.0,3,0.75,1420,3060,1.0,0,0,4,7,860,560,1923,0,98103,47.6872,-122.346,1350,4000,1640,2650,116.01307189542484,0.036721311475409836,Very Cheap
20150126T000000,233000.0,4,2.0,2130,9579,1.0,0,0,4,7,1250,880,1968,0,98001,47.3069,-122.271,1590,9800,7449,8210,24.324042175592442,0.020721311475409836,Very Cheap
20140904T000000,666000.0,3,2.5,3000,5000,1.5,0,0,4,7,2110,890,1918,0,98144,47.5781,-122.293,1970,5000,2000,3030,133.2,0.07750819672131147,Very Cheap
20140811T000000,317500.0,4,2.5,2150,9000,1.0,0,0,4,7,1360,790,1979,0,98059,47.4785,-122.16,1620,8400,6850,6780,35.27777777777778,0.03180327868852459,Very Cheap
20140722T000000,420000.0,4,2.0,2280,10319,1.0,0,3,4,8,1270,1010,1989,0,98198,47.3594,-122.322,2280,9767,8039,7487,40.70161837387344,0.04524590163934426,Very Cheap
20150312T000000,290000.0,4,2.0,1560,8800,2.0,0,0,5,6,1560,0,1942,1967,98168,47.4927,-122.312,1480,10000,7240,8520,32.95454545454545,0.02819672131147541,Very Cheap
20140603T000000,320000.0,3,2.0,1880,10758,1.0,0,0,5,6,940,940,1952,0,98059,47.5091,-122.144,2060,21000,8878,18940,29.745305818925452,0.032131147540983604,Very Cheap
20150323T000000,650000.0,3,2.5,2320,5284,2.0,0,0,3,8,2320,0,2004,0,98075,47.591,-122.017,2320,4383,2964,2063,123.01286903860712,0.07540983606557378,Very Cheap
20140714T000000,325000.0,3,1.75,1010,7171,1.0,0,0,4,7,1010,0,1967,0,98034,47.7317,-122.231,1250,7560,6161,6310,45.32143355180588,0.03278688524590164,Very Cheap
20140820T000000,165000.0,3,1.0,1120,5000,1.0,0,0,3,6,1120,0,1917,0,98146,47.5109,-122.357,1050,5000,3880,3950,33.0,0.01180327868852459,Very Cheap
20140807T000000,500000.0,3,1.75,1560,16194,1.0,0,0,3,8,1560,0,1961,0,98005,47.5966,-122.175,2430,16193,14634,13763,30.875632950475485,0.05573770491803279,Very Cheap
20140716T000000,443000.0,4,1.5,1860,12197,1.0,0,0,3,7,1860,0,1964,0,98034,47.729,-122.235,1510,11761,10337,10251,36.32040665737476,0.048262295081967214,Very Cheap
20140609T000000,213400.0,3,1.5,1150,8686,1.0,0,0,4,7,1150,0,1963,0,98055,47.4417,-122.194,1760,8798,7536,7038,24.56827078056643,0.018150819672131148,Very Cheap
20141002T000000,480000.0,4,1.75,1920,9380,1.0,0,0,3,7,1920,0,1964,0,98008,47.6344,-122.118,1580,8580,7460,7000,51.172707889125796,0.05311475409836065,Very Cheap
20150115T000000,275000.0,4,2.25,2490,7233,1.0,0,0,3,8,1460,1030,1978,0,98023,47.3115,-122.396,2000,8000,4743,6000,38.02018526199364,0.02622950819672131,Very Cheap
20140709T000000,299880.0,3,2.5,1460,3044,2.0,0,0,3,7,1460,0,2000,0,98108,47.544,-122.296,1490,3044,1584,1554,98.51511169513797,0.029492459016393444,Very Cheap
20140527T000000,499950.0,3,3.5,1820,1501,2.0,0,0,3,8,1430,390,2014,0,98144,47.596,-122.298,1550,1501,-319,-49,333.07794803464355,0.05573114754098361,Very Cheap
20141203T000000,1705000.0,5,3.0,4290,17100,1.0,0,3,3,9,2480,1810,1972,2007,98040,47.5473,-122.211,3550,16988,12810,13438,99.70760233918129,0.2137704918032787,Cheap
20140806T000000,550000.0,4,2.75,2230,9460,1.0,0,0,5,7,1480,750,1960,0,98027,47.5246,-122.044,1760,10878,7230,9118,58.13953488372093,0.06229508196721312,Very Cheap
20140602T000000,300000.0,4,2.5,2070,7476,2.0,0,0,3,8,2070,0,2003,0,98092,47.3352,-122.189,2430,5500,5406,3070,40.12841091492777,0.029508196721311476,Very Cheap
20141014T000000,920000.0,3,1.75,2480,4000,1.0,0,0,3,8,1240,1240,1948,2014,98122,47.615,-122.288,2450,4000,1520,1550,230.0,0.11081967213114755,Cheap
20140819T000000,2300000.0,4,3.25,4110,15929,2.0,1,4,3,12,2720,1390,2001,0,98115,47.6934,-122.271,2640,15929,11819,13289,144.3907338815996,0.29180327868852457,Cheap
20140724T000000,620000.0,4,2.75,2290,3060,1.5,0,0,5,7,1550,740,1928,0,98115,47.6793,-122.316,1460,3060,770,1600,202.6143790849673,0.07147540983606557,Very Cheap
20140811T000000,253500.0,3,1.0,1220,20400,1.0,0,0,5,6,1220,0,1959,0,98022,47.2063,-122.023,1640,53578,19180,51938,12.426470588235293,0.023409836065573772,Very Cheap
20140520T000000,978000.0,4,2.75,2620,13777,1.5,0,2,4,9,1720,900,1926,0,98144,47.58,-122.285,3530,9287,11157,5757,70.98787834797126,0.11842622950819671,Cheap
20141202T000000,387500.0,4,2.5,3190,9856,2.0,0,0,3,8,3190,0,1979,0,98058,47.4445,-122.126,2260,7996,6666,5736,39.3161525974026,0.040983606557377046,Very Cheap
20140624T000000,325000.0,3,1.0,850,6906,1.0,0,0,3,6,850,0,1948,0,98155,47.7441,-122.314,1150,6907,6056,5757,47.060527077903274,0.03278688524590164,Very Cheap
20150410T000000,568000.0,3,2.5,1740,1308,3.0,0,0,3,8,1740,0,2008,0,98116,47.5892,-122.387,1740,1280,-432,-460,434.2507645259939,0.06465573770491803,Very Cheap
20140922T000000,525000.0,4,2.5,2140,7754,2.0,0,0,3,8,2140,0,1996,0,98133,47.7173,-122.338,1690,7775,5614,6085,67.70698994067578,0.05901639344262295,Very Cheap
20140604T000000,560000.0,3,2.5,2070,12708,2.0,0,0,3,8,2070,0,1996,0,98056,47.5295,-122.18,2620,9617,10638,6997,44.066729619137554,0.06360655737704918,Very Cheap
20141020T000000,394000.0,3,2.5,1680,4075,2.0,0,0,3,7,1680,0,2008,0,98053,47.6964,-122.024,1710,4075,2395,2365,96.68711656441718,0.041836065573770495,Very Cheap
20141028T000000,484950.0,2,1.0,1000,4956,1.0,0,2,4,7,1000,0,1916,0,98107,47.6753,-122.36,1830,4959,3956,3129,97.85108958837772,0.05376393442622951,Very Cheap
20141105T000000,1295000.0,3,2.75,3340,12690,1.0,0,0,3,10,2550,790,1956,1988,98105,47.6665,-122.27,3340,9480,9350,6140,102.04885736800631,0.16,Cheap
20140729T000000,315000.0,3,2.5,1260,2767,2.0,0,0,3,8,1260,0,1999,0,98059,47.4914,-122.155,1310,2767,1507,1457,113.84170581857607,0.031475409836065574,Very Cheap
20140509T000000,590000.0,4,2.25,2430,32496,1.0,0,0,3,9,2430,0,1993,0,98077,47.7642,-122.048,2750,35506,30066,32756,18.156080748399802,0.06754098360655737,Very Cheap
20141126T000000,106000.0,1,1.0,560,5700,1.0,0,0,3,5,560,0,1947,0,98146,47.511,-122.359,1120,5000,5140,3880,18.596491228070175,0.0040655737704918034,Very Cheap
20141118T000000,751000.0,3,2.5,3380,9528,2.0,0,0,3,10,3380,0,1994,0,98059,47.5275,-122.148,3630,14089,6148,10459,78.82031905961377,0.08865573770491804,Very Cheap
20141017T000000,474000.0,2,1.0,1100,3500,1.0,0,0,5,7,1100,0,1908,0,98115,47.6741,-122.323,2050,4000,2400,1950,135.42857142857142,0.05232786885245902,Very Cheap
20140528T000000,189000.0,2,2.0,1700,3171,1.0,0,0,5,5,850,850,1927,0,98002,47.3025,-122.224,1380,5906,1471,4526,59.602649006622514,0.014950819672131148,Very Cheap
20141024T000000,440500.0,3,2.5,1600,3172,2.0,0,0,3,7,1600,0,2002,0,98053,47.6868,-122.042,1690,3698,1572,2008,138.87137452711224,0.0479344262295082,Very Cheap
20150318T000000,1017000.0,3,2.5,2605,2216,2.0,0,2,4,9,2090,515,1979,0,98033,47.6529,-122.202,2605,1979,-389,-626,458.93501805054154,0.12354098360655738,Cheap
20150511T000000,589000.0,2,2.0,1850,4667,1.0,0,0,3,8,1850,0,2010,0,98053,47.7101,-122.014,1860,6008,2817,4148,126.20527105206772,0.06740983606557377,Very Cheap
20140829T000000,273000.0,3,2.25,1830,7651,2.0,0,0,3,8,1830,0,1986,0,98092,47.2642,-122.219,2160,8442,5821,6282,35.68161024702653,0.025967213114754098,Very Cheap
20140620T000000,950000.0,3,3.25,3050,18892,1.0,1,4,4,8,1650,1400,1962,0,98198,47.3881,-122.326,1170,70973,15842,69803,50.285835274190134,0.11475409836065574,Cheap
20141110T000000,277700.0,2,1.5,1240,1055,2.0,0,0,3,8,1200,40,1967,0,98008,47.6104,-122.112,1410,1340,-185,-70,263.22274881516586,0.02658360655737705,Very Cheap
20141124T000000,299900.0,3,2.25,2100,8163,2.0,0,0,3,7,2100,0,1984,0,98001,47.3336,-122.269,1410,7515,6063,6105,36.73894401568051,0.029495081967213115,Very Cheap
20140603T000000,235000.0,3,1.0,1250,15603,1.0,0,0,4,7,1250,0,1959,0,98056,47.5093,-122.172,1720,10220,14353,8500,15.061206178299045,0.02098360655737705,Very Cheap
20150506T000000,464000.0,2,2.0,1230,4800,2.0,0,0,3,7,1230,0,1952,2004,98133,47.7145,-122.35,1560,7200,3570,5640,96.66666666666667,0.05101639344262295,Very Cheap
20150317T000000,281000.0,3,1.75,1690,9826,1.0,0,0,4,7,1690,0,1988,0,98023,47.314,-122.365,1980,9826,8136,7846,28.597598208833706,0.027016393442622952,Very Cheap
20141107T000000,320000.0,3,1.0,1520,8870,1.5,0,0,4,7,1520,0,1951,0,98155,47.7638,-122.317,1520,7800,7350,6280,36.076662908680944,0.032131147540983604,Very Cheap
20140620T000000,282000.0,4,2.0,1890,6302,2.0,0,0,3,7,1890,0,1997,0,98030,47.3846,-122.205,1690,5369,4412,3679,44.74769914312917,0.02714754098360656,Very Cheap
20150220T000000,745000.0,4,1.75,1990,8900,1.0,0,0,4,8,1990,0,1972,0,98006,47.5639,-122.149,2620,8925,6910,6305,83.70786516853933,0.08786885245901639,Very Cheap
20140820T000000,245000.0,3,1.75,1480,3900,1.0,0,0,4,7,1480,0,1980,0,98023,47.2977,-122.367,1830,6956,2420,5126,62.82051282051282,0.022295081967213116,Very Cheap
20141020T000000,250000.0,3,1.75,1480,3900,1.0,0,0,4,7,1480,0,1980,0,98023,47.2977,-122.367,1830,6956,2420,5126,64.1025641025641,0.022950819672131147,Very Cheap
20140922T000000,470000.0,3,2.5,2120,2374,2.0,0,0,3,8,1770,350,2005,0,98052,47.674,-122.142,2480,3043,254,563,197.9780960404381,0.05180327868852459,Very Cheap
20141015T000000,216650.0,3,3.5,1480,1077,2.0,0,0,3,7,1300,180,2007,0,98109,47.5421,-122.322,1140,2003,-403,863,201.1606313834726,0.01857704918032787,Very Cheap
20150505T000000,440000.0,3,1.0,1250,8412,1.0,0,0,4,7,1250,0,1975,0,98052,47.7012,-122.131,1840,8976,7162,7136,52.30622919638611,0.04786885245901639,Very Cheap
20140613T000000,590000.0,4,2.5,2010,7972,2.0,0,0,4,8,2010,0,1989,0,98029,47.5782,-122.018,2100,8511,5962,6411,74.00903161063724,0.06754098360655737,Very Cheap
20141028T000000,935000.0,5,2.5,3150,35283,1.0,0,0,3,10,1800,1350,1975,0,98005,47.6368,-122.157,3280,35283,32133,32003,26.500014171130573,0.11278688524590164,Cheap
20140922T000000,848000.0,3,3.5,3010,5717,2.0,0,0,3,10,3010,0,2000,0,98007,47.5943,-122.15,2780,5138,2707,2358,148.32954346685324,0.10137704918032787,Cheap
20150312T000000,827500.0,5,4.25,3920,5823,2.0,0,0,3,9,3000,920,2000,0,98029,47.5492,-122.008,3000,5297,1903,2297,142.10887858492185,0.09868852459016393,Very Cheap
20140520T000000,1125000.0,6,3.0,2880,3192,2.0,0,0,4,8,2180,700,1919,0,98103,47.6506,-122.332,1870,4533,312,2663,352.4436090225564,0.1377049180327869,Cheap
20140507T000000,630000.0,2,2.25,2550,5663,1.0,0,0,3,10,1720,830,2011,0,98056,47.5304,-122.202,2560,3828,3113,1268,111.24845488257108,0.07278688524590164,Very Cheap
20140505T000000,340000.0,5,1.0,1120,9022,1.5,0,0,4,7,1120,0,1962,0,98034,47.7296,-122.24,1310,7500,7902,6190,37.68565728219907,0.03475409836065574,Very Cheap
20140923T000000,570000.0,4,2.75,3140,10918,1.0,0,0,3,8,1900,1240,1968,1986,98034,47.7086,-122.243,3170,10918,7778,7748,52.207363986078036,0.06491803278688525,Very Cheap
20141209T000000,2750000.0,4,4.0,4130,5575,2.0,1,4,4,10,2860,1270,1993,0,98075,47.5968,-122.083,2980,5575,1445,2595,493.27354260089686,0.35081967213114756,Medium
20150102T000000,514500.0,4,2.5,2990,9614,1.0,0,2,4,9,1740,1250,1976,0,98003,47.3424,-122.329,3370,12085,6624,8715,53.51570626170169,0.057639344262295084,Very Cheap
20150413T000000,360000.0,2,1.0,1120,12625,1.0,0,3,3,7,1120,0,1940,0,98136,47.5397,-122.385,1880,6828,11505,4948,28.514851485148515,0.037377049180327866,Very Cheap
20141217T000000,228900.0,4,1.5,1570,8775,1.0,0,0,3,7,1570,0,1943,0,98166,47.4789,-122.335,980,8775,7205,7795,26.085470085470085,0.02018360655737705,Very Cheap
20140625T000000,660000.0,3,2.75,2210,4000,2.0,0,0,3,8,2210,0,2008,0,98053,47.6954,-122.017,2230,4674,1790,2444,165.0,0.07672131147540984,Very Cheap
20150303T000000,647000.0,4,2.5,2390,5800,2.0,0,0,3,9,2390,0,2000,0,98075,47.5965,-122.038,2590,6507,3410,3917,111.55172413793103,0.07501639344262295,Very Cheap
20140610T000000,366000.0,3,1.75,1520,8625,1.0,0,0,3,8,1520,0,1976,0,98011,47.7687,-122.223,2080,9200,7105,7120,42.43478260869565,0.03816393442622951,Very Cheap
20140718T000000,354000.0,5,1.75,1830,7986,1.0,0,0,4,7,1060,770,1962,0,98106,47.5208,-122.35,1410,7260,6156,5850,44.32757325319309,0.03659016393442623,Very Cheap
20140519T000000,850000.0,4,3.5,2640,5900,2.0,0,2,3,8,2640,0,1937,1998,98136,47.5421,-122.383,1700,5900,3260,4200,144.0677966101695,0.10163934426229508,Cheap
20140524T000000,496700.0,3,2.5,1740,5782,2.0,0,0,4,8,1740,0,1989,0,98029,47.5783,-122.001,2080,5782,4042,3702,85.90453130404704,0.055304918032786886,Very Cheap
20141104T000000,300000.0,3,2.0,1550,8300,1.0,0,0,4,8,1550,0,1965,0,98055,47.4654,-122.195,1860,8000,6750,6140,36.144578313253014,0.029508196721311476,Very Cheap
20141017T000000,390000.0,3,1.0,1040,8075,1.0,0,0,4,7,1040,0,1961,0,98033,47.6701,-122.176,1450,8075,7035,6625,48.297213622291025,0.04131147540983607,Very Cheap
20140519T000000,350000.0,3,2.25,1640,7200,2.0,0,0,4,8,1640,0,1985,0,98007,47.5948,-122.153,1830,8372,5560,6542,48.611111111111114,0.036065573770491806,Very Cheap
20140922T000000,561000.0,3,2.25,1640,7200,2.0,0,0,4,8,1640,0,1985,0,98007,47.5948,-122.153,1830,8372,5560,6542,77.91666666666667,0.06373770491803278,Very Cheap
20140730T000000,475000.0,3,1.75,1260,10065,1.0,0,0,3,7,1260,0,1954,2014,98006,47.5727,-122.138,1320,10278,8805,8958,47.19324391455539,0.05245901639344262,Very Cheap
20141016T000000,275000.0,3,1.5,1170,1174,2.0,0,0,3,7,840,330,2007,0,98126,47.5459,-122.376,1170,2537,4,1367,234.2419080068143,0.02622950819672131,Very Cheap
20141028T000000,290000.0,3,1.75,1590,13500,1.0,0,0,4,7,1090,500,1980,0,98038,47.3621,-122.031,1540,10375,11910,8835,21.48148148148148,0.02819672131147541,Very Cheap
20150211T000000,199000.0,3,2.5,1750,6725,1.0,0,0,3,7,1330,420,1993,0,98038,47.352,-122.058,1670,7744,4975,6074,29.5910780669145,0.016262295081967214,Very Cheap
20150324T000000,279900.0,4,2.5,1770,4338,2.0,0,0,3,7,1770,0,2001,0,98042,47.3672,-122.099,1770,6606,2568,4836,64.52282157676349,0.026872131147540983,Very Cheap
20150505T000000,1655000.0,4,2.25,3530,5500,2.0,0,0,3,8,2860,670,1940,0,98105,47.6618,-122.273,2840,5500,1970,2660,300.90909090909093,0.20721311475409837,Cheap
20150413T000000,405000.0,3,2.5,2160,10200,1.0,0,0,3,7,1360,800,1978,0,98133,47.7295,-122.331,2010,7850,8040,5840,39.705882352941174,0.043278688524590166,Very Cheap
20150127T000000,615000.0,4,2.25,2360,15860,1.0,0,0,3,9,2360,0,1977,0,98074,47.6307,-122.051,2650,11798,13500,9148,38.77679697351829,0.07081967213114754,Very Cheap
20141002T000000,268000.0,3,1.75,1980,12543,1.0,0,0,3,8,1180,800,1978,0,98023,47.3104,-122.394,2090,8539,10563,6449,21.36649924260544,0.025311475409836064,Very Cheap
20140825T000000,451000.0,4,1.5,1620,5444,1.5,0,0,3,8,1620,0,1955,0,98125,47.7065,-122.297,1620,6912,3824,5292,82.8434974283615,0.04931147540983607,Very Cheap
20141215T000000,850000.0,2,2.75,2700,9854,1.0,0,0,3,9,2700,0,2012,0,98053,47.7187,-122.024,1440,4168,7154,2728,86.25938705094377,0.10163934426229508,Cheap
20140921T000000,1180000.0,5,2.25,3270,16553,2.0,0,2,5,9,2470,800,1968,0,98040,47.5428,-122.236,3690,17916,13283,14226,71.28617169093216,0.14491803278688525,Cheap
20140516T000000,245000.0,2,1.0,870,6150,1.0,0,0,3,6,870,0,1941,0,98106,47.5256,-122.347,1120,6150,5280,5030,39.83739837398374,0.022295081967213116,Very Cheap
20140626T000000,450000.0,2,1.75,840,3340,1.0,0,0,3,6,700,140,1912,0,98107,47.6692,-122.359,1700,3980,2500,2280,134.7305389221557,0.04918032786885246,Very Cheap
20150409T000000,370350.0,3,3.5,1340,1168,2.0,0,2,3,8,1080,260,2002,0,98133,47.711,-122.356,1650,1378,-172,-272,317.0804794520548,0.0387344262295082,Very Cheap
20140729T000000,543000.0,3,2.5,1540,1256,3.0,0,0,3,8,1540,0,2004,0,98103,47.6498,-122.346,1500,1350,-284,-150,432.3248407643312,0.06137704918032787,Very Cheap
20150127T000000,265000.0,2,2.0,1650,8975,1.0,0,0,5,6,1650,0,1942,0,98146,47.5073,-122.36,1260,8668,7325,7408,29.526462395543174,0.024918032786885248,Very Cheap
20150325T000000,497000.0,3,2.5,2630,4611,2.0,0,0,3,8,2630,0,2001,0,98065,47.5322,-121.868,2220,5250,1981,3030,107.78572977662112,0.055344262295081964,Very Cheap
20150412T000000,419000.0,4,2.25,1880,9727,1.0,0,0,3,7,1100,780,1979,0,98028,47.7731,-122.257,1790,10274,7847,8484,43.07597409273157,0.04511475409836065,Very Cheap
20140724T000000,545800.0,4,2.5,1980,4500,2.0,0,0,3,8,1980,0,1989,0,98029,47.579,-122.001,1770,4595,2520,2825,121.28888888888889,0.06174426229508197,Very Cheap
20150403T000000,403000.0,3,1.0,1500,10730,1.0,0,0,3,7,1000,500,1977,0,98053,47.6385,-121.966,1570,12210,9230,10640,37.55824790307549,0.04301639344262295,Very Cheap
20141110T000000,195000.0,3,2.0,1230,8235,1.5,0,0,3,6,1230,0,1959,0,98168,47.4853,-122.304,1080,10281,7005,9201,23.67941712204007,0.015737704918032787,Very Cheap
20141211T000000,1125000.0,4,2.5,2520,2600,2.0,0,0,5,8,1670,850,1925,0,98119,47.6434,-122.358,2290,3600,80,1310,432.6923076923077,0.1377049180327869,Cheap
20140929T000000,255000.0,5,1.75,1970,8925,1.0,0,0,5,7,1170,800,1977,0,98002,47.2925,-122.196,1910,8025,6955,6115,28.571428571428573,0.02360655737704918,Very Cheap
20140627T000000,500000.0,2,1.5,1520,8040,1.0,0,0,5,7,1520,0,1951,0,98125,47.7131,-122.306,1440,8040,6520,6600,62.18905472636816,0.05573770491803279,Very Cheap
20140505T000000,855000.0,4,2.75,2600,5390,1.0,0,0,4,8,1300,1300,1960,0,98199,47.6382,-122.397,2550,5600,2790,3050,158.62708719851577,0.10229508196721311,Cheap
20150107T000000,390000.0,4,2.0,2290,9200,1.5,0,0,3,7,2290,0,1920,0,98166,47.4678,-122.363,2140,9200,6910,7060,42.391304347826086,0.04131147540983607,Very Cheap
20150324T000000,339000.0,3,2.0,1979,8470,1.0,0,2,4,7,1329,650,1956,0,98198,47.3912,-122.301,1650,8591,6491,6941,40.023612750885476,0.03462295081967213,Very Cheap
20150306T000000,1325000.0,4,3.5,2170,3672,2.0,0,0,3,9,2170,0,1905,1989,98115,47.6828,-122.329,1950,3450,1502,1500,360.838779956427,0.16393442622950818,Cheap
20150217T000000,429900.0,4,1.5,1820,17918,1.0,0,0,4,8,1190,630,1962,0,98056,47.521,-122.179,1890,15241,16098,13351,23.99263310637348,0.04654426229508197,Very Cheap
20140925T000000,370900.0,3,1.5,1200,8560,1.0,0,0,4,7,1200,0,1975,0,98011,47.7392,-122.194,1550,7800,7360,6250,43.32943925233645,0.03880655737704918,Very Cheap
20150429T000000,457500.0,3,1.0,1210,7636,1.0,0,0,4,7,1210,0,1952,0,98118,47.5377,-122.266,1530,5900,6426,4370,59.91356731272918,0.05016393442622951,Very Cheap
20150227T000000,499000.0,4,2.5,1970,2601,2.0,0,0,3,7,1440,530,1999,0,98144,47.5949,-122.308,1760,3025,631,1265,191.84928873510188,0.05560655737704918,Very Cheap
20150212T000000,225000.0,2,1.0,1040,11500,1.0,0,0,5,7,1040,0,1947,0,98003,47.2791,-122.3,1300,11954,10460,10654,19.565217391304348,0.019672131147540985,Very Cheap
20140915T000000,615000.0,3,1.75,1920,4000,1.0,0,0,3,7,1070,850,1950,0,98102,47.6392,-122.318,2280,4000,2080,1720,153.75,0.07081967213114754,Very Cheap
20150113T000000,455000.0,2,1.5,1020,1146,3.0,0,0,3,7,1020,0,2001,0,98115,47.6774,-122.325,1138,1156,126,18,397.0331588132635,0.049836065573770495,Very Cheap
20140514T000000,458000.0,3,1.0,1660,7500,1.0,0,0,4,7,1060,600,1940,0,98125,47.7105,-122.306,1450,7500,5840,6050,61.06666666666667,0.05022950819672131,Very Cheap
20141030T000000,580000.0,3,2.25,1670,7416,1.0,0,0,4,7,1220,450,1974,0,98005,47.6028,-122.172,1710,7416,5746,5706,78.20927723840346,0.06622950819672131,Very Cheap
20140514T000000,966000.0,5,4.5,3810,8019,2.0,0,0,3,10,3810,0,2008,0,98074,47.5915,-122.058,3390,7713,4209,4323,120.46389824167602,0.11685245901639345,Cheap
20141007T000000,240000.0,4,1.75,2020,10332,1.0,0,0,3,7,1010,1010,1954,0,98168,47.5059,-122.303,2240,8379,8312,6139,23.228803716608596,0.021639344262295083,Very Cheap
20150331T000000,229050.0,1,1.0,420,3298,1.0,0,0,4,4,420,0,1949,0,98136,47.5375,-122.391,1460,4975,2878,3515,69.45118253486962,0.02020327868852459,Very Cheap
20150223T000000,328500.0,3,2.25,1390,1407,3.0,0,0,3,7,1390,0,2004,0,98125,47.7227,-122.296,1390,1628,17,238,233.47547974413646,0.03324590163934426,Very Cheap
20150121T000000,319000.0,3,1.5,2010,10100,1.0,0,0,4,7,1110,900,1964,0,98168,47.4738,-122.266,1900,10100,8090,8200,31.584158415841586,0.032,Very Cheap
20140502T000000,650000.0,4,2.0,1820,5000,1.5,0,1,3,7,1640,180,1945,0,98115,47.6815,-122.269,2060,5000,3180,2940,130.0,0.07540983606557378,Very Cheap
20150217T000000,398500.0,3,2.5,1630,1971,2.0,0,0,3,8,1630,0,1996,0,98177,47.7753,-122.375,1630,3451,341,1821,202.181633688483,0.042426229508196724,Very Cheap
20140620T000000,250000.0,1,1.0,800,16306,1.0,0,0,2,6,680,120,1931,0,98168,47.4916,-122.308,1270,8666,15506,7396,15.331779712989084,0.022950819672131147,Very Cheap
20140626T000000,815000.0,3,2.0,2270,11989,1.0,0,0,4,9,2270,0,1968,0,98040,47.5434,-122.229,2880,12439,9719,9559,67.97898073233797,0.09704918032786886,Very Cheap
20150316T000000,1065000.0,3,2.75,2290,5002,2.0,0,0,4,9,1950,340,1995,0,98033,47.6811,-122.207,2290,5100,2712,2810,212.91483406637346,0.1298360655737705,Cheap
20141001T000000,510000.0,3,2.25,2750,219542,2.0,0,0,3,7,1870,880,1981,0,98014,47.6367,-121.948,2430,219542,216792,217112,2.323017919122537,0.057049180327868855,Very Cheap
20141114T000000,156000.0,2,1.75,590,6138,1.0,0,0,2,5,590,0,1947,0,98118,47.545,-122.278,1360,7112,5548,5752,25.41544477028348,0.010622950819672131,Very Cheap
20140522T000000,254500.0,4,2.75,2570,7264,2.0,0,0,3,8,1720,850,1998,0,98092,47.258,-122.208,2420,7911,4694,5491,35.03579295154185,0.02354098360655738,Very Cheap
20140721T000000,760000.0,3,2.5,2050,15020,1.0,0,2,3,9,1600,450,1960,0,98177,47.759,-122.371,2930,15050,12970,12120,50.59920106524634,0.0898360655737705,Very Cheap
20150506T000000,210000.0,3,2.5,1610,6732,2.0,0,0,3,7,1610,0,1994,0,98030,47.3658,-122.172,1680,7414,5122,5734,31.194295900178254,0.017704918032786884,Very Cheap
20140825T000000,349950.0,3,2.5,2140,7715,2.0,0,0,3,7,2140,0,1991,0,98198,47.384,-122.322,1990,7628,5575,5638,45.35968891769281,0.036059016393442625,Very Cheap
20150402T000000,676000.0,3,2.0,1730,6784,2.5,0,0,4,7,1730,0,1942,0,98199,47.6462,-122.403,1210,6784,5054,5574,99.64622641509433,0.07881967213114754,Very Cheap
20150102T000000,475000.0,4,3.5,2440,3052,2.0,0,0,3,8,1940,500,2006,0,98108,47.555,-122.309,2390,4600,612,2210,155.6356487549148,0.05245901639344262,Very Cheap
20140630T000000,880000.0,4,2.75,3220,4392,1.5,0,0,4,9,2320,900,1931,0,98105,47.6713,-122.276,2310,5795,1172,3485,200.36429872495447,0.10557377049180328,Cheap
20140903T000000,1209000.0,4,3.25,4330,26162,2.0,0,0,3,11,4330,0,1997,0,98074,47.6009,-122.011,5110,26319,21832,21209,46.212063297913005,0.14872131147540985,Cheap
20141212T000000,420000.0,3,1.5,1780,5000,1.0,0,4,4,7,1030,750,1958,0,98118,47.5168,-122.256,1780,7500,3220,5720,84.0,0.04524590163934426,Very Cheap
20140523T000000,607000.0,3,1.0,1230,8114,1.0,0,0,4,7,1230,0,1951,0,98004,47.5822,-122.196,2220,8114,6884,5894,74.80897214690658,0.06977049180327868,Very Cheap
20141124T000000,475000.0,4,1.75,2160,19283,2.0,0,0,3,8,2160,0,1981,0,98011,47.7603,-122.169,1990,9744,17123,7754,24.633096509879167,0.05245901639344262,Very Cheap
20141022T000000,395000.0,2,1.75,1400,2500,1.0,0,0,5,7,710,690,1916,0,98116,47.5628,-122.391,1250,5700,1100,4450,158.0,0.0419672131147541,Very Cheap
20150220T000000,650000.0,4,1.75,1900,10454,1.0,0,0,4,7,1180,720,1954,0,98004,47.5933,-122.195,2060,11325,8554,9265,62.17715706906447,0.07540983606557378,Very Cheap
20150331T000000,625000.0,5,2.75,2910,85377,1.0,0,0,4,8,1510,1400,1966,0,98027,47.48,-122.03,2160,66120,82467,63960,7.320472726846809,0.07213114754098361,Very Cheap
20140729T000000,849000.0,3,3.0,2960,42159,2.0,0,0,3,10,2960,0,1995,0,98052,47.7183,-122.1,2640,25209,39199,22569,20.1380488151996,0.10150819672131148,Cheap
20140610T000000,429950.0,3,1.5,2010,9480,1.0,0,0,3,8,1570,440,1951,0,98125,47.7102,-122.281,1920,8791,7470,6871,45.35337552742616,0.04655081967213115,Very Cheap
20141028T000000,825000.0,3,2.5,3760,5260,2.0,0,0,3,9,3230,530,2002,0,98029,47.5489,-122.007,3080,5312,1500,2232,156.84410646387832,0.09836065573770492,Very Cheap
20140829T000000,505000.0,2,1.0,1020,5000,1.0,0,0,4,7,1020,0,1916,0,98117,47.6781,-122.363,1480,5000,3980,3520,101.0,0.05639344262295082,Very Cheap
20140512T000000,265000.0,2,1.0,1290,2828,2.0,0,0,3,7,1290,0,2008,0,98053,47.6968,-122.025,1290,2628,1538,1338,93.70579915134371,0.024918032786885248,Very Cheap
20140625T000000,283000.0,3,1.0,890,8400,1.0,0,0,4,6,890,0,1954,0,98056,47.5168,-122.204,1850,5565,7510,3715,33.69047619047619,0.027278688524590165,Very Cheap
20150407T000000,560000.0,3,2.75,1620,7500,1.0,0,0,5,7,1140,480,1979,0,98074,47.6175,-122.065,1900,7500,5880,5600,74.66666666666667,0.06360655737704918,Very Cheap
20141113T000000,765000.0,4,2.5,3360,13636,2.0,0,0,3,10,3360,0,1987,0,98074,47.6373,-122.042,2980,10615,10276,7635,56.1014960398944,0.09049180327868853,Very Cheap
20140722T000000,610000.0,5,2.75,2930,31411,1.0,0,0,4,9,1520,1410,1975,0,98006,47.5576,-122.186,3070,12378,28481,9308,19.41994842571074,0.07016393442622951,Very Cheap
20140903T000000,589000.0,3,2.5,2940,4799,1.0,0,0,3,9,1710,1230,1996,0,98033,47.6681,-122.184,2540,4616,1859,2076,122.73390289643676,0.06740983606557377,Very Cheap
20140618T000000,192500.0,3,1.0,1080,8580,1.5,0,0,3,6,1080,0,1900,0,98168,47.4716,-122.262,1800,12672,7500,10872,22.435897435897434,0.01540983606557377,Very Cheap
20150109T000000,3200000.0,3,3.25,4560,13363,1.0,0,4,3,11,2760,1800,1995,0,98004,47.6205,-122.214,4060,13362,8803,9302,239.4671855122353,0.4098360655737705,High
20150213T000000,550000.0,3,1.0,1010,6120,1.0,0,0,3,7,860,150,1940,0,98115,47.6861,-122.296,1930,6120,5110,4190,89.86928104575163,0.06229508196721312,Very Cheap
20141014T000000,460000.0,2,1.5,1790,3760,1.5,0,0,4,8,1280,510,1928,0,98117,47.6871,-122.373,1540,5080,1970,3540,122.34042553191489,0.050491803278688525,Very Cheap
20140703T000000,264500.0,4,2.25,2060,11385,1.0,0,0,4,7,1200,860,1962,0,98023,47.314,-122.363,2110,11385,9325,9275,23.232323232323232,0.024852459016393443,Very Cheap
20150427T000000,339000.0,3,1.0,1150,2496,1.0,0,0,3,6,1010,140,1947,0,98126,47.5194,-122.376,1340,1203,1346,-137,135.81730769230768,0.03462295081967213,Very Cheap
20141112T000000,950000.0,4,3.5,4030,4200,3.0,0,0,3,9,4030,0,1992,0,98199,47.6416,-122.386,2130,5000,170,2870,226.1904761904762,0.11475409836065574,Cheap
20140822T000000,677500.0,3,1.75,2020,9718,1.0,0,0,3,8,2020,0,1956,0,98040,47.574,-122.21,2370,8604,7698,6234,69.71599094463882,0.07901639344262296,Very Cheap
20141205T000000,690000.0,4,2.5,2740,8120,2.0,0,0,3,9,2740,0,1999,0,98074,47.6123,-122.006,2780,8344,5380,5564,84.97536945812809,0.08065573770491803,Very Cheap
20140509T000000,312000.0,4,2.25,1930,7452,1.0,0,0,3,7,1430,500,1984,0,98031,47.4098,-122.189,1714,7200,5522,5486,41.86795491143317,0.031081967213114754,Very Cheap
20141022T000000,840000.0,5,1.75,2500,11617,1.0,0,0,4,9,1560,940,1966,0,98040,47.5361,-122.217,3370,11617,9117,8247,72.30782473960575,0.10032786885245902,Cheap
20140701T000000,357500.0,3,3.5,2080,5100,2.0,0,0,3,8,2080,0,2004,0,98038,47.35,-122.005,2080,5100,3020,3020,70.09803921568627,0.03704918032786885,Very Cheap
20150427T000000,675000.0,3,1.5,1460,6480,1.0,0,2,4,7,980,480,1940,0,98117,47.6962,-122.397,2180,6912,5020,4732,104.16666666666667,0.07868852459016394,Very Cheap
20141021T000000,515000.0,3,2.75,3290,11441,2.0,0,0,4,10,3290,0,1988,0,98023,47.3052,-122.34,2600,12070,8151,9470,45.013547766803605,0.057704918032786885,Very Cheap
20140623T000000,491234.0,4,2.5,1540,1860,2.0,0,0,3,8,1540,0,2014,0,98029,47.5521,-121.999,1210,1090,320,-120,264.10430107526884,0.054588065573770495,Very Cheap
20150319T000000,290000.0,3,2.0,1310,6265,1.0,0,0,3,7,1310,0,1988,0,98038,47.3893,-122.051,1100,6360,4955,5260,46.288906624102154,0.02819672131147541,Very Cheap
20140821T000000,490000.0,4,2.5,2120,7820,1.0,0,0,3,8,1280,840,1975,0,98052,47.6743,-122.145,2350,8605,5700,6255,62.65984654731458,0.05442622950819672,Very Cheap
20150428T000000,810000.0,4,2.0,2920,10424,1.0,0,0,5,8,1520,1400,1964,0,98005,47.5876,-122.172,2360,10696,7504,8336,77.70529547198772,0.09639344262295083,Very Cheap
20150220T000000,252000.0,3,1.5,1150,13200,1.0,0,0,3,7,1150,0,1956,0,98166,47.4752,-122.345,1220,13066,12050,11846,19.09090909090909,0.02321311475409836,Very Cheap
20150410T000000,299999.0,3,2.5,2380,9719,2.0,0,0,3,8,2380,0,2001,0,98001,47.2932,-122.283,2830,11505,7339,8675,30.86727029529787,0.029508065573770493,Very Cheap
20150309T000000,400000.0,3,2.75,2220,5000,2.0,0,0,3,7,2220,0,1993,0,98108,47.5515,-122.324,960,5000,2780,4040,80.0,0.04262295081967213,Very Cheap
20141229T000000,530000.0,5,2.0,3020,6000,1.5,0,0,5,7,1860,1160,1925,0,98126,47.5207,-122.378,1380,6000,2980,4620,88.33333333333333,0.05967213114754098,Very Cheap
20140911T000000,357000.0,3,2.0,2460,53882,1.0,1,4,3,7,2460,0,1955,0,98198,47.3811,-122.325,2660,32625,51422,29965,6.625589250584611,0.03698360655737705,Very Cheap
20150310T000000,365000.0,3,1.75,1820,5555,1.0,0,0,4,7,1030,790,1939,0,98103,47.6867,-122.352,1420,4000,3735,2580,65.70657065706571,0.0380327868852459,Very Cheap
20150203T000000,804000.0,4,2.5,2620,5060,2.0,0,0,3,9,2620,0,2005,0,98116,47.5634,-122.394,900,5060,2440,4160,158.89328063241106,0.09560655737704918,Very Cheap
20140904T000000,808250.0,3,2.0,1750,2640,1.0,0,0,3,8,1010,740,1914,2005,98119,47.6419,-122.368,1750,4560,890,2810,306.155303030303,0.0961639344262295,Very Cheap
20150514T000000,360000.0,4,2.5,2020,7289,2.0,0,0,3,7,2020,0,1994,0,98031,47.401,-122.171,2090,7259,5269,5169,49.3894910138565,0.037377049180327866,Very Cheap
20141023T000000,240000.0,3,1.75,1240,10956,1.0,0,0,3,6,1240,0,1987,0,98042,47.3705,-122.15,1240,8137,9716,6897,21.90580503833516,0.021639344262295083,Very Cheap
20140722T000000,335000.0,2,2.0,1380,5840,1.0,0,0,3,7,1380,0,1988,0,98011,47.7732,-122.172,1810,5035,4460,3225,57.363013698630134,0.03409836065573771,Very Cheap
20140829T000000,380000.0,3,1.75,1920,8775,1.0,0,0,3,7,1920,0,1953,0,98166,47.4544,-122.351,1560,8100,6855,6540,43.3048433048433,0.04,Very Cheap
20140515T000000,350000.0,3,1.75,1680,250470,1.0,0,0,4,7,1070,610,1940,0,98019,47.7624,-121.93,1680,360000,248790,358320,1.3973729388749152,0.036065573770491806,Very Cheap
20140925T000000,194000.0,3,1.0,1400,7955,1.0,0,0,3,7,1400,0,1964,0,98055,47.4848,-122.221,1160,14959,6555,13799,24.38717787554997,0.01560655737704918,Very Cheap
20150325T000000,310000.0,3,1.0,1240,7194,1.0,0,0,3,6,1090,150,1936,0,98011,47.7636,-122.202,2090,8514,5954,6424,43.09146510981373,0.03081967213114754,Very Cheap
20150209T000000,315000.0,3,1.75,1410,15134,1.0,0,0,3,7,1410,0,1980,0,98014,47.6931,-121.921,1770,15337,13724,13567,20.814061054579092,0.031475409836065574,Very Cheap
20141208T000000,258950.0,3,1.75,1440,8050,1.0,0,0,3,8,1440,0,1985,0,98023,47.3187,-122.39,1790,7488,6610,5698,32.16770186335404,0.024124590163934426,Very Cheap
20140617T000000,479000.0,2,2.25,1230,932,2.0,0,0,3,8,1020,210,2004,0,98112,47.6192,-122.301,1230,1064,-298,-166,513.9484978540772,0.05298360655737705,Very Cheap
20141110T000000,510000.0,5,1.5,1550,9750,1.0,0,0,4,7,1550,0,1966,0,98033,47.6811,-122.169,1970,9750,8200,7780,52.30769230769231,0.057049180327868855,Very Cheap
20140709T000000,400000.0,3,2.0,1760,6875,1.0,0,0,4,8,1760,0,1967,0,98072,47.74,-122.093,1670,13650,5115,11980,58.18181818181818,0.04262295081967213,Very Cheap
20150401T000000,1450000.0,4,3.5,5000,38012,2.0,0,0,3,11,3610,1390,2004,0,98029,47.554,-122.036,3850,18054,33012,14204,38.14584867936441,0.18032786885245902,Cheap
20141029T000000,680000.0,5,2.0,2140,5000,1.5,0,0,4,7,2020,120,1913,0,98122,47.6044,-122.299,1810,4400,2860,2590,136.0,0.07934426229508197,Very Cheap
20140508T000000,1750000.0,6,3.0,3510,5760,2.5,0,0,4,10,3510,0,1906,0,98112,47.6263,-122.312,3450,5760,2250,2310,303.81944444444446,0.21967213114754097,Cheap
20140804T000000,335000.0,3,1.75,2010,9417,1.0,0,0,4,8,1500,510,1967,0,98030,47.373,-122.185,1200,8250,7407,7050,35.5739619836466,0.03409836065573771,Very Cheap
20140623T000000,460000.0,5,2.5,3390,9760,1.0,0,0,5,8,1750,1640,1978,0,98058,47.4462,-122.137,2360,9600,6370,7240,47.131147540983605,0.050491803278688525,Very Cheap
20140502T000000,440000.0,4,2.25,2160,8119,1.0,0,0,3,8,1080,1080,1966,0,98006,47.5443,-122.177,1850,9000,5959,7150,54.19386623968469,0.04786885245901639,Very Cheap
20150326T000000,412250.0,2,2.0,1300,2983,1.0,0,0,3,8,1300,0,2006,0,98053,47.703,-122.015,1510,3876,1683,2366,138.19979886020784,0.044229508196721314,Very Cheap
20141120T000000,185000.0,3,1.5,1280,4031,2.0,0,0,4,6,1280,0,1985,0,98002,47.3342,-122.215,1150,4500,2751,3350,45.89431902753659,0.014426229508196721,Very Cheap
20150407T000000,286500.0,3,2.0,1840,8140,1.0,0,0,4,7,1040,800,1975,0,98003,47.3106,-122.325,1600,6720,6300,5120,35.1965601965602,0.027737704918032787,Very Cheap
20150502T000000,422000.0,4,2.5,3200,6691,2.0,0,0,3,7,3200,0,2002,0,98038,47.367,-122.031,2610,6510,3491,3900,63.06979524734718,0.04550819672131148,Very Cheap
20150319T000000,408000.0,3,2.25,2800,35362,2.0,0,0,3,9,2800,0,1985,0,98042,47.3507,-122.089,2800,37058,32562,34258,11.537808947457723,0.04367213114754098,Very Cheap
20141027T000000,306500.0,2,1.0,1390,19988,1.0,0,2,4,7,1390,0,1949,0,98198,47.3985,-122.321,2580,10490,18598,7910,15.334200520312187,0.03036065573770492,Very Cheap
20150413T000000,359900.0,4,2.5,2600,5188,2.0,0,0,3,8,2600,0,2005,0,98038,47.3451,-122.04,2610,5188,2588,2578,69.3716268311488,0.03736393442622951,Very Cheap
20140709T000000,560000.0,3,2.5,1960,6058,2.0,0,0,3,8,1960,0,2002,0,98053,47.6319,-122.007,2480,6656,4098,4176,92.43974909210961,0.06360655737704918,Very Cheap
20140827T000000,259875.0,3,1.0,1250,21303,1.0,0,0,3,6,1250,0,1970,0,98053,47.6625,-122.059,1250,17920,20053,16670,12.198986058301648,0.024245901639344262,Very Cheap
20141105T000000,385000.0,3,1.0,1250,21303,1.0,0,0,3,6,1250,0,1970,0,98053,47.6625,-122.059,1250,17920,20053,16670,18.072571938224662,0.04065573770491803,Very Cheap
20141007T000000,188000.0,1,1.0,550,16345,1.0,0,0,3,4,550,0,1945,0,98106,47.5181,-122.339,1100,9240,15795,8140,11.501988375650045,0.014819672131147541,Very Cheap
20140615T000000,1142000.0,4,3.25,2500,5801,1.5,0,0,3,8,1960,540,1926,0,98112,47.632,-122.29,3670,7350,3301,3680,196.86260989484572,0.1399344262295082,Cheap
20141010T000000,255000.0,3,1.0,1250,10094,1.0,0,0,4,6,1250,0,1927,0,98045,47.4987,-121.781,1300,10094,8844,8794,25.262532197344957,0.02360655737704918,Very Cheap
20140730T000000,1185000.0,4,2.75,3020,8622,2.0,0,0,3,9,3020,0,1976,2003,98004,47.5866,-122.201,3060,14303,5602,11243,137.4391092553932,0.14557377049180328,Cheap
20140529T000000,635200.0,4,1.75,1640,4240,1.0,0,0,5,7,920,720,1921,0,98117,47.6766,-122.368,1300,4240,2600,2940,149.81132075471697,0.0734688524590164,Very Cheap
20150428T000000,355000.0,3,1.75,1870,8250,2.0,0,0,3,7,1870,0,1956,1979,98188,47.445,-122.285,1350,8714,6380,7364,43.03030303030303,0.036721311475409836,Very Cheap
20150130T000000,544000.0,3,2.5,1760,1755,3.5,0,0,3,8,1760,0,1998,0,98105,47.6688,-122.279,1700,1721,-5,21,309.97150997151,0.06150819672131148,Very Cheap
20150422T000000,402000.0,3,1.5,1320,3145,2.0,0,0,3,7,1320,0,1998,0,98144,47.5909,-122.297,1320,3002,1825,1682,127.82193958664547,0.04288524590163934,Very Cheap
20141226T000000,575000.0,4,1.5,1430,4163,1.5,0,0,3,7,1430,0,1910,0,98199,47.6606,-122.397,1500,4000,2733,2500,138.12154696132598,0.06557377049180328,Very Cheap
20140724T000000,216000.0,3,1.75,1580,9705,1.0,0,0,4,7,1580,0,1977,0,98042,47.3819,-122.09,1580,9942,8125,8362,22.256568778979908,0.018491803278688525,Very Cheap
20140617T000000,1200000.0,4,3.5,4170,9748,2.0,0,0,3,11,4170,0,2004,0,98059,47.528,-122.132,4560,10589,5578,6029,123.10217480508823,0.14754098360655737,Cheap
20140522T000000,850000.0,4,3.25,3090,6744,2.0,0,4,3,9,3090,0,1923,2015,98177,47.768,-122.388,2020,6656,3654,4636,126.0379596678529,0.10163934426229508,Cheap
20140516T000000,238000.0,3,2.0,1020,1204,2.0,0,0,3,7,720,300,2004,0,98126,47.5445,-122.376,1360,1506,184,146,197.67441860465115,0.02137704918032787,Very Cheap
20150413T000000,625000.0,4,1.75,2180,4431,1.5,0,0,3,8,2020,160,1912,0,98112,47.636,-122.302,1890,4400,2251,2510,141.05168133604153,0.07213114754098361,Very Cheap
20140701T000000,1110000.0,5,3.25,3350,4000,2.0,0,0,4,8,2510,840,1997,0,98105,47.6645,-122.291,1620,4000,650,2380,277.5,0.13573770491803278,Cheap
20140528T000000,820000.0,3,2.5,2510,5503,2.0,0,2,3,9,2510,0,1995,0,98136,47.5419,-122.383,1790,6099,2993,4309,149.00963111030347,0.09770491803278689,Very Cheap
20141201T000000,355000.0,3,2.5,1880,5290,1.0,0,0,3,8,1250,630,1974,0,98108,47.5401,-122.3,2030,5092,3410,3062,67.10775047258979,0.036721311475409836,Very Cheap
20150303T000000,495000.0,4,1.5,1810,7998,1.0,0,0,3,8,1210,600,1960,0,98125,47.726,-122.297,1830,7763,6188,5933,61.89047261815454,0.05508196721311476,Very Cheap
20150302T000000,1300000.0,5,2.5,4170,33310,2.0,0,0,4,11,4170,0,1991,0,98006,47.5455,-122.126,4670,37960,29140,33290,39.02731912338637,0.16065573770491803,Cheap
20140505T000000,398750.0,3,2.5,2230,4000,2.0,0,0,3,7,2230,0,1954,0,98144,47.5801,-122.306,1310,4000,1770,2690,99.6875,0.04245901639344262,Very Cheap
20140716T000000,835000.0,4,2.5,3650,7784,2.0,0,0,3,9,3650,0,2006,0,98052,47.7066,-122.101,3150,6442,4134,3292,107.27132579650565,0.09967213114754099,Very Cheap
20141002T000000,705000.0,6,2.75,2830,10579,1.0,0,0,4,8,1430,1400,1967,0,98005,47.636,-122.171,2060,10745,7749,8685,66.64145949522639,0.08262295081967214,Very Cheap
20150504T000000,625000.0,4,1.5,2120,5000,2.0,0,0,4,8,2120,0,1900,0,98122,47.6024,-122.296,1830,5000,2880,3170,125.0,0.07213114754098361,Very Cheap
20150211T000000,550000.0,4,2.5,2090,6926,2.0,0,0,3,8,2090,0,1990,0,98074,47.6339,-122.022,2000,7151,4836,5151,79.41091539127923,0.06229508196721312,Very Cheap
20140529T000000,540000.0,3,1.5,2600,5085,1.0,0,0,4,7,1400,1200,1940,0,98126,47.5659,-122.376,1320,4000,2485,2680,106.19469026548673,0.06098360655737705,Very Cheap
20140604T000000,519000.0,2,1.0,830,2820,1.0,0,0,4,7,830,0,1920,0,98103,47.689,-122.347,1460,3150,1990,1690,184.04255319148936,0.05822950819672131,Very Cheap
20150128T000000,311000.0,4,2.5,1975,8734,2.0,0,0,3,7,1975,0,1996,0,98038,47.363,-122.034,1975,8538,6759,6563,35.60796885733914,0.030950819672131147,Very Cheap
20150406T000000,305000.0,4,2.5,1900,7000,1.0,0,0,2,7,1420,480,1968,0,98023,47.3092,-122.376,1600,7600,5100,6000,43.57142857142857,0.03016393442622951,Very Cheap
20140703T000000,395000.0,4,2.75,2640,35070,1.5,0,0,3,8,2640,0,1963,0,98058,47.4242,-122.181,2520,34986,32430,32466,11.263187909894496,0.0419672131147541,Very Cheap
20141107T000000,275000.0,4,1.5,1610,6923,1.0,0,0,3,6,1010,600,1969,0,98198,47.3747,-122.306,1320,7684,5313,6364,39.72266358515095,0.02622950819672131,Very Cheap
20140807T000000,450000.0,3,3.25,1770,1863,2.0,0,0,3,8,1430,340,2003,0,98029,47.5478,-122.005,1410,1375,93,-35,241.54589371980677,0.04918032786885246,Very Cheap
20140911T000000,324000.0,2,1.0,1070,6000,1.0,0,0,3,7,1070,0,1955,0,98133,47.7307,-122.332,1490,7622,4930,6132,54.0,0.03265573770491803,Very Cheap
20150415T000000,2795000.0,5,3.25,4590,12793,2.0,0,2,5,11,3590,1000,1928,0,98199,47.6453,-122.41,2920,8609,8203,5689,218.47885562416946,0.35672131147540986,Medium
20140716T000000,565000.0,4,1.0,1540,2452,1.5,0,0,4,7,1540,0,1906,0,98103,47.6522,-122.348,1290,3360,912,2070,230.4241435562806,0.06426229508196721,Very Cheap
20140707T000000,373000.0,4,1.75,1590,7920,2.0,0,0,4,7,1590,0,1960,0,98133,47.7456,-122.336,1720,7998,6330,6278,47.0959595959596,0.03908196721311476,Very Cheap
20140708T000000,613000.0,2,2.0,1170,1890,1.5,0,1,4,8,1170,0,1927,0,98119,47.6402,-122.371,2160,4000,720,1840,324.33862433862436,0.07055737704918033,Very Cheap
20141107T000000,614000.0,4,2.25,2880,9996,1.0,0,0,4,8,1920,960,1981,0,98072,47.7584,-122.143,2410,10584,7116,8174,61.42456982793117,0.07068852459016393,Very Cheap
20150505T000000,595000.0,4,1.75,2510,8989,1.0,0,0,4,8,1680,830,1964,0,98006,47.5569,-122.172,2510,8931,6479,6421,66.19201245967294,0.06819672131147542,Very Cheap
20140821T000000,440000.0,2,1.0,1280,12086,1.0,0,0,3,7,850,430,1983,0,98074,47.634,-122.033,1280,10452,10806,9172,36.40575872910806,0.04786885245901639,Very Cheap
20150317T000000,425000.0,3,1.5,1570,12412,1.0,0,3,3,8,1570,0,1954,0,98166,47.438,-122.349,2130,12412,10842,10282,34.241057041572674,0.04590163934426229,Very Cheap
20140925T000000,407000.0,2,1.0,740,6380,1.0,0,0,3,6,740,0,1912,0,98115,47.6929,-122.318,1800,6380,5640,4580,63.793103448275865,0.04354098360655738,Very Cheap
20140825T000000,472000.0,3,1.5,1740,9038,1.0,0,0,4,7,1740,0,1955,0,98007,47.5897,-122.136,1390,9770,7298,8380,52.22394335029874,0.052065573770491806,Very Cheap
20140617T000000,472000.0,3,2.5,1180,1262,3.0,0,0,3,8,1180,0,2010,0,98119,47.6381,-122.375,1180,2632,82,1452,374.0095087163233,0.052065573770491806,Very Cheap
20141022T000000,1250000.0,5,2.75,2960,28300,1.0,0,3,4,9,2160,800,1959,0,98177,47.7606,-122.37,2940,23250,25340,20310,44.169611307420496,0.1540983606557377,Cheap
20140708T000000,412000.0,3,1.75,1880,5752,1.0,0,0,4,7,940,940,1945,0,98126,47.5354,-122.378,1110,5201,3872,4091,71.62726008344923,0.04419672131147541,Very Cheap
20150406T000000,717000.0,3,1.0,1150,5000,1.0,0,0,3,8,1150,0,1959,2015,98117,47.6805,-122.369,1160,5000,3850,3840,143.4,0.0841967213114754,Very Cheap
20140812T000000,425000.0,3,1.0,1320,7076,1.0,0,0,4,7,1320,0,1959,0,98008,47.6131,-122.123,1510,9000,5756,7490,60.062182023742224,0.04590163934426229,Very Cheap
20140819T000000,299999.0,4,2.0,1640,7200,1.0,0,0,5,6,820,820,1944,0,98166,47.4791,-122.347,1640,8200,5560,6560,41.66652777777778,0.029508065573770493,Very Cheap
20150507T000000,254000.0,3,2.0,1470,7694,1.0,0,0,4,7,1470,0,1992,0,98038,47.3539,-122.054,1580,7480,6224,5900,33.01273719781648,0.023475409836065574,Very Cheap
20150212T000000,178500.0,3,1.0,900,10511,1.0,0,0,4,6,900,0,1961,0,98001,47.2883,-122.272,1460,10643,9611,9183,16.98220911426125,0.01357377049180328,Very Cheap
20141121T000000,800000.0,3,1.75,1510,3600,1.0,0,0,5,8,1230,280,1910,0,98119,47.6387,-122.363,1300,3600,2090,2300,222.22222222222223,0.09508196721311475,Very Cheap
20140911T000000,420000.0,3,1.0,1440,5623,1.0,0,0,4,6,720,720,1922,0,98115,47.696,-122.319,1280,5623,4183,4343,74.69322425751378,0.04524590163934426,Very Cheap
20150312T000000,319900.0,2,1.0,1380,9251,1.0,0,0,3,7,1380,0,1940,0,98028,47.7486,-122.249,1870,12158,7871,10288,34.58004540049724,0.03211803278688525,Very Cheap
20150302T000000,350000.0,2,1.5,1150,7552,1.0,0,1,3,7,1150,0,1944,0,98125,47.7298,-122.286,1910,8145,6402,6235,46.345338983050844,0.036065573770491806,Very Cheap
20140528T000000,968000.0,6,2.75,3610,17580,1.0,0,4,5,9,2070,1540,1959,0,98075,47.5739,-122.069,2890,14060,13970,11170,55.062571103526736,0.11711475409836065,Cheap
20150225T000000,491000.0,3,2.0,1250,1306,3.0,0,0,3,7,1250,0,2000,0,98107,47.6705,-122.39,1320,1306,56,-14,375.9571209800919,0.05455737704918033,Very Cheap
20150421T000000,948000.0,3,2.5,3510,9824,2.0,0,0,3,9,3510,0,2002,0,98075,47.5635,-122.032,3510,10588,6314,7078,96.49837133550488,0.11449180327868852,Cheap
20140924T000000,900000.0,3,2.5,2260,9577,2.0,0,0,3,8,1700,560,1925,2004,98117,47.6928,-122.399,1740,10240,7317,8500,93.9751487939856,0.10819672131147541,Cheap
20150309T000000,270000.0,3,1.75,2840,9800,1.0,0,0,4,7,1420,1420,1977,0,98042,47.3516,-122.119,1650,9590,6960,7940,27.551020408163264,0.025573770491803278,Very Cheap
20140617T000000,198000.0,3,1.5,1430,7347,1.0,0,0,3,7,820,610,1980,0,98023,47.2927,-122.369,1430,8723,5917,7293,26.949775418538177,0.016131147540983607,Very Cheap
20141121T000000,250000.0,2,1.0,1420,21158,1.0,0,0,3,7,1420,0,1953,0,98166,47.4594,-122.359,1220,8625,19738,7405,11.815861612628792,0.022950819672131147,Very Cheap
20140730T000000,615000.0,4,2.5,2120,3720,2.0,0,0,3,8,2120,0,2004,0,98029,47.5526,-121.994,2170,3720,1600,1550,165.32258064516128,0.07081967213114754,Very Cheap
20140916T000000,550000.0,3,2.5,2080,7749,2.0,0,0,3,8,2080,0,1988,0,98029,47.5723,-122.021,2210,7471,5669,5261,70.97690024519292,0.06229508196721312,Very Cheap
20141017T000000,190000.0,2,2.5,1370,3438,2.0,0,0,3,7,1370,0,1987,0,98188,47.4606,-122.283,1370,2308,2068,938,55.26468877254218,0.015081967213114755,Very Cheap
20141007T000000,629000.0,4,2.25,1900,11171,1.0,0,0,3,8,1280,620,1984,0,98006,47.561,-122.126,2330,9934,9271,7604,56.306507922298806,0.07265573770491804,Very Cheap
20141007T000000,434000.0,3,1.75,1660,8301,1.0,0,0,5,7,1660,0,1955,0,98028,47.7647,-122.263,1660,9489,6641,7829,52.28285748704975,0.04708196721311476,Very Cheap
20141008T000000,415885.0,3,1.0,1310,4163,1.0,0,0,4,7,1310,0,1964,0,98126,47.5301,-122.381,1120,4166,2853,3046,99.90031227480182,0.04470622950819672,Very Cheap
20140602T000000,550000.0,3,2.5,1840,3035,1.0,0,0,3,7,920,920,1926,0,98105,47.6557,-122.327,1780,4000,1195,2220,181.2191103789127,0.06229508196721312,Very Cheap
20150121T000000,272000.0,1,0.75,1040,6034,1.0,0,1,3,7,580,460,1991,0,98178,47.5078,-122.251,1560,5650,4994,4090,45.07789194564137,0.02583606557377049,Very Cheap
20140627T000000,665000.0,3,2.5,2610,35000,2.0,0,0,3,10,2610,0,1988,0,98072,47.7377,-122.101,3060,35427,32390,32367,19.0,0.07737704918032787,Very Cheap
20141009T000000,510000.0,3,2.0,1990,7405,1.0,0,0,5,7,1990,0,1971,0,98006,47.5421,-122.172,2120,6462,5415,4342,68.87238352464551,0.057049180327868855,Very Cheap
20140904T000000,530000.0,3,2.0,3080,17700,1.0,0,0,4,8,1740,1340,1965,0,98166,47.4695,-122.366,2100,15100,14620,13000,29.943502824858758,0.05967213114754098,Very Cheap
20141020T000000,355000.0,3,1.0,1200,16000,1.0,0,0,3,7,1200,0,1970,0,98072,47.7452,-122.101,1960,15500,14800,13540,22.1875,0.036721311475409836,Very Cheap
20150223T000000,255000.0,4,1.0,1250,9102,1.0,0,0,3,7,1250,0,1955,0,98148,47.4258,-122.327,1260,9180,7852,7920,28.01582069874753,0.02360655737704918,Very Cheap
20140724T000000,790000.0,4,2.75,2640,9000,2.0,0,0,3,10,2640,0,1990,0,98052,47.6481,-122.125,2980,9137,6360,6157,87.77777777777777,0.09377049180327869,Very Cheap
20141202T000000,695000.0,5,1.75,1790,9335,2.0,0,0,5,8,1790,0,1952,0,98004,47.5945,-122.201,1840,9612,7545,7772,74.45099089448313,0.08131147540983606,Very Cheap
20141107T000000,255000.0,2,2.0,1140,8400,1.0,0,0,2,7,1140,0,1954,0,98148,47.4351,-122.335,1130,9375,7260,8245,30.357142857142858,0.02360655737704918,Very Cheap
20140723T000000,410000.0,3,2.25,1790,5794,1.5,0,0,3,7,1380,410,1985,0,98072,47.7477,-122.171,2140,7769,4004,5629,70.76285812909907,0.043934426229508196,Very Cheap
20140625T000000,650000.0,4,2.75,1910,16532,1.0,0,0,4,7,1420,490,1940,0,98117,47.6952,-122.39,2300,8250,14622,5950,39.3176869102347,0.07540983606557378,Very Cheap
20150318T000000,675000.0,4,1.75,1530,3615,1.5,0,0,4,7,1530,0,1913,0,98103,47.6529,-122.334,1650,4200,2085,2550,186.7219917012448,0.07868852459016394,Very Cheap
20140701T000000,332888.0,2,2.5,1050,1029,2.0,0,0,3,8,950,100,2007,0,98122,47.6018,-122.299,1350,3600,-21,2250,323.50631681243925,0.033821377049180326,Very Cheap
20150220T000000,300000.0,3,1.75,1730,6900,1.0,0,0,4,7,1130,600,1976,0,98031,47.3915,-122.188,1950,7200,5170,5250,43.47826086956522,0.029508196721311476,Very Cheap
20140801T000000,320000.0,4,1.5,1100,11824,1.0,0,0,4,7,1100,0,1954,0,98006,47.5704,-122.141,1380,11796,10724,10416,27.06359945872801,0.032131147540983604,Very Cheap
20150508T000000,342500.0,5,2.25,2100,10726,1.0,0,0,4,7,1050,1050,1963,0,98059,47.4922,-122.134,2100,10726,8626,8626,31.93175461495432,0.035081967213114754,Very Cheap
20150320T000000,752875.0,4,2.5,2800,72309,2.0,0,0,3,9,2800,0,1992,0,98072,47.7432,-122.112,2280,36420,69509,34140,10.411912763279814,0.08890163934426229,Very Cheap
20140630T000000,1730000.0,5,3.5,5000,26540,2.0,0,3,3,10,3410,1590,2008,0,98040,47.5665,-122.21,3360,17398,21540,14038,65.1846269781462,0.21704918032786885,Cheap
20140814T000000,255000.0,1,0.5,880,1642,1.0,0,0,3,6,500,380,1910,0,98126,47.5732,-122.372,1410,2992,762,1582,155.29841656516444,0.02360655737704918,Very Cheap
20141103T000000,244000.0,3,2.5,1470,9337,2.0,0,0,3,7,1470,0,1991,0,98155,47.7651,-122.323,1360,8684,7867,7324,26.132590767912607,0.02216393442622951,Very Cheap
20150401T000000,1420000.0,5,3.25,3950,11438,2.0,0,2,3,10,3430,520,2006,0,98033,47.6898,-122.189,2070,10751,7488,8681,124.14757824794545,0.1763934426229508,Cheap
20141110T000000,218000.0,3,1.0,980,12812,1.0,0,0,3,7,980,0,1956,0,98168,47.4892,-122.306,1430,8986,11832,7556,17.015298157976897,0.018754098360655738,Very Cheap
20141203T000000,359000.0,4,1.0,2180,10617,1.5,0,0,3,7,2180,0,1950,0,98155,47.7522,-122.307,1360,9519,8437,8159,33.813695017424884,0.03724590163934426,Very Cheap
20141027T000000,840000.0,4,2.75,3040,13559,2.0,0,0,3,11,3040,0,2003,0,98059,47.522,-122.149,3830,12202,10519,8372,61.9514713474445,0.10032786885245902,Cheap
20140507T000000,900000.0,5,3.75,4130,226076,2.0,0,0,3,9,3170,960,1985,0,98077,47.715,-122.065,4130,55321,221946,51191,3.980962154319786,0.10819672131147541,Cheap
20141009T000000,205000.0,4,1.75,1850,65340,1.5,0,0,4,7,1850,0,1972,0,98042,47.3468,-122.11,1750,40946,63490,39196,3.137434955616774,0.017049180327868854,Very Cheap
20150121T000000,205000.0,3,2.5,1600,7295,2.0,0,0,2,7,1600,0,1993,0,98042,47.3904,-122.165,1410,9000,5695,7590,28.10143934201508,0.017049180327868854,Very Cheap
20150408T000000,500000.0,2,1.5,2070,5432,2.0,0,0,3,7,1370,700,1951,0,98108,47.5571,-122.299,2070,5505,3362,3435,92.04712812960236,0.05573770491803279,Very Cheap
20150109T000000,510000.0,4,2.5,3180,5405,2.0,0,0,3,7,3180,0,2001,0,98059,47.4905,-122.14,2610,5403,2225,2793,94.35707678075856,0.057049180327868855,Very Cheap
20140620T000000,1135000.0,6,4.25,6900,244716,2.0,0,0,4,9,4820,2080,2002,0,98077,47.7506,-122.012,4170,266587,237816,262417,4.638029389169486,0.13901639344262295,Cheap
20150430T000000,1545000.0,4,2.25,2640,3000,2.0,0,0,3,7,2080,560,1908,0,98109,47.6313,-122.344,1910,3000,360,1090,515.0,0.19278688524590165,Cheap
20140721T000000,210000.0,3,1.5,1920,61014,1.0,0,0,3,6,1920,0,1953,0,98038,47.4446,-122.074,1616,61014,59094,59398,3.4418330219293933,0.017704918032786884,Very Cheap
20141209T000000,597500.0,3,1.75,2030,32565,1.0,0,0,3,8,1600,430,1981,0,98052,47.7112,-122.098,2910,34190,30535,31280,18.347919545524334,0.06852459016393443,Very Cheap
20141029T000000,400000.0,2,1.0,1140,101529,1.5,0,0,3,6,1140,0,1932,0,98092,47.2592,-122.228,1580,101529,100389,99949,3.9397610534921057,0.04262295081967213,Very Cheap
20140821T000000,412000.0,3,1.0,1660,6992,1.0,0,0,5,7,1260,400,1952,0,98155,47.7576,-122.318,1390,7359,5332,5969,58.924485125858126,0.04419672131147541,Very Cheap
20150325T000000,299950.0,2,1.5,1390,1756,3.0,0,0,3,7,1390,0,2005,0,98133,47.7274,-122.357,1340,1756,366,416,170.8143507972665,0.029501639344262295,Very Cheap
20150423T000000,1081000.0,4,3.0,2490,4325,1.5,0,0,3,8,1690,800,1922,2003,98105,47.6628,-122.326,1960,4284,1835,2324,249.94219653179192,0.13193442622950818,Cheap
20141118T000000,422500.0,4,2.5,2550,8824,2.0,0,0,3,9,2550,0,1990,0,98031,47.3979,-122.212,2630,11237,6274,8607,47.88077969174977,0.04557377049180328,Very Cheap
20140714T000000,410000.0,3,2.0,1270,10227,1.0,0,0,4,6,1270,0,1968,0,98033,47.6876,-122.168,1470,9750,8957,8280,40.08995795443434,0.043934426229508196,Very Cheap
20140528T000000,1400000.0,4,3.25,2980,7000,2.0,0,3,3,10,2140,840,1900,2014,98144,47.5933,-122.292,2200,4800,4020,2600,200.0,0.1737704918032787,Cheap
20140715T000000,245000.0,3,2.0,1470,8000,1.0,0,0,4,8,1470,0,1974,0,98023,47.3191,-122.385,1980,8000,6530,6020,30.625,0.022295081967213116,Very Cheap
20140702T000000,720000.0,4,3.0,3550,12327,1.5,0,0,4,10,2180,1370,1990,0,98011,47.7533,-122.205,3170,12937,8777,9767,58.40837186663422,0.08459016393442623,Very Cheap
20141024T000000,315000.0,2,1.0,780,7200,1.0,0,0,2,6,780,0,1935,0,98118,47.5609,-122.279,1750,7200,6420,5450,43.75,0.031475409836065574,Very Cheap
20150224T000000,191950.0,2,2.5,1390,1302,2.0,0,0,3,7,1390,0,1987,0,98003,47.3081,-122.329,1390,2052,-88,662,147.42703533026113,0.015337704918032788,Very Cheap
20140923T000000,455000.0,4,2.5,2440,5001,2.0,0,0,3,8,2440,0,2005,0,98056,47.5108,-122.193,2260,5001,2561,2741,90.98180363927214,0.049836065573770495,Very Cheap
20140516T000000,523000.0,3,1.5,1260,3135,1.5,0,0,3,8,1260,0,1931,0,98116,47.5755,-122.388,1700,4180,1875,2480,166.8261562998405,0.05875409836065574,Very Cheap
20141024T000000,250000.0,3,2.25,1640,4420,2.0,0,0,4,7,1640,0,1918,1983,98002,47.311,-122.21,1230,6632,2780,5402,56.56108597285068,0.022950819672131147,Very Cheap
20150113T000000,294000.0,3,3.0,1670,4120,1.5,0,0,3,7,1140,530,1929,2012,98055,47.4881,-122.199,1010,4120,2450,3110,71.35922330097087,0.028721311475409836,Very Cheap
20141010T000000,490000.0,3,2.25,2380,6000,1.0,0,0,3,8,2040,340,1961,0,98115,47.6955,-122.275,1680,7200,3620,5520,81.66666666666667,0.05442622950819672,Very Cheap
20140916T000000,310000.0,4,1.0,1030,5750,1.0,0,0,3,7,1030,0,1971,0,98126,47.553,-122.37,1250,5750,4720,4500,53.91304347826087,0.03081967213114754,Very Cheap
20140721T000000,265000.0,3,1.5,1560,10489,1.0,0,0,5,7,1560,0,1961,0,98022,47.2048,-121.999,1400,10489,8929,9089,25.26456287539327,0.024918032786885248,Very Cheap
20140811T000000,402000.0,4,1.75,1640,10500,1.0,0,0,4,7,1010,630,1968,0,98052,47.6933,-122.116,1680,7650,8860,5970,38.285714285714285,0.04288524590163934,Very Cheap
20140509T000000,705000.0,2,2.5,2200,188200,1.0,0,3,3,8,2200,0,2007,0,98022,47.2458,-122.002,2700,84942,186000,82242,3.7460148777895856,0.08262295081967214,Very Cheap
20141124T000000,589450.0,4,2.5,3190,7941,2.0,0,0,3,10,3190,0,2005,0,98038,47.353,-122.002,3190,7255,4751,4065,74.22868656340512,0.06746885245901639,Very Cheap
20141223T000000,219950.0,3,1.5,1200,8404,1.0,0,0,3,7,1200,0,1964,0,98188,47.4482,-122.269,2120,12000,7204,9880,26.172060923369823,0.01900983606557377,Very Cheap
20140813T000000,750000.0,3,2.25,2250,5301,2.0,0,0,4,8,1510,740,1975,0,98115,47.6741,-122.271,2240,7200,3051,4960,141.4827391058291,0.08852459016393442,Very Cheap
20140821T000000,478000.0,2,1.75,1960,6000,1.0,0,0,4,7,980,980,1904,0,98199,47.6531,-122.401,1650,6000,4040,4350,79.66666666666667,0.05285245901639344,Very Cheap
20140714T000000,170000.0,3,1.0,1250,7015,1.0,0,0,3,7,1250,0,1958,0,98188,47.4548,-122.29,1510,11460,5765,9950,24.233784746970777,0.012459016393442624,Very Cheap
20140612T000000,489950.0,4,2.25,2640,31941,1.0,0,0,4,9,2640,0,1986,0,98092,47.3099,-122.116,2780,35365,29301,32585,15.33921918537303,0.05441967213114754,Very Cheap
20140606T000000,1370000.0,2,2.25,2460,16940,1.5,0,4,4,9,1930,530,1936,0,98117,47.6792,-122.404,2260,6851,14480,4591,80.87367178276268,0.16983606557377048,Cheap
20150302T000000,319950.0,3,2.5,1700,7000,2.0,0,0,3,7,1700,0,1996,0,98038,47.3798,-122.025,1950,7000,5300,5050,45.707142857142856,0.03212459016393442,Very Cheap
20141124T000000,208417.0,2,1.0,840,4200,1.0,0,0,3,5,840,0,1938,0,98108,47.5292,-122.316,830,5000,3360,4170,49.62309523809524,0.017497311475409835,Very Cheap
20141117T000000,410000.0,4,2.0,1900,5100,1.0,0,0,3,6,950,950,1914,1973,98117,47.6767,-122.38,1230,5100,3200,3870,80.3921568627451,0.043934426229508196,Very Cheap
20140725T000000,590000.0,4,2.75,2160,4205,1.0,0,3,3,7,1080,1080,1969,0,98125,47.7081,-122.276,2450,6014,2045,3564,140.30915576694412,0.06754098360655737,Very Cheap
20150429T000000,648000.0,3,1.75,1610,10229,1.0,0,0,5,8,1610,0,1961,0,98006,47.553,-122.174,2270,8800,8619,6530,63.34930100694105,0.07514754098360656,Very Cheap
20140627T000000,255000.0,3,2.5,1720,6194,2.0,0,0,3,8,1720,0,1998,0,98092,47.2624,-122.221,1720,6211,4474,4491,41.16887310300291,0.02360655737704918,Very Cheap
20140825T000000,465000.0,4,2.75,2190,3267,2.0,0,0,3,8,2190,0,2004,0,98072,47.7751,-122.168,2190,3619,1077,1429,142.33241505968778,0.051147540983606556,Very Cheap
20150128T000000,622000.0,4,1.75,3020,10714,1.0,0,0,5,8,1510,1510,1958,0,98006,47.56,-122.181,2230,14400,7694,12170,58.054881463505694,0.07173770491803279,Very Cheap
20140915T000000,306000.0,3,1.75,1980,9800,1.0,0,0,3,7,1980,0,1991,0,98030,47.3745,-122.224,1630,7650,7820,6020,31.224489795918366,0.030295081967213113,Very Cheap
20141010T000000,617000.0,3,2.5,1880,5500,2.0,0,0,4,7,1880,0,1947,2007,98199,47.657,-122.393,1230,5500,3620,4270,112.18181818181819,0.07108196721311476,Very Cheap
20140528T000000,438750.0,3,1.75,1610,6480,1.0,0,0,4,7,1610,0,1947,0,98125,47.7137,-122.307,1230,8040,4870,6810,67.70833333333333,0.04770491803278688,Very Cheap
20140925T000000,1280000.0,4,3.0,3260,4500,2.0,0,0,3,9,2300,960,1930,2014,98109,47.6314,-122.353,2410,4995,1240,2585,284.44444444444446,0.1580327868852459,Cheap
20141124T000000,995000.0,5,3.25,3970,8029,2.0,0,2,3,9,2970,1000,1979,0,98177,47.7764,-122.385,2520,8214,4059,5694,123.92576908705941,0.12065573770491804,Cheap
20140623T000000,1580000.0,4,2.5,4570,74487,2.0,0,4,5,12,4570,0,1948,1985,98177,47.7282,-122.372,3810,74487,69917,70677,21.211755071354734,0.19737704918032786,Cheap
20150422T000000,635000.0,5,2.75,2620,5500,1.5,0,0,3,7,1710,910,1911,0,98117,47.6806,-122.388,1790,5500,2880,3710,115.45454545454545,0.07344262295081967,Very Cheap
20140728T000000,215000.0,3,1.0,1180,9000,1.0,0,0,4,7,1180,0,1970,0,98031,47.39,-122.166,1290,8316,7820,7026,23.88888888888889,0.018360655737704918,Very Cheap
20141027T000000,530000.0,3,2.5,1365,1090,3.0,0,0,3,7,1315,50,2003,0,98115,47.6776,-122.324,1360,1124,-275,-236,486.23853211009174,0.05967213114754098,Very Cheap
20150320T000000,295000.0,2,1.0,720,4125,1.0,0,0,4,6,720,0,1943,0,98106,47.5245,-122.354,1000,6100,3405,5100,71.51515151515152,0.028852459016393443,Very Cheap
20150302T000000,245000.0,3,2.25,1350,6775,1.0,0,0,3,7,930,420,1981,0,98032,47.3593,-122.289,1460,7210,5425,5750,36.162361623616235,0.022295081967213116,Very Cheap
20150105T000000,400000.0,6,2.5,3060,17112,1.0,0,0,4,8,1530,1530,1967,0,98058,47.4379,-122.146,2690,16038,14052,13348,23.37540906965872,0.04262295081967213,Very Cheap
20140721T000000,303000.0,3,2.75,1850,8820,2.0,0,0,4,8,1850,0,1993,0,98022,47.1928,-122.01,1850,8651,6970,6801,34.35374149659864,0.029901639344262296,Very Cheap
20141015T000000,330000.0,3,1.75,1320,9675,1.5,0,0,4,7,1320,0,1970,0,98024,47.5695,-121.902,1160,9675,8355,8515,34.10852713178294,0.03344262295081967,Very Cheap
20150304T000000,700000.0,3,1.75,1990,13000,2.0,0,3,3,9,1990,0,1980,0,98028,47.7439,-122.262,2880,11340,11010,8460,53.84615384615385,0.08196721311475409,Very Cheap
20140826T000000,126000.0,1,1.0,610,4400,1.0,0,0,3,5,610,0,1922,0,98055,47.4865,-122.197,1090,4930,3790,3840,28.636363636363637,0.006688524590163935,Very Cheap
20140723T000000,850000.0,4,1.0,2500,35802,1.5,0,0,3,7,2500,0,1955,0,98005,47.6488,-122.153,2880,40510,33302,37630,23.741690408357076,0.10163934426229508,Cheap
20141218T000000,405000.0,3,2.0,1440,7425,1.0,0,0,4,7,1440,0,1965,0,98034,47.7243,-122.185,1800,8344,5985,6544,54.54545454545455,0.043278688524590166,Very Cheap
20140819T000000,869900.0,6,4.5,2750,4400,2.0,0,0,3,8,1770,980,1987,0,98103,47.6883,-122.335,1860,4400,1650,2540,197.70454545454547,0.10424918032786885,Cheap
20150331T000000,485000.0,3,1.75,1790,6775,1.0,0,2,3,8,1790,0,1951,0,98126,47.5412,-122.377,1310,6028,4985,4718,71.58671586715867,0.05377049180327869,Very Cheap
20150128T000000,400000.0,2,2.0,1050,1173,2.0,0,0,3,8,720,330,2004,0,98122,47.6181,-122.302,1340,1317,123,-23,341.00596760443307,0.04262295081967213,Very Cheap
20140911T000000,299950.0,3,2.5,1780,4650,2.0,0,0,3,7,1780,0,2011,0,98038,47.386,-122.047,3050,3848,2870,798,64.50537634408602,0.029501639344262295,Very Cheap
20150327T000000,585000.0,4,2.5,2200,9099,2.0,0,0,3,8,2200,0,1994,0,98034,47.733,-122.225,2270,8900,6899,6630,64.29277942631059,0.06688524590163934,Very Cheap
20150506T000000,495000.0,4,2.0,1720,5413,2.0,0,0,3,7,1470,250,1938,1980,98115,47.6929,-122.321,1510,5413,3693,3903,91.446517642712,0.05508196721311476,Very Cheap
20150311T000000,2200000.0,5,4.5,5840,17168,2.0,0,0,3,12,4570,1270,2006,0,98029,47.5457,-121.991,4850,15017,11328,10167,128.14538676607643,0.2786885245901639,Cheap
20141110T000000,447000.0,3,2.25,1520,14080,2.0,0,0,3,7,1520,0,1984,0,98074,47.6273,-122.059,1530,9758,12560,8228,31.74715909090909,0.04878688524590164,Very Cheap
20150417T000000,206000.0,3,1.0,1320,9239,1.0,0,0,4,7,1320,0,1968,0,98092,47.312,-122.183,1320,8415,7919,7095,22.29678536638164,0.017180327868852457,Very Cheap
20141021T000000,500000.0,3,1.0,1070,4600,1.0,0,0,3,7,950,120,1930,0,98116,47.5627,-122.383,1090,4600,3530,3510,108.69565217391305,0.05573770491803279,Very Cheap
20141121T000000,302500.0,4,2.5,1990,5511,2.0,0,0,3,8,1990,0,1994,0,98030,47.3585,-122.191,1850,6031,3521,4181,54.89021956087824,0.02983606557377049,Very Cheap
20141125T000000,1250000.0,4,4.25,4980,13000,2.0,0,3,3,9,3080,1900,1982,0,98052,47.6406,-122.101,2840,11308,8020,8468,96.15384615384616,0.1540983606557377,Cheap
20140723T000000,391000.0,2,1.0,890,5423,1.0,0,0,3,6,890,0,1946,0,98117,47.6966,-122.368,1690,5993,4533,4303,72.10031347962382,0.04144262295081967,Very Cheap
20140710T000000,250000.0,3,2.0,1440,5457,2.0,0,0,3,7,1440,0,1986,0,98038,47.3784,-122.046,1480,6286,4017,4806,45.81271761040865,0.022950819672131147,Very Cheap
20140723T000000,435000.0,4,2.5,2440,5350,2.0,0,0,3,7,2440,0,2003,0,98059,47.4891,-122.149,2440,5090,2910,2650,81.30841121495327,0.04721311475409836,Very Cheap
20150211T000000,160000.0,4,2.25,1800,14722,1.0,0,0,3,7,1440,360,1962,0,98055,47.4874,-122.223,2400,10000,12922,7600,10.868088574921886,0.011147540983606558,Very Cheap
20140722T000000,451000.0,5,3.0,2260,6508,1.0,0,0,3,7,1330,930,2003,0,98155,47.7508,-122.322,1940,9450,4248,7510,69.29932390903504,0.04931147540983607,Very Cheap
20140505T000000,206000.0,2,1.0,810,7158,1.0,0,0,5,6,810,0,1944,0,98168,47.4882,-122.325,1090,7158,6348,6068,28.778988544286115,0.017180327868852457,Very Cheap
20140923T000000,590000.0,4,2.75,2240,5400,2.0,0,0,4,7,1540,700,1940,0,98116,47.5785,-122.402,1830,5000,3160,3170,109.25925925925925,0.06754098360655737,Very Cheap
20140515T000000,695000.0,3,2.5,4560,17622,2.0,0,0,4,9,3800,760,1986,0,98074,47.621,-122.03,2360,15000,13062,12640,39.43933719214618,0.08131147540983606,Very Cheap
20141120T000000,350000.0,3,1.5,1550,40752,1.0,0,0,5,7,1550,0,1954,0,98031,47.394,-122.202,1550,8000,39202,6450,8.58853553199843,0.036065573770491806,Very Cheap
20150326T000000,1236300.0,5,3.5,3180,4628,2.0,0,0,3,10,2420,760,2001,0,98199,47.6423,-122.394,2060,4640,1448,2580,267.13483146067415,0.1523016393442623,Cheap
20150330T000000,395000.0,6,2.25,2950,11200,1.0,0,0,4,7,1700,1250,1970,0,98072,47.7476,-122.087,1790,11200,8250,9410,35.267857142857146,0.0419672131147541,Very Cheap
20150405T000000,419000.0,5,3.0,2190,9652,2.0,0,0,3,7,2190,0,1999,0,98178,47.5049,-122.239,1440,6710,7462,5270,43.41069208454206,0.04511475409836065,Very Cheap
20140708T000000,592350.0,2,2.0,1570,4665,1.0,0,0,3,8,1570,0,2006,0,98053,47.709,-122.017,2165,6262,3095,4097,126.97749196141478,0.06784918032786885,Very Cheap
20140806T000000,855000.0,5,3.25,3420,5669,2.0,0,0,3,9,2620,800,2003,0,98027,47.5366,-122.067,3310,6006,2249,2696,150.82025048509436,0.10229508196721311,Cheap
20141230T000000,771000.0,4,2.5,2420,7200,2.0,0,0,3,9,2420,0,1991,0,98033,47.6893,-122.197,2650,7800,4780,5150,107.08333333333333,0.09127868852459016,Very Cheap
20141218T000000,325000.0,3,2.25,1570,43350,1.0,0,3,4,7,1570,0,1967,0,98022,47.2377,-122.016,1570,220849,41780,219279,7.497116493656286,0.03278688524590164,Very Cheap
20141018T000000,1850000.0,5,3.25,3680,6060,2.0,0,0,5,9,2630,1050,1925,0,98112,47.6341,-122.304,3050,5850,2380,2800,305.28052805280527,0.23278688524590163,Cheap
20140729T000000,545000.0,4,1.75,1910,6731,1.0,0,0,4,7,1210,700,1953,0,98116,47.5693,-122.391,1780,6350,4821,4570,80.96865250334274,0.06163934426229508,Very Cheap
20150226T000000,615000.0,3,1.75,1780,5175,1.0,0,0,4,7,990,790,1927,0,98116,47.5696,-122.386,1780,5175,3395,3395,118.84057971014492,0.07081967213114754,Very Cheap
20150410T000000,625500.0,2,1.0,2160,7439,1.0,0,0,4,6,1300,860,1953,0,98115,47.6981,-122.286,1680,7439,5279,5759,84.08388224223685,0.0721967213114754,Very Cheap
20140708T000000,232000.0,3,1.5,1460,15000,1.0,0,0,3,7,1460,0,1966,0,98001,47.3182,-122.271,1510,15000,13540,13490,15.466666666666667,0.02059016393442623,Very Cheap
20140714T000000,168000.0,3,1.5,1370,7439,1.0,0,0,4,6,1370,0,1963,0,98055,47.4499,-122.189,2350,3370,6069,1020,22.58368060223148,0.01219672131147541,Very Cheap
20150128T000000,238000.0,3,1.5,1370,7439,1.0,0,0,4,6,1370,0,1963,0,98055,47.4499,-122.189,2350,3370,6069,1020,31.993547519827935,0.02137704918032787,Very Cheap
20150414T000000,260000.0,3,2.5,1500,7401,2.0,0,0,3,8,1500,0,1998,0,98092,47.2625,-122.221,1720,7171,5901,5451,35.1303877854344,0.024262295081967214,Very Cheap
20150302T000000,460000.0,3,1.75,1210,7500,1.0,0,0,3,7,1210,0,1951,0,98027,47.5294,-122.033,1250,6000,6290,4750,61.333333333333336,0.050491803278688525,Very Cheap
20140825T000000,900000.0,3,2.5,2850,11535,1.0,0,1,3,8,1680,1170,1952,2008,98155,47.748,-122.288,2670,9942,8685,7272,78.02340702210664,0.10819672131147541,Cheap
20141021T000000,289950.0,3,1.0,1090,8280,1.0,0,0,3,6,1090,0,1947,2006,98155,47.7562,-122.318,1060,7609,7190,6549,35.018115942028984,0.028190163934426228,Very Cheap
20150220T000000,265000.0,3,1.75,1450,5858,1.0,0,0,4,7,1450,0,1991,0,98038,47.3482,-122.037,1520,6573,4408,5053,45.237282348924545,0.024918032786885248,Very Cheap
20140530T000000,465000.0,4,2.25,1820,20349,1.0,0,0,5,8,1340,480,1977,0,98072,47.7415,-122.096,1270,12800,18529,11530,22.85124576146248,0.051147540983606556,Very Cheap
20141113T000000,370000.0,3,1.5,1320,7201,1.0,0,0,3,7,1320,0,1971,0,98034,47.7126,-122.211,1380,7201,5881,5821,51.38175253437023,0.038688524590163934,Very Cheap
20140806T000000,240000.0,2,1.5,1670,9880,1.0,0,0,4,7,1670,0,1941,1963,98146,47.4864,-122.348,1670,9807,8210,8137,24.291497975708502,0.021639344262295083,Very Cheap
20140917T000000,232000.0,4,2.0,1440,5911,1.0,0,0,5,5,1440,0,1943,0,98056,47.5072,-122.181,1500,11089,4471,9589,39.248858061241755,0.02059016393442623,Very Cheap
20140729T000000,237502.0,3,1.0,980,7560,1.0,0,0,3,7,980,0,1951,0,98126,47.5256,-122.375,1300,7560,6580,6260,31.415608465608464,0.021311737704918034,Very Cheap
20141215T000000,1280000.0,4,3.5,4340,5500,2.0,0,0,3,10,2850,1490,2008,0,98199,47.6427,-122.397,1290,5500,1160,4210,232.72727272727272,0.1580327868852459,Cheap
20150424T000000,957000.0,4,2.25,2860,11545,1.0,0,0,4,8,1430,1430,1966,0,98005,47.588,-122.168,2190,11396,8685,9206,82.89302728453876,0.11567213114754098,Cheap
20150305T000000,218000.0,3,1.5,1140,4875,1.0,0,0,5,6,1140,0,1970,0,98042,47.3684,-122.08,980,5070,3735,4090,44.717948717948715,0.018754098360655738,Very Cheap
20140820T000000,205000.0,3,1.5,1120,8366,1.0,0,0,3,7,1120,0,1968,0,98042,47.3632,-122.11,1260,9000,7246,7740,24.50394453741334,0.017049180327868854,Very Cheap
20140611T000000,350000.0,3,3.25,1460,1592,2.0,0,0,3,8,1130,330,2006,0,98126,47.5481,-122.374,1560,1701,132,141,219.84924623115577,0.036065573770491806,Very Cheap
20140702T000000,256000.0,4,2.5,2050,5787,2.0,0,0,3,7,2050,0,2002,0,98198,47.3527,-122.315,2030,6615,3737,4585,44.23708311733195,0.023737704918032787,Very Cheap
20140730T000000,275000.0,3,1.0,1250,7654,1.0,0,0,3,7,1000,250,1952,0,98125,47.7289,-122.291,1310,7350,6404,6040,35.928926051737655,0.02622950819672131,Very Cheap
20150403T000000,372000.0,4,2.5,2520,9604,2.0,0,0,3,9,2520,0,1990,0,98031,47.3893,-122.216,2540,9793,7084,7253,38.73386089129529,0.03895081967213115,Very Cheap
20150319T000000,688888.0,3,3.25,2580,9825,1.5,0,1,4,9,1760,820,1978,0,98027,47.5314,-122.054,2140,10270,7245,8130,70.11582697201018,0.08050990163934427,Very Cheap
20140630T000000,170000.0,2,1.0,1200,24792,2.0,0,0,2,7,1200,0,1976,0,98053,47.6337,-121.961,2150,24792,23592,22642,6.857050661503711,0.012459016393442624,Very Cheap
20140625T000000,530000.0,5,2.25,2140,7910,1.0,0,0,3,7,1070,1070,1962,0,98007,47.6071,-122.137,1680,8700,5770,7020,67.00379266750949,0.05967213114754098,Very Cheap
20140623T000000,905000.0,4,3.25,3440,7661,2.0,0,0,3,11,3440,0,2006,0,98029,47.5429,-121.995,3580,6478,4221,2898,118.13079232476179,0.10885245901639344,Cheap
20140825T000000,365000.0,4,2.5,1800,5070,1.0,0,0,5,7,1080,720,1979,0,98118,47.5303,-122.28,1870,5365,3270,3495,71.99211045364892,0.0380327868852459,Very Cheap
20150406T000000,312000.0,4,2.5,1790,10584,1.0,0,0,4,7,1290,500,1981,0,98031,47.4061,-122.188,1730,9120,8794,7390,29.478458049886623,0.031081967213114754,Very Cheap
20140822T000000,400000.0,2,1.75,1250,7680,1.0,0,0,3,7,1250,0,1922,1968,98126,47.5242,-122.371,1250,7680,6430,6430,52.083333333333336,0.04262295081967213,Very Cheap
20140912T000000,278750.0,2,2.0,800,5765,1.0,0,0,4,6,800,0,1936,0,98133,47.7024,-122.346,1160,3844,4965,2684,48.35212489158717,0.026721311475409838,Very Cheap
20150401T000000,510000.0,3,2.0,1410,11995,1.0,0,0,4,8,1410,0,1965,0,98006,47.5718,-122.127,2690,12650,10585,9960,42.5177157148812,0.057049180327868855,Very Cheap
20150414T000000,527700.0,2,2.25,1330,806,3.0,0,0,3,8,1330,0,2009,0,98117,47.6904,-122.395,1320,1389,-524,69,654.7146401985111,0.05937049180327869,Very Cheap
20150415T000000,740000.0,4,2.75,2890,4000,1.5,0,0,4,9,2190,700,1931,0,98109,47.6419,-122.351,2280,4000,1110,1720,185.0,0.08721311475409836,Very Cheap
20140808T000000,512000.0,4,2.5,2550,17209,2.0,0,0,3,9,2550,0,1996,0,98059,47.4836,-122.136,2840,12560,14659,9720,29.75187401940845,0.05731147540983607,Very Cheap
20141112T000000,362000.0,5,2.5,2880,8216,2.0,0,0,3,8,2880,0,2001,0,98030,47.3747,-122.185,1960,7200,5336,5240,44.0603700097371,0.03763934426229508,Very Cheap
20150206T000000,225000.0,3,1.0,660,6600,1.0,0,0,4,5,660,0,1940,0,98168,47.4842,-122.33,1320,6600,5940,5280,34.09090909090909,0.019672131147540985,Very Cheap
20140630T000000,491500.0,3,2.25,1470,4322,2.0,0,0,3,7,1470,0,1985,0,98029,47.5672,-122.018,1610,4322,2852,2712,113.72049976862564,0.05462295081967213,Very Cheap
20150204T000000,429950.0,4,1.75,1700,10230,1.0,0,0,3,8,1320,380,1959,0,98133,47.7453,-122.351,2000,8006,8530,6006,42.028347996089934,0.04655081967213115,Very Cheap
20141117T000000,375000.0,3,1.0,1040,9800,1.0,0,0,4,7,1040,0,1955,0,98006,47.5765,-122.155,1280,8880,8760,7600,38.265306122448976,0.03934426229508197,Very Cheap
20140813T000000,199400.0,2,1.0,880,4000,1.0,0,0,4,6,880,0,1916,0,98106,47.5331,-122.352,1430,4000,3120,2570,49.85,0.016314754098360657,Very Cheap
20150126T000000,364900.0,4,2.5,2490,9346,2.0,0,2,3,9,2490,0,1996,0,98042,47.3831,-122.147,2650,9454,6856,6804,39.043441044297026,0.03801967213114754,Very Cheap
20140912T000000,324950.0,3,1.5,1210,7560,1.0,0,0,3,7,1210,0,1941,0,98126,47.5255,-122.374,980,7560,6350,6580,42.982804232804234,0.03278032786885246,Very Cheap
20150330T000000,467000.0,5,2.0,2080,4000,1.0,0,0,4,6,1040,1040,1909,0,98144,47.5858,-122.308,1940,6000,1920,4060,116.75,0.05140983606557377,Very Cheap
20140822T000000,380000.0,3,1.0,1380,5400,1.0,0,0,4,7,1380,0,1954,0,98125,47.7134,-122.288,1190,6075,4020,4885,70.37037037037037,0.04,Very Cheap
20141103T000000,250000.0,3,2.25,1620,10850,1.0,0,0,3,7,1620,0,1966,0,98055,47.4437,-122.194,1910,10568,9230,8658,23.04147465437788,0.022950819672131147,Very Cheap
20140520T000000,700000.0,4,1.0,1680,4021,1.5,0,0,3,7,1680,0,1921,0,98103,47.6663,-122.332,1710,4021,2341,2311,174.0860482467048,0.08196721311475409,Very Cheap
20141113T000000,206990.0,3,1.0,1330,9620,1.0,0,0,5,6,1330,0,1976,0,98092,47.3174,-122.127,1300,10360,8290,9060,21.516632016632016,0.01731016393442623,Very Cheap
20150406T000000,670000.0,3,1.75,1730,3400,1.0,0,0,5,7,970,760,1928,0,98107,47.6662,-122.364,1640,5000,1670,3360,197.05882352941177,0.0780327868852459,Very Cheap
20140520T000000,315000.0,2,1.0,790,6969,1.0,0,0,3,6,790,0,1955,1984,98052,47.6978,-122.164,1380,12196,6179,10816,45.200172191132154,0.031475409836065574,Very Cheap
20150410T000000,319950.0,3,2.5,2240,7500,2.0,0,0,3,8,2240,0,1985,0,98092,47.265,-122.22,2190,7506,5260,5316,42.66,0.03212459016393442,Very Cheap
20140730T000000,419000.0,3,1.5,1500,8272,1.0,0,0,4,7,1500,0,1958,0,98177,47.7741,-122.38,1630,8270,6772,6640,50.652804642166345,0.04511475409836065,Very Cheap
20140822T000000,205000.0,3,2.0,1800,11419,1.0,0,0,3,8,1800,0,1989,0,98092,47.2623,-122.217,2220,11406,9619,9186,17.952535248270426,0.017049180327868854,Very Cheap
20141023T000000,335000.0,4,2.5,1980,4745,2.0,0,0,3,7,1980,0,2004,0,98038,47.3495,-122.04,1980,4878,2765,2898,70.60063224446786,0.03409836065573771,Very Cheap
20141024T000000,397000.0,3,1.75,1340,5100,1.0,0,0,3,7,1340,0,1953,0,98103,47.694,-122.348,1550,5100,3760,3550,77.84313725490196,0.04222950819672131,Very Cheap
20150429T000000,370000.0,2,1.0,750,2020,1.0,0,0,3,7,750,0,1908,1995,98122,47.6175,-122.301,1630,2383,1270,753,183.16831683168317,0.038688524590163934,Very Cheap
20140918T000000,330000.0,4,2.25,1790,9920,1.0,0,0,4,7,1170,620,1969,0,98059,47.5126,-122.149,1990,9648,8130,7658,33.266129032258064,0.03344262295081967,Very Cheap
20141030T000000,1785000.0,4,3.5,5490,14300,1.0,0,4,3,12,2910,2580,1996,0,98006,47.5511,-122.114,4290,13822,8810,9532,124.82517482517483,0.2242622950819672,Cheap
20140808T000000,399000.0,3,2.0,1940,16300,1.0,0,0,3,7,1140,800,1978,0,98155,47.774,-122.283,1940,11250,14360,9310,24.478527607361965,0.042491803278688525,Very Cheap
20140620T000000,400000.0,4,1.75,2670,189486,2.0,0,4,3,8,2670,0,1972,0,98092,47.2585,-122.061,2190,218610,186816,216420,2.1109738978077535,0.04262295081967213,Very Cheap
20140717T000000,249900.0,3,2.0,1220,6404,1.0,0,0,3,7,1220,0,1994,0,98038,47.3523,-122.059,1570,7000,5184,5430,39.022485946283574,0.02293770491803279,Very Cheap
20140513T000000,717000.0,3,1.5,1310,3880,1.0,0,0,3,7,1090,220,1956,0,98117,47.6821,-122.392,1570,3880,2570,2310,184.79381443298968,0.0841967213114754,Very Cheap
20140807T000000,319000.0,4,2.5,1930,8336,2.0,0,0,3,8,1930,0,1995,0,98031,47.4016,-122.166,2280,7959,6406,5679,38.267754318618046,0.032,Very Cheap
20150403T000000,635000.0,4,3.0,2100,3800,2.0,0,0,3,8,2100,0,1972,0,98115,47.6807,-122.291,1320,3800,1700,2480,167.10526315789474,0.07344262295081967,Very Cheap
20140910T000000,355000.0,3,1.0,1180,7573,1.0,0,0,4,7,1180,0,1977,0,98155,47.7372,-122.294,1320,7573,6393,6253,46.87706325102337,0.036721311475409836,Very Cheap
20150401T000000,1600000.0,5,3.25,4320,32840,2.0,0,0,3,12,4320,0,1990,0,98006,47.5461,-122.122,4410,33210,28520,28800,48.721071863580995,0.2,Cheap
20140714T000000,585000.0,4,1.75,3140,12519,1.0,0,0,3,7,2320,820,1951,1983,98033,47.6941,-122.173,2240,7308,9379,5068,46.728971962616825,0.06688524590163934,Very Cheap
20141229T000000,320000.0,3,2.0,2320,7800,1.0,0,0,4,7,1160,1160,1960,0,98168,47.5141,-122.316,1380,7800,5480,6420,41.02564102564103,0.032131147540983604,Very Cheap
20140514T000000,305495.0,3,1.75,2110,10200,2.0,0,0,4,7,2110,0,1966,0,98059,47.4744,-122.154,1800,10200,8090,8400,29.95049019607843,0.030228852459016395,Very Cheap
20140619T000000,240000.0,4,2.0,1790,14690,1.0,0,1,4,7,1670,120,1960,0,98198,47.3965,-122.321,2440,10664,12900,8224,16.337644656228726,0.021639344262295083,Very Cheap
20140623T000000,199950.0,5,2.5,1740,8750,1.0,0,0,4,7,1740,0,1959,0,98198,47.3904,-122.299,1740,8750,7010,7010,22.85142857142857,0.01638688524590164,Very Cheap
20140826T000000,1620000.0,4,3.25,3820,8114,2.0,0,0,3,10,3820,0,2005,0,98004,47.5837,-122.194,2440,9195,4294,6755,199.65491742666995,0.20262295081967213,Cheap
20150218T000000,770000.0,3,3.5,2050,21744,2.0,1,4,4,9,1750,300,1930,0,98166,47.4536,-122.376,2300,12200,19694,9900,35.41206769683591,0.09114754098360656,Very Cheap
20140702T000000,255000.0,4,2.25,1680,3179,2.0,0,0,3,8,1680,0,2002,0,98092,47.3258,-122.186,1678,3590,1499,1912,80.21390374331551,0.02360655737704918,Very Cheap
20140915T000000,289000.0,4,2.25,1930,8925,1.0,0,0,4,8,1930,0,1974,0,98058,47.4501,-122.128,1930,8400,6995,6470,32.38095238095238,0.028065573770491802,Very Cheap
20140718T000000,494500.0,4,3.0,3760,8804,2.0,0,0,3,8,2470,1290,2002,0,98056,47.5161,-122.191,1960,7225,5044,5265,56.167651067696504,0.05501639344262295,Very Cheap
20140604T000000,746000.0,3,2.25,2370,9619,1.0,0,0,4,8,1650,720,1973,0,98052,47.6366,-122.099,1960,9712,7249,7752,77.55483938039298,0.088,Very Cheap
20141023T000000,385000.0,4,3.0,2120,13000,2.0,0,0,4,8,2120,0,1978,0,98059,47.4745,-122.141,2180,11440,10880,9260,29.615384615384617,0.04065573770491803,Very Cheap
20141118T000000,688100.0,4,2.5,2370,10513,2.0,0,0,4,8,2370,0,1987,0,98052,47.6915,-122.099,2110,9540,8143,7430,65.45229715590222,0.08040655737704919,Very Cheap
20140512T000000,870300.0,4,2.5,2350,3150,1.5,0,0,4,8,1690,660,1910,0,98103,47.6605,-122.335,1750,3150,800,1400,276.2857142857143,0.1043016393442623,Cheap
20141022T000000,310000.0,3,1.0,1180,8474,1.5,0,0,3,7,1180,0,1956,0,98155,47.7416,-122.327,1180,7200,7294,6020,36.582487609157425,0.03081967213114754,Very Cheap
20150312T000000,500000.0,3,2.5,2270,5654,2.0,0,0,3,8,2270,0,1999,0,98133,47.7733,-122.351,1770,7840,3384,6070,88.43296781039972,0.05573770491803279,Very Cheap
20140814T000000,255000.0,3,2.25,1830,7770,1.0,0,0,4,7,1400,430,1977,0,98042,47.3925,-122.161,1960,7272,5940,5312,32.818532818532816,0.02360655737704918,Very Cheap
20150218T000000,1475000.0,3,2.75,3910,7080,1.0,0,0,5,9,1970,1940,1949,0,98112,47.6324,-122.289,3480,7370,3170,3890,208.33333333333334,0.18360655737704917,Cheap
20140924T000000,154500.0,3,1.0,890,9465,1.0,0,0,3,6,890,0,1957,0,98148,47.4388,-122.328,1590,9147,8575,7557,16.323296354992078,0.010426229508196721,Very Cheap
20140530T000000,425000.0,3,2.25,1820,8058,1.0,0,0,3,7,1260,560,1974,0,98034,47.7241,-122.168,1850,7384,6238,5534,52.742616033755276,0.04590163934426229,Very Cheap
20140721T000000,700000.0,4,2.5,2440,7491,2.0,0,0,4,10,2440,0,1988,0,98029,47.561,-122.019,2490,8580,5051,6090,93.4454678948071,0.08196721311475409,Very Cheap
20141121T000000,410500.0,2,1.0,1110,3943,1.0,0,0,5,6,740,370,1916,0,98109,47.6436,-122.352,1590,4311,2833,2721,104.10854679178291,0.044,Very Cheap
20140714T000000,432000.0,3,2.0,1870,7080,1.0,0,0,4,7,1210,660,1969,0,98034,47.7244,-122.179,1620,8000,5210,6380,61.016949152542374,0.046819672131147544,Very Cheap
20150414T000000,530000.0,3,1.5,1240,4080,1.5,0,0,3,8,1240,0,1914,0,98144,47.5745,-122.291,1420,4080,2840,2660,129.90196078431373,0.05967213114754098,Very Cheap
20140527T000000,465000.0,3,2.0,1560,8640,1.0,0,0,5,7,1560,0,1967,0,98034,47.7294,-122.186,1970,8625,7080,6655,53.81944444444444,0.051147540983606556,Very Cheap
20140923T000000,498688.0,3,2.5,1910,5600,2.0,0,0,3,8,1910,0,1989,0,98029,47.5752,-122.009,1800,4928,3690,3128,89.05142857142857,0.05556563934426229,Very Cheap
20150402T000000,573500.0,3,1.0,2200,21450,1.0,0,0,4,9,1600,600,1952,0,98166,47.4527,-122.372,1880,11250,19250,9370,26.736596736596738,0.06537704918032787,Very Cheap
20141015T000000,349900.0,4,2.75,2530,13474,2.0,0,0,4,8,2530,0,1994,0,98023,47.289,-122.344,2490,13140,10944,10650,25.96853198753154,0.036052459016393444,Very Cheap
20140618T000000,220000.0,3,1.0,1130,12519,1.0,0,0,3,7,1130,0,1958,0,98056,47.4965,-122.176,1460,12507,11389,11047,17.573288601325984,0.01901639344262295,Very Cheap
20140731T000000,260000.0,2,1.0,820,6771,1.0,0,0,4,6,820,0,1918,0,98106,47.52,-122.354,1000,4440,5951,3440,38.39905479249742,0.024262295081967214,Very Cheap
20140911T000000,290000.0,2,1.0,960,4000,1.0,0,0,3,6,960,0,1918,0,98118,47.5554,-122.267,1210,4000,3040,2790,72.5,0.02819672131147541,Very Cheap
20150402T000000,615000.0,4,1.5,1980,3240,1.5,0,0,4,8,1780,200,1930,0,98144,47.584,-122.294,2250,4000,1260,1750,189.8148148148148,0.07081967213114754,Very Cheap
20141022T000000,730000.0,4,3.5,3370,5638,2.0,0,0,3,10,2250,1120,2001,0,98034,47.7196,-122.223,3080,7200,2268,4120,129.47853848882582,0.0859016393442623,Very Cheap
20150112T000000,1950000.0,4,3.25,7420,167869,2.0,0,3,3,12,7420,0,2002,0,98045,47.4548,-121.764,5610,169549,160449,163939,11.616200727948579,0.2459016393442623,Cheap
20140521T000000,332500.0,3,2.25,1800,10500,2.0,0,0,3,7,1800,0,1995,0,98038,47.3879,-122.032,1870,8555,8700,6685,31.666666666666668,0.033770491803278686,Very Cheap
20141224T000000,650000.0,5,3.5,3990,10120,2.0,0,0,3,9,2820,1170,1990,0,98011,47.741,-122.208,2750,9622,6130,6872,64.2292490118577,0.07540983606557378,Very Cheap
20140829T000000,1400000.0,4,2.5,4070,7800,3.0,0,0,4,8,3390,680,2002,0,98115,47.6838,-122.327,2020,6760,3730,4740,179.48717948717947,0.1737704918032787,Cheap
20150513T000000,465000.0,4,1.75,1640,7194,1.5,0,0,4,7,1480,160,1915,0,98011,47.7649,-122.205,1440,9405,5554,7965,64.6371976647206,0.051147540983606556,Very Cheap
20140722T000000,690000.0,4,3.25,3730,11820,2.0,0,0,3,10,2460,1270,1990,0,98029,47.5775,-122.019,3680,10667,8090,6987,58.3756345177665,0.08065573770491803,Very Cheap
20140711T000000,289900.0,3,1.75,1220,7004,1.0,0,0,5,7,1220,0,1966,0,98058,47.4492,-122.157,1640,7210,5784,5570,41.3906339234723,0.02818360655737705,Very Cheap
20141218T000000,1620000.0,3,3.5,3490,4000,2.0,0,0,3,9,2570,920,2009,0,98112,47.6385,-122.281,1880,4000,510,2120,405.0,0.20262295081967213,Cheap
20150422T000000,339950.0,3,2.5,1730,4286,2.0,0,0,3,7,1730,0,1999,0,98148,47.432,-122.329,1780,4343,2556,2563,79.31637890807279,0.03474754098360656,Very Cheap
20150423T000000,367999.0,4,2.75,3430,8000,1.5,0,0,4,8,3430,0,1972,0,98023,47.3183,-122.382,2090,8000,4570,5910,45.999875,0.03842609836065574,Very Cheap
20150218T000000,380000.0,4,2.5,2320,10079,2.0,0,0,3,7,2320,0,1994,0,98038,47.3828,-122.026,2010,7438,7759,5428,37.702152991368195,0.04,Very Cheap
20140625T000000,440000.0,3,1.75,2030,17100,1.0,0,0,4,7,2030,0,1953,0,98166,47.451,-122.365,1950,14400,15070,12450,25.730994152046783,0.04786885245901639,Very Cheap
20140521T000000,975000.0,5,4.0,4850,36450,2.0,0,0,3,10,4850,0,1977,0,98005,47.6426,-122.158,3850,35325,31600,31475,26.74897119341564,0.1180327868852459,Cheap
20140805T000000,309500.0,3,1.5,1340,13560,1.0,0,0,3,7,1340,0,1968,0,98028,47.741,-122.234,1540,15000,12220,13460,22.82448377581121,0.03075409836065574,Very Cheap
20140723T000000,350000.0,3,1.0,1130,8201,1.0,0,0,5,6,1130,0,1948,0,98155,47.7359,-122.306,1180,8203,7071,7023,42.677722228996466,0.036065573770491806,Very Cheap
20150316T000000,215000.0,2,2.0,1180,2521,2.0,0,0,3,6,1180,0,2005,0,98038,47.3487,-122.021,1310,3003,1341,1693,85.2836176120587,0.018360655737704918,Very Cheap
20140826T000000,254000.0,2,1.0,910,6000,1.0,0,0,3,6,910,0,1943,0,98118,47.5253,-122.266,1460,5800,5090,4340,42.333333333333336,0.023475409836065574,Very Cheap
20150420T000000,567000.0,3,1.75,1630,4275,1.5,0,3,3,7,1630,0,1908,0,98115,47.6851,-122.322,1800,4275,2645,2475,132.6315789473684,0.06452459016393443,Very Cheap
20140529T000000,402000.0,2,1.0,710,1173,2.0,0,0,4,7,710,0,1943,0,98102,47.6412,-122.329,1370,1173,463,-197,342.71099744245527,0.04288524590163934,Very Cheap
20141120T000000,365000.0,4,1.0,1520,80150,1.0,0,0,2,5,1520,0,1948,0,98045,47.4742,-121.769,1740,84506,78630,82766,4.553961322520275,0.0380327868852459,Very Cheap
20140502T000000,625000.0,4,2.5,2820,8408,2.0,0,0,3,9,2820,0,2014,0,98155,47.7538,-122.325,1300,8408,5588,7108,74.33396764985729,0.07213114754098361,Very Cheap
20150423T000000,432000.0,4,1.75,1970,5160,1.5,0,0,3,7,1970,0,1942,0,98126,47.534,-122.373,1230,4920,3190,3690,83.72093023255815,0.046819672131147544,Very Cheap
20140801T000000,335500.0,5,3.0,2240,19090,1.0,0,0,4,8,1700,540,1968,0,98058,47.4416,-122.149,2280,20000,16850,17720,17.57464641173389,0.03416393442622951,Very Cheap
20140806T000000,672500.0,2,1.75,1860,5940,1.0,0,2,5,8,1020,840,1956,0,98116,47.5751,-122.407,2130,5940,4080,3810,113.21548821548822,0.07836065573770491,Very Cheap
20140722T000000,336000.0,4,1.0,1780,4310,1.5,0,0,5,6,1780,0,1919,0,98118,47.5486,-122.278,1460,4310,2530,2850,77.95823665893272,0.03422950819672131,Very Cheap
20141124T000000,294400.0,4,2.5,1788,10183,2.0,0,0,4,7,1788,0,1990,0,98002,47.2883,-122.218,1700,6600,8395,4900,28.91092998134145,0.02877377049180328,Very Cheap
20150420T000000,541900.0,3,2.5,1880,3054,2.0,0,0,3,8,1880,0,1988,0,98007,47.6091,-122.147,1840,3815,1174,1975,177.43942370661426,0.0612327868852459,Very Cheap
20141217T000000,505000.0,3,1.75,2300,11400,1.0,0,0,4,8,1520,780,1977,0,98052,47.6884,-122.128,2300,10140,9100,7840,44.29824561403509,0.05639344262295082,Very Cheap
20140605T000000,255000.0,3,2.5,1610,6176,2.0,0,0,3,7,1610,0,1994,0,98030,47.3657,-122.173,1680,7414,4566,5734,41.288860103626945,0.02360655737704918,Very Cheap
20150122T000000,435000.0,6,2.5,2270,11970,1.0,0,0,3,7,1470,800,1964,0,98011,47.7722,-122.204,2270,10640,9700,8370,36.340852130325814,0.04721311475409836,Very Cheap
20140508T000000,636000.0,2,1.75,1230,3600,1.5,0,0,5,7,1230,0,1925,0,98119,47.6423,-122.361,1210,4500,2370,3290,176.66666666666666,0.07357377049180328,Very Cheap
20140909T000000,655000.0,4,3.5,3420,33106,2.0,0,0,3,9,3420,0,2004,0,98010,47.3554,-121.986,3420,36590,29686,33170,19.784933244729054,0.0760655737704918,Very Cheap
20150318T000000,280500.0,3,1.5,1670,6988,1.0,0,0,3,7,1370,300,1953,0,98148,47.4283,-122.323,1090,7753,5318,6663,40.140240412135086,0.026950819672131147,Very Cheap
20150422T000000,520000.0,2,1.0,1120,6141,1.0,0,0,3,7,900,220,1946,0,98117,47.6924,-122.372,1500,7529,5021,6029,84.6767627422244,0.058360655737704915,Very Cheap
20140626T000000,354000.0,4,2.5,2580,5476,2.0,0,0,3,8,2580,0,2005,0,98031,47.4042,-122.205,2900,5476,2896,2576,64.64572680788898,0.03659016393442623,Very Cheap
20140822T000000,810000.0,5,2.75,3847,17654,1.0,0,2,5,9,2299,1548,1975,0,98003,47.3379,-122.322,2690,15344,13807,12654,45.881953098447944,0.09639344262295083,Very Cheap
20140502T000000,400000.0,4,2.5,3630,42884,1.5,0,0,3,9,2300,1330,1979,0,98092,47.2617,-122.19,2830,80148,39254,77318,9.327488107452663,0.04262295081967213,Very Cheap
20150107T000000,879900.0,4,2.75,3580,12000,1.0,0,0,3,10,1840,1740,1979,0,98074,47.6319,-122.05,2910,12428,8420,9518,73.325,0.10556065573770491,Cheap
20150320T000000,1288000.0,5,4.0,4050,11358,2.0,0,0,4,10,2780,1270,1980,0,98040,47.56,-122.225,3120,13555,7308,10435,113.40024652227505,0.15908196721311477,Cheap
20150402T000000,902500.0,3,3.5,3240,23522,2.0,0,0,3,10,2130,1110,1992,0,98010,47.3388,-122.033,3180,23273,20282,20093,38.368336025848144,0.10852459016393443,Cheap
20150513T000000,900000.0,3,1.75,1540,8400,1.5,0,0,3,7,1540,0,1902,0,98122,47.6187,-122.295,1330,4800,6860,3470,107.14285714285714,0.10819672131147541,Cheap
20140717T000000,419500.0,4,2.5,2550,7200,2.0,0,2,3,7,2550,0,2003,0,98056,47.4793,-122.18,2560,5715,4650,3155,58.263888888888886,0.04518032786885246,Very Cheap
20141103T000000,685000.0,4,2.0,2340,6000,1.0,0,0,5,8,1270,1070,1953,0,98199,47.6495,-122.401,1600,6000,3660,4400,114.16666666666667,0.08,Very Cheap
20141107T000000,429950.0,4,2.5,2320,4524,2.0,0,0,3,8,2320,0,2004,0,98059,47.4798,-122.136,2330,4524,2204,2194,95.03757736516357,0.04655081967213115,Very Cheap
20150423T000000,464950.0,4,2.5,1640,6000,2.0,0,0,3,7,1640,0,2011,0,98106,47.559,-122.365,1640,4800,4360,3160,77.49166666666666,0.051140983606557375,Very Cheap
20141010T000000,239900.0,2,1.0,910,9000,1.0,0,0,4,6,910,0,1983,0,98045,47.4463,-121.771,1410,9440,8090,8030,26.655555555555555,0.02162622950819672,Very Cheap
20150218T000000,406250.0,4,3.25,2550,11524,2.0,0,0,3,8,2550,0,1990,0,98019,47.7324,-121.963,2370,14001,8974,11631,35.25251648733079,0.04344262295081967,Very Cheap
20141027T000000,447000.0,4,2.5,2660,8027,2.0,0,0,3,8,2660,0,1997,0,98045,47.4831,-121.781,2480,8095,5367,5615,55.68705618537436,0.04878688524590164,Very Cheap
20140605T000000,466800.0,3,2.5,1480,14250,2.0,0,0,3,7,1480,0,1996,0,98033,47.6595,-122.186,1660,14250,12770,12590,32.757894736842104,0.05138360655737705,Very Cheap
20140917T000000,674000.0,4,2.5,2810,11560,1.0,0,0,5,7,1740,1070,1962,0,98008,47.5846,-122.12,1970,11560,8750,9590,58.30449826989619,0.07855737704918032,Very Cheap
20141126T000000,525000.0,1,1.0,830,3200,1.0,0,0,3,7,830,0,1924,0,98103,47.6557,-122.348,1350,2512,2370,1162,164.0625,0.05901639344262295,Very Cheap
20150501T000000,674950.0,3,2.75,3510,92347,2.0,0,0,3,10,3510,0,1990,0,98038,47.3735,-122.018,2970,37070,88837,34100,7.308845983085536,0.07868196721311475,Very Cheap
20150429T000000,374900.0,3,2.5,2480,4950,2.0,0,0,3,7,2480,0,2004,0,98058,47.4389,-122.116,2230,5298,2470,3068,75.73737373737374,0.03933114754098361,Very Cheap
20141006T000000,1443920.0,4,3.0,3720,5000,2.5,0,0,5,9,2720,1000,1905,0,98102,47.6282,-122.322,2610,5000,1280,2390,288.784,0.17953049180327868,Cheap
20141205T000000,559500.0,3,2.25,2150,9250,2.0,0,0,3,8,2150,0,1984,0,98052,47.7179,-122.113,2240,9266,7100,7026,60.486486486486484,0.06354098360655738,Very Cheap
20140516T000000,522500.0,3,2.5,2370,7875,2.0,0,0,3,9,2370,0,2003,0,98065,47.5427,-121.863,2660,7752,5505,5092,66.34920634920636,0.05868852459016394,Very Cheap
20150427T000000,1130000.0,5,2.5,4310,28008,2.0,0,0,3,10,4310,0,1988,0,98053,47.6662,-122.056,3170,28559,23698,25389,40.3456155384176,0.13836065573770492,Cheap
20140612T000000,498500.0,5,2.75,2990,7420,2.0,0,0,3,8,2990,0,1996,0,98059,47.4944,-122.162,2290,7678,4430,5388,67.18328840970351,0.055540983606557376,Very Cheap
20140825T000000,571000.0,4,1.0,1350,4000,1.5,0,0,3,8,1350,0,1930,0,98117,47.6885,-122.386,1520,4000,2650,2480,142.75,0.06504918032786886,Very Cheap
20140514T000000,543000.0,2,2.0,2370,217800,1.5,0,0,3,7,1600,770,1992,0,98027,47.5007,-122.088,2370,157687,215430,155317,2.4931129476584024,0.06137704918032787,Very Cheap
20150304T000000,271920.0,3,2.0,1410,10248,1.0,0,0,3,7,1410,0,1985,0,98001,47.3315,-122.265,2090,9414,8838,7324,26.533957845433257,0.025825573770491803,Very Cheap
20141208T000000,104950.0,2,1.0,1170,8254,1.0,0,0,2,6,1170,0,1949,0,98146,47.497,-122.346,1820,8922,7084,7102,12.71504724981827,0.003927868852459017,Very Cheap
20140929T000000,485500.0,4,2.5,1800,4500,2.0,0,0,3,8,1800,0,1999,0,98075,47.5998,-122.014,1800,4500,2700,2700,107.88888888888889,0.05383606557377049,Very Cheap
20140528T000000,1210000.0,4,2.75,3650,6982,2.0,0,2,4,9,2530,1120,1951,2003,98115,47.6756,-122.275,3140,7894,3332,4754,173.30277857347465,0.14885245901639343,Cheap
20150122T000000,260250.0,3,1.75,1490,8357,1.0,0,0,4,7,1490,0,1993,0,98038,47.3473,-122.037,1490,7376,6867,5886,31.141557975350008,0.024295081967213115,Very Cheap
20150413T000000,875909.0,4,2.5,3610,13292,2.0,0,0,3,10,3610,0,1996,0,98075,47.5868,-121.974,3000,10776,9682,7776,65.8974571170629,0.10503724590163935,Cheap
20140606T000000,455000.0,4,1.75,2050,94525,1.0,0,0,4,7,1250,800,1959,0,98058,47.4492,-122.084,2270,47480,92475,45210,4.813541391166358,0.049836065573770495,Very Cheap
20140520T000000,309000.0,3,1.0,1092,7500,1.5,0,0,3,6,1092,0,1918,0,98106,47.5321,-122.354,930,4000,6408,3070,41.2,0.030688524590163933,Very Cheap
20140709T000000,229000.0,4,2.25,2010,7688,1.0,0,0,3,8,1170,840,1979,0,98023,47.3086,-122.396,1990,7688,5678,5698,29.786680541103017,0.02019672131147541,Very Cheap
20150429T000000,250000.0,3,2.0,1680,7900,2.0,0,0,4,7,1680,0,1953,0,98003,47.3255,-122.305,1250,15600,6220,14350,31.645569620253166,0.022950819672131147,Very Cheap
20140528T000000,600000.0,4,2.0,2510,38141,1.0,0,0,3,9,2510,0,1960,0,98034,47.7219,-122.258,3180,11760,35631,8580,15.731103012506226,0.06885245901639345,Very Cheap
20140508T000000,535000.0,4,2.5,2280,65836,2.0,0,0,3,8,2280,0,2004,0,98077,47.7237,-122.076,2300,97574,63556,95274,8.126253113797922,0.06032786885245902,Very Cheap
20141117T000000,571000.0,3,2.5,2510,5186,2.0,0,0,3,7,2510,0,2001,0,98053,47.6895,-122.041,2530,5186,2676,2656,110.10412649440802,0.06504918032786886,Very Cheap
20140505T000000,1030000.0,5,2.75,3190,16920,1.0,0,3,3,9,1690,1500,1976,0,98006,47.5641,-122.16,3100,13100,13730,10000,60.874704491725765,0.12524590163934426,Cheap
20140624T000000,600000.0,4,3.25,4690,14930,2.0,0,2,3,10,3680,1010,1995,0,98155,47.7718,-122.283,2910,13320,10240,10410,40.187541862022776,0.06885245901639345,Very Cheap
20150428T000000,469500.0,3,2.25,1850,12000,1.0,0,0,4,7,1300,550,1977,0,98072,47.7408,-122.101,1580,12616,10150,11036,39.125,0.051737704918032784,Very Cheap
20150402T000000,1150000.0,4,3.0,4160,13170,2.0,0,0,3,11,3040,1120,2001,0,98059,47.5182,-122.149,3780,13148,9010,9368,87.31966590736522,0.14098360655737704,Cheap
20140825T000000,785000.0,4,1.5,2220,4000,1.5,0,0,3,8,1970,250,1925,0,98105,47.6564,-122.325,1984,4000,1780,2016,196.25,0.09311475409836066,Very Cheap
20150428T000000,872750.0,3,2.5,2870,13695,2.0,0,0,3,10,2870,0,1991,0,98052,47.6944,-122.102,2840,8472,10825,5632,63.72763782402337,0.10462295081967213,Cheap
20140815T000000,900000.0,4,2.75,3950,10214,1.0,0,3,3,10,2050,1900,1955,0,98117,47.6969,-122.384,3130,8608,6264,5478,88.11435284903074,0.10819672131147541,Cheap
20140717T000000,350000.0,2,1.75,1740,6620,1.5,0,0,3,8,1740,0,2002,0,98065,47.526,-121.828,1560,5400,4880,3840,52.87009063444109,0.036065573770491806,Very Cheap
20150410T000000,2575000.0,5,3.0,4780,20440,1.0,0,0,4,10,3660,1120,1975,0,98039,47.6242,-122.239,4660,20440,15660,15780,125.97847358121331,0.32786885245901637,Medium
20140729T000000,940000.0,4,2.5,3160,39960,1.0,0,0,3,10,3160,0,1980,0,98005,47.6418,-122.157,3900,36444,36800,32544,23.523523523523522,0.11344262295081967,Cheap
20140715T000000,185000.0,5,1.75,1990,27810,1.0,0,0,3,7,1990,0,1955,0,98023,47.3325,-122.35,2240,20000,25820,17760,6.6522833513124775,0.014426229508196721,Very Cheap
20140624T000000,850000.0,4,3.5,3920,37122,2.0,0,0,3,10,3920,0,1996,0,98053,47.6316,-121.988,2550,32647,33202,30097,22.897473196487258,0.10163934426229508,Cheap
20140917T000000,201000.0,3,1.0,960,15273,1.0,0,0,4,7,960,0,1963,0,98022,47.238,-122.039,1930,51400,14313,49470,13.160479277155765,0.016524590163934427,Very Cheap
20150107T000000,499000.0,2,1.5,1540,6549,2.0,0,0,3,7,1540,0,1980,0,98133,47.7189,-122.353,1470,6552,5009,5082,76.19483890670331,0.05560655737704918,Very Cheap
20150408T000000,315000.0,4,2.5,1970,5190,2.0,0,0,3,7,1970,0,2002,0,98059,47.515,-122.164,1840,5564,3220,3724,60.69364161849711,0.031475409836065574,Very Cheap
20140806T000000,509950.0,3,2.5,1880,4668,2.0,0,0,3,8,1880,0,1993,0,98029,47.5666,-121.999,2060,4668,2788,2608,109.24378748928878,0.057042622950819674,Very Cheap
20150225T000000,286300.0,3,2.75,2000,6405,1.0,0,0,3,8,1260,740,1964,0,98178,47.5066,-122.259,2130,6510,4405,4380,44.69945355191257,0.027711475409836067,Very Cheap
20140728T000000,590000.0,3,2.5,1990,8325,2.0,0,0,4,8,1310,680,1997,0,98034,47.705,-122.201,2450,10606,6335,8156,70.87087087087087,0.06754098360655737,Very Cheap
20140904T000000,325000.0,4,1.0,1400,9384,1.5,0,0,4,6,1400,0,1948,0,98106,47.5166,-122.361,1600,8432,7984,6832,34.633418584825236,0.03278688524590164,Very Cheap
20140822T000000,625000.0,4,2.5,3190,27806,2.0,0,0,3,9,3190,0,1997,0,98010,47.3425,-122.03,2810,28619,24616,25809,22.477163202186578,0.07213114754098361,Very Cheap
20141113T000000,378000.0,3,1.5,1000,6914,1.0,0,0,3,7,1000,0,1947,0,98125,47.7144,-122.319,1000,6947,5914,5947,54.671680647960656,0.03973770491803279,Very Cheap
20140618T000000,239950.0,3,1.75,1670,6900,1.0,0,0,3,7,1170,500,1978,0,98023,47.2975,-122.38,1740,7000,5230,5260,34.77536231884058,0.021632786885245902,Very Cheap
20141111T000000,550000.0,4,2.0,2100,4500,1.0,0,0,5,7,1060,1040,1924,0,98105,47.6699,-122.317,1920,3900,2400,1980,122.22222222222223,0.06229508196721312,Very Cheap
20150422T000000,325000.0,2,1.0,1010,6180,1.0,0,0,3,6,1010,0,1903,0,98118,47.5532,-122.28,1560,6180,5170,4620,52.58899676375405,0.03278688524590164,Very Cheap
20140609T000000,831000.0,4,2.5,2030,3905,1.5,0,0,4,7,1630,400,1926,0,98103,47.6547,-122.34,2000,3905,1875,1905,212.80409731113957,0.09914754098360656,Very Cheap
20141212T000000,249000.0,3,1.0,1090,10296,1.0,0,0,4,6,1090,0,1950,0,98028,47.7743,-122.26,1910,10296,9206,8386,24.184149184149184,0.02281967213114754,Very Cheap
20150126T000000,484000.0,4,1.75,2440,16730,1.0,0,0,3,7,1390,1050,1976,0,98072,47.7406,-122.11,1390,11600,14290,10210,28.93006575014943,0.05363934426229508,Very Cheap
20141121T000000,395000.0,4,3.0,2500,6278,2.0,0,0,3,9,2500,0,2002,0,98092,47.3325,-122.168,2700,7200,3778,4500,62.918126791971964,0.0419672131147541,Very Cheap
20141119T000000,839900.0,4,2.5,3420,7462,2.0,0,0,3,9,3420,0,2002,0,98074,47.6388,-122.064,3080,8031,4042,4951,112.55695523988207,0.10031475409836066,Cheap
20141113T000000,760000.0,4,2.5,2850,11000,2.0,0,0,3,8,2850,0,1998,0,98052,47.6759,-122.161,1720,11000,8150,9280,69.0909090909091,0.0898360655737705,Very Cheap
20150512T000000,750000.0,4,1.5,2030,3300,1.5,0,0,4,8,1530,500,1927,0,98116,47.5855,-122.383,2610,5400,1270,2790,227.27272727272728,0.08852459016393442,Very Cheap
20150408T000000,3000000.0,5,3.75,4590,11265,2.0,0,0,4,11,3450,1140,1927,0,98112,47.6389,-122.288,3870,8996,6675,5126,266.31158455392807,0.3836065573770492,Medium
20140915T000000,440000.0,3,2.5,2230,5800,2.0,0,0,3,7,2230,0,2004,0,98065,47.5308,-121.847,2230,6088,3570,3858,75.86206896551724,0.04786885245901639,Very Cheap
20141203T000000,501000.0,2,1.75,1810,7523,1.0,0,0,3,8,1170,640,1962,1980,98027,47.5695,-122.087,2090,7523,5713,5433,66.59577296291373,0.05586885245901639,Very Cheap
20140924T000000,739000.0,6,4.5,4000,7500,2.0,0,0,3,7,4000,0,1978,0,98122,47.6146,-122.306,1380,6298,3500,4918,98.53333333333333,0.08708196721311476,Very Cheap
20140908T000000,685650.0,3,1.75,1490,16200,1.0,0,0,5,8,1490,0,1958,0,98005,47.5919,-122.175,2070,16200,14710,14130,42.324074074074076,0.08008524590163935,Very Cheap
20140625T000000,1005000.0,4,4.5,4225,284011,2.0,0,0,4,11,4225,0,1985,0,98074,47.6118,-122.024,2870,14576,279786,11706,3.538595336096137,0.1219672131147541,Cheap
20140916T000000,980000.0,4,1.75,2120,4000,1.5,0,0,4,8,1920,200,1929,0,98105,47.6601,-122.275,2300,4000,1880,1700,245.0,0.11868852459016394,Cheap
20140930T000000,275000.0,3,1.5,1030,7184,1.0,0,0,4,7,1030,0,1968,0,98056,47.5069,-122.189,1330,7262,6154,5932,38.279510022271715,0.02622950819672131,Very Cheap
20140519T000000,319950.0,4,1.75,2310,8045,1.0,0,0,4,7,1650,660,1976,0,98058,47.4569,-122.165,1790,8086,5735,6296,39.770043505282786,0.03212459016393442,Very Cheap
20150320T000000,448500.0,3,2.25,1830,7943,2.0,0,0,3,8,1830,0,1985,0,98028,47.7466,-122.249,2100,8070,6113,5970,56.46481178396072,0.048983606557377046,Very Cheap
20140603T000000,437000.0,5,2.0,2120,137565,1.5,0,0,3,7,2120,0,1913,0,98070,47.4558,-122.507,2120,157123,135445,155003,3.176680114854796,0.047475409836065574,Very Cheap
20141107T000000,330000.0,4,1.5,2500,9448,1.0,0,0,4,7,1250,1250,1966,0,98106,47.5212,-122.339,1640,9490,6948,7850,34.92802709568163,0.03344262295081967,Very Cheap
20141217T000000,365000.0,3,2.5,2470,7700,2.0,0,0,4,8,2470,0,1990,0,98031,47.4096,-122.17,2400,7700,5230,5300,47.4025974025974,0.0380327868852459,Very Cheap
20141112T000000,329000.0,2,1.0,940,7700,1.0,0,0,4,6,940,0,1916,0,98133,47.7067,-122.354,1290,7375,6760,6085,42.72727272727273,0.03331147540983607,Very Cheap
20140620T000000,681500.0,5,2.75,3260,11700,1.0,0,0,3,8,1630,1630,1964,0,98008,47.6169,-122.104,2860,11700,8440,8840,58.24786324786325,0.07954098360655738,Very Cheap
20140509T000000,566000.0,3,2.25,1660,10140,1.0,0,0,4,8,1370,290,1980,0,98052,47.6889,-122.128,2100,10125,8480,8025,55.81854043392505,0.06439344262295082,Very Cheap
20141020T000000,897500.0,4,3.0,4370,217882,2.0,0,0,3,10,4370,0,1984,0,98053,47.6573,-122.034,2430,35096,213512,32666,4.119202136936507,0.1078688524590164,Cheap
20141229T000000,738000.0,3,2.5,2620,9112,2.0,0,0,3,9,2620,0,1995,0,98052,47.6972,-122.116,2620,9067,6492,6447,80.99209833187007,0.08695081967213114,Very Cheap
20150420T000000,185000.0,3,1.75,1500,7800,1.0,0,0,3,7,1500,0,1968,0,98092,47.3141,-122.192,1490,7800,6300,6310,23.71794871794872,0.014426229508196721,Very Cheap
20150304T000000,445000.0,2,1.0,910,7200,1.0,0,1,4,7,830,80,1936,0,98136,47.5145,-122.39,1700,7200,6290,5500,61.80555555555556,0.04852459016393443,Very Cheap
20150325T000000,175000.0,3,1.75,1430,4920,1.0,0,0,2,6,1430,0,1957,0,98118,47.5388,-122.275,1550,5646,3490,4096,35.56910569105691,0.013114754098360656,Very Cheap
20141121T000000,315000.0,2,1.0,900,8556,1.0,0,0,3,6,760,140,1941,0,98136,47.5148,-122.386,1500,8556,7656,7056,36.81626928471248,0.031475409836065574,Very Cheap
20140624T000000,445000.0,4,1.75,1250,7400,1.0,0,0,5,6,1250,0,1959,0,98008,47.62,-122.12,990,7600,6150,6610,60.13513513513514,0.04852459016393443,Very Cheap
20140805T000000,1400000.0,5,3.0,3850,14990,1.0,0,0,4,9,2290,1560,1964,0,98004,47.6425,-122.218,3010,15001,11140,11991,93.3955970647098,0.1737704918032787,Cheap
20141126T000000,832500.0,4,2.5,3450,35100,2.0,0,0,3,10,3450,0,1987,0,98052,47.7302,-122.106,3110,35894,31650,32784,23.71794871794872,0.09934426229508196,Very Cheap
20140717T000000,771150.0,4,3.5,3950,12320,2.0,0,0,3,10,3950,0,2001,0,98065,47.5414,-121.869,3920,11086,8370,7166,62.59334415584416,0.09129836065573771,Very Cheap
20140513T000000,225000.0,4,1.5,1950,12559,1.5,0,0,3,6,1950,0,1939,0,98188,47.4364,-122.282,1950,9178,10609,7228,17.915439127319054,0.019672131147540985,Very Cheap
20140923T000000,389950.0,3,2.5,1700,6396,2.0,0,0,3,7,1700,0,2003,0,98065,47.5333,-121.87,1700,4444,4696,2744,60.96779237023139,0.04130491803278689,Very Cheap
20140804T000000,435000.0,3,2.5,2370,6082,2.0,0,0,3,7,2370,0,2004,0,98065,47.5288,-121.846,2690,6152,3712,3462,71.52252548503782,0.04721311475409836,Very Cheap
20150316T000000,845000.0,3,1.75,1600,2538,2.0,0,0,3,7,1600,0,1929,0,98102,47.6447,-122.327,1660,1750,938,90,332.93932230102445,0.10098360655737705,Cheap
20140725T000000,1300000.0,4,1.75,4060,5500,2.0,0,0,5,9,2660,1400,1924,0,98102,47.6437,-122.321,3320,5500,1440,2180,236.36363636363637,0.16065573770491803,Cheap
20140714T000000,350000.0,3,2.25,1322,1796,2.0,0,0,3,8,1087,235,2005,0,98144,47.5976,-122.298,1690,2025,474,335,194.87750556792872,0.036065573770491806,Very Cheap
20140708T000000,250000.0,3,1.75,1140,10400,1.0,0,0,4,7,1140,0,1983,0,98003,47.2598,-122.311,1280,9800,9260,8520,24.03846153846154,0.022950819672131147,Very Cheap
20150430T000000,370000.0,2,1.5,1280,2096,2.0,0,0,3,7,1080,200,2007,0,98144,47.5872,-122.308,1340,7452,816,6112,176.5267175572519,0.038688524590163934,Very Cheap
20140729T000000,750000.0,4,2.5,3080,4553,2.5,0,0,3,8,3080,0,2008,0,98052,47.7066,-122.112,2750,4929,1473,2179,164.726553920492,0.08852459016393442,Very Cheap
20140825T000000,439950.0,2,1.75,1210,3000,1.0,0,0,5,7,910,300,1906,0,98117,47.6789,-122.365,1260,3000,1790,1740,146.65,0.04786229508196721,Very Cheap
20141103T000000,395000.0,4,1.75,1950,10219,1.0,0,0,3,7,1950,0,1962,0,98133,47.7492,-122.336,1500,9099,8269,7599,38.653488599667284,0.0419672131147541,Very Cheap
20140807T000000,375000.0,4,1.0,1450,6820,1.5,0,0,3,6,1450,0,1947,0,98133,47.7061,-122.347,1450,6820,5370,5370,54.98533724340176,0.03934426229508197,Very Cheap
20140515T000000,263000.0,3,2.25,1590,7748,2.0,0,0,4,7,1590,0,1991,0,98003,47.2857,-122.3,1590,7606,6158,6016,33.9442436757873,0.024655737704918034,Very Cheap
20141208T000000,185000.0,3,1.0,1240,9198,1.5,0,0,4,7,1240,0,1959,0,98032,47.37,-122.297,1170,8970,7958,7800,20.113068058273537,0.014426229508196721,Very Cheap
20150225T000000,500000.0,3,1.0,1440,54315,1.0,0,0,3,7,790,650,1974,0,98075,47.591,-122.01,2690,40518,52875,37828,9.205560158335635,0.05573770491803279,Very Cheap
20140926T000000,920000.0,4,2.5,3470,10045,2.0,0,0,3,10,3470,0,1993,0,98027,47.554,-122.095,4370,12359,6575,7989,91.58785465405674,0.11081967213114755,Cheap
20141024T000000,936000.0,7,3.75,5100,21802,2.0,0,0,3,10,3640,1460,2001,0,98075,47.595,-122.04,3350,10005,16702,6655,42.93184111549399,0.11291803278688524,Cheap
20140508T000000,1500000.0,3,1.75,2430,12757,1.0,0,2,4,8,1340,1090,1952,0,98004,47.6201,-122.209,2930,12450,10327,9520,117.58250372344595,0.18688524590163935,Cheap
20141027T000000,1100000.0,3,2.25,2420,7200,1.0,0,0,3,8,1420,1000,1948,0,98115,47.6867,-122.275,2500,7200,4780,4700,152.77777777777777,0.13442622950819672,Cheap
20150102T000000,247000.0,3,2.5,1510,10875,1.0,0,0,3,7,1150,360,1990,0,98003,47.3482,-122.3,1810,9916,9365,8106,22.71264367816092,0.022557377049180326,Very Cheap
20150425T000000,289500.0,3,1.0,1200,5525,1.0,0,0,2,7,1200,0,1947,0,98115,47.6981,-122.325,1580,7200,4325,5620,52.39819004524887,0.028131147540983607,Very Cheap
20140602T000000,432500.0,3,2.5,2240,6396,2.0,0,0,3,7,2240,0,2002,0,98065,47.5356,-121.881,2610,5128,4156,2518,67.62038774233896,0.046885245901639346,Very Cheap
20150327T000000,680000.0,3,1.75,1870,4320,1.0,0,0,4,7,970,900,1920,0,98103,47.6663,-122.357,1810,3900,2450,2090,157.40740740740742,0.07934426229508197,Very Cheap
20140528T000000,589000.0,3,1.0,1110,6000,1.5,0,0,5,7,1110,0,1932,0,98199,47.6496,-122.403,1420,6000,4890,4580,98.16666666666667,0.06740983606557377,Very Cheap
20141223T000000,756450.0,4,2.0,3210,8400,1.5,0,0,5,7,2040,1170,1914,0,98136,47.5322,-122.391,2540,6458,5190,3918,90.05357142857143,0.08937049180327869,Very Cheap
20150407T000000,536650.0,3,1.75,2090,8910,1.0,0,0,3,8,1230,860,1975,0,98034,47.7149,-122.222,2310,10695,6820,8385,60.230078563411894,0.06054426229508197,Very Cheap
20140702T000000,540000.0,3,2.25,1320,1800,2.0,0,0,3,7,1320,0,1994,0,98122,47.6081,-122.289,2010,4500,480,2490,300.0,0.06098360655737705,Very Cheap
20150428T000000,385000.0,3,1.75,1340,3850,1.0,0,0,4,7,1340,0,1960,0,98125,47.7134,-122.292,1540,7645,2510,6105,100.0,0.04065573770491803,Very Cheap
20140902T000000,485000.0,3,1.0,1020,6120,1.0,0,0,3,7,1020,0,1941,0,98115,47.6787,-122.285,2370,6695,5100,4325,79.2483660130719,0.05377049180327869,Very Cheap
20140926T000000,240000.0,3,2.0,1220,17652,1.0,0,0,4,7,1220,0,1980,0,98059,47.4712,-122.1,1990,17652,16432,15662,13.596193065941536,0.021639344262295083,Very Cheap
20150326T000000,415500.0,3,2.0,1220,17652,1.0,0,0,4,7,1220,0,1980,0,98059,47.4712,-122.1,1990,17652,16432,15662,23.538409245411284,0.044655737704918035,Very Cheap
20141113T000000,550000.0,3,2.0,1390,2688,1.5,0,0,5,7,1390,0,1915,0,98117,47.6783,-122.366,1440,2900,1298,1460,204.61309523809524,0.06229508196721312,Very Cheap
20140929T000000,1260000.0,4,2.0,2970,5400,2.5,0,0,4,9,2970,0,1900,0,98112,47.6235,-122.309,2500,5040,2430,2540,233.33333333333334,0.15540983606557376,Cheap
20140715T000000,430000.0,2,2.0,1440,213008,2.0,0,0,4,7,1440,0,1990,0,98070,47.3604,-122.457,1630,161172,211568,159542,2.0187035228723804,0.04655737704918033,Very Cheap
20141112T000000,415000.0,2,1.75,1550,4257,1.0,0,3,3,7,830,720,1953,0,98136,47.5274,-122.384,1920,5100,2707,3180,97.48649283533004,0.04459016393442623,Very Cheap
20150128T000000,365000.0,4,2.5,1904,8200,2.0,0,0,5,7,1904,0,1999,0,98010,47.3107,-122.001,1560,12426,6296,10866,44.51219512195122,0.0380327868852459,Very Cheap
20141210T000000,257000.0,4,1.5,1400,8500,2.0,0,0,3,7,1400,0,1975,0,98001,47.3314,-122.275,1580,7650,7100,6070,30.235294117647058,0.023868852459016394,Very Cheap
20140624T000000,420000.0,3,2.5,2140,3821,2.0,0,0,3,8,2140,0,2005,0,98029,47.5541,-121.995,2860,3841,1681,981,109.91886940591468,0.04524590163934426,Very Cheap
20140916T000000,338995.0,3,1.75,1320,9450,1.0,0,0,5,7,1320,0,1943,0,98166,47.4557,-122.348,1320,8315,8130,6995,35.87248677248677,0.034622295081967215,Very Cheap
20150410T000000,615000.0,3,1.75,2620,8280,1.0,0,0,4,7,1330,1290,1948,0,98177,47.7235,-122.359,1530,8160,5660,6630,74.27536231884058,0.07081967213114754,Very Cheap
20141212T000000,312500.0,4,0.5,2300,5570,2.0,0,0,3,8,2300,0,1996,0,98092,47.3285,-122.168,1820,6371,3270,4551,56.104129263913826,0.03114754098360656,Very Cheap
20140506T000000,513000.0,4,2.5,2000,5684,2.0,0,0,3,8,2000,0,1996,0,98028,47.7443,-122.22,2210,7066,3684,4856,90.2533427163969,0.05744262295081967,Very Cheap
20150127T000000,857500.0,4,2.75,2960,5040,2.0,0,3,3,9,2210,750,1952,1993,98116,47.5747,-122.408,2270,5500,2080,3230,170.13888888888889,0.10262295081967213,Cheap
20141230T000000,1060000.0,3,2.75,2700,22343,1.5,0,1,4,10,2700,0,1977,0,98040,47.5706,-122.209,3390,15682,19643,12292,47.44215190439959,0.12918032786885245,Cheap
20140722T000000,585000.0,3,1.75,1740,9500,1.0,0,3,4,8,1150,590,1958,0,98146,47.4919,-122.365,2110,9450,7760,7340,61.578947368421055,0.06688524590163934,Very Cheap
20141008T000000,350500.0,2,2.5,1770,4950,1.0,0,0,3,7,1770,0,2003,0,98038,47.3497,-122.025,1770,4500,3180,2730,70.8080808080808,0.03613114754098361,Very Cheap
20141006T000000,215000.0,3,2.0,1290,9312,1.0,0,0,3,7,1290,0,1947,0,98168,47.4811,-122.325,1650,7300,8022,5650,23.08848797250859,0.018360655737704918,Very Cheap
20140617T000000,440000.0,4,2.0,1450,8400,1.5,0,0,4,7,1450,0,1962,0,98034,47.7285,-122.24,1450,7440,6950,5990,52.38095238095238,0.04786885245901639,Very Cheap
20150427T000000,270000.0,3,2.25,1420,7800,1.0,0,0,4,7,1130,290,1985,0,98042,47.3598,-122.157,1460,7800,6380,6340,34.61538461538461,0.025573770491803278,Very Cheap
20141023T000000,385000.0,3,0.75,1330,7020,1.0,0,0,5,7,1330,0,1924,0,98126,47.5377,-122.376,1410,5802,5690,4392,54.84330484330484,0.04065573770491803,Very Cheap
20141117T000000,688500.0,3,1.75,1760,4125,1.5,0,3,4,7,1760,0,1927,0,98103,47.6748,-122.352,1760,4000,2365,2240,166.9090909090909,0.08045901639344262,Very Cheap
20140519T000000,700000.0,3,1.75,2010,4905,1.0,0,0,5,7,1230,780,1912,0,98122,47.6105,-122.309,2210,1834,2895,-376,142.71151885830784,0.08196721311475409,Very Cheap
20140822T000000,585000.0,5,2.0,2560,14467,1.0,0,0,3,8,1280,1280,1960,0,98006,47.5547,-122.178,2200,10267,11907,8067,40.43685629363379,0.06688524590163934,Very Cheap
20150226T000000,401000.0,2,1.5,1260,2625,2.0,0,0,4,7,1260,0,1983,0,98052,47.6747,-122.151,1260,2625,1365,1365,152.76190476190476,0.04275409836065574,Very Cheap
20150306T000000,655000.0,4,2.25,2420,7725,1.0,0,0,4,8,1890,530,1972,0,98052,47.6287,-122.093,1740,7944,5305,6204,84.78964401294499,0.0760655737704918,Very Cheap
20140604T000000,317000.0,3,1.0,1010,5400,1.0,0,0,3,6,1010,0,1959,0,98144,47.5746,-122.293,960,5400,4390,4440,58.7037037037037,0.03173770491803279,Very Cheap
20150505T000000,500000.0,4,2.5,1770,8155,1.5,0,0,4,6,1770,0,1970,1993,98034,47.719,-122.173,1460,7360,6385,5900,61.31207847946045,0.05573770491803279,Very Cheap
20141021T000000,314963.0,2,1.0,890,6350,1.0,0,0,3,6,890,0,1943,0,98103,47.6975,-122.357,1490,6350,5460,4860,49.600472440944884,0.03147055737704918,Very Cheap
20141027T000000,715000.0,3,1.5,1670,5060,2.0,0,2,5,7,1670,0,1925,0,98126,47.5671,-122.379,1670,5118,3390,3448,141.30434782608697,0.0839344262295082,Very Cheap
20141014T000000,280000.0,3,2.25,1360,9600,2.0,0,0,3,7,1360,0,1992,0,98045,47.4687,-121.749,1200,10400,8240,9200,29.166666666666668,0.026885245901639345,Very Cheap
20140612T000000,531000.0,3,2.5,2120,9736,2.0,0,0,3,9,2120,0,1988,0,98011,47.7374,-122.219,2490,8763,7616,6273,54.53985209531635,0.05980327868852459,Very Cheap
20140923T000000,617000.0,3,2.5,1910,4488,2.0,0,0,3,8,1910,0,1998,0,98007,47.6176,-122.14,1530,3696,2578,2166,137.4777183600713,0.07108196721311476,Very Cheap
20141009T000000,440000.0,4,1.0,1480,7560,1.5,0,0,3,7,1480,0,1940,0,98177,47.7079,-122.358,1480,7560,6080,6080,58.2010582010582,0.04786885245901639,Very Cheap
20140729T000000,140000.0,3,1.0,1090,10114,1.0,0,0,4,7,1090,0,1955,0,98002,47.2975,-122.223,1380,7800,9024,6420,13.842198932173226,0.008524590163934427,Very Cheap
20150213T000000,661000.0,4,1.75,1670,13125,1.0,0,0,5,8,1670,0,1973,0,98052,47.6315,-122.101,2360,12500,11455,10140,50.36190476190476,0.07685245901639344,Very Cheap
20150429T000000,697000.0,4,1.75,1670,13125,1.0,0,0,5,8,1670,0,1973,0,98052,47.6315,-122.101,2360,12500,11455,10140,53.10476190476191,0.08157377049180328,Very Cheap
20140627T000000,1195000.0,5,2.75,3650,13297,2.0,0,0,5,9,2750,900,1969,0,98040,47.5497,-122.228,2900,11568,9647,8668,89.86989546514252,0.14688524590163934,Cheap
20140920T000000,535000.0,4,2.0,1970,3515,1.0,0,0,5,8,1030,940,1969,0,98115,47.6873,-122.314,1650,4275,1545,2625,152.20483641536273,0.06032786885245902,Very Cheap
20150324T000000,404500.0,2,2.0,1320,3060,1.5,0,0,4,6,1320,0,1910,0,98118,47.5643,-122.284,1410,3264,1740,1854,132.18954248366012,0.043213114754098364,Very Cheap
20141112T000000,396500.0,3,1.0,1710,5110,1.0,0,0,3,7,1100,610,1954,0,98126,47.5256,-122.379,1310,5110,3400,3800,77.59295499021526,0.04216393442622951,Very Cheap
20150320T000000,450000.0,3,2.25,1740,9488,1.0,0,0,4,8,1180,560,1977,0,98056,47.5339,-122.174,1880,8615,7748,6735,47.4283305227656,0.04918032786885246,Very Cheap
20150116T000000,605000.0,3,3.25,2200,2400,2.0,0,0,3,8,1740,460,1988,0,98119,47.6325,-122.371,2200,3600,200,1400,252.08333333333334,0.06950819672131148,Very Cheap
20140911T000000,699000.0,3,2.0,2010,4320,2.0,0,2,3,9,2010,0,1999,0,98118,47.5153,-122.256,1640,5225,2310,3585,161.80555555555554,0.08183606557377049,Very Cheap
20140619T000000,805000.0,3,3.0,3910,19023,2.0,0,0,3,11,3910,0,1985,0,98014,47.6953,-121.914,1860,15001,15113,13141,42.317194974504545,0.09573770491803278,Very Cheap
20150219T000000,156000.0,1,0.75,470,15000,1.0,0,0,3,4,470,0,1947,0,98014,47.6554,-121.908,1730,22500,14530,20770,10.4,0.010622950819672131,Very Cheap
20150306T000000,595000.0,4,2.5,2330,7064,1.0,0,0,4,8,1780,550,1984,0,98052,47.6955,-122.097,1740,8075,4734,6335,84.2298980747452,0.06819672131147542,Very Cheap
20140728T000000,285000.0,3,1.75,1930,7200,1.5,0,0,3,6,1930,0,1929,0,98065,47.5263,-121.809,1350,9000,5270,7650,39.583333333333336,0.02754098360655738,Very Cheap
20150325T000000,725000.0,4,2.5,3270,6055,2.0,0,0,3,9,3270,0,2007,0,98056,47.5374,-122.192,2740,7367,2785,4627,119.73575557390586,0.08524590163934426,Very Cheap
20141125T000000,216300.0,3,2.5,1650,5000,2.0,0,0,3,8,1650,0,1985,0,98023,47.3206,-122.394,1720,5000,3350,3280,43.26,0.018531147540983606,Very Cheap
20141020T000000,410000.0,4,2.75,2220,8450,1.0,0,0,4,7,1260,960,1983,0,98059,47.4804,-122.157,1580,8450,6230,6870,48.5207100591716,0.043934426229508196,Very Cheap
20140903T000000,597000.0,2,1.75,2470,4600,1.0,0,3,4,7,1140,1330,1916,0,98126,47.5599,-122.378,1790,5175,2130,3385,129.7826086956522,0.06845901639344262,Very Cheap
20150218T000000,325000.0,3,1.0,1300,9300,1.0,0,0,4,7,1300,0,1977,0,98077,47.7562,-122.073,1300,10064,8000,8764,34.946236559139784,0.03278688524590164,Very Cheap
20150401T000000,355000.0,5,2.75,2530,9375,1.0,0,0,5,7,1530,1000,1966,0,98030,47.3738,-122.214,2250,8200,6845,5950,37.86666666666667,0.036721311475409836,Very Cheap
20141218T000000,338000.0,3,1.5,2400,8215,1.0,0,0,3,7,1200,1200,1961,0,98146,47.5001,-122.338,1460,8217,5815,6757,41.1442483262325,0.034491803278688525,Very Cheap
20141118T000000,210000.0,4,2.25,1500,5393,2.0,0,0,3,7,1500,0,1999,0,98001,47.3378,-122.263,1700,5917,3893,4217,38.93936584461339,0.017704918032786884,Very Cheap
20140814T000000,423000.0,4,1.75,1700,9000,1.0,0,0,3,7,1700,0,1967,0,98034,47.7308,-122.18,1930,7818,7300,5888,47.0,0.04563934426229508,Very Cheap
20150211T000000,249500.0,4,1.5,2120,8554,1.0,0,0,4,7,1170,950,1977,0,98002,47.2933,-122.195,1790,8554,6434,6764,29.16764086976853,0.022885245901639345,Very Cheap
20150110T000000,325000.0,4,2.5,2240,5105,2.0,0,0,4,8,2240,0,2002,0,98042,47.3922,-122.165,1920,5288,2865,3368,63.66307541625857,0.03278688524590164,Very Cheap
20150325T000000,257000.0,3,1.75,1540,8223,1.0,0,0,4,7,1070,470,1987,0,98042,47.3666,-122.089,1240,8113,6683,6873,31.253800316186307,0.023868852459016394,Very Cheap
20150420T000000,550000.0,3,1.75,1890,100623,1.0,0,3,3,8,1890,0,1978,0,98053,47.6454,-121.978,2110,50529,98733,48419,5.46594714926011,0.06229508196721312,Very Cheap
20141114T000000,490000.0,3,1.0,1260,9638,2.0,0,0,4,7,1260,0,1920,0,98033,47.6773,-122.178,1760,7822,8378,6062,50.84042332434115,0.05442622950819672,Very Cheap
20150202T000000,299000.0,2,1.5,1160,3838,2.0,0,0,3,7,1160,0,1983,0,98034,47.7255,-122.164,1410,3780,2678,2370,77.90515893694632,0.02937704918032787,Very Cheap
20141103T000000,295000.0,2,1.0,1300,39639,1.0,0,0,4,6,1300,0,1960,0,98070,47.466,-122.452,1880,98881,38339,97001,7.442165544034915,0.028852459016393443,Very Cheap
20141029T000000,630000.0,4,2.5,3220,14463,2.0,0,0,3,8,3220,0,1978,0,98074,47.6261,-122.047,2550,12109,11243,9559,43.559427504667084,0.07278688524590164,Very Cheap
20150424T000000,320000.0,4,1.5,2020,8474,1.0,0,0,5,7,1010,1010,1962,0,98058,47.4579,-122.17,1720,8166,6454,6446,37.76256785461411,0.032131147540983604,Very Cheap
20150424T000000,1110000.0,4,2.5,2990,8640,1.0,0,0,5,8,2100,890,1959,0,98005,47.5932,-122.172,2270,8800,5650,6530,128.47222222222223,0.13573770491803278,Cheap
20140922T000000,398000.0,4,1.0,1420,6458,1.0,0,0,4,7,1420,0,1953,0,98117,47.6988,-122.358,1670,6350,5038,4680,61.62898730257046,0.042360655737704915,Very Cheap
20140521T000000,218000.0,3,1.0,1020,7874,1.0,0,0,3,7,1020,0,1956,0,98106,47.5175,-122.346,1290,7320,6854,6030,27.686055372110744,0.018754098360655738,Very Cheap
20150303T000000,590000.0,4,2.75,2400,104108,2.0,0,0,3,8,2400,0,1988,0,98027,47.4686,-121.989,2270,54450,101708,52180,5.667191762400584,0.06754098360655737,Very Cheap
20140601T000000,1595000.0,5,3.0,3640,8239,2.0,0,3,3,10,2540,1100,1982,0,98008,47.5842,-122.111,3330,10643,4599,7313,193.59145527369827,0.19934426229508198,Cheap
20141218T000000,348500.0,2,2.25,1550,1824,2.0,0,0,3,8,1550,0,2007,0,98106,47.5396,-122.368,1460,1826,274,366,191.06359649122808,0.035868852459016394,Very Cheap
20140725T000000,592500.0,2,2.0,1870,4751,1.0,0,0,3,8,1870,0,2006,0,98053,47.7082,-122.015,2170,5580,2881,3410,124.71058724479057,0.06786885245901639,Very Cheap
20140610T000000,505000.0,3,2.5,2340,5957,2.0,0,0,3,8,2340,0,1995,0,98028,47.7347,-122.236,2340,6604,3617,4264,84.77421520899782,0.05639344262295082,Very Cheap
20141029T000000,1430000.0,5,4.25,3350,3600,2.0,0,0,3,10,2260,1090,2014,0,98119,47.6351,-122.364,1810,3600,250,1790,397.22222222222223,0.17770491803278687,Cheap
20140721T000000,502000.0,3,1.0,1710,5000,1.0,0,0,5,7,1140,570,1921,0,98116,47.5719,-122.385,1670,4000,3290,2330,100.4,0.056,Very Cheap
20140624T000000,257500.0,2,2.0,1180,9265,1.0,0,0,3,7,1180,0,1940,0,98125,47.7252,-122.297,460,18000,8085,17540,27.792768483540204,0.023934426229508195,Very Cheap
20140711T000000,405000.0,3,1.5,1600,7500,1.0,0,0,3,7,1600,0,1966,0,98034,47.721,-122.182,1700,7500,5900,5800,54.0,0.043278688524590166,Very Cheap
20150317T000000,427000.0,3,1.75,1300,5111,1.0,0,0,4,7,1300,0,1959,0,98115,47.7005,-122.314,1370,5111,3811,3741,83.54529446292311,0.04616393442622951,Very Cheap
20141204T000000,290000.0,3,1.5,1040,9997,1.0,0,0,4,7,1040,0,1955,0,98155,47.7583,-122.302,1040,8699,8957,7659,29.008702610783235,0.02819672131147541,Very Cheap
20150324T000000,222000.0,3,1.0,1220,7695,1.0,0,0,3,7,1220,0,1954,0,98106,47.5191,-122.339,1210,7412,6475,6202,28.84990253411306,0.019278688524590165,Very Cheap
20141218T000000,315000.0,3,2.5,2240,6097,2.0,0,0,3,8,2240,0,2002,0,98038,47.3503,-122.042,2240,5574,3857,3334,51.66475315729047,0.031475409836065574,Very Cheap
20140604T000000,371000.0,3,1.5,1420,4500,1.0,0,0,3,7,1420,0,1959,0,98103,47.694,-122.332,1540,6375,3080,4835,82.44444444444444,0.038819672131147544,Very Cheap
20140626T000000,279900.0,3,1.75,1580,6620,1.0,0,0,3,7,1580,0,1988,0,98003,47.2798,-122.303,1580,8137,5040,6557,42.2809667673716,0.026872131147540983,Very Cheap
20150420T000000,250000.0,3,1.5,2390,23522,1.0,0,0,2,7,1890,500,1938,1968,98059,47.4754,-122.09,2430,23958,21132,21528,10.628347929597822,0.022950819672131147,Very Cheap
20140506T000000,599000.0,4,2.25,2260,29930,2.0,0,0,4,8,1400,860,1977,0,98006,47.5689,-122.126,2770,29930,27670,27160,20.013364517206817,0.06872131147540983,Very Cheap
20140716T000000,267300.0,3,1.75,1890,93218,1.0,0,0,4,7,1890,0,1964,0,98092,47.2568,-122.07,1690,172062,91328,170372,2.867471947477955,0.02521967213114754,Very Cheap
20141211T000000,585000.0,2,1.75,1830,7200,1.0,0,2,4,7,1070,760,1949,0,98118,47.5592,-122.273,1570,6000,5370,4430,81.25,0.06688524590163934,Very Cheap
20150414T000000,350000.0,3,1.75,1000,8268,1.0,0,0,3,6,1000,0,1969,0,98072,47.7417,-122.172,1220,7800,7268,6580,42.33188195452347,0.036065573770491806,Very Cheap
20140617T000000,506000.0,3,1.75,2180,7700,1.0,0,0,3,8,1480,700,1961,0,98177,47.7594,-122.361,2180,7604,5520,5424,65.71428571428571,0.05652459016393443,Very Cheap
20141113T000000,400000.0,6,2.0,2320,210830,2.0,0,0,4,8,2320,0,1962,0,98058,47.398,-122.081,2540,217800,208510,215260,1.89726319783712,0.04262295081967213,Very Cheap
20141104T000000,151100.0,3,1.0,840,4495,1.0,0,0,3,6,840,0,1921,0,98146,47.496,-122.349,1260,7434,3655,6174,33.61512791991101,0.00998032786885246,Very Cheap
20150421T000000,251000.0,3,1.0,840,4495,1.0,0,0,3,6,840,0,1921,0,98146,47.496,-122.349,1260,7434,3655,6174,55.83982202447164,0.023081967213114753,Very Cheap
20140522T000000,555000.0,4,2.25,2350,8140,1.0,0,0,4,8,1430,920,1977,0,98006,47.5579,-122.129,2640,8700,5790,6060,68.18181818181819,0.06295081967213115,Very Cheap
20141006T000000,467500.0,3,1.75,2040,273556,1.0,0,0,3,7,2040,0,1997,0,98070,47.4361,-122.469,1790,273556,271516,271766,1.7089736653555396,0.05147540983606557,Very Cheap
20150407T000000,479000.0,4,2.5,2370,30378,2.0,0,0,3,8,2370,0,1996,0,98042,47.3389,-122.066,2870,34834,28008,31964,15.767989992757917,0.05298360655737705,Very Cheap
20150416T000000,247000.0,5,2.0,1590,9350,1.0,0,0,5,7,1060,530,1962,0,98001,47.3398,-122.286,1460,8210,7760,6750,26.41711229946524,0.022557377049180326,Very Cheap
20150123T000000,299500.0,3,1.0,1380,10875,1.0,0,0,3,7,1380,0,1977,0,98045,47.4653,-121.745,1040,10875,9495,9835,27.54022988505747,0.02944262295081967,Very Cheap
20150507T000000,306888.0,4,1.5,1940,8970,1.5,0,0,3,7,1270,670,1980,0,98125,47.7297,-122.326,1960,8470,7030,6510,34.212709030100335,0.030411540983606558,Very Cheap
20141006T000000,675000.0,4,2.5,3320,244807,2.0,0,0,3,9,3320,0,2001,0,98010,47.3637,-121.955,2530,217800,241487,215270,2.7572740975544,0.07868852459016394,Very Cheap
20150421T000000,577000.0,2,1.0,1090,5265,1.5,0,0,4,7,1090,0,1947,0,98105,47.6638,-122.292,2080,4000,4175,1920,109.59164292497626,0.06583606557377049,Very Cheap
20140520T000000,219950.0,3,1.5,1650,9936,1.0,0,0,3,7,1090,560,1967,0,98003,47.3285,-122.328,1560,9890,8286,8330,22.136674718196456,0.01900983606557377,Very Cheap
20140723T000000,375000.0,3,1.5,1110,5500,1.0,0,0,3,6,1110,0,1940,1997,98033,47.6717,-122.184,1670,6600,4390,4930,68.18181818181819,0.03934426229508197,Very Cheap
20141107T000000,650000.0,4,2.5,2110,6820,1.0,0,0,5,7,1530,580,1942,0,98115,47.6882,-122.306,1420,6431,4710,5011,95.30791788856305,0.07540983606557378,Very Cheap
20150406T000000,975000.0,3,3.0,1850,5000,1.5,0,0,2,6,1850,0,1900,0,98107,47.6711,-122.386,1360,2500,3150,1140,195.0,0.1180327868852459,Cheap
20150429T000000,229000.0,1,1.0,600,3720,1.0,0,0,3,6,600,0,1920,0,98106,47.5558,-122.363,1480,4800,3120,3320,61.55913978494624,0.02019672131147541,Very Cheap
20140921T000000,575000.0,5,2.5,2760,4000,1.5,0,0,3,8,1730,1030,1926,2014,98122,47.6074,-122.299,1680,4000,1240,2320,143.75,0.06557377049180328,Very Cheap
20150428T000000,815000.0,4,1.75,2970,14880,1.0,0,4,5,9,1560,1410,1962,0,98075,47.5907,-122.086,3310,13388,11910,10078,54.77150537634409,0.09704918032786886,Very Cheap
20140806T000000,525000.0,3,1.75,2300,43560,1.0,0,0,4,7,1350,950,1979,0,98077,47.7716,-122.101,2320,57000,41260,54680,12.052341597796143,0.05901639344262295,Very Cheap
20140606T000000,471000.0,3,2.5,2030,2805,2.0,0,0,3,8,1720,310,2001,0,98027,47.5305,-122.047,1670,2898,775,1228,167.9144385026738,0.051934426229508196,Very Cheap
20140623T000000,450000.0,4,1.75,2160,4333,1.0,0,0,4,8,1260,900,1942,0,98117,47.6893,-122.388,1670,4426,2173,2756,103.85414262635588,0.04918032786885246,Very Cheap
20140528T000000,590000.0,3,2.0,1650,6150,2.0,0,0,4,7,1650,0,1926,1993,98116,47.5713,-122.394,1280,6150,4500,4870,95.9349593495935,0.06754098360655737,Very Cheap
20140801T000000,744000.0,4,2.5,3140,7260,2.0,0,0,3,8,2200,940,2004,0,98006,47.5664,-122.124,2860,8186,4120,5326,102.47933884297521,0.08773770491803279,Very Cheap
20141201T000000,460000.0,4,2.25,2690,36114,2.0,0,0,4,9,2690,0,1986,0,98092,47.3106,-122.116,2570,35091,33424,32521,12.737442543058094,0.050491803278688525,Very Cheap
20150313T000000,299000.0,5,2.5,1940,9389,1.0,0,0,4,7,1290,650,1960,0,98155,47.7438,-122.328,1810,9390,7449,7580,31.845776973053574,0.02937704918032787,Very Cheap
20150129T000000,231000.0,4,1.0,1220,5120,1.5,0,0,5,6,1220,0,1940,0,98022,47.205,-121.996,1540,7670,3900,6130,45.1171875,0.020459016393442622,Very Cheap
20140820T000000,195000.0,3,1.0,1300,9600,1.0,0,0,4,6,1300,0,1975,0,98092,47.3037,-122.107,1150,10222,8300,9072,20.3125,0.015737704918032787,Very Cheap
20150423T000000,305000.0,3,1.75,1660,11500,1.0,0,0,3,7,1130,530,1979,0,98045,47.4473,-121.774,1250,11000,9840,9750,26.52173913043478,0.03016393442622951,Very Cheap
20150302T000000,895000.0,4,1.5,3390,6200,2.0,0,0,4,8,2530,860,1916,0,98144,47.58,-122.29,3080,6000,2810,2920,144.3548387096774,0.10754098360655738,Cheap
20140507T000000,1110000.0,4,1.5,2310,13300,1.0,0,0,3,7,1890,420,1950,0,98004,47.6232,-122.21,2840,12744,10990,9904,83.45864661654136,0.13573770491803278,Cheap
20140626T000000,339000.0,2,1.0,950,7954,1.0,0,0,4,7,950,0,1941,0,98108,47.557,-122.306,1180,6828,7004,5648,42.620065375911494,0.03462295081967213,Very Cheap
20150411T000000,885000.0,4,3.75,2400,3520,1.0,0,0,3,7,1370,1030,1924,2005,98109,47.6295,-122.346,2230,1419,1120,-811,251.42045454545453,0.1062295081967213,Cheap
20141103T000000,375000.0,3,1.0,1780,5236,1.5,0,0,5,6,1050,730,1944,0,98146,47.5119,-122.386,1260,5320,3456,4060,71.61955691367456,0.03934426229508197,Very Cheap
20140804T000000,367400.0,4,1.5,1280,7400,1.0,0,0,3,7,1280,0,1958,0,98008,47.6023,-122.123,1310,7400,6120,6090,49.648648648648646,0.03834754098360656,Very Cheap
20150424T000000,700000.0,4,2.0,1930,5398,1.0,0,0,3,7,1430,500,1953,0,98119,47.646,-122.363,1910,4902,3468,2992,129.67765839199703,0.08196721311475409,Very Cheap
20150130T000000,667000.0,5,2.25,2560,10360,1.0,0,0,4,8,1870,690,1966,0,98008,47.5819,-122.126,2070,7875,7800,5805,64.38223938223938,0.07763934426229509,Very Cheap
20141222T000000,200000.0,2,1.0,920,5250,1.0,0,0,4,6,920,0,1906,0,98118,47.5177,-122.266,1210,5250,4330,4040,38.095238095238095,0.01639344262295082,Very Cheap
20150415T000000,552775.0,3,2.5,1900,18414,2.0,0,0,3,8,1900,0,1971,2007,98074,47.6326,-122.015,2900,39921,16514,37021,30.01927880960139,0.06265901639344262,Very Cheap
20140722T000000,452000.0,3,2.0,2270,148975,1.0,0,0,4,6,1270,1000,1900,1980,98056,47.5092,-122.195,2210,17388,146705,15178,3.0340661184762543,0.04944262295081967,Very Cheap
20141121T000000,418000.0,3,2.5,2080,16050,1.0,0,0,5,8,1360,720,1978,0,98059,47.4694,-122.069,1790,14550,13970,12760,26.043613707165107,0.04498360655737705,Very Cheap
20150212T000000,601500.0,3,1.75,1460,10128,1.0,0,0,3,8,1460,0,1968,2000,98033,47.6709,-122.167,2240,10154,8668,7914,59.389810426540286,0.06904918032786886,Very Cheap
20140505T000000,600000.0,3,1.75,1670,39639,1.0,0,0,4,8,1670,0,1976,1992,98075,47.5929,-121.989,2330,30492,37969,28162,15.136607886172708,0.06885245901639345,Very Cheap
20150424T000000,340000.0,4,2.5,2810,6481,2.0,0,0,3,9,2810,0,1998,0,98092,47.333,-122.172,2660,6958,3671,4298,52.46103996296868,0.03475409836065574,Very Cheap
20140826T000000,310000.0,3,2.5,2370,6752,2.0,0,0,3,8,2370,0,1994,0,98003,47.2703,-122.312,1870,7455,4382,5585,45.91232227488152,0.03081967213114754,Very Cheap
20141217T000000,290000.0,2,1.75,1700,18000,1.0,0,0,3,8,1700,0,1972,0,98056,47.5066,-122.194,1700,8225,16300,6525,16.11111111111111,0.02819672131147541,Very Cheap
20150424T000000,438000.0,2,1.0,1630,9255,1.0,0,0,3,7,1630,0,1941,0,98133,47.7222,-122.332,1800,8000,7625,6200,47.3257698541329,0.04760655737704918,Very Cheap
20150224T000000,718000.0,4,2.75,2930,4408,1.0,0,0,5,8,1660,1270,1939,0,98144,47.5841,-122.295,2200,4000,1478,1800,162.8856624319419,0.08432786885245902,Very Cheap
20140620T000000,200000.0,2,1.0,860,6600,1.0,0,0,5,6,860,0,1949,0,98168,47.4878,-122.324,1030,6732,5740,5702,30.303030303030305,0.01639344262295082,Very Cheap
20140528T000000,479900.0,3,2.0,1980,12150,1.0,0,0,3,9,1980,0,1994,0,98042,47.3657,-122.152,2200,12150,10170,9950,39.49794238683128,0.0531016393442623,Very Cheap
20150423T000000,400000.0,3,2.5,2080,7877,2.0,0,0,3,9,2080,0,1987,0,98058,47.4395,-122.151,2550,7660,5797,5110,50.7807540941983,0.04262295081967213,Very Cheap
20150323T000000,219950.0,3,1.0,1060,10042,1.0,0,0,4,7,1060,0,1957,0,98188,47.4434,-122.283,1130,10925,8982,9795,21.90300736904999,0.01900983606557377,Very Cheap
20140827T000000,300000.0,3,2.5,1590,3381,2.0,0,0,3,7,1590,0,2000,0,98019,47.7344,-121.986,1820,3383,1791,1563,88.73114463176574,0.029508196721311476,Very Cheap
20140805T000000,437000.0,3,2.25,1980,8775,1.0,0,0,3,7,1290,690,1959,0,98177,47.7753,-122.359,1550,9240,6795,7690,49.800569800569804,0.047475409836065574,Very Cheap
20140710T000000,350000.0,4,2.0,1720,7210,1.0,0,0,3,7,860,860,1971,0,98034,47.7307,-122.239,1250,7210,5490,5960,48.54368932038835,0.036065573770491806,Very Cheap
20140929T000000,626000.0,4,1.75,1350,9293,1.0,0,0,4,7,1350,0,1954,0,98004,47.6335,-122.196,1890,9293,7943,7403,67.36253093726461,0.07226229508196721,Very Cheap
20150224T000000,490000.0,3,2.5,2080,12032,2.0,0,0,3,8,2080,0,1978,0,98077,47.7455,-122.073,2320,9900,9952,7580,40.724734042553195,0.05442622950819672,Very Cheap
20140520T000000,289000.0,3,2.5,2090,4700,2.0,0,0,3,8,2090,0,2002,0,98042,47.3724,-122.104,2740,5040,2610,2300,61.48936170212766,0.028065573770491802,Very Cheap
20141114T000000,595000.0,3,2.5,2030,5100,2.0,0,0,3,7,2030,0,2008,0,98199,47.6594,-122.397,1790,4380,3070,2590,116.66666666666667,0.06819672131147542,Very Cheap
20141211T000000,676000.0,3,2.25,2680,41804,1.0,0,0,3,9,2680,0,1989,0,98045,47.4828,-121.73,2680,40866,39124,38186,16.170701368290114,0.07881967213114754,Very Cheap
20150414T000000,389000.0,3,1.75,1820,8028,1.0,0,0,3,7,1220,600,1980,0,98133,47.7466,-122.355,1940,11100,6208,9160,48.455406078724465,0.04118032786885246,Very Cheap
20140915T000000,240000.0,3,2.0,1300,5000,1.0,0,0,4,7,1300,0,1983,0,98198,47.3837,-122.304,1630,7500,3700,5870,48.0,0.021639344262295083,Very Cheap
20140617T000000,382500.0,4,2.5,2210,7079,2.0,0,0,3,8,2210,0,1993,0,98031,47.4206,-122.183,1970,7000,4869,5030,54.03305551631586,0.040327868852459016,Very Cheap
20140509T000000,511555.0,3,2.0,1400,7293,1.0,0,0,4,7,1400,0,1963,0,98008,47.586,-122.12,1600,7960,5893,6360,70.14328808446456,0.05725311475409836,Very Cheap
20140910T000000,710500.0,3,1.75,2040,4125,1.5,0,0,4,8,1540,500,1917,0,98107,47.6608,-122.359,1620,4400,2085,2780,172.24242424242425,0.08334426229508196,Very Cheap
20140521T000000,429000.0,3,2.5,2420,49928,2.0,0,0,3,8,1860,560,1985,0,98027,47.463,-122.008,2620,37301,47508,34681,8.592373017144688,0.04642622950819672,Very Cheap
20140723T000000,170000.0,4,1.75,1920,7500,1.0,0,0,4,7,1920,0,1962,0,98198,47.4222,-122.318,1490,8000,5580,6510,22.666666666666668,0.012459016393442624,Very Cheap
20140821T000000,2135000.0,4,3.25,3860,17820,1.0,0,4,4,10,2630,1230,1975,0,98004,47.6224,-122.215,4590,23760,13960,19170,119.80920314253648,0.2701639344262295,Cheap
20150408T000000,480000.0,5,2.75,2760,7200,1.0,0,0,3,7,1430,1330,1979,0,98072,47.7563,-122.147,2460,8750,4440,6290,66.66666666666667,0.05311475409836065,Very Cheap
20140720T000000,1665000.0,4,3.75,3450,8395,2.0,0,4,4,10,2640,810,1993,0,98122,47.6134,-122.282,3180,5183,4945,2003,198.33234067897558,0.20852459016393443,Cheap
20140513T000000,225000.0,3,1.0,1040,6535,1.0,0,0,3,6,1040,0,1947,0,98168,47.4906,-122.306,1100,6535,5495,5435,34.429992348890586,0.019672131147540985,Very Cheap
20141201T000000,615000.0,3,1.75,2220,7224,1.0,0,2,3,8,2040,180,1975,0,98177,47.774,-122.384,2540,9990,5004,7450,85.1328903654485,0.07081967213114754,Very Cheap
20141120T000000,438950.0,4,2.5,2470,385506,2.0,0,3,3,7,2470,0,1991,0,98022,47.2396,-121.993,1680,158994,383036,157314,1.1386333805440123,0.04773114754098361,Very Cheap
20150304T000000,242000.0,3,1.75,1300,9856,1.0,0,0,4,7,1300,0,1962,0,98003,47.3448,-122.298,1400,9600,8556,8200,24.553571428571427,0.021901639344262296,Very Cheap
20140716T000000,560000.0,3,2.5,1960,9686,1.0,0,0,3,8,1460,500,1989,0,98074,47.6339,-122.026,1960,8254,7726,6294,57.81540367540781,0.06360655737704918,Very Cheap
20141003T000000,857500.0,3,1.5,2040,3960,2.0,0,2,5,8,2040,0,1928,0,98103,47.6658,-122.355,1540,3400,1920,1860,216.54040404040404,0.10262295081967213,Cheap
20140506T000000,685000.0,4,2.5,3030,7864,2.0,0,0,3,9,3030,0,1999,0,98074,47.6075,-122.017,2790,7034,4834,4244,87.1057985757884,0.08,Very Cheap
20150403T000000,486000.0,4,3.0,2260,7336,2.0,0,0,4,7,2260,0,1977,0,98034,47.7297,-122.219,2200,7724,5076,5524,66.24863685932388,0.053901639344262293,Very Cheap
20140605T000000,749000.0,3,2.5,2670,10338,2.0,0,0,3,9,2670,0,1987,0,98007,47.6599,-122.146,2670,8866,7668,6196,72.45115109305475,0.08839344262295082,Very Cheap
20141114T000000,260000.0,3,2.5,1520,6298,2.0,0,0,3,7,1520,0,1986,0,98030,47.3687,-122.182,1670,7207,4778,5537,41.2829469672912,0.024262295081967214,Very Cheap
20150114T000000,1015000.0,3,1.75,3610,8502,1.5,0,2,3,10,2610,1000,1930,0,98126,47.583,-122.379,2900,5016,4892,2116,119.38367442954599,0.12327868852459016,Cheap
20150310T000000,565000.0,3,1.75,1130,5111,1.0,0,0,4,7,930,200,1942,0,98199,47.6379,-122.4,1360,4424,3981,3064,110.54588143220505,0.06426229508196721,Very Cheap
20141014T000000,355000.0,3,2.0,1480,2502,2.0,0,0,3,7,1480,0,1991,0,98103,47.6969,-122.338,1850,5000,1022,3150,141.8864908073541,0.036721311475409836,Very Cheap
20140730T000000,775000.0,5,2.0,3540,9970,2.0,0,3,3,9,3540,0,1970,0,98125,47.7108,-122.277,2280,7195,6430,4915,77.73319959879639,0.09180327868852459,Very Cheap
20150422T000000,335000.0,4,2.25,2100,7305,1.0,0,0,4,7,1050,1050,1963,0,98188,47.4676,-122.296,1760,7308,5205,5548,45.8590006844627,0.03409836065573771,Very Cheap
20140620T000000,1300000.0,5,4.0,3366,7800,2.5,0,2,3,8,2966,400,1937,0,98199,47.6466,-122.391,2340,6000,4434,3660,166.66666666666666,0.16065573770491803,Cheap
20140603T000000,545000.0,3,1.75,1810,3000,1.5,0,0,4,7,1810,0,1903,0,98107,47.6599,-122.363,1140,3000,1190,1860,181.66666666666666,0.06163934426229508,Very Cheap
20141118T000000,540000.0,3,1.75,1680,4240,1.5,0,0,4,7,1680,0,1926,0,98144,47.5745,-122.311,1460,4240,2560,2780,127.35849056603773,0.06098360655737705,Very Cheap
20140915T000000,687500.0,3,1.75,2450,9377,1.0,0,2,4,8,1540,910,1962,0,98125,47.7296,-122.284,2520,9725,6927,7205,73.31769222565853,0.08032786885245902,Very Cheap
20140708T000000,115000.0,1,2.0,1150,9812,1.0,0,0,4,7,1150,0,1962,0,98001,47.2951,-122.284,1200,9812,8662,8612,11.720342437831228,0.005245901639344262,Very Cheap
20141125T000000,227000.0,1,2.0,1150,9812,1.0,0,0,4,7,1150,0,1962,0,98001,47.2951,-122.284,1200,9812,8662,8612,23.134936812066858,0.019934426229508195,Very Cheap
20150429T000000,870000.0,4,2.5,3240,7621,2.0,0,2,3,9,3240,0,2003,0,98075,47.5641,-122.032,4610,7150,4381,2540,114.15824694921926,0.10426229508196722,Cheap
20141112T000000,1190000.0,4,2.5,3480,12164,1.5,0,0,4,11,3480,0,1984,0,98005,47.6404,-122.171,3960,16855,8684,12895,97.82966129562644,0.14622950819672131,Cheap
20140910T000000,375000.0,4,2.5,2800,5000,2.0,0,0,3,9,2800,0,2006,0,98038,47.3596,-122.036,2960,5092,2200,2132,75.0,0.03934426229508197,Very Cheap
20140828T000000,902000.0,3,2.75,3240,7200,1.0,0,2,3,8,1620,1620,1960,0,98118,47.567,-122.273,2700,7200,3960,4500,125.27777777777777,0.10845901639344262,Cheap
20140617T000000,269500.0,2,1.5,1480,7276,1.0,0,0,4,6,940,540,1978,0,98056,47.4942,-122.166,1090,6710,5796,5620,37.039582188015395,0.025508196721311476,Very Cheap
20150310T000000,570000.0,3,1.0,1700,4750,1.5,0,0,4,6,1200,500,1909,0,98117,47.6819,-122.389,1550,4750,3050,3200,120.0,0.06491803278688525,Very Cheap
20140821T000000,359950.0,2,1.0,1240,7590,1.0,0,0,4,7,1040,200,1939,0,98133,47.7061,-122.34,1190,5692,6350,4502,47.42424242424242,0.037370491803278685,Very Cheap
20150325T000000,1450000.0,4,3.5,3720,8301,2.0,0,0,3,10,2880,840,2008,0,98004,47.5885,-122.199,2080,9676,4581,7596,174.67774966871463,0.18032786885245902,Cheap
20140717T000000,615000.0,3,2.5,1910,3427,2.0,0,0,3,8,1910,0,2001,0,98052,47.6324,-122.11,2240,3720,1517,1480,179.45725124015175,0.07081967213114754,Very Cheap
20140604T000000,250000.0,4,2.0,2120,8701,1.5,0,0,4,7,2120,0,1960,0,98198,47.3722,-122.308,1720,8527,6581,6807,28.73232961728537,0.022950819672131147,Very Cheap
20140916T000000,530000.0,4,2.5,3020,6788,2.0,0,0,3,7,3020,0,2002,0,98065,47.5346,-121.881,2640,5325,3768,2685,78.07896287566294,0.05967213114754098,Very Cheap
20150127T000000,474950.0,3,2.0,2250,222156,1.0,0,0,3,7,2250,0,1987,0,98065,47.542,-121.792,2110,121968,219906,119858,2.137912097805146,0.05245245901639344,Very Cheap
20150222T000000,490000.0,4,2.0,1650,6480,2.0,0,0,5,7,1650,0,1947,0,98125,47.7117,-122.286,1650,6350,4830,4700,75.61728395061728,0.05442622950819672,Very Cheap
20140528T000000,210000.0,2,1.5,880,1157,2.0,0,0,3,7,880,0,2007,0,98126,47.5188,-122.376,1070,1203,277,133,181.5038893690579,0.017704918032786884,Very Cheap
20141114T000000,265500.0,3,1.0,1860,9225,1.0,0,0,3,7,1860,0,1957,0,98198,47.3904,-122.3,1740,12204,7365,10464,28.78048780487805,0.02498360655737705,Very Cheap
20140620T000000,1462500.0,5,3.25,3840,4800,3.0,0,3,3,10,2750,1090,2008,0,98144,47.5929,-122.29,2060,4800,960,2740,304.6875,0.1819672131147541,Cheap
20140605T000000,310000.0,4,2.25,2192,12128,2.0,0,0,3,8,2192,0,2006,0,98030,47.3644,-122.2,1914,4649,9936,2735,25.560686015831134,0.03081967213114754,Very Cheap
20150409T000000,324500.0,3,2.5,1590,4108,2.0,0,0,3,7,1590,0,2003,0,98056,47.4832,-122.181,2160,3912,2518,1752,78.99221032132425,0.03272131147540984,Very Cheap
20140929T000000,599000.0,4,4.75,3700,11000,1.0,0,0,4,7,1840,1860,1962,0,98028,47.768,-122.251,1720,11564,7300,9844,54.45454545454545,0.06872131147540983,Very Cheap
20140709T000000,525000.0,4,2.5,3670,9958,2.0,0,0,3,10,3670,0,2005,0,98058,47.4617,-122.159,3300,10679,6288,7379,52.72143000602531,0.05901639344262295,Very Cheap
20140515T000000,400000.0,3,1.0,1630,10304,1.0,0,0,5,7,1630,0,1953,0,98155,47.7548,-122.317,1480,8515,8674,7035,38.81987577639752,0.04262295081967213,Very Cheap
20141223T000000,887500.0,3,3.0,4230,54977,2.0,0,3,3,9,3780,450,1951,2000,98166,47.4176,-122.343,2880,27201,50747,24321,16.14311439329174,0.10655737704918032,Cheap
20140723T000000,344000.0,2,1.0,1060,3325,1.5,0,0,4,6,770,290,1932,0,98115,47.6896,-122.307,1820,4275,2265,2455,103.45864661654136,0.035278688524590165,Very Cheap
20140515T000000,525000.0,3,2.5,2700,7434,2.0,0,0,3,9,2700,0,1991,0,98072,47.7434,-122.174,2660,8405,4734,5745,70.62146892655367,0.05901639344262295,Very Cheap
20140822T000000,385000.0,3,2.25,2110,8000,2.0,0,0,3,8,2110,0,1975,0,98034,47.7311,-122.204,1740,7270,5890,5530,48.125,0.04065573770491803,Very Cheap
20141217T000000,820000.0,4,2.5,3720,8633,2.0,0,0,3,10,3720,0,1999,0,98074,47.6085,-122.013,3515,9660,4913,6145,94.98436233059192,0.09770491803278689,Very Cheap
20150427T000000,1305000.0,4,3.5,3440,5000,2.0,0,0,3,11,2560,880,2006,0,98199,47.6672,-122.409,3090,10241,1560,7151,261.0,0.16131147540983606,Cheap
20140729T000000,549000.0,4,2.25,2420,59800,1.0,0,0,4,8,1350,1070,1985,0,98074,47.6206,-122.056,2160,17598,57380,15438,9.180602006688963,0.06216393442622951,Very Cheap
20150225T000000,180000.0,3,1.0,1090,6771,1.5,0,0,3,7,1090,0,1929,0,98106,47.5177,-122.353,1230,4662,5681,3432,26.583961010190517,0.01377049180327869,Very Cheap
20140521T000000,589000.0,4,2.5,2910,5776,2.0,0,2,3,8,2910,0,1998,0,98065,47.5388,-121.87,2550,6750,2866,4200,101.97368421052632,0.06740983606557377,Very Cheap
20150127T000000,350000.0,3,1.0,1050,5518,1.0,0,0,3,7,1050,0,1948,0,98118,47.5564,-122.278,1490,4269,4468,2779,63.42877854295035,0.036065573770491806,Very Cheap
20150409T000000,197400.0,3,2.0,1610,7575,1.0,0,0,4,7,1110,500,1965,0,98003,47.334,-122.3,1920,8400,5965,6480,26.059405940594058,0.016052459016393444,Very Cheap
20140806T000000,267000.0,3,2.5,1760,6477,2.0,0,0,4,8,1760,0,1986,0,98030,47.3731,-122.172,1890,6800,4717,4910,41.2227883279296,0.025180327868852458,Very Cheap
20141224T000000,480000.0,3,1.5,1540,20281,1.0,0,0,3,7,1540,0,1977,0,98075,47.5817,-122.007,1710,21090,18741,19380,23.667472018145062,0.05311475409836065,Very Cheap
20141013T000000,650000.0,4,2.5,2580,9450,1.0,0,0,4,8,1660,920,1959,0,98125,47.703,-122.28,2060,9450,6870,7390,68.78306878306879,0.07540983606557378,Very Cheap
20150213T000000,600000.0,2,1.0,1370,5000,1.5,0,0,3,7,1370,0,1905,0,98107,47.6744,-122.383,1500,5000,3630,3500,120.0,0.06885245901639345,Very Cheap
20150430T000000,490000.0,2,1.75,1440,6265,1.0,0,0,3,8,1440,0,2005,0,98053,47.7028,-122.013,1810,5209,4825,3399,78.2122905027933,0.05442622950819672,Very Cheap
20141121T000000,225000.0,3,1.0,1410,7700,1.0,0,0,3,7,980,430,1962,0,98058,47.4577,-122.171,1510,7700,6290,6190,29.22077922077922,0.019672131147540985,Very Cheap
20140703T000000,640000.0,3,2.25,1980,10115,1.0,0,0,3,8,1980,0,1959,0,98005,47.6384,-122.174,2800,10143,8135,7343,63.272367770637665,0.0740983606557377,Very Cheap
20140610T000000,710000.0,3,3.5,2440,3427,2.0,0,0,3,7,1990,450,2000,0,98005,47.589,-122.165,2440,2601,987,161,207.17829004960606,0.08327868852459017,Very Cheap
20140609T000000,325000.0,3,2.0,1350,11805,1.0,0,0,3,7,1350,0,1986,0,98019,47.7313,-121.971,1350,14200,10455,12850,27.530707327403643,0.03278688524590164,Very Cheap
20140725T000000,595000.0,3,3.25,3130,28001,1.0,0,0,3,9,2210,920,1985,0,98072,47.7741,-122.122,2710,34999,24871,32289,21.249241098532195,0.06819672131147542,Very Cheap
20140718T000000,128750.0,3,1.0,880,7004,1.0,0,0,3,5,880,0,1950,0,98002,47.3019,-122.216,880,7828,6124,6948,18.38235294117647,0.007049180327868852,Very Cheap
20141017T000000,465000.0,3,2.25,1920,7300,1.0,0,0,3,7,1240,680,1961,0,98008,47.6078,-122.128,1920,7700,5380,5780,63.6986301369863,0.051147540983606556,Very Cheap
20140726T000000,710000.0,4,1.75,2700,7625,1.0,0,0,4,8,1450,1250,1937,0,98115,47.6838,-122.323,1760,3300,4925,1540,93.11475409836065,0.08327868852459017,Very Cheap
20150306T000000,605000.0,4,2.75,1670,6000,1.0,0,0,5,7,840,830,1917,0,98136,47.5496,-122.385,1100,6000,4330,4900,100.83333333333333,0.06950819672131148,Very Cheap
20140808T000000,994000.0,4,2.5,3470,20445,2.0,0,0,4,10,3470,0,1963,0,98040,47.547,-122.219,3360,21950,16975,18590,48.61824406945463,0.12052459016393442,Cheap
20140619T000000,489950.0,3,2.25,1820,7326,2.0,0,0,3,8,1820,0,1983,0,98034,47.7133,-122.217,2430,7696,5506,5266,66.87824187824188,0.05441967213114754,Very Cheap
20140506T000000,365000.0,3,1.5,1310,8160,1.0,0,0,3,7,1310,0,1950,0,98133,47.7291,-122.339,1090,7560,6850,6470,44.73039215686274,0.0380327868852459,Very Cheap
20150202T000000,359950.0,3,2.0,1790,7212,1.0,0,0,4,8,1790,0,1998,0,98042,47.3898,-122.154,2330,7212,5422,4882,49.90987243483084,0.037370491803278685,Very Cheap
20140929T000000,495000.0,4,2.5,2460,4774,2.0,0,0,3,8,2460,0,2006,0,98059,47.4912,-122.145,2510,4399,2314,1889,103.68663594470046,0.05508196721311476,Very Cheap
20140521T000000,255000.0,3,1.5,1060,9039,1.0,0,0,3,7,1060,0,1973,2013,98058,47.4293,-122.151,1410,9515,7979,8105,28.211085297046132,0.02360655737704918,Very Cheap
20140812T000000,330000.0,3,1.75,1340,10276,1.0,0,0,4,7,1340,0,1961,0,98034,47.7207,-122.222,2950,7987,8936,5037,32.11366290385364,0.03344262295081967,Very Cheap
20140707T000000,450000.0,3,1.75,1480,8394,1.0,0,0,4,8,1480,0,1971,0,98052,47.6634,-122.144,1920,9184,6914,7264,53.609721229449605,0.04918032786885246,Very Cheap
20150318T000000,655000.0,4,2.5,3500,11306,2.0,0,2,3,9,3500,0,2005,0,98065,47.5428,-121.861,3180,8028,7806,4848,57.93384043870511,0.0760655737704918,Very Cheap
20150421T000000,485000.0,4,2.75,2910,16362,1.0,0,2,4,9,2120,790,1969,0,98003,47.3397,-122.322,2850,14904,13452,12054,29.64185307419631,0.05377049180327869,Very Cheap
20140812T000000,375000.0,4,1.75,1940,15909,1.0,0,0,3,8,970,970,1974,0,98072,47.7578,-122.094,1940,15120,13969,13180,23.571563266075806,0.03934426229508197,Very Cheap
20141017T000000,570000.0,4,2.5,2280,4534,2.0,0,0,3,8,2280,0,2003,0,98075,47.5902,-122.018,2246,4534,2254,2288,125.71680635200705,0.06491803278688525,Very Cheap
20150423T000000,350000.0,3,2.25,1190,1022,3.0,0,0,3,8,1190,0,1998,0,98103,47.6972,-122.349,1210,1171,-168,-39,342.4657534246575,0.036065573770491806,Very Cheap
20150225T000000,550000.0,3,1.0,1260,6000,1.0,0,3,3,7,1260,0,1951,0,98146,47.5058,-122.384,2020,6600,4740,4580,91.66666666666667,0.06229508196721312,Very Cheap
20140731T000000,513000.0,5,2.0,2270,8652,1.0,0,0,3,7,1150,1120,1965,0,98052,47.6692,-122.151,1950,8050,6382,6100,59.29264909847434,0.05744262295081967,Very Cheap
20141205T000000,450000.0,4,2.25,1990,7320,1.0,0,0,4,7,1030,960,1965,0,98126,47.5237,-122.376,1320,7320,5330,6000,61.47540983606557,0.04918032786885246,Very Cheap
20150209T000000,432500.0,4,1.75,1500,1856,1.0,0,0,5,7,750,750,1901,0,98144,47.5917,-122.296,1220,1739,356,519,233.0280172413793,0.046885245901639346,Very Cheap
20150213T000000,432000.0,5,2.75,2060,329903,1.5,0,3,5,7,2060,0,1989,0,98022,47.1776,-121.944,2240,220232,327843,217992,1.3094758156185302,0.046819672131147544,Very Cheap
20150123T000000,480000.0,3,2.25,1950,8892,2.0,0,0,3,8,1950,0,1983,0,98052,47.7213,-122.11,1900,8750,6942,6850,53.98110661268556,0.05311475409836065,Very Cheap
20140728T000000,402200.0,3,1.75,1790,6980,1.0,0,0,3,7,1330,460,1980,0,98034,47.7311,-122.226,1770,8081,5190,6311,57.621776504298,0.042911475409836065,Very Cheap
20150413T000000,650000.0,3,1.0,1520,10227,1.0,0,0,4,6,1520,0,1951,0,98004,47.5872,-122.196,2710,10912,8707,8202,63.557250415566635,0.07540983606557378,Very Cheap
20150424T000000,1199500.0,4,2.5,3240,13044,2.0,0,0,4,9,3240,0,1984,0,98040,47.5825,-122.242,2920,13044,9804,10124,91.95798834713278,0.14747540983606558,Cheap
20140728T000000,312000.0,3,2.0,2440,13250,1.0,0,0,4,8,1440,1000,1977,0,98030,47.375,-122.227,2400,10650,10810,8250,23.547169811320753,0.031081967213114754,Very Cheap
20150402T000000,610000.0,4,2.0,2220,5821,1.5,0,0,4,7,1380,840,1916,0,98116,47.5723,-122.382,1850,5000,3601,3150,104.79299089503522,0.07016393442622951,Very Cheap
20150323T000000,823000.0,5,1.75,2640,7722,1.5,0,0,4,7,1650,990,1915,0,98117,47.6802,-122.361,1750,4000,5082,2250,106.57860657860658,0.09809836065573771,Very Cheap
20141113T000000,471000.0,4,1.75,1450,3750,1.0,0,0,4,7,950,500,1925,0,98105,47.6706,-122.3,1850,4000,2300,2150,125.6,0.051934426229508196,Very Cheap
20140702T000000,481015.0,3,2.25,1550,5511,2.0,0,0,3,8,1550,0,1987,0,98033,47.6946,-122.185,1620,5511,3961,3891,87.28270731264743,0.05324786885245902,Very Cheap
20141015T000000,1959000.0,5,4.5,6200,23373,3.0,0,1,4,11,5050,1150,1988,0,98040,47.5632,-122.215,3700,14486,17173,10786,83.81465793864716,0.24708196721311476,Cheap
20140923T000000,624000.0,4,3.25,2810,11250,1.0,0,0,3,8,1680,1130,1980,0,98052,47.692,-122.099,2110,11250,8440,9140,55.46666666666667,0.072,Very Cheap
20150320T000000,480000.0,4,2.5,2080,7966,1.0,0,0,3,7,1200,880,1970,0,98011,47.7393,-122.181,1920,7500,5886,5580,60.256088375596285,0.05311475409836065,Very Cheap
20140715T000000,815000.0,3,1.5,1370,8671,1.0,0,0,3,7,1370,0,1955,0,98004,47.6217,-122.198,1580,8671,7301,7091,93.99146580555876,0.09704918032786886,Very Cheap
20140829T000000,1650000.0,4,2.25,2920,20400,1.0,0,0,4,11,2920,0,1966,0,98004,47.6237,-122.228,3080,20400,17480,17320,80.88235294117646,0.20655737704918034,Cheap
20140516T000000,180000.0,3,1.0,1000,18513,1.0,0,0,3,6,1000,0,1940,0,98146,47.5118,-122.348,1280,8113,17513,6833,9.722897423432183,0.01377049180327869,Very Cheap
20150217T000000,156601.0,2,1.75,1210,9750,1.0,0,0,3,7,1210,0,1984,0,98038,47.3438,-122.037,1650,9750,8540,8100,16.061641025641027,0.010701770491803278,Very Cheap
20140719T000000,374950.0,4,2.5,2790,4650,2.0,0,0,3,8,2790,0,2004,0,98038,47.3557,-122.026,2850,4650,1860,1800,80.63440860215054,0.03933770491803279,Very Cheap
20140519T000000,368000.0,2,1.5,1660,4680,1.0,0,0,5,6,830,830,1908,0,98146,47.5134,-122.388,1930,5400,3020,3470,78.63247863247864,0.03842622950819672,Very Cheap
20141202T000000,550000.0,3,2.0,1650,3952,2.0,0,0,3,7,1650,0,1950,0,98103,47.6727,-122.33,1210,4560,2302,3350,139.17004048582996,0.06229508196721312,Very Cheap
20140717T000000,198000.0,3,1.75,1300,6318,1.0,0,0,3,7,1300,0,1980,0,98001,47.2752,-122.251,1150,8002,5018,6852,31.33903133903134,0.016131147540983607,Very Cheap
20140513T000000,345000.0,3,1.75,1090,7200,1.0,0,0,3,7,1090,0,1968,0,98034,47.7227,-122.179,1240,7200,6110,5960,47.916666666666664,0.03540983606557377,Very Cheap
20150309T000000,1712750.0,5,2.5,2660,6572,1.0,0,0,5,9,1960,700,1959,0,98039,47.6176,-122.223,3960,14595,3912,10635,260.6132075471698,0.21478688524590164,Cheap
20150130T000000,185900.0,3,1.0,940,10890,1.0,0,0,4,5,940,0,1909,0,98001,47.2763,-122.257,1370,10255,9950,8885,17.07070707070707,0.014544262295081968,Very Cheap
20140617T000000,950000.0,3,2.75,2750,18029,1.0,0,2,5,9,1810,940,1978,0,98006,47.5617,-122.134,2850,10021,15279,7171,52.69288368739254,0.11475409836065574,Cheap
20140620T000000,995000.0,4,4.5,3850,13551,2.0,0,2,3,10,3000,850,1998,0,98006,47.5522,-122.103,3480,10737,9701,7257,73.42631540107742,0.12065573770491804,Cheap
20140802T000000,345000.0,2,1.0,860,8250,1.0,0,0,3,7,860,0,1940,0,98133,47.7132,-122.334,1780,11200,7390,9420,41.81818181818182,0.03540983606557377,Very Cheap
20141105T000000,741000.0,4,2.75,2070,10125,1.0,0,0,3,7,1390,680,1962,0,98040,47.5697,-122.219,1850,10125,8055,8275,73.18518518518519,0.08734426229508196,Very Cheap
20140709T000000,737000.0,2,2.25,2290,9772,1.0,0,0,3,8,2290,0,2007,0,98053,47.7199,-122.025,1810,6077,7482,4267,75.41956610724519,0.08681967213114754,Very Cheap
20140521T000000,668750.0,4,2.5,2340,6420,1.0,0,2,3,8,1590,750,1964,0,98177,47.7728,-122.386,2110,10856,4080,8746,104.16666666666667,0.0778688524590164,Very Cheap
20140702T000000,575000.0,3,1.75,2680,8625,1.0,0,0,5,8,1590,1090,1974,0,98027,47.5316,-122.056,2620,14275,5945,11655,66.66666666666667,0.06557377049180328,Very Cheap
20141017T000000,280000.0,4,2.0,1710,5440,1.0,0,0,5,8,1030,680,1976,0,98042,47.366,-122.093,1620,6696,3730,5076,51.470588235294116,0.026885245901639345,Very Cheap
20140804T000000,583000.0,3,1.5,1800,10050,1.0,0,0,3,7,1800,0,1955,0,98008,47.6344,-122.126,1610,10050,8250,8440,58.00995024875622,0.06662295081967214,Very Cheap
20150128T000000,196000.0,3,2.25,1510,9600,1.0,0,0,1,7,1090,420,1966,0,98028,47.7758,-122.238,1870,10681,8090,8811,20.416666666666668,0.015868852459016394,Very Cheap
20140515T000000,349950.0,3,2.5,1700,7496,2.0,0,0,3,8,1700,0,1994,0,98055,47.432,-122.189,2280,7496,5796,5216,46.684898612593386,0.036059016393442625,Very Cheap
20141211T000000,429000.0,4,1.0,1350,3333,1.5,0,0,3,7,1350,0,1912,0,98107,47.6727,-122.397,1530,5000,1983,3470,128.7128712871287,0.04642622950819672,Very Cheap
20150220T000000,270000.0,5,2.5,2140,10320,1.0,0,0,4,7,1330,810,1967,0,98031,47.3927,-122.194,2050,8964,8180,6914,26.162790697674417,0.025573770491803278,Very Cheap
20140909T000000,385000.0,6,4.0,2700,7416,1.0,0,0,3,7,1350,1350,1969,0,98108,47.5525,-122.3,2260,5324,4716,3064,51.91477885652643,0.04065573770491803,Very Cheap
20140922T000000,535000.0,1,1.0,920,5000,1.0,0,3,4,7,920,0,1906,0,98103,47.6748,-122.352,1890,5000,4080,3110,107.0,0.06032786885245902,Very Cheap
20150420T000000,352500.0,3,1.75,1500,10269,1.0,0,0,3,7,1030,470,1958,0,98133,47.7672,-122.348,2090,10269,8769,8179,34.32661408121531,0.03639344262295082,Very Cheap
20150301T000000,624000.0,3,1.75,1510,5200,1.0,0,0,4,7,860,650,1922,0,98117,47.6864,-122.365,1650,4160,3690,2510,120.0,0.072,Very Cheap
20141217T000000,215000.0,5,1.5,1980,7958,1.5,0,0,3,7,1980,0,1962,0,98058,47.4571,-122.17,1510,8438,5978,6928,27.016838401608446,0.018360655737704918,Very Cheap
20140602T000000,870000.0,4,3.0,4500,21780,2.0,0,2,3,9,3040,1460,1980,0,98040,47.5581,-122.213,3540,20473,17280,16933,39.94490358126722,0.10426229508196722,Cheap
20140729T000000,440000.0,4,2.5,3220,8256,2.0,0,0,3,8,2610,610,2006,0,98059,47.495,-122.155,2500,9472,5036,6972,53.29457364341085,0.04786885245901639,Very Cheap
20150505T000000,518000.0,2,1.5,1140,1149,2.0,0,0,3,7,940,200,2001,0,98122,47.6124,-122.314,1460,1149,9,-311,450.82680591818973,0.0580983606557377,Very Cheap
20150325T000000,259500.0,3,2.25,1490,7589,2.0,0,0,3,7,1490,0,1993,0,98038,47.3474,-122.037,1510,6603,6099,5093,34.19422848860192,0.02419672131147541,Very Cheap
20141029T000000,795127.0,4,3.25,4360,91158,1.0,0,0,3,10,3360,1000,1993,0,98053,47.6398,-121.985,3540,90940,86798,87400,8.7225147546019,0.09444288524590164,Very Cheap
20140818T000000,290000.0,3,1.0,960,9000,1.0,0,0,4,7,960,0,1955,0,98006,47.5765,-122.154,1520,9000,8040,7480,32.22222222222222,0.02819672131147541,Very Cheap
20150423T000000,385000.0,4,3.0,2253,7700,2.0,0,0,3,7,2253,0,1957,2014,98198,47.3935,-122.3,1786,9052,5447,7266,50.0,0.04065573770491803,Very Cheap
20141007T000000,259950.0,2,1.0,770,6542,1.0,0,0,3,6,770,0,1948,0,98155,47.747,-122.301,1120,8149,5772,7029,39.73555487618465,0.024255737704918033,Very Cheap
20150429T000000,330000.0,2,2.5,1310,2915,2.0,0,0,3,8,1310,0,1999,0,98059,47.4911,-122.154,1310,3425,1605,2115,113.20754716981132,0.03344262295081967,Very Cheap
20141219T000000,280000.0,3,1.0,980,7480,1.0,0,0,3,6,830,150,1948,0,98106,47.5206,-122.363,1140,7480,6500,6340,37.4331550802139,0.026885245901639345,Very Cheap
20140701T000000,595000.0,4,2.5,1820,20011,2.0,0,0,3,8,1820,0,1987,0,98075,47.5842,-122.045,2710,33915,18191,31205,29.733646494428065,0.06819672131147542,Very Cheap
20141117T000000,925900.0,4,3.75,3980,7828,2.0,0,0,3,10,3980,0,2001,0,98074,47.6303,-122.065,3980,8910,3848,4930,118.2805314256515,0.11159344262295082,Cheap
20140808T000000,499000.0,3,2.25,3010,9600,2.0,0,0,3,8,2410,600,1978,0,98028,47.7671,-122.263,2620,9660,6590,7040,51.979166666666664,0.05560655737704918,Very Cheap
20150403T000000,325000.0,4,2.5,1830,7762,2.0,0,0,3,8,1830,0,1993,0,98003,47.267,-122.31,2109,8966,5932,6857,41.870651893841796,0.03278688524590164,Very Cheap
20140610T000000,895000.0,5,2.5,2550,20875,1.0,0,0,4,9,1610,940,1953,0,98004,47.6336,-122.192,2510,21673,18325,19163,42.874251497005986,0.10754098360655738,Cheap
20150429T000000,162248.0,2,1.0,800,8960,1.0,0,0,4,6,800,0,1944,0,98058,47.4756,-122.174,850,8082,8160,7232,18.108035714285716,0.011442360655737704,Very Cheap
20141015T000000,1072500.0,3,2.25,2890,21480,2.0,0,4,3,8,1790,1100,1941,1989,98146,47.5027,-122.381,2110,8107,18590,5997,49.93016759776536,0.13081967213114754,Cheap
20140703T000000,430000.0,3,1.5,1810,5080,1.0,0,0,3,7,1030,780,1958,0,98115,47.6819,-122.287,1780,7620,3270,5840,84.64566929133858,0.04655737704918033,Very Cheap
20150129T000000,615500.0,3,1.5,1810,5080,1.0,0,0,3,7,1030,780,1958,0,98115,47.6819,-122.287,1780,7620,3270,5840,121.16141732283465,0.07088524590163935,Very Cheap
20150416T000000,260000.0,3,1.0,940,5650,1.0,0,0,3,6,940,0,1949,0,98118,47.5551,-122.292,1180,5276,4710,4096,46.017699115044245,0.024262295081967214,Very Cheap
20141117T000000,295000.0,4,2.0,1810,42981,1.0,0,0,4,7,1810,0,1973,0,98024,47.5597,-121.85,1980,113691,41171,111711,6.863497824620181,0.028852459016393443,Very Cheap
20140924T000000,1186040.0,3,1.75,2550,6117,2.0,0,0,3,9,1650,900,1951,2004,98122,47.6109,-122.285,2100,4967,3567,2867,193.89243093019454,0.14571016393442623,Cheap
20141120T000000,749950.0,4,2.5,2370,2971,2.0,0,2,3,9,2080,290,2008,0,98034,47.7064,-122.224,2970,7500,601,4530,252.42342645573882,0.08851803278688525,Very Cheap
20140618T000000,175000.0,6,1.0,1370,5080,1.5,0,0,3,6,1120,250,1931,0,98106,47.5238,-122.35,1020,5080,3710,4060,34.44881889763779,0.013114754098360656,Very Cheap
20150120T000000,415000.0,6,1.0,1370,5080,1.5,0,0,3,6,1120,250,1931,0,98106,47.5238,-122.35,1020,5080,3710,4060,81.69291338582677,0.04459016393442623,Very Cheap
20141119T000000,190000.0,3,1.0,1200,8316,1.0,0,0,4,6,1200,0,1953,0,98002,47.3231,-122.215,1250,8316,7116,7066,22.847522847522846,0.015081967213114755,Very Cheap
20150417T000000,625000.0,3,1.75,2100,3264,1.5,0,0,5,7,1350,750,1912,0,98107,47.6702,-122.364,1720,3750,1164,2030,191.4828431372549,0.07213114754098361,Very Cheap
20140826T000000,420000.0,3,2.25,2020,21010,2.0,0,0,3,7,2020,0,1995,0,98014,47.6988,-121.915,1850,18151,18990,16301,19.990480723465016,0.04524590163934426,Very Cheap
20150416T000000,339900.0,4,1.5,1570,9210,1.0,0,2,3,7,1400,170,1965,0,98030,47.3864,-122.22,2326,9210,7640,6884,36.90553745928339,0.03474098360655738,Very Cheap
20150427T000000,160000.0,2,1.0,1140,23030,1.0,0,0,3,8,1140,0,1980,0,98028,47.7637,-122.266,1850,14260,21890,12410,6.9474598349978285,0.011147540983606558,Very Cheap
20141215T000000,353000.0,4,2.5,1830,5331,2.0,0,0,3,7,1830,0,2002,0,98038,47.3557,-122.016,1830,5175,3501,3345,66.21646970549615,0.03645901639344262,Very Cheap
20150206T000000,390000.0,3,2.0,1010,14183,1.0,0,0,3,8,1010,0,1982,0,98074,47.6232,-122.043,1750,11700,13173,9950,27.497708524289642,0.04131147540983607,Very Cheap
20150305T000000,675000.0,4,2.5,1770,9858,1.0,0,2,3,8,1770,0,1971,0,98155,47.7382,-122.287,2470,9858,8088,7388,68.47230675593427,0.07868852459016394,Very Cheap
20150313T000000,400000.0,3,2.5,2120,3757,2.0,0,0,3,7,2120,0,2006,0,98059,47.4787,-122.128,2230,4103,1637,1873,106.4679265371307,0.04262295081967213,Very Cheap
20140626T000000,1340000.0,4,3.5,3190,5040,2.0,0,3,3,10,2160,1030,2003,0,98144,47.5928,-122.29,2390,4800,1850,2410,265.87301587301585,0.1659016393442623,Cheap
20150209T000000,1650000.0,4,2.5,2780,11904,1.0,0,1,5,8,1730,1050,1951,0,98004,47.6209,-122.216,3590,13860,9124,10270,138.60887096774192,0.20655737704918034,Cheap
20140825T000000,1000000.0,5,3.0,3350,9450,2.0,0,0,5,8,2180,1170,1912,1980,98103,47.6705,-122.34,2660,4500,6100,1840,105.82010582010582,0.12131147540983607,Cheap
20140618T000000,850000.0,5,3.5,3450,28324,1.0,0,0,5,8,2350,1100,1972,0,98033,47.6991,-122.196,2640,14978,24874,12338,30.009885609377207,0.10163934426229508,Cheap
20140715T000000,275000.0,3,1.5,1060,6954,1.0,0,0,4,6,1060,0,1983,0,98106,47.5498,-122.355,1560,6954,5894,5394,39.545585274662066,0.02622950819672131,Very Cheap
20140813T000000,450000.0,3,2.5,1670,2589,2.0,0,0,3,8,1670,0,2000,0,98027,47.5314,-122.047,1670,2897,919,1227,173.81228273464657,0.04918032786885246,Very Cheap
20141113T000000,305000.0,4,1.75,2251,12731,1.0,0,1,4,8,1390,861,1957,0,98003,47.3369,-122.32,2520,12539,10480,10019,23.95726965674338,0.03016393442622951,Very Cheap
20140902T000000,643002.0,3,2.5,1770,3744,1.5,0,0,3,7,1270,500,1929,0,98117,47.6807,-122.364,1400,4680,1974,3280,171.74198717948718,0.07449206557377049,Very Cheap
20150413T000000,468000.0,2,1.75,1510,4500,1.0,0,0,3,8,1510,0,1978,0,98052,47.6644,-122.13,1740,6000,2990,4260,104.0,0.05154098360655738,Very Cheap
20150220T000000,324950.0,4,2.5,1770,5000,2.0,0,0,3,7,1770,0,2004,0,98038,47.3506,-122.006,2080,5100,3230,3020,64.99,0.03278032786885246,Very Cheap
20150326T000000,290000.0,3,2.0,1260,7346,1.0,0,0,3,7,1260,0,1987,0,98031,47.4034,-122.176,1460,7363,6086,5903,39.477266539613396,0.02819672131147541,Very Cheap
20150429T000000,488500.0,3,2.0,1710,10959,1.0,0,0,4,7,1030,680,1981,0,98033,47.697,-122.199,1710,10498,9249,8788,44.57523496669404,0.05422950819672131,Very Cheap
20140813T000000,367950.0,3,1.75,2290,8234,1.0,0,0,4,7,1250,1040,1950,0,98133,47.7611,-122.351,1660,7200,5944,5540,44.686665047364585,0.03841967213114754,Very Cheap
20150220T000000,285000.0,2,1.0,790,6555,1.0,0,0,2,6,790,0,1956,0,98146,47.5015,-122.35,1440,7601,5765,6161,43.47826086956522,0.02754098360655738,Very Cheap
20150410T000000,417000.0,3,2.75,1820,52889,2.0,0,0,3,8,1820,0,1991,0,98070,47.501,-122.463,1820,45528,51069,43708,7.884437217568871,0.04485245901639344,Very Cheap
20140708T000000,1115000.0,4,2.5,3180,31931,1.0,0,0,4,10,2390,790,1978,0,98007,47.6388,-122.149,3180,35007,28751,31827,34.919044189032604,0.13639344262295083,Cheap
20150422T000000,1550000.0,4,4.0,5280,17677,2.0,0,3,3,11,3220,2060,1978,0,98040,47.5323,-122.238,3470,17474,12397,14004,87.68456186004413,0.19344262295081968,Cheap
20140502T000000,604000.0,3,2.5,3240,33151,2.0,0,2,3,10,3240,0,1995,0,98023,47.3256,-122.378,4050,24967,29911,20917,18.219661548671233,0.06937704918032787,Very Cheap
20150428T000000,380000.0,3,2.5,2390,8102,2.0,0,0,4,8,2390,0,1986,0,98058,47.4378,-122.16,2310,8606,5712,6296,46.90199950629474,0.04,Very Cheap
20141116T000000,336500.0,4,2.5,2500,5264,2.0,0,0,3,7,2500,0,2003,0,98038,47.3853,-122.028,1960,5250,2764,3290,63.92477203647417,0.03429508196721311,Very Cheap
20150218T000000,685000.0,4,2.0,2290,6000,1.5,0,3,5,7,2290,0,1900,0,98115,47.6807,-122.318,2000,3150,3710,1150,114.16666666666667,0.08,Very Cheap
20150506T000000,4208000.0,5,6.0,7440,21540,2.0,0,0,3,12,5550,1890,2003,0,98006,47.5692,-122.189,4740,19329,14100,14589,195.35747446610955,0.5420327868852459,Very High
20141211T000000,670000.0,3,1.0,1600,16868,1.0,0,1,3,7,990,610,1946,0,98040,47.5872,-122.241,2600,12735,15268,10135,39.72018022290728,0.0780327868852459,Very Cheap
20140616T000000,524000.0,2,1.0,1120,2000,1.5,0,0,3,7,1120,0,1910,0,98109,47.6454,-122.354,1500,4000,880,2500,262.0,0.05888524590163934,Very Cheap
20141211T000000,172000.0,3,1.0,1340,10260,1.0,0,0,3,7,1340,0,1968,0,98003,47.3173,-122.317,1250,8775,8920,7525,16.764132553606238,0.012721311475409836,Very Cheap
20140619T000000,680000.0,6,2.0,1670,3000,1.0,0,0,5,7,900,770,1911,0,98105,47.6637,-122.316,1330,1099,1330,-231,226.66666666666666,0.07934426229508197,Very Cheap
20140523T000000,549900.0,4,3.0,2830,213879,2.0,0,0,4,8,2830,0,1987,0,98092,47.2925,-122.107,2250,213008,211049,210758,2.571079909668551,0.062281967213114756,Very Cheap
20141205T000000,357000.0,4,2.75,2700,49428,1.0,0,0,4,9,2700,0,1988,0,98042,47.3168,-122.079,2728,85905,46728,83177,7.22262685117747,0.03698360655737705,Very Cheap
20140828T000000,107000.0,3,1.5,910,5120,1.0,0,0,3,6,910,0,1973,0,98106,47.5238,-122.356,1410,5132,4210,3722,20.8984375,0.00419672131147541,Very Cheap
20141202T000000,232900.0,3,1.5,910,5120,1.0,0,0,3,6,910,0,1973,0,98106,47.5238,-122.356,1410,5132,4210,3722,45.48828125,0.020708196721311474,Very Cheap
20150112T000000,800000.0,4,3.5,2370,3302,2.0,0,0,3,8,1610,760,1926,2014,98103,47.684,-122.341,2170,3800,932,1630,242.27740763173833,0.09508196721311475,Very Cheap
20150327T000000,248500.0,2,1.5,880,1498,2.0,0,0,3,7,880,0,1999,0,98133,47.7063,-122.342,880,5060,618,4180,165.88785046728972,0.02275409836065574,Very Cheap
20140612T000000,670000.0,3,2.5,2050,6420,1.0,0,3,3,8,1730,320,1956,0,98116,47.5708,-122.405,2370,7620,4370,5250,104.3613707165109,0.0780327868852459,Very Cheap
20150227T000000,207000.0,3,1.75,1180,21275,1.0,0,0,4,6,1180,0,1958,0,98038,47.4018,-122.037,1490,35100,20095,33610,9.72972972972973,0.017311475409836064,Very Cheap
20141103T000000,164000.0,3,1.0,1070,8250,1.0,0,0,3,7,1070,0,1961,0,98092,47.2899,-122.192,1190,8250,7180,7060,19.87878787878788,0.011672131147540983,Very Cheap
20150217T000000,570500.0,2,1.0,1380,1800,2.0,0,0,3,7,1080,300,1954,0,98119,47.6416,-122.361,1600,3600,420,2000,316.94444444444446,0.06498360655737705,Very Cheap
20140625T000000,599990.0,3,2.25,2680,9162,1.0,0,0,3,8,1570,1110,1978,0,98027,47.5683,-122.091,2480,8261,6482,5781,65.48679327657716,0.0688511475409836,Very Cheap
20141006T000000,395000.0,5,1.75,2100,9599,1.0,0,0,3,7,1060,1040,1961,0,98034,47.7097,-122.216,1680,10712,7499,9032,41.150119804146264,0.0419672131147541,Very Cheap
20140827T000000,979500.0,4,3.75,4133,361548,2.0,0,0,3,11,4133,0,2000,0,98019,47.7479,-121.972,1970,291416,357415,289446,2.7091838428092534,0.11862295081967213,Cheap
20140929T000000,207000.0,3,1.0,920,5546,1.0,0,0,2,6,920,0,1928,0,98125,47.7114,-122.284,1300,5546,4626,4246,37.324197619906236,0.017311475409836064,Very Cheap
20150112T000000,237000.0,3,1.0,920,5546,1.0,0,0,2,6,920,0,1928,0,98125,47.7114,-122.284,1300,5546,4626,4246,42.7335016227912,0.021245901639344263,Very Cheap
20150410T000000,650100.0,2,1.0,1750,60872,1.0,0,0,4,7,1180,570,1973,0,98075,47.5946,-122.006,2480,5425,59122,2945,10.679787094230516,0.07542295081967212,Very Cheap
20141201T000000,385000.0,4,2.5,1950,7350,1.0,0,0,3,7,1150,800,1963,0,98052,47.656,-122.134,2050,9068,5400,7018,52.38095238095238,0.04065573770491803,Very Cheap
20140813T000000,335000.0,2,1.75,1660,11437,2.0,0,0,3,7,1660,0,1958,1992,98146,47.4899,-122.339,1290,7860,9777,6570,29.29089796275247,0.03409836065573771,Very Cheap
20140524T000000,347000.0,4,1.5,2670,10026,2.0,0,0,3,8,2670,0,1996,0,98092,47.2659,-122.215,2420,11900,7356,9480,34.61001396369439,0.03567213114754098,Very Cheap
20150326T000000,204000.0,3,1.0,980,8000,1.0,0,0,4,6,980,0,1954,0,98198,47.42,-122.317,1240,8000,7020,6760,25.5,0.016918032786885247,Very Cheap
20150507T000000,615000.0,4,2.25,1780,10260,2.0,0,0,3,8,1780,0,1971,0,98052,47.6647,-122.142,2360,10080,8480,7720,59.941520467836256,0.07081967213114754,Very Cheap
20141028T000000,943500.0,3,2.25,2370,10890,2.0,0,0,4,7,2370,0,1980,0,98004,47.5827,-122.197,2370,9514,8520,7144,86.63911845730027,0.1139016393442623,Cheap
20150423T000000,560000.0,3,2.0,1640,7333,1.0,0,0,4,7,1020,620,1941,0,98108,47.5636,-122.316,2130,4933,5693,2803,76.36710759579981,0.06360655737704918,Very Cheap
20150407T000000,547500.0,4,2.5,2610,7254,1.0,0,0,2,8,1610,1000,1975,0,98006,47.5618,-122.176,2250,7407,4644,5157,75.47559966914805,0.061967213114754095,Very Cheap
20141010T000000,359500.0,4,1.75,2030,7210,1.0,0,0,3,7,1450,580,1968,0,98059,47.5067,-122.164,1750,8387,5180,6637,49.86130374479889,0.037311475409836065,Very Cheap
20150401T000000,660000.0,3,2.5,2590,35640,1.0,0,0,3,9,2590,0,1987,0,98029,47.5516,-122.03,2590,31200,33050,28610,18.51851851851852,0.07672131147540984,Very Cheap
20140523T000000,258000.0,3,1.75,1620,7540,1.0,0,0,3,7,1310,310,1988,0,98038,47.3635,-122.052,1580,7540,5920,5960,34.217506631299734,0.024,Very Cheap
20140627T000000,355000.0,3,1.75,2040,22693,1.0,0,0,4,8,2040,0,1980,0,98042,47.3519,-122.14,1950,6280,20653,4330,15.643590534526066,0.036721311475409836,Very Cheap
20140606T000000,253500.0,2,1.0,810,4800,1.0,0,0,3,7,810,0,1948,0,98126,47.5232,-122.375,1240,7740,3990,6500,52.8125,0.023409836065573772,Very Cheap
20150415T000000,422500.0,3,1.0,1270,8920,1.0,0,0,5,7,1270,0,1969,0,98056,47.534,-122.172,1590,8589,7650,6999,47.365470852017935,0.04557377049180328,Very Cheap
20141113T000000,239000.0,2,2.0,1470,2052,1.5,0,0,3,7,1470,0,1986,0,98003,47.3086,-122.328,1470,2052,582,582,116.47173489278752,0.021508196721311476,Very Cheap
20150403T000000,628000.0,3,2.25,1720,8521,1.0,0,0,4,7,1140,580,1984,0,98033,47.6882,-122.184,1530,8692,6801,7162,73.70026992137073,0.07252459016393442,Very Cheap
20150310T000000,352000.0,2,2.5,1320,1957,1.0,0,0,3,8,660,660,2004,0,98106,47.5364,-122.365,1420,2198,637,778,179.86714358712314,0.03632786885245902,Very Cheap
20150203T000000,311600.0,3,2.25,1358,1196,3.0,0,0,3,7,1358,0,2007,0,98133,47.7052,-122.346,1358,1196,-162,-162,260.53511705685617,0.03102950819672131,Very Cheap
20141009T000000,235000.0,4,1.5,2070,7245,1.0,0,0,4,7,1060,1010,1964,0,98001,47.3417,-122.281,1450,7350,5175,5900,32.43616287094548,0.02098360655737705,Very Cheap
20140811T000000,870000.0,5,2.25,2910,9525,2.0,0,0,4,9,2910,0,1968,0,98040,47.5633,-122.218,2740,9525,6615,6785,91.33858267716535,0.10426229508196722,Cheap
20150319T000000,190848.0,4,1.5,1370,7904,1.0,0,0,3,7,900,470,1970,0,98001,47.3344,-122.28,1370,7900,6534,6530,24.14574898785425,0.015193180327868852,Very Cheap
20141001T000000,570000.0,4,1.75,2340,5080,1.0,0,0,5,7,1170,1170,1924,0,98115,47.6746,-122.32,1270,3270,2740,2000,112.20472440944881,0.06491803278688525,Very Cheap
20140523T000000,661254.0,4,4.0,2290,6250,1.5,0,0,5,7,1690,600,1940,0,98116,47.5824,-122.384,1920,4335,3960,2415,105.80064,0.07688577049180328,Very Cheap
20140507T000000,575000.0,4,2.0,1650,5000,1.0,0,0,3,7,1650,0,1955,0,98117,47.6781,-122.374,1690,2276,3350,586,115.0,0.06557377049180328,Very Cheap
20140513T000000,230000.0,2,0.75,650,5360,1.0,0,0,4,5,650,0,1931,0,98133,47.7281,-122.335,1110,6700,4710,5590,42.91044776119403,0.020327868852459016,Very Cheap
20150402T000000,680000.0,3,2.25,2300,9914,2.0,0,0,4,8,2300,0,1980,0,98027,47.5677,-122.086,2240,9032,7614,6792,68.5898729070002,0.07934426229508197,Very Cheap
20140611T000000,148000.0,1,1.0,620,8261,1.0,0,0,3,5,620,0,1939,0,98106,47.5138,-122.364,1180,8244,7641,7064,17.915506597264255,0.00957377049180328,Very Cheap
20141208T000000,244900.0,1,1.0,620,8261,1.0,0,0,3,5,620,0,1939,0,98106,47.5138,-122.364,1180,8244,7641,7064,29.645321389662268,0.022281967213114755,Very Cheap
20141030T000000,214950.0,3,1.0,1400,6600,1.0,0,0,3,6,1280,120,1954,0,98168,47.4845,-122.331,1730,6600,5200,4870,32.56818181818182,0.018354098360655737,Very Cheap
20141030T000000,580000.0,3,1.5,1800,6250,1.0,0,0,3,8,1420,380,1947,0,98116,47.5778,-122.389,1800,5625,4450,3825,92.8,0.06622950819672131,Very Cheap
20140828T000000,263000.0,3,1.5,1300,7885,1.0,0,0,3,7,1300,0,1968,0,98055,47.4556,-122.209,1840,7600,6585,5760,33.35447051363348,0.024655737704918034,Very Cheap
20140624T000000,317000.0,5,2.5,2360,11375,1.0,0,0,4,7,1180,1180,1962,0,98178,47.4875,-122.255,1160,7800,9015,6640,27.86813186813187,0.03173770491803279,Very Cheap
20141022T000000,302000.0,4,3.0,3320,13500,1.0,0,0,3,7,1750,1570,1963,0,98059,47.4596,-122.065,1830,13800,10180,11970,22.37037037037037,0.02977049180327869,Very Cheap
20140623T000000,899000.0,3,1.0,1480,6978,2.0,0,0,4,8,1480,0,1949,1985,98004,47.6497,-122.217,2660,13062,5498,10402,128.8334766408713,0.10806557377049181,Cheap
20140623T000000,1289000.0,3,2.5,2190,11394,1.0,0,0,3,8,1550,640,1956,0,98199,47.6685,-122.409,2190,9540,9204,7350,113.12971739512024,0.15921311475409836,Cheap
20140626T000000,710000.0,3,3.25,3740,136915,2.5,0,0,3,11,3100,640,1990,0,98166,47.4549,-122.363,2400,16104,133175,13704,5.185699156410912,0.08327868852459017,Very Cheap
20141107T000000,230000.0,3,1.0,1360,9310,1.0,0,0,4,7,1020,340,1980,0,98056,47.4901,-122.185,1480,8330,7950,6850,24.704618689581096,0.020327868852459016,Very Cheap
20150504T000000,430000.0,3,1.0,1210,5200,1.0,0,0,3,6,1210,0,1941,0,98126,47.531,-122.373,890,5200,3990,4310,82.6923076923077,0.04655737704918033,Very Cheap
20140818T000000,1169000.0,5,4.25,4610,13252,2.0,0,4,3,11,4610,0,2004,0,98075,47.5878,-121.969,4400,15154,8642,10754,88.21309990944764,0.14347540983606558,Cheap
20141014T000000,397000.0,3,1.0,860,6380,1.5,0,0,4,7,860,0,1927,0,98115,47.6942,-122.315,1250,6380,5520,5130,62.225705329153605,0.04222950819672131,Very Cheap
20150225T000000,595000.0,3,2.5,2250,8300,2.0,0,0,3,8,2250,0,2003,0,98125,47.7174,-122.308,1790,7626,6050,5836,71.6867469879518,0.06819672131147542,Very Cheap
20150310T000000,485000.0,3,1.75,2030,10089,1.0,0,0,4,8,1330,700,1976,0,98027,47.5217,-122.05,2030,9827,8059,7797,48.07215779561899,0.05377049180327869,Very Cheap
20140627T000000,755000.0,5,2.5,3260,24300,1.5,0,1,4,8,2310,950,1950,0,98155,47.7587,-122.274,2390,32057,21040,29667,31.069958847736626,0.08918032786885247,Very Cheap
20140606T000000,185000.0,3,1.0,1840,8100,1.0,0,0,4,7,920,920,1953,0,98166,47.455,-122.35,1250,8100,6260,6850,22.839506172839506,0.014426229508196721,Very Cheap
20150219T000000,340000.0,3,1.0,1840,8100,1.0,0,0,4,7,920,920,1953,0,98166,47.455,-122.35,1250,8100,6260,6850,41.97530864197531,0.03475409836065574,Very Cheap
20140624T000000,236000.0,4,2.75,2000,5827,2.0,0,0,3,7,2000,0,1997,0,98038,47.3629,-122.026,1710,6929,3827,5219,40.50111549682512,0.021114754098360656,Very Cheap
20140919T000000,550000.0,4,2.5,2810,7549,2.0,0,0,3,9,2810,0,1992,0,98072,47.7441,-122.173,2750,7642,4739,4892,72.85733209696649,0.06229508196721312,Very Cheap
20140709T000000,680000.0,3,2.0,1780,5720,1.0,0,0,5,7,980,800,1925,0,98103,47.6794,-122.351,1620,5050,3940,3430,118.88111888111888,0.07934426229508197,Very Cheap
20150421T000000,630000.0,4,2.5,2540,8706,2.0,0,0,3,9,2540,0,1997,0,98075,47.5855,-122.031,2540,6239,6166,3699,72.36388697450035,0.07278688524590164,Very Cheap
20140617T000000,560000.0,3,2.0,2340,3477,1.0,0,1,5,7,1170,1170,1971,0,98118,47.54,-122.267,2110,6300,1137,4190,161.05838366407824,0.06360655737704918,Very Cheap
20140513T000000,385000.0,3,2.0,1480,6600,1.0,0,2,3,7,740,740,1943,0,98146,47.5081,-122.385,1250,7300,5120,6050,58.333333333333336,0.04065573770491803,Very Cheap
20141022T000000,280000.0,3,2.25,1358,1141,3.0,0,0,3,7,1358,0,2007,0,98133,47.7052,-122.346,1358,1196,-217,-162,245.39877300613497,0.026885245901639345,Very Cheap
20140825T000000,225000.0,3,2.5,1750,7490,1.0,0,0,4,7,1180,570,1979,0,98042,47.3746,-122.149,1570,7490,5740,5920,30.040053404539385,0.019672131147540985,Very Cheap
20140605T000000,610000.0,4,1.75,1830,29110,2.0,0,0,3,8,1230,600,1990,0,98040,47.5449,-122.215,3630,16488,27280,12858,20.95499828237719,0.07016393442622951,Very Cheap
20141209T000000,592500.0,3,2.0,1170,6750,1.0,0,0,5,7,800,370,1947,0,98115,47.6752,-122.281,1330,6750,5580,5420,87.77777777777777,0.06786885245901639,Very Cheap
20141009T000000,750000.0,4,2.75,3170,7634,2.0,0,0,3,10,3170,0,1992,0,98075,47.5774,-122.054,2940,7846,4464,4906,98.24469478648153,0.08852459016393442,Very Cheap
20141023T000000,164000.0,4,1.0,1530,4875,2.0,0,0,3,7,1530,0,1977,0,98042,47.3638,-122.091,1470,4875,3345,3405,33.64102564102564,0.011672131147540983,Very Cheap
20140612T000000,320000.0,2,1.0,1100,8281,1.0,0,0,4,7,1100,0,1947,0,98155,47.7414,-122.315,1510,8281,7181,6771,38.64267600531337,0.032131147540983604,Very Cheap
20140625T000000,544000.0,4,2.5,2030,3974,2.0,0,0,3,8,2030,0,1994,0,98029,47.5692,-122.006,1780,3953,1944,2173,136.8897835933568,0.06150819672131148,Very Cheap
20140909T000000,344950.0,3,1.75,1870,7500,1.0,0,0,5,8,1320,550,1978,0,98058,47.4428,-122.134,1870,7275,5630,5405,45.99333333333333,0.03540327868852459,Very Cheap
20140606T000000,539500.0,3,2.5,3080,12476,2.0,0,0,3,10,3080,0,1990,0,98038,47.3752,-122.029,3130,13631,9396,10501,43.2430266110933,0.06091803278688525,Very Cheap
20150417T000000,420000.0,4,1.75,2480,60548,1.0,0,0,4,7,1600,880,1968,0,98027,47.4722,-122.001,2390,90169,58068,87779,6.936645306203343,0.04524590163934426,Very Cheap
20150402T000000,305000.0,2,1.0,910,22725,1.0,0,0,1,6,910,0,1926,0,98155,47.7712,-122.299,2000,14566,21815,12566,13.421342134213422,0.03016393442622951,Very Cheap
20141201T000000,229000.0,2,1.0,810,5100,1.0,0,0,3,6,810,0,1955,0,98133,47.7317,-122.343,1500,5100,4290,3600,44.90196078431372,0.02019672131147541,Very Cheap
20140619T000000,1068000.0,5,3.5,3990,9938,2.0,0,0,3,11,3990,0,2001,0,98059,47.5198,-122.156,3490,11734,5948,8244,107.4662910042262,0.1302295081967213,Cheap
20140808T000000,397500.0,3,2.25,1430,1383,3.0,0,0,3,8,1430,0,2005,0,98103,47.6917,-122.341,1430,1347,-47,-83,287.4186550976139,0.04229508196721311,Very Cheap
20150401T000000,540000.0,4,2.0,2190,8402,2.0,0,0,4,6,2190,0,1928,0,98033,47.6944,-122.175,2210,7802,6212,5592,64.27041180671269,0.06098360655737705,Very Cheap
20140923T000000,650000.0,4,2.5,2290,10186,2.0,0,0,3,8,2290,0,1985,0,98008,47.6353,-122.124,2150,10186,7896,8036,63.813076772040056,0.07540983606557378,Very Cheap
20140724T000000,1900000.0,6,4.0,3020,13237,2.0,1,4,3,8,2840,180,1942,1983,98144,47.5924,-122.287,3680,12620,10217,8940,143.53705522399335,0.23934426229508196,Cheap
20140623T000000,649000.0,2,1.75,2260,280962,2.0,0,2,3,9,1890,370,2005,0,98014,47.6359,-121.94,2860,219542,278702,216682,2.309920914572077,0.07527868852459016,Very Cheap
20150325T000000,287500.0,5,2.0,2020,67953,1.5,0,0,4,7,1620,400,1936,0,98178,47.4891,-122.263,1270,13198,65933,11928,4.230865451120628,0.027868852459016394,Very Cheap
20140626T000000,815000.0,4,2.75,2620,4743,1.0,0,2,4,8,1310,1310,1949,0,98117,47.6829,-122.4,1900,4764,2123,2864,171.83217372970694,0.09704918032786886,Very Cheap
20141209T000000,795000.0,2,2.5,2830,8630,2.0,0,0,3,10,2830,0,2001,0,98074,47.6481,-122.081,3190,7515,5800,4325,92.12050984936269,0.09442622950819672,Very Cheap
20150130T000000,502775.0,3,1.75,1700,9840,1.0,0,0,4,8,1200,500,1976,0,98027,47.5192,-122.046,2040,14169,8140,12129,51.09502032520325,0.056101639344262294,Very Cheap
20150112T000000,222900.0,2,1.0,1110,6411,1.0,0,0,3,6,1110,0,1944,0,98178,47.4962,-122.242,1150,6504,5301,5354,34.76836686944314,0.01939672131147541,Very Cheap
20141203T000000,399950.0,4,3.0,2150,64694,1.0,0,0,3,8,1450,700,1969,0,98023,47.3268,-122.388,2430,59612,62544,57182,6.1821807277336385,0.04261639344262295,Very Cheap
20140823T000000,728000.0,4,2.5,2650,13684,2.0,0,0,3,9,2650,0,1994,0,98052,47.6278,-122.108,2650,12032,11034,9382,53.20081847413037,0.08563934426229508,Very Cheap
20140929T000000,850000.0,5,3.5,3870,65556,2.0,0,0,3,10,3870,0,1994,0,98053,47.6403,-121.992,4290,67019,61686,62729,12.96601378973702,0.10163934426229508,Cheap
20141002T000000,525000.0,4,2.75,2530,17856,2.0,0,0,3,8,2530,0,1998,0,98019,47.7356,-121.959,2530,14640,15326,12110,29.401881720430108,0.05901639344262295,Very Cheap
20140903T000000,257000.0,3,1.0,1450,7850,1.5,0,0,5,7,1450,0,1910,0,98055,47.4299,-122.199,1360,10400,6400,9040,32.738853503184714,0.023868852459016394,Very Cheap
20140519T000000,433500.0,3,2.5,2200,3360,2.0,0,0,3,8,2200,0,2009,0,98118,47.5418,-122.287,2130,3423,1160,1293,129.01785714285714,0.04701639344262295,Very Cheap
20150423T000000,314950.0,4,1.75,1890,9623,1.0,0,0,4,7,1290,600,1969,0,98001,47.2901,-122.279,1510,9711,7733,8201,32.728878728047384,0.03146885245901639,Very Cheap
20140922T000000,500000.0,3,1.75,1530,14633,1.0,0,0,3,7,1100,430,1977,0,98052,47.6949,-122.119,1780,8100,13103,6320,34.169343265222444,0.05573770491803279,Very Cheap
20140627T000000,300000.0,3,1.5,1590,8911,1.0,0,0,3,7,1590,0,1956,0,98028,47.7394,-122.252,1590,9625,7321,8035,33.66625519021434,0.029508196721311476,Very Cheap
20140707T000000,645000.0,4,2.5,2690,18653,2.0,0,0,3,8,2690,0,1985,0,98074,47.6449,-122.059,2230,9744,15963,7514,34.57888811451241,0.07475409836065573,Very Cheap
20141002T000000,222500.0,3,1.0,990,10125,1.0,0,0,3,7,990,0,1972,0,98042,47.3422,-122.089,1360,10125,9135,8765,21.97530864197531,0.019344262295081967,Very Cheap
20140715T000000,275000.0,3,1.75,1300,8099,1.0,0,0,4,7,1080,220,1976,0,98056,47.5026,-122.172,1270,8099,6799,6829,33.95480923570811,0.02622950819672131,Very Cheap
20150416T000000,498000.0,3,1.5,1720,6570,1.5,0,0,4,8,1720,0,1909,0,98118,47.5284,-122.265,1360,6000,4850,4640,75.79908675799086,0.055475409836065574,Very Cheap
20140626T000000,800000.0,3,1.75,2080,75794,1.0,0,0,3,7,2080,0,1958,0,98033,47.7018,-122.189,1870,11020,73714,9150,10.554925191967701,0.09508196721311475,Very Cheap
20140814T000000,297000.0,3,2.5,1840,8234,2.0,0,0,3,8,1840,0,1994,0,98003,47.267,-122.312,1940,7601,6394,5661,36.069953849890695,0.029114754098360656,Very Cheap
20150512T000000,625000.0,5,3.5,4010,6000,2.0,0,3,3,9,2560,1450,1997,0,98178,47.4928,-122.229,2440,6000,1990,3560,104.16666666666667,0.07213114754098361,Very Cheap
20141030T000000,770000.0,4,2.5,3560,6187,2.0,0,0,3,9,3560,0,2003,0,98029,47.5593,-122.016,3190,6981,2627,3791,124.45450137384839,0.09114754098360656,Very Cheap
20140917T000000,517000.0,3,2.25,1640,4635,1.5,0,0,3,8,1540,100,1930,0,98115,47.6793,-122.319,1530,4635,2995,3105,111.54261057173679,0.0579672131147541,Very Cheap
20140829T000000,238000.0,1,1.0,530,6350,1.0,0,0,5,5,530,0,1941,0,98103,47.6946,-122.357,1200,6350,5820,5150,37.48031496062992,0.02137704918032787,Very Cheap
20141021T000000,234550.0,3,1.0,1990,15375,1.0,0,0,3,7,1140,850,1946,0,98168,47.4778,-122.288,1160,10236,13385,9076,15.255284552845529,0.020924590163934425,Very Cheap
20140929T000000,230500.0,3,2.25,1690,7245,1.0,0,1,3,7,1160,530,1973,0,98003,47.3505,-122.305,1690,6720,5555,5030,31.81504485852312,0.02039344262295082,Very Cheap
20140628T000000,585000.0,5,2.5,2670,16777,1.5,0,0,4,7,1620,1050,1920,0,98125,47.7015,-122.301,1610,8227,14107,6617,34.86916612028372,0.06688524590163934,Very Cheap
20140822T000000,733000.0,4,1.75,1930,3876,1.5,0,0,5,7,1450,480,1924,0,98105,47.6604,-122.324,1280,3825,1946,2545,189.1124871001032,0.08629508196721311,Very Cheap
20141114T000000,357950.0,2,1.0,810,3880,1.0,0,0,3,7,810,0,1952,0,98107,47.6631,-122.365,900,4365,3070,3465,92.25515463917526,0.03710819672131148,Very Cheap
20140611T000000,530000.0,3,1.75,1550,3680,1.0,0,0,3,7,1050,500,1927,0,98117,47.6817,-122.36,1560,4000,2130,2440,144.02173913043478,0.05967213114754098,Very Cheap
20141229T000000,377500.0,4,2.5,2640,10720,2.0,0,0,3,8,2640,0,1999,0,98188,47.4485,-122.278,1680,10018,8080,8338,35.21455223880597,0.039672131147540986,Very Cheap
20150206T000000,475000.0,4,2.5,2320,10046,2.0,0,0,3,7,2320,0,2006,0,98065,47.5406,-121.887,2320,5253,7726,2933,47.28250049771053,0.05245901639344262,Very Cheap
20150508T000000,399000.0,3,1.75,2170,73616,1.0,0,0,3,7,2170,0,2008,0,98092,47.2881,-122.086,1710,297514,71446,295804,5.420017387524451,0.042491803278688525,Very Cheap
20141126T000000,660000.0,3,2.0,2080,5750,1.0,0,0,5,7,1040,1040,1926,0,98116,47.5791,-122.392,1710,4830,3670,3120,114.78260869565217,0.07672131147540984,Very Cheap
20141007T000000,400000.0,5,2.25,2070,10488,1.0,0,0,4,7,1080,990,1958,0,98008,47.6095,-122.122,1740,9225,8418,7485,38.13882532418002,0.04262295081967213,Very Cheap
20140502T000000,440000.0,2,1.0,800,4850,1.0,0,0,4,7,800,0,1944,0,98107,47.6639,-122.364,1150,4365,4050,3215,90.72164948453609,0.04786885245901639,Very Cheap
20150206T000000,366400.0,4,2.25,2040,14383,1.0,0,0,4,8,1270,770,1977,0,98042,47.3849,-122.163,2030,11500,12343,9470,25.474518528818745,0.03821639344262295,Very Cheap
20150320T000000,627250.0,4,2.5,2830,10677,2.0,0,0,3,9,2830,0,1993,0,98011,47.742,-122.208,2970,9619,7847,6649,58.747775592394866,0.07242622950819672,Very Cheap
20140730T000000,375950.0,3,1.75,1480,7560,1.0,0,0,3,6,1100,380,1920,1985,98117,47.6985,-122.364,1510,7250,6080,5740,49.72883597883598,0.03946885245901639,Very Cheap
20150218T000000,162000.0,3,2.25,1810,6750,1.0,0,0,3,7,1280,530,1978,0,98023,47.2976,-122.377,1690,7770,4940,6080,24.0,0.01140983606557377,Very Cheap
20140724T000000,780000.0,3,2.75,1970,2600,2.5,0,0,3,8,1970,0,1924,1994,98103,47.663,-122.335,1680,3120,630,1440,300.0,0.09245901639344262,Very Cheap
20140507T000000,705000.0,4,2.5,2650,4316,1.5,0,0,3,8,1520,1130,1905,2013,98116,47.5866,-122.389,1690,5625,1666,3935,163.3456904541242,0.08262295081967214,Very Cheap
20141223T000000,450000.0,4,2.5,2820,15233,1.0,0,2,4,9,1820,1000,1972,0,98003,47.3426,-122.321,2560,11998,12413,9438,29.541127814613013,0.04918032786885246,Very Cheap
20141117T000000,311000.0,3,2.75,1400,7880,1.0,0,0,3,7,1000,400,1981,0,98056,47.5095,-122.193,1400,7279,6480,5879,39.46700507614213,0.030950819672131147,Very Cheap
20140613T000000,485000.0,3,2.5,1580,6065,2.0,0,0,3,8,1580,0,1985,0,98029,47.5692,-122.021,1770,6700,4485,4930,79.96702390766694,0.05377049180327869,Very Cheap
20140716T000000,485000.0,3,2.5,1800,11034,2.0,0,0,4,8,1800,0,1987,0,98072,47.7558,-122.142,1940,8900,9234,6960,43.95504803335146,0.05377049180327869,Very Cheap
20141010T000000,725000.0,5,3.75,3360,6000,2.0,0,0,3,8,2640,720,1963,1999,98118,47.558,-122.277,1930,6000,2640,4070,120.83333333333333,0.08524590163934426,Very Cheap
20140715T000000,185000.0,3,1.0,1510,17040,1.0,0,0,4,6,1510,0,1975,0,98001,47.2649,-122.285,1520,14000,15530,12480,10.85680751173709,0.014426229508196721,Very Cheap
20141201T000000,1890000.0,4,4.25,4285,9345,2.0,0,0,3,10,4285,0,2013,0,98004,47.6332,-122.199,1570,8994,5060,7424,202.24719101123594,0.2380327868852459,Cheap
20150508T000000,260000.0,3,2.25,1610,7423,2.0,0,0,4,7,1610,0,1990,0,98042,47.3713,-122.091,1530,8102,5813,6572,35.02626970227671,0.024262295081967214,Very Cheap
20150430T000000,356000.0,4,2.5,2470,5074,2.0,0,0,3,8,2470,0,2004,0,98038,47.3457,-122.041,2470,5078,2604,2608,70.16160819865983,0.03685245901639344,Very Cheap
20150319T000000,225205.0,3,1.0,1200,7220,1.0,0,0,3,6,1200,0,1977,0,98030,47.3746,-122.183,1200,7200,6020,6000,31.191828254847646,0.019699016393442622,Very Cheap
20141229T000000,445000.0,3,1.0,1260,8910,1.0,0,0,4,7,1260,0,1949,0,98117,47.7,-122.375,1560,8910,7650,7350,49.943883277216614,0.04852459016393443,Very Cheap
20140605T000000,356000.0,2,1.0,920,4095,1.0,0,0,4,6,920,0,1914,0,98118,47.5484,-122.278,1460,4945,3175,3485,86.93528693528694,0.03685245901639344,Very Cheap
20141010T000000,760250.0,5,2.75,2540,8250,1.0,0,0,4,7,1440,1100,1953,0,98040,47.5875,-122.24,2540,11000,5710,8460,92.15151515151516,0.0898688524590164,Very Cheap
20150430T000000,572000.0,2,2.0,1870,5143,1.0,0,0,3,8,1870,0,2005,0,98053,47.7142,-122.033,1810,5143,3273,3333,111.21913280186662,0.06518032786885246,Very Cheap
20140624T000000,970000.0,3,2.25,3060,9950,1.5,0,2,4,9,1810,1250,1930,0,98144,47.579,-122.284,4950,10655,6890,5705,97.48743718592965,0.11737704918032787,Cheap
20140831T000000,348450.0,4,2.5,1950,8628,2.0,0,0,3,8,1950,0,1994,0,98038,47.3817,-122.035,2210,9019,6678,6809,40.38595271210014,0.03586229508196721,Very Cheap
20140606T000000,535500.0,3,1.5,1730,40250,2.0,0,0,4,8,1730,0,1983,0,98072,47.7499,-122.111,1730,36250,38520,34520,13.304347826086957,0.06039344262295082,Very Cheap
20141013T000000,710000.0,5,2.5,2570,9600,1.0,0,2,3,8,1620,950,1956,0,98125,47.7216,-122.282,2680,9900,7030,7220,73.95833333333333,0.08327868852459017,Very Cheap
20140528T000000,745000.0,3,1.75,1490,9800,1.0,0,0,4,7,1140,350,1947,0,98004,47.584,-122.198,2310,9800,8310,7490,76.0204081632653,0.08786885245901639,Very Cheap
20140620T000000,355000.0,4,2.5,2040,8265,2.0,0,0,3,7,2040,0,1996,0,98146,47.4973,-122.341,2160,8265,6225,6105,42.95220810647308,0.036721311475409836,Very Cheap
20150323T000000,333000.0,4,2.5,2690,5505,2.0,0,0,3,8,2690,0,2004,0,98042,47.3666,-122.119,2690,5505,2815,2815,60.490463215258856,0.033836065573770495,Very Cheap
20140826T000000,282000.0,3,2.5,1610,6000,2.0,0,0,4,7,1610,0,1993,0,98038,47.349,-122.036,1570,6000,4390,4430,47.0,0.02714754098360656,Very Cheap
20140528T000000,840500.0,3,2.0,2520,5400,1.5,0,0,4,8,1410,1110,1906,0,98119,47.6365,-122.361,1960,5400,2880,3440,155.64814814814815,0.10039344262295082,Cheap
20150407T000000,432000.0,3,1.75,1550,8134,1.0,0,0,4,7,1550,0,1959,0,98008,47.6136,-122.121,1360,8000,6584,6640,53.110400786820755,0.046819672131147544,Very Cheap
20141029T000000,625000.0,3,1.0,1800,4800,1.0,0,2,4,9,900,900,1927,0,98126,47.5672,-122.372,1400,4800,3000,3400,130.20833333333334,0.07213114754098361,Very Cheap
20140910T000000,209977.0,3,1.0,1170,6134,1.0,0,0,4,7,1170,0,1948,0,98168,47.4941,-122.312,1440,9823,4964,8383,34.23165960221715,0.01770190163934426,Very Cheap
20140701T000000,174000.0,2,1.0,900,13531,1.0,0,0,3,6,900,0,1979,0,98001,47.2616,-122.251,1767,8308,12631,6541,12.859359988175301,0.012983606557377049,Very Cheap
20150422T000000,740000.0,4,2.0,2800,8540,1.0,0,0,4,8,1730,1070,1977,0,98052,47.6869,-122.126,2470,9400,5740,6930,86.65105386416862,0.08721311475409836,Very Cheap
20140917T000000,518000.0,3,1.75,1830,4500,1.5,0,0,4,7,1830,0,1909,0,98115,47.676,-122.308,1830,4080,2670,2250,115.11111111111111,0.0580983606557377,Very Cheap
20150305T000000,539000.0,3,1.75,1380,3225,1.0,0,0,4,7,940,440,1915,0,98103,47.6652,-122.338,1250,3750,1845,2500,167.13178294573643,0.06085245901639344,Very Cheap
20150429T000000,575000.0,3,2.75,1990,9600,1.0,0,0,3,8,1530,460,1978,0,98027,47.532,-122.05,2170,10400,7610,8230,59.895833333333336,0.06557377049180328,Very Cheap
20150209T000000,530000.0,2,1.75,1170,976,2.0,0,0,3,9,780,390,2010,0,98102,47.6192,-122.316,1280,1183,-194,-97,543.0327868852459,0.05967213114754098,Very Cheap
20140716T000000,242025.0,4,1.75,1400,54014,1.5,0,0,4,7,1400,0,1935,0,98031,47.4153,-122.184,1910,8523,52614,6613,4.480782760025178,0.021904918032786887,Very Cheap
20150306T000000,1030000.0,4,2.5,2620,11200,1.0,0,0,4,8,1770,850,1962,0,98004,47.5876,-122.193,2360,11200,8580,8840,91.96428571428571,0.12524590163934426,Cheap
20140826T000000,230000.0,3,1.0,880,7500,1.0,0,0,3,7,880,0,1978,0,98198,47.3837,-122.307,880,7500,6620,6620,30.666666666666668,0.020327868852459016,Very Cheap
20150107T000000,350000.0,4,2.5,2260,7500,1.0,0,0,3,8,1460,800,1965,0,98055,47.4645,-122.196,2260,7500,5240,5240,46.666666666666664,0.036065573770491806,Very Cheap
20150429T000000,595000.0,3,1.0,1300,11520,1.0,0,0,3,6,1300,0,1958,0,98033,47.6829,-122.195,1440,8064,10220,6624,51.64930555555556,0.06819672131147542,Very Cheap
20140711T000000,440000.0,3,1.75,1450,6829,1.0,0,0,3,8,1450,0,1983,0,98052,47.7222,-122.108,1950,7622,5379,5672,64.43110265046127,0.04786885245901639,Very Cheap
20150220T000000,550000.0,3,1.0,1110,6000,1.0,0,0,3,7,1110,0,1904,0,98109,47.6461,-122.357,1460,6000,4890,4540,91.66666666666667,0.06229508196721312,Very Cheap
20140507T000000,940000.0,4,2.25,1890,5940,1.0,0,1,3,9,1470,420,1963,0,98112,47.6316,-122.303,2430,5940,4050,3510,158.24915824915826,0.11344262295081967,Cheap
20140516T000000,375000.0,3,1.5,1100,1751,2.0,0,0,3,8,940,160,2007,0,98144,47.5927,-122.306,1380,1751,651,371,214.16333523700743,0.03934426229508197,Very Cheap
20141205T000000,567500.0,2,1.5,1350,4592,1.0,0,0,3,7,1070,280,1939,0,98199,47.6511,-122.405,1610,5102,3242,3492,123.58449477351917,0.06459016393442622,Very Cheap
20140916T000000,735000.0,3,2.5,3020,50800,1.0,0,0,5,8,1510,1510,1968,0,98029,47.5529,-122.026,2400,27135,47780,24735,14.468503937007874,0.08655737704918033,Very Cheap
20141017T000000,114000.0,2,1.0,730,5200,1.0,0,0,3,6,730,0,1928,0,98146,47.4943,-122.337,1220,6240,4470,5020,21.923076923076923,0.0051147540983606556,Very Cheap
20140825T000000,608000.0,2,1.0,1390,3600,1.0,0,0,4,7,1010,380,1913,0,98119,47.6422,-122.36,1590,3600,2210,2010,168.88888888888889,0.0699016393442623,Very Cheap
20141107T000000,442500.0,3,1.5,2710,47419,1.5,0,0,3,7,2170,540,1980,0,98053,47.6522,-121.966,2130,48144,44709,46014,9.331702482127417,0.04819672131147541,Very Cheap
20141016T000000,381800.0,4,2.0,1530,5250,1.0,0,0,3,7,1110,420,1981,0,98133,47.7336,-122.339,1100,5250,3720,4150,72.72380952380952,0.04023606557377049,Very Cheap
20140724T000000,330000.0,3,2.0,2170,3978,1.0,0,0,5,7,1340,830,1919,0,98116,47.571,-122.391,1350,4680,1808,3330,82.95625942684767,0.03344262295081967,Very Cheap
20140513T000000,90000.0,2,1.0,790,2640,1.0,0,0,3,7,790,0,1973,0,98034,47.7351,-122.178,1310,2064,1850,754,34.09090909090909,0.0019672131147540984,Very Cheap
20140724T000000,312000.0,2,1.75,1160,8625,1.0,0,0,4,6,1160,0,1941,0,98106,47.5509,-122.366,960,5750,7465,4790,36.17391304347826,0.031081967213114754,Very Cheap
20140512T000000,339000.0,3,1.0,1080,8100,1.0,0,0,4,7,1080,0,1955,0,98155,47.777,-122.307,1080,8100,7020,7020,41.851851851851855,0.03462295081967213,Very Cheap
20140507T000000,313000.0,3,1.75,2190,8000,1.0,0,0,4,8,2190,0,1967,0,98023,47.3098,-122.381,1980,8000,5810,6020,39.125,0.03121311475409836,Very Cheap
20140507T000000,618080.0,3,2.5,2030,6500,2.0,0,0,3,8,2030,0,1988,0,98027,47.5654,-122.092,2030,8485,4470,6455,95.08923076923077,0.07122360655737706,Very Cheap
20141006T000000,325000.0,3,2.25,2480,8755,2.0,0,0,3,8,2480,0,1979,0,98058,47.4543,-122.125,2280,9940,6275,7660,37.12164477441462,0.03278688524590164,Very Cheap
20140715T000000,242000.0,4,1.0,2240,7620,1.0,0,0,3,7,1120,1120,1966,0,98146,47.5089,-122.346,1080,7620,5380,6540,31.758530183727036,0.021901639344262296,Very Cheap
20141218T000000,364000.0,2,1.5,1650,7311,1.0,0,0,3,7,860,790,1978,0,98133,47.7772,-122.357,1660,7255,5661,5595,49.78799069894679,0.03790163934426229,Very Cheap
20140815T000000,545000.0,3,1.75,1700,5750,1.5,0,2,5,7,1450,250,1925,0,98126,47.5643,-122.38,1700,5750,4050,4050,94.78260869565217,0.06163934426229508,Very Cheap
20141223T000000,445000.0,3,2.5,2790,16173,2.0,0,0,3,10,2790,0,1988,0,98023,47.3043,-122.343,2890,11632,13383,8742,27.51499412601249,0.04852459016393443,Very Cheap
20140728T000000,1085500.0,4,2.75,3010,10830,2.0,0,3,4,9,3010,0,1980,0,98034,47.7005,-122.232,3010,10650,7820,7640,100.2308402585411,0.13252459016393442,Cheap
20140512T000000,660000.0,4,2.5,2550,10000,1.0,0,0,3,8,1290,1260,1964,0,98007,47.6208,-122.141,2270,8640,7450,6370,66.0,0.07672131147540984,Very Cheap
20141028T000000,845000.0,4,2.5,2880,35610,1.0,0,0,3,10,2880,0,1989,0,98052,47.6911,-122.054,3460,35610,32730,32150,23.72928952541421,0.10098360655737705,Cheap
20140923T000000,417000.0,4,2.0,2090,4000,1.0,0,0,3,6,1060,1030,1907,0,98144,47.5893,-122.299,1590,4000,1910,2410,104.25,0.04485245901639344,Very Cheap
20150428T000000,213800.0,2,1.0,740,5200,1.0,0,0,4,5,740,0,1952,0,98056,47.4934,-122.173,750,5200,4460,4450,41.11538461538461,0.01820327868852459,Very Cheap
20141028T000000,400000.0,2,1.75,960,6200,1.0,0,0,4,7,960,0,1946,0,98136,47.5551,-122.396,1000,6000,5240,5000,64.51612903225806,0.04262295081967213,Very Cheap
20150305T000000,759950.0,4,3.5,2100,7560,2.0,0,0,5,8,2100,0,2005,0,98133,47.7076,-122.356,1250,7560,5460,6310,100.52248677248677,0.08982950819672131,Very Cheap
20150423T000000,990000.0,4,2.5,2540,5930,2.0,0,0,3,9,2540,0,2003,0,98199,47.6451,-122.387,1400,4000,3390,2600,166.9477234401349,0.12,Cheap
20140820T000000,710000.0,3,1.75,1650,10250,1.0,0,0,5,8,1650,0,1963,0,98005,47.6118,-122.169,2400,10250,8600,7850,69.26829268292683,0.08327868852459017,Very Cheap
20141016T000000,315000.0,1,0.75,770,4600,1.0,0,0,4,6,770,0,1910,0,98126,47.5565,-122.377,1550,4600,3830,3050,68.47826086956522,0.031475409836065574,Very Cheap
20140902T000000,515000.0,4,2.5,2280,14810,1.0,0,0,5,8,1500,780,1977,0,98056,47.5392,-122.186,2690,12196,12530,9506,34.773801485482785,0.057704918032786885,Very Cheap
20140626T000000,638000.0,3,2.0,1660,3729,1.0,0,0,5,7,970,690,1922,0,98116,47.5741,-122.414,1560,3729,2069,2169,171.09144542772862,0.0738360655737705,Very Cheap
20150218T000000,370000.0,4,2.0,2020,8100,1.5,0,0,4,7,1160,860,1946,0,98125,47.7307,-122.297,1840,8680,6080,6840,45.67901234567901,0.038688524590163934,Very Cheap
20150129T000000,184000.0,3,1.0,970,14850,1.0,0,0,3,7,970,0,1968,0,98001,47.3251,-122.268,1410,14850,13880,13440,12.390572390572391,0.014295081967213115,Very Cheap
20140728T000000,583800.0,3,2.5,2480,6600,2.0,0,0,3,8,2480,0,2002,0,98053,47.6313,-122.008,2310,6656,4120,4346,88.45454545454545,0.06672786885245902,Very Cheap
20141028T000000,309500.0,3,1.0,1250,7320,1.0,0,0,3,7,1250,0,1968,0,98059,47.5074,-122.163,1770,7320,6070,5550,42.28142076502732,0.03075409836065574,Very Cheap
20150422T000000,1960000.0,4,4.0,4430,31353,2.0,0,0,3,12,4430,0,1998,0,98005,47.6422,-122.157,3900,35237,26923,31337,62.51395400759098,0.24721311475409835,Cheap
20140805T000000,299000.0,1,1.0,740,5000,1.0,0,0,3,7,740,0,1923,0,98118,47.5519,-122.292,1400,4400,4260,3000,59.8,0.02937704918032787,Very Cheap
20140613T000000,215000.0,2,1.0,710,7200,1.0,0,0,3,6,710,0,1943,0,98178,47.4903,-122.245,960,7200,6490,6240,29.86111111111111,0.018360655737704918,Very Cheap
20140618T000000,410000.0,4,2.0,1970,10500,1.0,0,0,3,8,1820,150,1961,0,98166,47.479,-122.356,2090,12300,8530,10210,39.04761904761905,0.043934426229508196,Very Cheap
20141030T000000,478000.0,2,1.0,820,6000,1.0,0,0,3,7,820,0,1939,0,98199,47.6494,-122.395,1630,6000,5180,4370,79.66666666666667,0.05285245901639344,Very Cheap
20140910T000000,431000.0,2,1.0,1000,6500,1.0,0,0,4,7,1000,0,1918,0,98136,47.5474,-122.388,1280,6500,5500,5220,66.3076923076923,0.046688524590163934,Very Cheap
20140709T000000,635000.0,4,2.5,3080,35430,2.0,0,0,3,9,3080,0,1997,0,98053,47.6325,-121.97,2640,28972,32350,26332,17.922664408693198,0.07344262295081967,Very Cheap
20150408T000000,648000.0,5,2.25,2410,12000,2.0,0,0,4,8,2410,0,1973,0,98006,47.5434,-122.175,2080,12000,9590,9920,54.0,0.07514754098360656,Very Cheap
20140603T000000,640000.0,3,2.5,2370,11172,2.0,0,0,3,9,2370,0,1993,0,98056,47.5345,-122.179,2550,11558,8802,9008,57.28607232366631,0.0740983606557377,Very Cheap
20141215T000000,932808.0,5,4.5,4690,6705,2.0,0,0,3,10,3450,1240,1995,0,98006,47.5539,-122.108,4070,11505,2015,7435,139.12125279642058,0.11249940983606557,Cheap
20140606T000000,835000.0,2,2.0,2280,6815,1.0,0,0,3,8,2280,0,2002,0,98053,47.7103,-122.027,2280,6750,4535,4470,122.52384446074835,0.09967213114754099,Very Cheap
20140728T000000,469775.0,2,1.75,1530,7020,1.0,0,0,3,7,1030,500,1942,0,98199,47.6465,-122.395,2090,6600,5490,4510,66.91951566951568,0.051773770491803275,Very Cheap
20140717T000000,587000.0,5,3.5,3610,52595,2.0,0,0,4,7,3610,0,1989,0,98014,47.6832,-121.907,1620,60112,48985,58492,11.160756725924518,0.06714754098360656,Very Cheap
20140721T000000,677915.0,3,2.0,1740,3600,1.0,0,0,5,7,990,750,1923,0,98119,47.6448,-122.358,1250,3600,1860,2350,188.30972222222223,0.07907081967213114,Very Cheap
20140522T000000,1075000.0,4,3.0,3600,9200,1.0,0,4,4,9,2100,1500,1976,0,98008,47.5866,-122.116,2700,9775,5600,7075,116.84782608695652,0.13114754098360656,Cheap
20140705T000000,671000.0,4,3.0,3130,5700,1.5,0,0,3,7,1750,1380,1953,0,98115,47.6811,-122.283,2080,5700,2570,3620,117.71929824561404,0.07816393442622951,Very Cheap
20140903T000000,695000.0,5,3.25,3940,9780,2.0,0,0,3,9,3940,0,2007,0,98065,47.5435,-121.888,3550,8468,5840,4918,71.06339468302659,0.08131147540983606,Very Cheap
20140729T000000,205000.0,4,2.0,2200,13320,1.0,0,0,3,6,1100,1100,1944,0,98168,47.481,-122.292,1330,6099,11120,4769,15.39039039039039,0.017049180327868854,Very Cheap
20150430T000000,350000.0,4,1.0,1510,7200,1.5,0,0,4,7,1510,0,1955,0,98155,47.761,-122.307,1950,10656,5690,8706,48.611111111111114,0.036065573770491806,Very Cheap
20140804T000000,360000.0,3,1.75,1560,7930,2.0,0,0,4,7,1560,0,1980,0,98059,47.4779,-122.161,1720,8073,6370,6353,45.39722572509458,0.037377049180327866,Very Cheap
20141108T000000,313999.0,4,2.25,1870,4198,2.0,0,0,3,7,1870,0,2008,0,98038,47.3657,-122.021,1870,4184,2328,2314,74.79728442115292,0.031344131147540984,Very Cheap
20150421T000000,300000.0,3,2.25,2070,7225,1.0,0,0,3,8,1690,380,1979,0,98042,47.3551,-122.148,2070,7400,5155,5330,41.522491349480966,0.029508196721311476,Very Cheap
20150423T000000,452000.0,2,1.75,1660,11747,1.0,0,0,3,7,830,830,1981,0,98155,47.7661,-122.306,1900,19850,10087,17950,38.477909253426404,0.04944262295081967,Very Cheap
20150325T000000,495500.0,3,2.5,2010,57934,1.0,0,0,3,7,2010,0,1978,0,98014,47.6262,-121.96,2040,55527,55924,53487,8.552835985776918,0.05514754098360656,Very Cheap
20141218T000000,288000.0,3,1.0,1410,40500,1.0,0,0,4,7,1410,0,1961,0,98092,47.3199,-122.1,1570,40500,39090,38930,7.111111111111111,0.027934426229508195,Very Cheap
20150217T000000,227490.0,3,1.75,1820,7194,1.0,0,0,4,7,1820,0,1967,0,98003,47.3352,-122.307,1420,7560,5374,6140,31.622185154295245,0.019998688524590164,Very Cheap
20141107T000000,470950.0,3,2.5,2560,16420,2.0,0,0,4,8,2560,0,1989,0,98014,47.6916,-121.916,2120,16298,13860,14178,28.68148599269184,0.051927868852459015,Very Cheap
20140614T000000,735000.0,4,2.75,2450,4187,2.0,0,2,3,8,2450,0,2010,0,98027,47.5471,-122.016,2320,4187,1737,1867,175.54334845951755,0.08655737704918033,Very Cheap
20141015T000000,730000.0,7,2.75,3110,4400,1.5,0,0,5,7,2010,1100,1914,0,98105,47.6684,-122.319,1240,4280,1290,3040,165.9090909090909,0.0859016393442623,Very Cheap
20141203T000000,412000.0,3,2.5,2210,7000,2.0,0,0,4,8,2210,0,1985,0,98058,47.4377,-122.132,2260,7224,4790,4964,58.857142857142854,0.04419672131147541,Very Cheap
20140606T000000,589500.0,4,2.5,2630,6326,2.0,0,0,3,9,2630,0,2008,0,98065,47.5222,-121.874,3240,6229,3696,2989,93.18684792918116,0.06747540983606558,Very Cheap
20141104T000000,291000.0,7,1.0,2350,8636,1.0,0,0,3,7,1550,800,1962,0,98118,47.5432,-122.277,1500,7366,6286,5866,33.69615562760537,0.028327868852459016,Very Cheap
20150402T000000,1300000.0,5,3.75,4450,7680,2.0,0,0,3,9,3460,990,2010,0,98199,47.6418,-122.392,2550,6400,3230,3850,169.27083333333334,0.16065573770491803,Cheap
20141020T000000,190000.0,3,1.0,1200,10458,1.0,0,0,4,6,1200,0,1961,0,98023,47.3262,-122.342,1160,9000,9258,7840,18.167909734174795,0.015081967213114755,Very Cheap
20150422T000000,456200.0,2,1.75,1210,7733,1.0,0,0,3,6,1210,0,1904,0,98125,47.7148,-122.282,1670,7733,6523,6063,58.99392215181689,0.04999344262295082,Very Cheap
20140919T000000,225000.0,3,1.0,1290,8470,1.0,0,0,4,7,970,320,1966,0,98023,47.3054,-122.371,1300,7350,7180,6050,26.564344746162927,0.019672131147540985,Very Cheap
20150422T000000,2000000.0,3,2.5,3490,21064,1.0,1,4,3,10,2290,1200,1968,0,98074,47.6092,-122.073,1780,15244,17574,13464,94.94872768704899,0.25245901639344265,Cheap
20140709T000000,740000.0,4,2.5,3360,15091,2.0,0,0,3,9,3360,0,1997,0,98052,47.6649,-122.135,1930,9936,11731,8006,49.035849181631434,0.08721311475409836,Very Cheap
20141201T000000,467000.0,3,1.75,2660,5511,1.0,0,0,3,8,1330,1330,1948,0,98108,47.5575,-122.3,2030,6111,2851,4081,84.73961168571947,0.05140983606557377,Very Cheap
20141008T000000,385000.0,2,1.0,770,7554,1.0,0,0,3,6,770,0,1946,0,98177,47.7057,-122.36,1390,7500,6784,6110,50.96637543023564,0.04065573770491803,Very Cheap
20141020T000000,670000.0,3,2.5,1800,4763,2.0,0,0,3,7,1240,560,1985,0,98119,47.646,-122.362,1790,4763,2963,2973,140.6676464413185,0.0780327868852459,Very Cheap
20150422T000000,500000.0,4,2.5,2900,5760,1.0,0,0,4,8,1660,1240,1959,0,98118,47.55,-122.272,2250,6098,2860,3848,86.80555555555556,0.05573770491803279,Very Cheap
20140619T000000,352450.0,3,2.0,1430,6000,1.0,0,0,5,7,1430,0,1945,0,98155,47.7564,-122.316,1630,6315,4570,4685,58.74166666666667,0.03638688524590164,Very Cheap
20141028T000000,669888.0,4,2.75,2550,7591,2.0,0,0,3,9,2550,0,1989,0,98059,47.5302,-122.147,2670,7796,5041,5126,88.24766170465024,0.07801809836065574,Very Cheap
20140624T000000,405000.0,3,2.75,1310,7300,1.0,0,0,3,7,1310,0,1957,0,98008,47.6016,-122.123,1310,7030,5990,5720,55.47945205479452,0.043278688524590166,Very Cheap
20140506T000000,518000.0,3,1.5,1430,8000,1.0,0,0,4,7,1430,0,1956,0,98007,47.5874,-122.136,1450,8000,6570,6550,64.75,0.0580983606557377,Very Cheap
20141001T000000,280000.0,4,1.0,1880,6288,1.0,0,0,3,7,1120,760,1974,0,98178,47.5101,-122.259,1880,6334,4408,4454,44.529262086513995,0.026885245901639345,Very Cheap
20140718T000000,435000.0,3,2.5,1600,2375,2.0,0,0,3,7,1600,0,2005,0,98029,47.5531,-121.996,1830,2375,775,545,183.1578947368421,0.04721311475409836,Very Cheap
20150507T000000,314950.0,3,2.0,1760,9732,1.0,0,0,3,7,1760,0,1996,0,98022,47.1923,-122.014,1910,9231,7972,7321,32.3623099054665,0.03146885245901639,Very Cheap
20150224T000000,209900.0,2,2.0,1180,3003,2.0,0,0,3,6,1180,0,2005,0,98038,47.3491,-122.02,1310,3003,1823,1693,69.8967698967699,0.017691803278688526,Very Cheap
20150416T000000,630000.0,4,2.5,2330,31705,2.0,0,0,4,8,2330,0,1980,0,98052,47.6471,-122.03,2460,36600,29375,34140,19.87068285759344,0.07278688524590164,Very Cheap
20140718T000000,442000.0,4,1.5,1960,12688,1.5,0,0,4,7,1960,0,1962,0,98052,47.6304,-122.097,2050,9375,10728,7325,34.83606557377049,0.048131147540983604,Very Cheap
20150402T000000,340000.0,4,1.0,1140,13440,1.0,0,0,2,5,1140,0,1944,0,98166,47.4619,-122.344,1450,7560,12300,6110,25.297619047619047,0.03475409836065574,Very Cheap
20140616T000000,230000.0,3,1.75,1400,6956,1.0,0,0,4,7,1400,0,1957,0,98031,47.4233,-122.198,1400,9375,5556,7975,33.064979873490515,0.020327868852459016,Very Cheap
20141205T000000,495200.0,5,2.25,2710,22120,1.0,0,0,3,7,1410,1300,1955,0,98011,47.7642,-122.195,2850,12224,19410,9374,22.386980108499095,0.055108196721311474,Very Cheap
20150331T000000,900000.0,4,2.5,3510,6745,2.0,0,0,3,10,3510,0,1998,0,98075,47.6016,-122.074,3320,8370,3235,5050,133.4321719792439,0.10819672131147541,Cheap
20150313T000000,265000.0,2,1.0,910,4600,1.0,0,0,3,5,910,0,1917,0,98117,47.6916,-122.362,1020,4600,3690,3580,57.608695652173914,0.024918032786885248,Very Cheap
20150102T000000,489500.0,3,1.75,2090,65558,1.0,0,0,3,8,1330,760,1977,0,98072,47.7621,-122.127,2450,47178,63468,44728,7.466670734311602,0.05436065573770492,Very Cheap
20150514T000000,335000.0,3,2.0,1410,44866,1.0,0,0,4,7,1410,0,1985,0,98023,47.3273,-122.37,2950,29152,43456,26202,7.466678553916106,0.03409836065573771,Very Cheap
20141205T000000,585000.0,3,3.25,3050,12700,2.0,0,0,3,8,2240,810,1990,0,98011,47.7445,-122.214,3050,12386,9650,9336,46.06299212598425,0.06688524590163934,Very Cheap
20141017T000000,800000.0,4,2.25,2010,7200,1.0,0,1,4,8,1010,1000,1950,0,98118,47.5591,-122.267,2010,7200,5190,5190,111.11111111111111,0.09508196721311475,Very Cheap
20140908T000000,379500.0,4,2.25,2120,53578,2.0,0,2,4,7,2120,0,1985,0,98022,47.2041,-122.021,2120,53578,51458,51458,7.083131135913995,0.0399344262295082,Very Cheap
20140812T000000,475000.0,3,1.0,1270,8000,1.0,0,0,4,6,1270,0,1959,0,98008,47.6175,-122.118,1210,7875,6730,6665,59.375,0.05245901639344262,Very Cheap
20141124T000000,520000.0,3,2.0,1670,8800,1.0,0,0,4,7,1150,520,1961,0,98008,47.6096,-122.132,2020,8250,7130,6230,59.09090909090909,0.058360655737704915,Very Cheap
20150128T000000,515000.0,4,2.5,1800,4338,2.0,0,0,3,8,1800,0,2001,0,98075,47.5962,-122.015,1800,4507,2538,2707,118.71830336560627,0.057704918032786885,Very Cheap
20150503T000000,577500.0,2,1.0,1640,5515,1.0,0,0,4,7,940,700,1926,0,98103,47.6912,-122.334,2054,5515,3875,3461,104.71441523118767,0.0659016393442623,Very Cheap
20140716T000000,269900.0,3,2.25,1740,9672,1.0,0,0,4,7,1110,630,1963,0,98031,47.4149,-122.181,1640,9600,7932,7960,27.905293631100083,0.02556065573770492,Very Cheap
20140527T000000,329000.0,3,1.0,1600,5952,1.0,0,0,4,7,1150,450,1964,0,98106,47.5292,-122.362,1460,6200,4352,4740,55.2755376344086,0.03331147540983607,Very Cheap
20150424T000000,458500.0,3,1.5,1280,1920,1.5,0,0,3,7,1280,0,1905,1990,98122,47.6117,-122.301,1280,3150,640,1870,238.80208333333334,0.050295081967213114,Very Cheap
20150313T000000,890000.0,4,2.0,1480,11171,1.5,0,0,4,6,1480,0,1947,0,98075,47.5849,-122.051,2790,20680,9691,17890,79.67057559752932,0.10688524590163935,Cheap
20150401T000000,361500.0,4,2.5,1980,7334,2.0,0,0,3,7,1980,0,2003,0,98038,47.3528,-122.041,1850,7134,5354,5284,49.29097354785929,0.03757377049180328,Very Cheap
20140718T000000,2535000.0,5,3.25,3730,10626,1.0,0,4,4,10,3730,0,1963,0,98004,47.624,-122.221,4180,19110,6896,14930,238.56578204404292,0.3226229508196721,Medium
20140822T000000,325000.0,2,1.0,900,8374,1.0,0,0,3,7,900,0,1984,0,98034,47.7282,-122.225,1580,8965,7474,7385,38.81060425125388,0.03278688524590164,Very Cheap
20141105T000000,1850000.0,4,3.25,3480,6000,3.0,0,0,3,8,3480,0,2014,0,98109,47.6353,-122.353,2200,4080,2520,1880,308.3333333333333,0.23278688524590163,Cheap
20140523T000000,945000.0,4,2.0,2840,13367,1.0,0,0,3,7,1420,1420,1952,0,98004,47.6237,-122.21,2840,12744,10527,9904,70.69649135931772,0.11409836065573771,Cheap
20140828T000000,370000.0,3,2.5,2490,4244,2.0,0,0,3,9,2490,0,2005,0,98042,47.3705,-122.131,2490,4748,1754,2258,87.18190386427898,0.038688524590163934,Very Cheap
20150218T000000,320000.0,0,2.5,1490,7111,2.0,0,0,3,7,1490,0,1999,0,98065,47.5261,-121.826,1500,4675,5621,3175,45.0007031359865,0.032131147540983604,Very Cheap
20140915T000000,450000.0,2,2.0,1510,4908,1.0,0,0,3,8,1510,0,2006,0,98053,47.7196,-122.024,1440,3921,3398,2481,91.68704156479218,0.04918032786885246,Very Cheap
20150424T000000,800000.0,4,2.5,2900,18303,2.0,0,0,4,10,2900,0,1994,0,98075,47.5981,-122.03,2900,18303,15403,15403,43.70868163689013,0.09508196721311475,Very Cheap
20141211T000000,676000.0,3,2.5,2240,3825,2.0,0,0,3,7,2240,0,1995,0,98117,47.6786,-122.389,1460,5100,1585,3640,176.73202614379085,0.07881967213114754,Very Cheap
20150402T000000,1272500.0,4,1.75,2040,5000,2.0,0,0,4,9,2040,0,1921,0,98102,47.6279,-122.315,3220,5600,2960,2380,254.5,0.15704918032786885,Cheap
20141028T000000,290000.0,3,1.75,1460,7980,1.0,0,0,3,7,1460,0,1972,0,98028,47.7713,-122.265,1920,7980,6520,6060,36.340852130325814,0.02819672131147541,Very Cheap
20141118T000000,158000.0,3,1.5,990,8925,1.0,0,0,4,7,990,0,1962,0,98003,47.3294,-122.331,1360,8625,7935,7265,17.703081232493,0.010885245901639345,Very Cheap
20140505T000000,379950.0,4,1.75,1970,9389,1.0,0,0,5,7,1140,830,1960,0,98133,47.7771,-122.339,1820,8135,7419,6315,40.46756843114283,0.03999344262295082,Very Cheap
20140509T000000,583000.0,4,2.5,2660,4000,2.0,0,0,3,8,2660,0,2001,0,98053,47.6876,-122.038,2330,4517,1340,2187,145.75,0.06662295081967214,Very Cheap
20141230T000000,150000.0,2,1.0,870,5700,1.0,0,0,4,6,870,0,1957,0,98056,47.498,-122.17,1020,5700,4830,4680,26.31578947368421,0.009836065573770493,Very Cheap
20140721T000000,261500.0,3,2.5,1740,6992,2.0,0,0,3,7,1740,0,1990,0,98042,47.3574,-122.158,1260,6825,5252,5565,37.399885583524025,0.024459016393442622,Very Cheap
20141014T000000,278000.0,4,2.5,2290,3777,2.0,0,0,3,7,2290,0,2004,0,98198,47.3617,-122.308,1480,3608,1487,2128,73.60338893301562,0.02662295081967213,Very Cheap
20140923T000000,555000.0,4,2.75,2170,7140,1.0,0,0,3,8,1290,880,1977,0,98052,47.691,-122.113,2120,7820,4970,5700,77.73109243697479,0.06295081967213115,Very Cheap
20140827T000000,355000.0,3,1.75,2040,8173,1.0,0,0,3,7,1470,570,1958,0,98133,47.7439,-122.333,1900,8172,6133,6272,43.43570292426282,0.036721311475409836,Very Cheap
20140917T000000,375000.0,4,1.5,1770,6650,1.0,0,0,3,7,1770,0,1958,0,98008,47.6011,-122.124,1600,7000,4880,5400,56.390977443609025,0.03934426229508197,Very Cheap
20140729T000000,227000.0,3,1.75,2380,12681,1.0,0,0,1,6,1380,1000,1918,0,98118,47.5294,-122.279,1720,6377,10301,4657,17.900796467155587,0.019934426229508195,Very Cheap
20140619T000000,335000.0,4,2.0,2030,103672,1.0,0,0,4,7,2030,0,1969,0,98022,47.1647,-121.973,1560,325393,101642,323833,3.231345011189135,0.03409836065573771,Very Cheap
20140606T000000,680000.0,3,2.25,2270,23900,1.0,0,0,3,9,1820,450,1975,0,98177,47.7506,-122.372,2520,28300,21630,25780,28.451882845188283,0.07934426229508197,Very Cheap
20150205T000000,686500.0,2,1.75,1390,5025,1.5,0,0,4,8,1390,0,1928,0,98105,47.6701,-122.288,2160,5000,3635,2840,136.61691542288557,0.08019672131147541,Very Cheap
20141124T000000,410000.0,3,1.75,1530,26642,1.0,0,0,3,7,1180,350,1988,0,98072,47.7422,-122.097,1550,13566,25112,12016,15.389235042414233,0.043934426229508196,Very Cheap
20140826T000000,425000.0,2,1.0,1430,13300,1.5,0,0,3,6,1230,200,1921,0,98033,47.6996,-122.203,1950,11421,11870,9471,31.954887218045112,0.04590163934426229,Very Cheap
20150310T000000,562500.0,3,2.5,2030,7549,1.0,0,0,3,8,2030,0,1988,0,98074,47.6187,-122.044,2040,7130,5519,5090,74.51318055371573,0.06393442622950819,Very Cheap
20141014T000000,345000.0,4,2.5,2390,6976,2.0,0,0,3,7,2390,0,2003,0,98056,47.4807,-122.182,2390,6346,4586,3956,49.455275229357795,0.03540983606557377,Very Cheap
20150414T000000,627500.0,4,2.5,2540,11500,1.0,0,0,4,8,1640,900,1979,0,98006,47.5609,-122.15,2820,9800,8960,6980,54.56521739130435,0.07245901639344263,Very Cheap
20150313T000000,355000.0,3,1.0,1890,36300,1.0,0,0,3,7,1890,0,1962,0,98024,47.5719,-121.914,1746,54014,34410,52268,9.77961432506887,0.036721311475409836,Very Cheap
20150501T000000,335000.0,3,2.25,1870,5876,2.0,0,0,3,7,1870,0,1986,0,98038,47.3779,-122.045,1670,6203,4006,4533,57.011572498298165,0.03409836065573771,Very Cheap
20150311T000000,350000.0,4,3.0,1780,4228,1.0,0,0,3,7,1780,0,1953,0,98118,47.5488,-122.287,1730,5304,2448,3574,82.78145695364239,0.036065573770491806,Very Cheap
20150318T000000,590000.0,3,1.0,1610,58370,1.0,0,0,3,7,1610,0,1978,0,98053,47.6718,-122.044,2510,58127,56760,55617,10.10793215692993,0.06754098360655737,Very Cheap
20140717T000000,252000.0,3,2.0,1420,6788,2.0,0,0,3,7,1420,0,1990,0,98023,47.2887,-122.351,1790,6607,5368,4817,37.12433706540955,0.02321311475409836,Very Cheap
20150421T000000,1295000.0,5,4.0,4440,9270,1.0,0,0,5,10,2220,2220,1968,0,98040,47.5708,-122.212,2720,9614,4830,6894,139.69795037756202,0.16,Cheap
20141119T000000,705000.0,4,2.0,1820,5001,2.0,0,0,3,7,1820,0,1947,2002,98119,47.6438,-122.373,1440,5408,3181,3968,140.9718056388722,0.08262295081967214,Very Cheap
20140714T000000,498000.0,3,2.0,1620,8400,1.0,0,0,3,7,1180,440,1968,0,98052,47.6574,-122.128,2120,8424,6780,6304,59.285714285714285,0.055475409836065574,Very Cheap
20140921T000000,312500.0,2,1.0,870,7227,1.0,0,0,3,7,870,0,1948,0,98133,47.7288,-122.331,1250,7252,6357,6002,43.240625432406254,0.03114754098360656,Very Cheap
20141124T000000,260000.0,4,1.75,1830,5375,1.0,0,0,2,7,1060,770,1962,0,98198,47.4169,-122.316,1040,7500,3545,6460,48.372093023255815,0.024262295081967214,Very Cheap
20150318T000000,209950.0,3,1.5,2290,9600,1.0,0,0,4,7,2290,0,1967,0,98042,47.3643,-122.111,1310,9600,7310,8290,21.869791666666668,0.017698360655737704,Very Cheap
20150210T000000,610000.0,3,1.75,1110,10402,1.0,0,0,4,7,1110,0,1967,0,98006,47.5676,-122.177,2050,9660,9292,7610,58.642568736781385,0.07016393442622951,Very Cheap
20140627T000000,500000.0,4,1.0,1440,7100,1.5,0,0,3,7,1440,0,1906,0,98107,47.6725,-122.396,1490,5000,5660,3510,70.4225352112676,0.05573770491803279,Very Cheap
20150224T000000,850000.0,3,3.5,3070,7050,1.0,0,3,3,8,1570,1500,1928,1996,98125,47.7076,-122.276,2350,5881,3980,3531,120.56737588652483,0.10163934426229508,Cheap
20150219T000000,689000.0,4,2.5,2440,11700,1.0,0,0,5,8,1480,960,1961,0,98006,47.5606,-122.184,2140,10807,9260,8667,58.888888888888886,0.08052459016393443,Very Cheap
20141110T000000,470000.0,4,2.0,2410,4680,2.0,0,0,3,9,2410,0,1974,0,98008,47.6234,-122.113,1910,4611,2270,2701,100.42735042735043,0.05180327868852459,Very Cheap
20140507T000000,640000.0,3,3.0,2270,5175,2.0,0,0,3,9,2130,140,2002,0,98056,47.516,-122.203,2850,5661,2905,2811,123.67149758454106,0.0740983606557377,Very Cheap
20140812T000000,290000.0,4,1.75,2340,7200,1.0,0,0,3,8,1590,750,1960,0,98146,47.497,-122.369,1970,7800,4860,5830,40.27777777777778,0.02819672131147541,Very Cheap
20141218T000000,258500.0,3,2.5,1800,9000,2.0,0,0,3,7,1800,0,1983,0,98003,47.3186,-122.331,1670,8486,7200,6816,28.72222222222222,0.024065573770491802,Very Cheap
20140714T000000,1100000.0,4,3.5,2210,7597,1.0,0,0,4,9,1550,660,1977,2006,98004,47.5816,-122.197,2370,8811,5387,6441,144.79399763064367,0.13442622950819672,Cheap
20140528T000000,420000.0,3,1.75,1820,22320,1.0,0,0,3,7,1250,570,1977,0,98053,47.6441,-121.96,2030,22320,20500,20290,18.817204301075268,0.04524590163934426,Very Cheap
20140916T000000,230000.0,3,1.0,1190,9083,1.0,0,0,3,7,1190,0,1955,0,98198,47.4116,-122.293,1190,9450,7893,8260,25.322030166244634,0.020327868852459016,Very Cheap
20150402T000000,252000.0,3,1.5,1400,6865,1.0,0,0,4,7,1400,0,1986,0,98038,47.3639,-122.048,1480,8125,5465,6645,36.707938820101965,0.02321311475409836,Very Cheap
20140630T000000,515000.0,3,2.5,2600,4506,2.0,0,0,3,8,2600,0,2003,0,98028,47.7353,-122.222,2600,4658,1906,2058,114.29205503772748,0.057704918032786885,Very Cheap
20140609T000000,425000.0,2,1.0,910,4635,1.0,0,0,4,6,910,0,1905,0,98107,47.675,-122.393,1740,5000,3725,3260,91.69363538295578,0.04590163934426229,Very Cheap
20150125T000000,575000.0,3,2.5,1760,2320,2.0,0,2,3,8,1760,0,1994,0,98126,47.5723,-122.376,1760,4698,560,2938,247.8448275862069,0.06557377049180328,Very Cheap
20141026T000000,390000.0,2,1.0,860,5160,1.0,0,0,4,7,860,0,1909,0,98117,47.6823,-122.388,1090,5356,4300,4266,75.5813953488372,0.04131147540983607,Very Cheap
20140917T000000,561500.0,4,2.25,2310,9800,1.0,0,0,3,8,1780,530,1968,0,98033,47.6657,-122.178,2310,9800,7490,7490,57.295918367346935,0.06380327868852459,Very Cheap
20150507T000000,1350000.0,4,1.75,2000,3728,1.5,0,0,4,9,1820,180,1926,0,98112,47.643,-122.299,1950,3728,1728,1778,362.1244635193133,0.16721311475409836,Cheap
20140925T000000,835000.0,5,2.75,2460,7830,1.0,0,0,5,9,1490,970,1955,0,98115,47.6938,-122.31,2050,7830,5370,5780,106.6411238825032,0.09967213114754099,Very Cheap
20150218T000000,245000.0,2,1.0,1020,15000,1.5,0,0,3,6,1020,0,1933,0,98168,47.4956,-122.321,1480,14519,13980,13039,16.333333333333332,0.022295081967213116,Very Cheap
20140811T000000,475200.0,3,2.5,1670,3980,2.0,0,0,3,8,1670,0,2000,0,98027,47.5317,-122.047,1670,2897,2310,1227,119.39698492462311,0.052485245901639346,Very Cheap
20141113T000000,425000.0,2,1.0,790,5024,1.0,0,0,4,7,790,0,1941,0,98117,47.6833,-122.395,1330,5024,4234,3694,84.59394904458598,0.04590163934426229,Very Cheap
20150202T000000,218000.0,2,1.5,2010,7755,2.0,0,0,3,7,2010,0,1952,0,98178,47.4947,-122.233,1360,8037,5745,6677,28.110896196002578,0.018754098360655738,Very Cheap
20140822T000000,600000.0,4,2.5,2600,6536,2.0,0,0,3,9,2600,0,1999,0,98056,47.5232,-122.191,2640,6185,3936,3545,91.79926560587515,0.06885245901639345,Very Cheap
20150410T000000,545000.0,4,2.25,1890,7210,1.0,0,0,3,8,1890,0,1967,0,98008,47.6342,-122.117,1920,7210,5320,5290,75.58945908460471,0.06163934426229508,Very Cheap
20150428T000000,2408000.0,5,2.5,4600,23250,1.5,0,2,3,9,3600,1000,1918,2003,98004,47.623,-122.218,5500,20066,18650,14566,103.56989247311827,0.3059672131147541,Medium
20150506T000000,460000.0,5,3.0,2008,5050,1.0,0,0,3,7,1216,792,1992,0,98118,47.5376,-122.292,2040,5297,3042,3257,91.08910891089108,0.050491803278688525,Very Cheap
20140623T000000,425000.0,2,1.0,880,6413,1.0,0,0,3,7,880,0,1950,0,98116,47.573,-122.395,1360,6413,5533,5053,66.27163573990332,0.04590163934426229,Very Cheap
20141021T000000,455000.0,3,1.75,1700,8360,1.0,0,0,4,7,850,850,1955,0,98006,47.5766,-122.147,1520,8360,6660,6840,54.42583732057416,0.049836065573770495,Very Cheap
20150421T000000,313100.0,3,2.0,1730,12821,1.0,0,0,3,8,1730,0,1994,0,98001,47.353,-122.272,1980,11336,11091,9356,24.42087200686374,0.031226229508196722,Very Cheap
20140623T000000,780000.0,4,3.5,3910,59863,2.0,0,0,4,10,2490,1420,1987,0,98027,47.4846,-122.067,2830,37674,55953,34844,13.029751265389306,0.09245901639344262,Very Cheap
20141223T000000,345500.0,4,2.5,2160,9682,2.0,0,0,3,8,2160,0,1999,0,98031,47.4106,-122.204,1770,9600,7522,7830,35.68477587275356,0.03547540983606557,Very Cheap
20150119T000000,243000.0,3,1.75,1200,8034,1.0,0,0,5,7,1200,0,1975,0,98031,47.4135,-122.18,1270,7600,6834,6330,30.246452576549665,0.022032786885245903,Very Cheap
20141208T000000,670000.0,5,3.5,3860,9600,1.0,0,3,4,8,2660,1200,1973,0,98034,47.7139,-122.223,2440,9600,5740,7160,69.79166666666667,0.0780327868852459,Very Cheap
20150211T000000,325000.0,3,1.5,1320,7560,1.0,0,0,3,6,840,480,1983,0,98019,47.7451,-121.98,1210,7560,6240,6350,42.98941798941799,0.03278688524590164,Very Cheap
20141202T000000,281000.0,2,1.0,1280,12500,1.0,0,0,3,7,1060,220,1951,0,98178,47.4833,-122.237,1460,17771,11220,16311,22.48,0.027016393442622952,Very Cheap
20150305T000000,130000.0,3,1.0,1100,5100,1.0,0,0,4,7,1100,0,1913,0,98108,47.5231,-122.332,1450,5100,4000,3650,25.49019607843137,0.007213114754098361,Very Cheap
20140730T000000,340000.0,3,2.5,2170,9798,2.0,0,0,3,7,2170,0,1995,0,98038,47.3817,-122.023,2020,8121,7628,6101,34.700959379465196,0.03475409836065574,Very Cheap
20150209T000000,485000.0,4,2.75,2720,51396,2.0,0,0,4,8,2720,0,1977,0,98059,47.4777,-122.1,1960,51366,48676,49406,9.436532025838586,0.05377049180327869,Very Cheap
20141217T000000,642860.0,4,2.75,2520,6398,2.0,0,0,3,8,2520,0,2014,0,98072,47.7685,-122.159,2520,6398,3878,3878,100.47827446076899,0.07447344262295082,Very Cheap
20141003T000000,747000.0,3,1.75,2560,4800,1.0,0,0,3,7,1280,1280,1911,0,98112,47.6207,-122.295,1620,4800,2240,3180,155.625,0.08813114754098361,Very Cheap
20140729T000000,559950.0,4,2.5,2650,7200,2.0,0,0,3,8,2250,400,1979,0,98133,47.7317,-122.354,2110,7269,4550,5159,77.77083333333333,0.0636,Very Cheap
20141117T000000,577288.0,4,2.75,2870,7200,2.0,0,0,3,9,2870,0,2008,0,98108,47.5688,-122.317,2030,5400,4330,3370,80.17888888888889,0.06587383606557377,Very Cheap
20140924T000000,575000.0,2,1.0,1230,2726,1.5,0,0,3,7,880,350,1920,0,98117,47.6815,-122.359,1710,3750,1496,2040,210.93176815847394,0.06557377049180328,Very Cheap
20140505T000000,287000.0,3,1.0,1450,6000,1.0,0,0,4,7,1450,0,1953,0,98118,47.5238,-122.287,1170,6464,4550,5294,47.833333333333336,0.02780327868852459,Very Cheap
20141110T000000,1149000.0,4,3.75,3180,9889,2.0,0,0,3,9,2500,680,2012,0,98033,47.6853,-122.204,2910,8558,6709,5648,116.18970573364344,0.14085245901639346,Cheap
20150424T000000,335000.0,2,1.0,1800,8900,1.0,0,0,3,6,900,900,1945,0,98168,47.51,-122.323,2040,10450,7100,8410,37.640449438202246,0.03409836065573771,Very Cheap
20150106T000000,375000.0,4,2.25,2020,12500,2.0,0,0,2,8,2020,0,1966,0,98056,47.5403,-122.175,1800,13175,10480,11375,30.0,0.03934426229508197,Very Cheap
20150106T000000,325000.0,2,1.0,620,14823,1.0,0,0,3,6,620,0,1926,0,98125,47.7322,-122.3,1400,7930,14203,6530,21.92538622411118,0.03278688524590164,Very Cheap
20150423T000000,530000.0,3,2.25,2190,220414,1.0,0,0,4,7,1330,860,1976,0,98059,47.5041,-122.102,2550,175982,218224,173432,2.40456595316087,0.05967213114754098,Very Cheap
20150112T000000,287000.0,4,2.25,1980,7081,1.0,0,0,3,7,1470,510,1977,0,98032,47.3669,-122.288,1980,7081,5101,5101,40.530998446547095,0.02780327868852459,Very Cheap
20150226T000000,320000.0,5,3.0,2970,7000,1.0,0,0,3,8,1810,1160,1979,0,98023,47.3079,-122.341,2630,8062,4030,5432,45.714285714285715,0.032131147540983604,Very Cheap
20140822T000000,425000.0,4,2.5,2270,4400,2.0,0,0,3,7,2270,0,2006,0,98065,47.5381,-121.888,2090,4400,2130,2310,96.5909090909091,0.04590163934426229,Very Cheap
20140806T000000,550000.0,3,1.0,1630,6009,1.0,0,3,4,8,1630,0,1954,0,98117,47.693,-122.383,2120,6009,4379,3889,91.52937260775504,0.06229508196721312,Very Cheap
20141202T000000,135000.0,3,1.0,1520,8450,1.0,0,0,2,6,1120,400,1961,0,98023,47.328,-122.337,1320,8450,6930,7130,15.976331360946746,0.007868852459016393,Very Cheap
20140717T000000,695000.0,3,1.75,2080,5687,1.5,0,0,4,8,2080,0,1924,0,98144,47.5776,-122.289,2300,5995,3607,3695,122.20854580622472,0.08131147540983606,Very Cheap
20150506T000000,975000.0,5,2.5,3020,9648,1.0,0,2,4,9,1980,1040,1977,0,98006,47.5586,-122.134,2890,12598,6628,9708,101.05721393034825,0.1180327868852459,Cheap
20140520T000000,210000.0,4,1.75,2180,28710,1.0,0,0,3,8,1180,1000,1950,0,98198,47.405,-122.288,2180,28710,26530,26530,7.3145245559038665,0.017704918032786884,Very Cheap
20141231T000000,518000.0,4,1.75,1780,8768,1.0,0,0,4,7,1050,730,1951,0,98125,47.7085,-122.283,1590,8100,6988,6510,59.07846715328467,0.0580983606557377,Very Cheap
20140709T000000,335500.0,3,1.0,1370,6780,2.0,0,0,3,6,1370,0,1930,0,98125,47.7156,-122.291,1450,7214,5410,5764,49.48377581120944,0.03416393442622951,Very Cheap
20141126T000000,750000.0,4,3.5,3050,7020,2.0,0,3,3,9,2050,1000,1984,0,98126,47.571,-122.374,2170,5900,3970,3730,106.83760683760684,0.08852459016393442,Very Cheap
20141223T000000,515000.0,3,1.75,1490,12000,1.0,0,0,4,7,1490,0,1956,0,98006,47.569,-122.175,1630,12000,10510,10370,42.916666666666664,0.057704918032786885,Very Cheap
20140521T000000,344500.0,4,2.75,1800,5453,1.0,0,0,3,7,1050,750,2002,0,98055,47.4632,-122.209,1820,6900,3653,5080,63.17623326609206,0.03534426229508197,Very Cheap
20140616T000000,470000.0,3,1.5,1760,6723,1.0,0,0,3,7,1160,600,1958,0,98118,47.5514,-122.266,2080,8965,4963,6885,69.90926669641529,0.05180327868852459,Very Cheap
20140904T000000,606150.0,4,1.75,1770,9848,1.0,0,0,3,8,1370,400,1967,0,98008,47.6208,-122.099,2040,9587,8078,7547,61.550568643379364,0.06965901639344263,Very Cheap
20141120T000000,292000.0,4,2.75,2910,7712,1.0,0,0,3,7,1600,1310,1998,0,98002,47.2842,-122.198,2220,6649,4802,4429,37.863070539419084,0.028459016393442622,Very Cheap
20150507T000000,450000.0,3,2.5,2880,426452,2.0,0,3,3,7,2880,0,1979,0,98092,47.2485,-122.101,1460,320890,423572,319430,1.0552184067609016,0.04918032786885246,Very Cheap
20140819T000000,429000.0,3,1.75,2520,5043,1.0,0,0,3,8,1260,1260,1957,0,98126,47.5339,-122.372,1360,4920,2523,3560,85.06841165972635,0.04642622950819672,Very Cheap
20140820T000000,765000.0,4,2.5,3190,38119,2.0,0,0,3,9,3190,0,1988,0,98053,47.6698,-122.044,2560,36280,34929,33720,20.06873212833495,0.09049180327868853,Very Cheap
20150415T000000,425000.0,2,1.0,540,2500,1.0,0,0,3,5,540,0,1905,0,98107,47.6729,-122.383,1290,5000,1960,3710,170.0,0.04590163934426229,Very Cheap
20150212T000000,505000.0,4,2.5,3170,5340,2.0,0,0,3,7,3170,0,2000,0,98059,47.4911,-122.138,3010,5340,2170,2330,94.5692883895131,0.05639344262295082,Very Cheap
20150317T000000,544950.0,3,1.75,1830,7371,1.0,0,0,3,7,1830,0,1957,0,98008,47.6059,-122.121,1600,7700,5541,6100,73.93162393162393,0.0616327868852459,Very Cheap
20140924T000000,382000.0,3,2.0,1360,4840,1.5,0,0,3,8,1360,0,1936,0,98126,47.5487,-122.376,1450,4840,3480,3390,78.92561983471074,0.040262295081967214,Very Cheap
20140828T000000,475000.0,3,1.75,1870,25157,2.0,0,0,3,7,1870,0,1978,0,98014,47.695,-121.915,1870,15391,23287,13521,18.88142465317804,0.05245901639344262,Very Cheap
20150417T000000,355000.0,3,1.5,1370,4790,2.0,0,0,4,7,1370,0,1982,0,98034,47.7253,-122.164,1370,3799,3420,2429,74.11273486430062,0.036721311475409836,Very Cheap
20140703T000000,410000.0,4,2.5,1700,9000,1.0,0,0,5,7,1700,0,1972,0,98034,47.7306,-122.233,1370,7592,7300,6222,45.55555555555556,0.043934426229508196,Very Cheap
20150203T000000,450000.0,4,2.0,1960,5008,1.0,0,0,3,6,980,980,1900,1988,98144,47.5958,-122.299,1175,2315,3048,1140,89.85623003194888,0.04918032786885246,Very Cheap
20140528T000000,565000.0,7,4.5,4140,9066,1.0,0,0,3,7,2070,2070,1978,0,98125,47.7302,-122.291,1440,1865,4926,425,62.32075887932936,0.06426229508196721,Very Cheap
20150414T000000,529100.0,2,1.0,1290,6528,1.5,0,0,4,7,1290,0,1941,0,98115,47.694,-122.29,1670,5712,5238,4042,81.05085784313725,0.05955409836065574,Very Cheap
20150212T000000,452500.0,4,2.5,2460,6454,2.0,0,0,3,7,2460,0,2006,0,98065,47.5381,-121.89,2320,4578,3994,2258,70.1115587232724,0.04950819672131147,Very Cheap
20140522T000000,245000.0,4,2.0,1580,8000,1.0,0,0,3,7,1040,540,1967,0,98003,47.3467,-122.304,1550,8000,6420,6450,30.625,0.022295081967213116,Very Cheap
20150330T000000,415000.0,1,1.0,700,2550,1.0,0,0,3,6,700,0,1954,0,98117,47.6783,-122.383,1330,4110,1850,2780,162.7450980392157,0.04459016393442623,Very Cheap
20140724T000000,610000.0,4,2.5,2410,15899,2.0,0,3,3,9,2410,0,1990,0,98074,47.6242,-122.04,2360,11412,13489,9052,38.36719290521417,0.07016393442622951,Very Cheap
20141016T000000,363500.0,4,1.75,2180,9702,1.0,0,0,5,7,1090,1090,1962,0,98178,47.4973,-122.268,2020,9792,7522,7772,37.46650175221604,0.03783606557377049,Very Cheap
20150204T000000,510000.0,3,2.75,1950,12630,1.0,0,0,4,8,1230,720,1969,0,98052,47.6301,-122.107,1990,12196,10680,10206,40.38004750593824,0.057049180327868855,Very Cheap
20150325T000000,650000.0,4,2.5,2630,28298,2.0,0,0,3,8,2630,0,1996,0,98053,47.6314,-121.968,2840,26071,25668,23231,22.969821188776592,0.07540983606557378,Very Cheap
20150114T000000,290000.0,4,2.5,2050,9015,2.0,0,0,4,7,2050,0,1973,0,98058,47.4357,-122.168,1780,8820,6965,7040,32.16860787576262,0.02819672131147541,Very Cheap
20150318T000000,170000.0,3,1.0,790,6750,1.0,0,0,2,6,790,0,1944,0,98178,47.4984,-122.24,960,6298,5960,5338,25.185185185185187,0.012459016393442624,Very Cheap
20150330T000000,510000.0,2,1.0,1070,5280,1.0,0,0,3,6,1070,0,1900,0,98122,47.6168,-122.303,1380,2370,4210,990,96.5909090909091,0.057049180327868855,Very Cheap
20140505T000000,2280000.0,7,8.0,13540,307752,3.0,0,4,3,12,9410,4130,1999,0,98053,47.6675,-121.986,4850,217800,294212,212950,7.4085627388286674,0.28918032786885245,Cheap
20140922T000000,316000.0,4,2.5,2320,7379,2.0,0,0,3,8,2320,0,1987,0,98003,47.3432,-122.316,2230,7614,5059,5384,42.82423092559967,0.03160655737704918,Very Cheap
20140512T000000,690000.0,4,2.5,2670,13463,2.0,0,0,4,9,2670,0,1989,0,98029,47.5627,-122.018,2560,10982,10793,8422,51.25157840005942,0.08065573770491803,Very Cheap
20140808T000000,199950.0,2,1.0,700,5200,1.0,0,0,5,5,700,0,1952,0,98056,47.4924,-122.174,970,5200,4500,4230,38.45192307692308,0.01638688524590164,Very Cheap
20140813T000000,207000.0,3,1.0,860,7740,1.0,0,0,3,6,860,0,1960,0,98178,47.4906,-122.244,980,7200,6880,6220,26.74418604651163,0.017311475409836064,Very Cheap
20150416T000000,449950.0,4,2.25,3490,8400,1.5,0,0,4,8,3490,0,1976,0,98058,47.4513,-122.128,2320,8723,4910,6403,53.56547619047619,0.04917377049180328,Very Cheap
20150318T000000,361550.0,3,1.75,1160,257875,1.0,0,0,2,7,1160,0,1980,0,98059,47.4655,-122.072,1420,15450,256715,14030,1.402035870092099,0.03758032786885246,Very Cheap
20140924T000000,824000.0,4,3.5,3650,57538,2.0,0,0,3,10,3650,0,1996,0,98077,47.7711,-122.041,3730,56257,53888,52527,14.320970489068094,0.09822950819672131,Very Cheap
20150106T000000,537000.0,3,1.75,1550,10050,1.0,0,0,5,7,1550,0,1957,0,98008,47.6345,-122.123,1720,10050,8500,8330,53.43283582089552,0.060590163934426226,Very Cheap
20140805T000000,838400.0,4,2.5,2620,9525,2.5,0,0,4,9,2620,0,1974,0,98040,47.5631,-122.219,2580,9525,6905,6945,88.02099737532808,0.10011803278688525,Cheap
20140911T000000,225000.0,2,1.0,720,4758,1.0,0,0,3,6,720,0,1947,0,98126,47.5176,-122.376,990,4920,4038,3930,47.288776796973515,0.019672131147540985,Very Cheap
20150423T000000,329900.0,3,2.0,1380,5198,1.0,0,0,4,7,1380,0,1982,0,98106,47.5514,-122.357,1320,6827,3818,5507,63.4667179684494,0.03342950819672131,Very Cheap
20150106T000000,282500.0,4,1.0,1170,34925,1.0,0,0,4,6,1170,0,1942,0,98065,47.5305,-121.841,1610,28108,33755,26498,8.088761632068719,0.02721311475409836,Very Cheap
20150406T000000,229950.0,3,1.75,1170,11960,1.0,0,0,4,7,1170,0,1969,0,98042,47.3279,-122.136,1230,9800,10790,8570,19.226588628762542,0.020321311475409835,Very Cheap
20150331T000000,500000.0,2,1.0,1630,12059,1.0,0,0,3,7,1270,360,1947,0,98125,47.7228,-122.314,1660,8800,10429,7140,41.462807861348374,0.05573770491803279,Very Cheap
20141104T000000,495000.0,3,1.75,1890,6557,1.0,0,0,3,8,1890,0,1967,0,98125,47.7032,-122.286,1920,6793,4667,4873,75.4918407808449,0.05508196721311476,Very Cheap
20140610T000000,149500.0,3,1.0,1010,9450,1.0,0,0,4,7,1010,0,1959,0,98198,47.3592,-122.315,1240,9450,8440,8210,15.82010582010582,0.00977049180327869,Very Cheap
20140818T000000,726000.0,3,2.5,2040,10033,1.0,0,0,4,8,1420,620,1974,0,98005,47.6375,-122.173,2260,10115,7993,7855,72.36120801355527,0.08537704918032787,Very Cheap
20150409T000000,899000.0,4,2.5,4080,10295,2.0,0,0,3,10,4080,0,1998,0,98075,47.5933,-121.982,3470,10295,6215,6825,87.32394366197182,0.10806557377049181,Cheap
20150315T000000,317000.0,3,1.0,1270,8925,1.0,0,0,5,7,1270,0,1955,0,98056,47.5124,-122.165,1270,8996,7655,7726,35.51820728291317,0.03173770491803279,Very Cheap
20150326T000000,395000.0,1,1.0,790,3000,1.0,0,0,3,6,790,0,1953,0,98199,47.6544,-122.386,1110,4100,2210,2990,131.66666666666666,0.0419672131147541,Very Cheap
20150202T000000,360000.0,4,3.0,2580,6740,2.0,0,0,3,8,2580,0,1999,0,98058,47.4296,-122.185,2010,6740,4160,4730,53.41246290801187,0.037377049180327866,Very Cheap
20140618T000000,570000.0,4,2.5,2290,6738,2.0,0,0,3,8,2290,0,1996,0,98029,47.5714,-122.005,2100,6261,4448,4161,84.59483526268923,0.06491803278688525,Very Cheap
20140619T000000,320000.0,4,2.5,3490,5000,2.0,0,0,3,8,3490,0,2003,0,98042,47.3772,-122.127,2910,5025,1510,2115,64.0,0.032131147540983604,Very Cheap
20140925T000000,320000.0,3,1.75,1510,30185,1.5,0,0,3,7,1510,0,1976,0,98058,47.4118,-122.089,1470,12465,28675,10995,10.601292032466457,0.032131147540983604,Very Cheap
20150312T000000,268000.0,5,2.5,2400,4564,2.0,0,0,3,7,2400,0,2004,0,98042,47.369,-122.126,1880,4109,2164,2229,58.72042068361087,0.025311475409836064,Very Cheap
20140627T000000,191000.0,2,1.0,900,3400,1.0,0,0,5,6,900,0,1905,0,98108,47.5269,-122.314,940,6000,2500,5060,56.1764705882353,0.01521311475409836,Very Cheap
20140804T000000,400000.0,2,1.0,1270,7440,1.0,0,0,4,7,910,360,1949,0,98126,47.5285,-122.372,1040,7500,6170,6460,53.763440860215056,0.04262295081967213,Very Cheap
20140701T000000,515000.0,2,1.0,1050,5000,1.0,0,0,5,7,1050,0,1907,0,98107,47.6699,-122.369,1340,5000,3950,3660,103.0,0.057704918032786885,Very Cheap
20150416T000000,610000.0,4,2.5,2950,9010,2.0,0,0,3,9,2950,0,2004,0,98065,47.531,-121.86,3160,8813,6060,5653,67.70255271920088,0.07016393442622951,Very Cheap
20141024T000000,538000.0,2,1.75,1850,3060,1.0,0,0,3,7,1060,790,1929,1992,98115,47.6821,-122.308,1850,4080,1210,2230,175.81699346405227,0.06072131147540984,Very Cheap
20140603T000000,432000.0,3,2.5,1970,4036,2.0,0,0,4,7,1970,0,2003,0,98065,47.5335,-121.869,1960,5020,2066,3060,107.0366699702676,0.046819672131147544,Very Cheap
20150127T000000,335000.0,4,2.25,2400,8592,2.0,0,0,3,8,2400,0,1978,0,98055,47.4383,-122.193,2180,8100,6192,5920,38.98975791433892,0.03409836065573771,Very Cheap
20150220T000000,302000.0,5,1.75,2360,8642,1.5,0,0,5,7,2060,300,1926,0,98133,47.7617,-122.335,1950,8491,6282,6541,34.9456144411016,0.02977049180327869,Very Cheap
20140804T000000,787500.0,4,1.75,1580,9382,1.0,0,0,3,7,1080,500,1963,0,98039,47.6353,-122.232,2010,9382,7802,7372,83.93732679599232,0.09344262295081968,Very Cheap
20141218T000000,420000.0,3,1.0,1790,7055,1.0,0,0,5,8,1520,270,1937,0,98133,47.718,-122.355,1710,7055,5265,5345,59.532246633593196,0.04524590163934426,Very Cheap
20140918T000000,560000.0,3,2.5,2840,216493,2.0,0,0,3,9,2840,0,1991,0,98014,47.702,-121.892,2820,175111,213653,172291,2.5866887151085716,0.06360655737704918,Very Cheap
20150423T000000,535000.0,3,2.5,1970,6634,2.0,0,0,3,8,1970,0,1989,0,98029,47.5759,-122.012,2090,6176,4664,4086,80.64516129032258,0.06032786885245902,Very Cheap
20140610T000000,310000.0,3,2.5,1780,6771,1.0,0,0,3,7,1230,550,1990,0,98106,47.5237,-122.353,1780,6771,4991,4991,45.783488406439226,0.03081967213114754,Very Cheap
20141208T000000,760000.0,5,2.0,3920,5250,1.5,0,0,5,7,2560,1360,1910,0,98144,47.5798,-122.294,1830,4240,1330,2410,144.76190476190476,0.0898360655737705,Very Cheap
20140922T000000,242500.0,3,1.75,1550,1905,2.0,0,0,3,7,1550,0,2005,0,98055,47.4331,-122.195,1550,1866,355,316,127.29658792650919,0.021967213114754098,Very Cheap
20150220T000000,1313000.0,6,3.0,2980,7200,1.5,0,2,3,8,2980,0,1911,0,98119,47.6366,-122.362,1720,3600,4220,1880,182.36111111111111,0.16236065573770492,Cheap
20141016T000000,235000.0,3,1.0,1270,7153,1.0,0,0,5,6,1270,0,1949,0,98055,47.4815,-122.226,1650,7153,5883,5503,32.853348245491404,0.02098360655737705,Very Cheap
20150223T000000,598780.0,4,2.25,3040,12160,1.0,0,0,4,7,1520,1520,1963,0,98007,47.5911,-122.133,2560,12090,9120,9530,49.24177631578947,0.06869245901639344,Very Cheap
20140807T000000,433200.0,3,2.5,2075,16200,2.0,0,0,3,8,2075,0,2002,0,98045,47.4848,-121.698,2300,32379,14125,30079,26.74074074074074,0.04697704918032787,Very Cheap
20150511T000000,343000.0,2,1.0,1110,9920,1.0,0,0,5,6,700,410,1942,0,98056,47.5454,-122.192,2830,10091,8810,7261,34.57661290322581,0.035147540983606555,Very Cheap
20141110T000000,145000.0,2,1.0,800,8125,1.0,0,0,3,6,800,0,1964,0,98033,47.6836,-122.174,2390,8125,7325,5735,17.846153846153847,0.009180327868852459,Very Cheap
20150116T000000,291970.0,1,1.0,680,21727,1.0,0,0,3,5,680,0,1952,1995,98058,47.446,-122.175,1470,19406,21047,17936,13.43811847010632,0.028455081967213115,Very Cheap
20150318T000000,599950.0,3,1.0,1680,7910,1.0,0,0,3,7,1680,0,1949,0,98146,47.5085,-122.385,1330,7910,6230,6580,75.84702907711757,0.06884590163934426,Very Cheap
20140725T000000,1749000.0,4,2.5,3910,22710,1.5,0,0,3,8,3910,0,1908,2003,98004,47.6295,-122.217,2920,16544,18800,13624,77.01453104359314,0.21954098360655738,Cheap
20150319T000000,870000.0,4,1.75,2780,11000,1.0,0,0,3,9,1560,1220,1964,0,98004,47.595,-122.203,2350,11700,8220,9350,79.0909090909091,0.10426229508196722,Cheap
20150508T000000,323000.0,4,2.75,2000,9083,2.0,0,0,4,7,2000,0,1992,0,98038,47.3511,-122.058,1690,7735,7083,6045,35.56093801607398,0.03252459016393443,Very Cheap
20140825T000000,727000.0,4,3.0,3150,9703,2.0,0,0,3,9,3150,0,2001,0,98075,47.5962,-122.018,3150,8819,6553,5669,74.92528084097702,0.08550819672131148,Very Cheap
20141023T000000,166000.0,1,1.0,1120,17332,1.0,0,0,3,7,1120,0,1988,0,98001,47.2972,-122.267,1280,17334,16212,16054,9.577659819986152,0.011934426229508197,Very Cheap
20150430T000000,450000.0,4,1.75,1740,12204,1.0,0,0,3,7,1270,470,1961,0,98155,47.7675,-122.277,2190,12204,10464,10014,36.87315634218289,0.04918032786885246,Very Cheap
20140624T000000,400000.0,3,2.5,2970,23100,1.0,0,0,3,7,1510,1460,1967,0,98072,47.7735,-122.133,2390,20300,20130,17910,17.316017316017316,0.04262295081967213,Very Cheap
20150210T000000,599000.0,3,2.5,2970,23100,1.0,0,0,3,7,1510,1460,1967,0,98072,47.7735,-122.133,2390,20300,20130,17910,25.93073593073593,0.06872131147540983,Very Cheap
20140605T000000,165000.0,3,1.0,1150,19200,1.0,0,0,4,5,1150,0,1908,0,98001,47.2756,-122.27,1290,19200,18050,17910,8.59375,0.01180327868852459,Very Cheap
20140605T000000,229000.0,2,1.0,1190,7408,1.0,0,0,3,6,830,360,1941,0,98168,47.5094,-122.31,1140,7408,6218,6268,30.91252699784017,0.02019672131147541,Very Cheap
20141013T000000,305000.0,1,1.0,900,7500,1.0,0,0,3,5,900,0,1946,1987,98155,47.7553,-122.283,1470,7500,6600,6030,40.666666666666664,0.03016393442622951,Very Cheap
20140915T000000,930000.0,3,3.25,2950,4446,2.0,0,0,3,9,2450,500,2001,0,98116,47.5852,-122.391,1930,4255,1496,2325,209.17678812415656,0.1121311475409836,Cheap
20140923T000000,542000.0,3,2.5,1990,15985,1.0,0,0,3,8,1540,450,1964,0,98007,47.6205,-122.141,2470,10125,13995,7655,33.90678761338755,0.06124590163934426,Very Cheap
20140909T000000,214000.0,3,1.0,1020,9147,1.0,0,0,4,6,1020,0,1900,1965,98010,47.3127,-122.002,1600,9700,8127,8100,23.39564884661638,0.01822950819672131,Very Cheap
20140909T000000,718000.0,3,2.5,2070,7200,2.0,0,0,3,8,2070,0,2001,0,98033,47.6946,-122.211,1650,8877,5130,7227,99.72222222222223,0.08432786885245902,Very Cheap
20140611T000000,349000.0,3,2.5,1430,1002,3.0,0,0,3,8,1430,0,2002,0,98103,47.698,-122.349,1430,1530,-428,100,348.30339321357286,0.035934426229508196,Very Cheap
20150505T000000,305000.0,3,2.5,2030,8000,2.0,0,0,3,7,2030,0,1997,0,98031,47.4024,-122.216,2290,7945,5970,5655,38.125,0.03016393442622951,Very Cheap
20140715T000000,498000.0,3,2.5,1620,2640,2.0,0,0,4,7,1620,0,1900,1993,98122,47.6036,-122.305,1370,3840,1020,2470,188.63636363636363,0.055475409836065574,Very Cheap
20140523T000000,799950.0,4,3.5,4220,196817,2.0,0,0,3,10,4220,0,1993,0,98092,47.2642,-122.187,2500,195395,192597,192895,4.064435490836665,0.09507540983606558,Very Cheap
20150505T000000,737000.0,3,2.5,2300,7800,2.0,0,2,3,9,2300,0,1997,0,98052,47.6842,-122.155,2300,8187,5500,5887,94.48717948717949,0.08681967213114754,Very Cheap
20141226T000000,860000.0,4,3.25,3830,10005,2.0,0,0,3,10,3830,0,2001,0,98075,47.5953,-122.039,2555,5204,6175,2649,85.95702148925537,0.10295081967213114,Cheap
20140702T000000,339950.0,3,2.5,2390,34041,1.0,0,0,3,8,1840,550,1984,0,98042,47.3546,-122.081,2460,35686,31651,33226,9.986486883464059,0.03474754098360656,Very Cheap
20140516T000000,249000.0,3,2.25,1440,7673,1.0,0,0,3,7,940,500,1982,0,98031,47.4034,-122.178,1440,8418,6233,6978,32.451453147399974,0.02281967213114754,Very Cheap
20150507T000000,370000.0,2,1.0,910,5525,1.0,0,0,2,6,910,0,1910,0,98126,47.5322,-122.379,1620,5525,4615,3905,66.96832579185521,0.038688524590163934,Very Cheap
20141013T000000,725000.0,3,2.0,1550,12262,1.0,0,0,4,7,1550,0,1964,0,98040,47.5755,-122.216,2900,12372,10712,9472,59.12575436307291,0.08524590163934426,Very Cheap
20141205T000000,529000.0,5,2.5,2380,91476,1.0,0,0,4,8,1580,800,1976,0,98059,47.479,-122.153,1880,12870,89096,10990,5.78293760111942,0.05954098360655738,Very Cheap
20150317T000000,310000.0,4,2.75,2060,8100,1.0,0,0,4,7,1310,750,1988,0,98198,47.3581,-122.317,1540,8100,6040,6560,38.27160493827161,0.03081967213114754,Very Cheap
20141027T000000,315000.0,4,2.25,1880,9163,2.0,0,0,3,8,1880,0,1981,0,98058,47.4362,-122.165,1900,7980,7283,6080,34.37738731856379,0.031475409836065574,Very Cheap
20141002T000000,1300000.0,4,2.5,3470,4160,2.0,0,0,3,9,2480,990,1927,0,98119,47.63,-122.363,2280,5440,690,3160,312.5,0.16065573770491803,Cheap
20141105T000000,435000.0,3,2.0,2360,12744,2.0,0,0,5,7,2360,0,1964,0,98059,47.483,-122.164,1650,8625,10384,6975,34.133709981167605,0.04721311475409836,Very Cheap
20140716T000000,350000.0,3,1.75,1970,10800,1.0,0,0,4,7,1300,670,1979,0,98056,47.5107,-122.172,1970,8768,8830,6798,32.407407407407405,0.036065573770491806,Very Cheap
20140908T000000,240000.0,3,1.0,1040,7800,1.0,0,0,3,7,1040,0,1948,0,98055,47.4804,-122.229,1780,8400,6760,6620,30.76923076923077,0.021639344262295083,Very Cheap
20150428T000000,410000.0,3,2.25,1420,3750,2.0,0,0,3,7,1420,0,1987,0,98116,47.5725,-122.383,1430,4664,2330,3234,109.33333333333333,0.043934426229508196,Very Cheap
20140923T000000,430000.0,4,2.75,2290,5249,2.0,0,0,3,7,2290,0,2003,0,98059,47.4916,-122.162,2270,4348,2959,2078,81.92036578395884,0.04655737704918033,Very Cheap
20140818T000000,446000.0,4,2.5,1530,8375,1.0,0,0,3,7,1020,510,1974,0,98034,47.7174,-122.236,1650,9794,6845,8144,53.25373134328358,0.04865573770491803,Very Cheap
20140611T000000,240000.0,3,1.5,1360,9760,1.5,0,0,5,7,1360,0,1984,0,98045,47.4648,-121.757,1310,11456,8400,10146,24.59016393442623,0.021639344262295083,Very Cheap
20150108T000000,595000.0,4,3.0,3680,35736,1.5,0,0,4,8,2320,1360,1970,0,98027,47.4703,-122.015,3210,39512,32056,36302,16.649876874860084,0.06819672131147542,Very Cheap
20150306T000000,215150.0,3,1.0,920,4770,1.0,0,0,4,6,920,0,1969,0,98042,47.3654,-122.082,920,4770,3850,3850,45.104821802935014,0.01838032786885246,Very Cheap
20140522T000000,319950.0,2,1.0,1070,5824,1.0,0,2,5,7,1070,0,1949,0,98178,47.507,-122.242,2090,7980,4754,5890,54.93646978021978,0.03212459016393442,Very Cheap
20140616T000000,385000.0,3,2.0,1590,9912,2.0,0,0,3,8,1590,0,2000,0,98070,47.3731,-122.43,1670,9912,8322,8242,38.84180790960452,0.04065573770491803,Very Cheap
20150325T000000,280000.0,3,2.5,1600,6700,2.0,0,0,3,8,1600,0,1991,0,98042,47.3618,-122.074,1790,7577,5100,5787,41.791044776119406,0.026885245901639345,Very Cheap
20150511T000000,399950.0,3,2.5,1510,7300,1.0,0,0,3,7,1040,470,1974,0,98034,47.7153,-122.211,1360,7300,5790,5940,54.78767123287671,0.04261639344262295,Very Cheap
20140523T000000,132500.0,3,1.0,1080,10500,1.0,0,0,3,7,1080,0,1967,0,98001,47.32,-122.278,1200,9607,9420,8407,12.619047619047619,0.0075409836065573775,Very Cheap
20150423T000000,399950.0,2,0.75,1330,2856,1.0,0,0,4,7,930,400,1916,0,98126,47.5671,-122.37,1330,2856,1526,1526,140.03851540616247,0.04261639344262295,Very Cheap
20140721T000000,290000.0,2,1.0,850,6800,1.0,0,0,3,7,850,0,1948,0,98133,47.7282,-122.337,870,6800,5950,5930,42.64705882352941,0.02819672131147541,Very Cheap
20150512T000000,860000.0,5,2.25,1960,8592,1.0,0,0,4,8,1290,670,1958,0,98004,47.6066,-122.192,1720,8592,6632,6872,100.09310986964618,0.10295081967213114,Cheap
20140529T000000,3100000.0,6,4.25,6980,15682,3.0,0,4,4,12,5330,1650,1999,0,98040,47.5552,-122.231,3930,18367,8702,14437,197.6788674913914,0.39672131147540984,Medium
20140516T000000,245000.0,4,1.0,1530,7200,1.5,0,0,3,7,1400,130,1948,0,98178,47.5015,-122.262,1530,7200,5670,5670,34.02777777777778,0.022295081967213116,Very Cheap
20141215T000000,255000.0,3,1.5,1320,7980,1.0,0,0,3,7,1320,0,1956,0,98178,47.5068,-122.259,2000,7700,6660,5700,31.954887218045112,0.02360655737704918,Very Cheap
20141113T000000,310000.0,4,3.0,2320,7200,2.0,0,0,3,7,2320,0,1976,0,98155,47.7703,-122.312,2050,10000,4880,7950,43.05555555555556,0.03081967213114754,Very Cheap
20140813T000000,299000.0,3,1.0,960,8100,1.0,0,0,3,7,960,0,1955,0,98155,47.7763,-122.305,1080,8100,7140,7020,36.91358024691358,0.02937704918032787,Very Cheap
20141110T000000,575000.0,4,2.5,2040,5508,2.0,0,0,4,8,2040,0,1996,0,98029,47.5719,-122.007,2130,5496,3468,3366,104.39360929557007,0.06557377049180328,Very Cheap
20141114T000000,284000.0,3,1.0,1080,8214,1.0,0,0,3,7,1080,0,1944,0,98133,47.7401,-122.348,1850,13560,7134,11710,34.575115656196736,0.027409836065573772,Very Cheap
20150407T000000,840000.0,3,1.75,2020,4800,1.0,0,0,4,8,1090,930,1926,0,98115,47.6726,-122.294,1680,4800,2780,3120,175.0,0.10032786885245902,Cheap
20140813T000000,442573.0,3,1.75,1780,7567,1.0,0,0,3,7,1290,490,1980,0,98034,47.7314,-122.225,1910,8645,5787,6735,58.48724725783005,0.048206295081967214,Very Cheap
20141008T000000,560000.0,3,1.0,1140,7028,1.0,0,0,3,8,1140,0,1931,0,98115,47.6948,-122.322,1350,6923,5888,5573,79.6812749003984,0.06360655737704918,Very Cheap
20140507T000000,485000.0,3,2.0,1610,4160,1.0,0,0,4,7,1010,600,1917,0,98136,47.5421,-122.388,1040,4400,2550,3360,116.58653846153847,0.05377049180327869,Very Cheap
20150318T000000,472500.0,4,1.75,1440,8536,1.0,0,0,4,7,1440,0,1961,0,98033,47.6775,-122.18,1720,9748,7096,8028,55.353795688847235,0.05213114754098361,Very Cheap
20141126T000000,1610000.0,4,2.75,4270,25807,2.0,0,0,3,11,4270,0,1996,0,98004,47.5951,-122.206,3860,20723,21537,16863,62.38617429379626,0.20131147540983607,Cheap
20141219T000000,808000.0,8,3.75,3460,4600,2.0,0,0,3,7,2860,600,1987,0,98105,47.6617,-122.289,2170,3750,1140,1580,175.65217391304347,0.0961311475409836,Very Cheap
20141022T000000,398000.0,3,1.75,1890,16001,1.5,0,0,4,7,1890,0,1950,0,98011,47.7663,-122.201,1820,11450,14111,9630,24.873445409661898,0.042360655737704915,Very Cheap
20150217T000000,340000.0,3,2.5,2240,6000,2.0,0,0,3,8,2240,0,2003,0,98059,47.4837,-122.138,2400,6000,3760,3600,56.666666666666664,0.03475409836065574,Very Cheap
20150513T000000,380000.0,2,1.0,760,4000,1.5,0,0,3,6,760,0,1910,0,98108,47.5462,-122.32,1130,4000,3240,2870,95.0,0.04,Very Cheap
20140912T000000,235000.0,3,1.0,1020,6173,1.0,0,0,3,6,780,240,1948,0,98168,47.5042,-122.329,1330,5909,5153,4579,38.06901020573465,0.02098360655737705,Very Cheap
20141027T000000,400000.0,3,1.5,1330,9900,1.0,0,0,3,7,1330,0,1956,0,98034,47.7167,-122.233,1940,9900,8570,7960,40.4040404040404,0.04262295081967213,Very Cheap
20140711T000000,582000.0,5,2.5,2780,12335,1.0,0,0,4,8,1590,1190,1968,0,98006,47.5681,-122.128,2750,9930,9555,7180,47.182813133360355,0.06649180327868852,Very Cheap
20141231T000000,209000.0,2,1.0,1070,6120,1.0,0,0,3,6,1070,0,1962,0,98168,47.4989,-122.317,1130,6120,5050,4990,34.150326797385624,0.017573770491803278,Very Cheap
20150403T000000,335000.0,5,3.0,2660,7700,1.5,0,0,4,7,1670,990,1962,0,98058,47.46,-122.174,1610,7700,5040,6090,43.506493506493506,0.03409836065573771,Very Cheap
20141212T000000,285950.0,2,1.0,710,7120,1.0,0,0,5,6,710,0,1942,0,98146,47.5122,-122.374,1100,7020,6410,5920,40.16151685393258,0.027665573770491805,Very Cheap
20141107T000000,645000.0,5,2.25,3340,52476,2.0,0,0,4,8,3340,0,1975,0,98027,47.4553,-121.987,2460,48351,49136,45891,12.29133318088269,0.07475409836065573,Very Cheap
20141223T000000,312000.0,2,1.0,1160,7500,1.5,0,0,4,7,1160,0,1916,0,98014,47.6499,-121.916,1110,7500,6340,6390,41.6,0.031081967213114754,Very Cheap
20141010T000000,663000.0,3,2.25,2840,59677,1.0,0,0,3,7,1580,1260,1967,0,98075,47.5828,-122.044,2220,31688,56837,29468,11.109807798649395,0.07711475409836066,Very Cheap
20141020T000000,443950.0,3,1.75,2000,36000,1.0,0,0,3,6,2000,0,1946,1995,98056,47.5217,-122.182,2100,9681,34000,7581,12.331944444444444,0.04838688524590164,Very Cheap
20140530T000000,315000.0,3,2.0,1060,5750,1.0,0,0,3,7,1060,0,1981,0,98126,47.5523,-122.372,1080,5750,4690,4670,54.78260869565217,0.031475409836065574,Very Cheap
20150323T000000,302200.0,4,1.5,1730,10396,1.0,0,0,3,7,1730,0,1964,0,98058,47.4497,-122.168,1510,10396,8666,8886,29.068872643324354,0.02979672131147541,Very Cheap
20150108T000000,770000.0,3,2.5,2190,2658,2.0,0,3,4,9,2190,0,1979,0,98033,47.6528,-122.203,2315,2538,468,223,289.69149736644096,0.09114754098360656,Very Cheap
20150122T000000,374950.0,4,1.75,1660,8160,1.0,0,0,3,8,1660,0,1974,0,98058,47.4483,-122.129,1800,7684,6500,5884,45.94975490196079,0.03933770491803279,Very Cheap
20140611T000000,330000.0,3,2.5,2210,7557,2.0,0,0,3,9,2210,0,1989,0,98023,47.3079,-122.393,2440,8641,5347,6201,43.66812227074236,0.03344262295081967,Very Cheap
20141020T000000,230000.0,2,1.0,870,7020,1.0,0,0,4,6,570,300,1942,0,98106,47.5404,-122.352,1730,7020,6150,5290,32.763532763532766,0.020327868852459016,Very Cheap
20150427T000000,967000.0,4,2.5,3100,7250,2.0,0,0,3,9,3100,0,2010,0,98115,47.6961,-122.316,1240,6670,4150,5430,133.3793103448276,0.11698360655737705,Cheap
20140908T000000,536500.0,4,2.5,1720,3515,2.0,0,2,3,8,1470,250,2000,0,98144,47.591,-122.293,1140,2208,1795,1068,152.6315789473684,0.060524590163934425,Very Cheap
20140627T000000,315000.0,6,4.0,3120,4240,2.0,0,2,4,7,2090,1030,1993,0,98106,47.5305,-122.353,1460,4240,1120,2780,74.29245283018868,0.031475409836065574,Very Cheap
20140716T000000,626000.0,3,1.0,1040,4240,1.0,0,0,4,7,860,180,1924,0,98117,47.6768,-122.367,1170,4240,3200,3070,147.64150943396226,0.07226229508196721,Very Cheap
20140718T000000,334009.0,4,2.0,1650,9305,1.0,0,0,4,6,1650,0,1960,0,98034,47.7183,-122.213,1860,7486,7655,5626,35.89564750134336,0.03396839344262295,Very Cheap
20150129T000000,429000.0,2,1.0,1010,5000,1.0,0,0,2,7,1010,0,1924,0,98107,47.6715,-122.365,1410,5000,3990,3590,85.8,0.04642622950819672,Very Cheap
20150205T000000,818000.0,4,2.5,4020,44431,2.0,0,0,3,10,4020,0,1987,0,98072,47.7467,-122.132,3440,52900,40411,49460,18.41056919718215,0.09744262295081967,Very Cheap
20140828T000000,326000.0,5,2.75,2166,6342,2.0,0,0,3,8,2166,0,2013,0,98042,47.3461,-122.152,2474,5948,4176,3474,51.40334279407127,0.032918032786885244,Very Cheap
20140612T000000,310000.0,5,3.0,1880,5000,1.0,0,0,3,7,1100,780,1997,0,98106,47.5453,-122.363,1640,5000,3120,3360,62.0,0.03081967213114754,Very Cheap
20150421T000000,525000.0,4,2.0,2260,7680,1.0,0,0,4,7,1130,1130,1947,0,98177,47.7193,-122.361,1800,7680,5420,5880,68.359375,0.05901639344262295,Very Cheap
20150403T000000,350000.0,3,2.25,2010,4400,1.5,0,0,3,7,2010,0,1986,0,98055,47.4735,-122.189,1720,4187,2390,2467,79.54545454545455,0.036065573770491806,Very Cheap
20150402T000000,936000.0,4,2.5,3330,8897,2.0,0,0,3,10,3330,0,2001,0,98074,47.6484,-122.08,3150,7515,5567,4365,105.20400134876925,0.11291803278688524,Cheap
20141129T000000,226000.0,3,1.0,1520,7200,1.0,0,0,3,7,1030,490,1954,0,98166,47.4527,-122.352,1530,7201,5680,5671,31.38888888888889,0.01980327868852459,Very Cheap
20150501T000000,1250000.0,5,3.5,3510,4798,2.0,0,0,3,10,2700,810,2008,0,98105,47.669,-122.282,1460,1684,1288,224,260.5252188411838,0.1540983606557377,Cheap
20140819T000000,428000.0,3,1.75,1580,507038,1.0,0,2,4,7,1580,0,1985,0,98022,47.2303,-121.936,2040,210394,505458,208354,0.8441181923248356,0.04629508196721312,Very Cheap
20140529T000000,329932.0,3,1.5,1460,5040,1.0,0,0,3,7,1100,360,1971,0,98133,47.7112,-122.357,2330,7560,3580,5230,65.46269841269842,0.03343370491803279,Very Cheap
20150120T000000,539000.0,3,1.5,1460,5040,1.0,0,0,3,7,1100,360,1971,0,98133,47.7112,-122.357,2330,7560,3580,5230,106.94444444444444,0.06085245901639344,Very Cheap
20150310T000000,275000.0,3,1.75,1650,7700,1.0,0,0,4,8,1650,0,1977,0,98023,47.3155,-122.365,2020,7700,6050,5680,35.714285714285715,0.02622950819672131,Very Cheap
20140910T000000,590000.0,4,2.5,2660,35010,2.0,0,2,3,9,2660,0,1993,0,98045,47.4816,-121.714,2330,35448,32350,33118,16.852327906312482,0.06754098360655737,Very Cheap
20150123T000000,782000.0,4,2.5,3510,24604,2.0,0,0,3,10,3510,0,1997,0,98053,47.6772,-122.056,3530,26673,21094,23143,31.78344984555357,0.09272131147540984,Very Cheap
20140616T000000,575000.0,4,2.5,2120,9603,2.0,0,0,3,8,2120,0,1985,0,98027,47.5348,-122.053,1990,9611,7483,7621,59.877121732791835,0.06557377049180328,Very Cheap
20150114T000000,509000.0,3,2.25,1780,9315,2.0,0,0,3,7,1780,0,1996,0,98133,47.7484,-122.353,1780,8545,7535,6765,54.6430488459474,0.056918032786885245,Very Cheap
20140509T000000,290000.0,4,2.5,2000,13300,1.0,0,0,4,7,1200,800,1968,0,98001,47.353,-122.294,1800,9810,11300,8010,21.804511278195488,0.02819672131147541,Very Cheap
20140728T000000,305240.0,3,1.0,1300,9000,1.0,0,0,3,7,1300,0,1956,0,98133,47.7352,-122.337,1500,9600,7700,8100,33.91555555555556,0.030195409836065574,Very Cheap
20140610T000000,555000.0,3,2.0,2180,4976,1.5,0,2,4,8,1680,500,1930,0,98126,47.573,-122.38,1850,5000,2796,3150,111.53536977491962,0.06295081967213115,Very Cheap
20140725T000000,317000.0,3,2.0,1790,8228,1.0,0,0,3,7,1390,400,1980,0,98058,47.4658,-122.172,1880,8228,6438,6348,38.52698104035002,0.03173770491803279,Very Cheap
20140613T000000,430000.0,3,2.0,1910,5040,1.5,0,0,3,8,1910,0,1971,0,98074,47.6312,-122.061,1980,4275,3130,2295,85.31746031746032,0.04655737704918033,Very Cheap
20150224T000000,850000.0,2,1.5,1800,4144,1.0,0,4,4,7,900,900,1962,0,98116,47.5934,-122.39,2090,4173,2344,2083,205.1158301158301,0.10163934426229508,Cheap
20141126T000000,469000.0,3,2.25,2620,10659,1.0,0,0,3,7,1660,960,1976,0,98155,47.7643,-122.273,1820,12071,8039,10251,44.00037526972511,0.05167213114754098,Very Cheap
20140730T000000,327200.0,2,2.0,1440,8425,1.0,0,0,4,6,1440,0,1942,1983,98168,47.4831,-122.296,1430,12037,6985,10607,38.83679525222552,0.03307540983606557,Very Cheap
20140612T000000,835000.0,3,3.0,2790,12523,2.0,1,4,4,8,1600,1190,1977,0,98198,47.3571,-122.324,2990,11476,9733,8486,66.67731374271341,0.09967213114754099,Very Cheap
20140903T000000,360000.0,4,2.5,2340,13445,2.0,0,0,3,8,2340,0,1990,0,98042,47.374,-122.125,2340,11188,11105,8848,26.77575306805504,0.037377049180327866,Very Cheap
20141211T000000,372000.0,4,2.5,2070,8658,2.0,0,0,3,8,2070,0,1999,0,98178,47.5072,-122.257,2010,7215,6588,5205,42.96604296604296,0.03895081967213115,Very Cheap
20150326T000000,453000.0,3,1.0,2160,11484,1.5,0,0,4,7,2160,0,1968,0,98034,47.7277,-122.185,2270,10080,9324,7810,39.446185997910135,0.04957377049180328,Very Cheap
20140813T000000,275000.0,2,1.75,2090,11317,1.0,0,0,5,7,1090,1000,1931,0,98188,47.4594,-122.279,1940,11317,9227,9377,24.299726075815144,0.02622950819672131,Very Cheap
20140702T000000,475000.0,4,2.5,2040,7260,2.0,0,0,4,7,2040,0,1963,0,98133,47.7399,-122.332,2040,7360,5220,5320,65.42699724517907,0.05245901639344262,Very Cheap
20150213T000000,310000.0,4,2.75,1950,9720,1.0,0,0,3,7,1400,550,1986,0,98031,47.3969,-122.205,2300,10530,7770,8230,31.893004115226336,0.03081967213114754,Very Cheap
20150210T000000,173000.0,4,2.0,1200,8460,1.0,0,0,5,7,1200,0,1957,0,98188,47.4413,-122.277,1350,8623,7260,7273,20.44917257683215,0.012852459016393442,Very Cheap
20150403T000000,313500.0,5,3.0,2240,94960,1.0,0,0,3,6,2240,0,1985,0,98045,47.481,-121.788,1780,43400,92720,41620,3.3013900589721987,0.03127868852459016,Very Cheap
20140729T000000,345000.0,3,2.5,1360,1489,2.0,0,0,3,8,1360,0,2007,0,98126,47.549,-122.372,1360,1688,129,328,231.69912693082605,0.03540983606557377,Very Cheap
20150316T000000,436000.0,3,1.5,1500,10200,1.0,0,0,3,8,1300,200,1955,0,98177,47.7598,-122.359,1950,9500,8700,7550,42.745098039215684,0.047344262295081964,Very Cheap
20140924T000000,244500.0,2,1.75,1300,14500,1.0,0,0,3,6,650,650,1939,0,98168,47.4989,-122.329,1370,12986,13200,11616,16.862068965517242,0.02222950819672131,Very Cheap
20140711T000000,206000.0,3,1.75,1140,9800,1.0,0,0,4,7,1140,0,1968,0,98001,47.3063,-122.27,1370,9800,8660,8430,21.020408163265305,0.017180327868852457,Very Cheap
20150421T000000,890000.0,4,2.5,2930,9158,2.0,0,0,3,9,2930,0,2005,0,98052,47.7065,-122.13,3590,8065,6228,4475,97.18279100240227,0.10688524590163935,Cheap
20150122T000000,329950.0,4,2.25,2140,8874,2.0,0,0,3,8,2140,0,1986,0,98092,47.2654,-122.217,2140,8789,6734,6649,37.18165427090376,0.03343606557377049,Very Cheap
20150217T000000,250000.0,3,1.75,1628,286355,1.0,0,0,3,7,1628,0,1996,0,98092,47.2558,-122.122,1490,216344,284727,214854,0.8730422028600863,0.022950819672131147,Very Cheap
20141027T000000,246000.0,3,2.0,1990,203861,1.0,0,0,3,7,1990,0,1949,0,98022,47.2507,-122.039,2760,217800,201871,215040,1.2067045683087987,0.02242622950819672,Very Cheap
20140716T000000,440000.0,3,1.75,1950,19747,1.0,0,0,3,7,1150,800,1979,0,98072,47.7685,-122.162,2560,9674,17797,7114,22.28186559983795,0.04786885245901639,Very Cheap
20140924T000000,395000.0,4,1.75,1910,8117,1.0,0,0,3,7,1460,450,1975,0,98072,47.7344,-122.173,1810,8100,6207,6290,48.66329924849082,0.0419672131147541,Very Cheap
20140926T000000,305000.0,3,1.0,820,5150,1.0,0,0,5,6,820,0,1918,0,98118,47.5514,-122.284,1100,5150,4330,4050,59.22330097087379,0.03016393442622951,Very Cheap
20140923T000000,160000.0,3,2.25,1470,8682,1.0,0,0,3,7,1160,310,1985,0,98003,47.2729,-122.299,1670,8359,7212,6689,18.428933425478,0.011147540983606558,Very Cheap
20150226T000000,269000.0,3,2.25,1470,8682,1.0,0,0,3,7,1160,310,1985,0,98003,47.2729,-122.299,1670,8359,7212,6689,30.983644321584887,0.02544262295081967,Very Cheap
20140811T000000,169500.0,3,1.0,1060,10023,1.0,0,0,3,6,1060,0,1962,0,98023,47.2869,-122.36,1060,10023,8963,8963,16.911104459742592,0.01239344262295082,Very Cheap
20141205T000000,690500.0,4,2.75,3130,8920,2.0,0,0,3,8,3130,0,2014,0,98155,47.7397,-122.316,1450,9183,5790,7733,77.41031390134529,0.08072131147540984,Very Cheap
20141203T000000,245560.0,2,1.5,1260,9693,1.0,0,0,3,7,1260,0,1957,0,98177,47.7775,-122.365,1800,9693,8433,7893,25.333746002269677,0.022368524590163936,Very Cheap
20150311T000000,345000.0,4,2.75,2200,13498,2.0,0,0,3,8,2200,0,1987,0,98023,47.3148,-122.35,2190,11850,11298,9660,25.559342124759223,0.03540983606557377,Very Cheap
20141015T000000,383000.0,4,1.75,2580,19607,1.0,0,2,4,8,1290,1290,1958,0,98056,47.5067,-122.197,1970,9569,17027,7599,19.53383995511807,0.04039344262295082,Very Cheap
20140827T000000,388500.0,3,2.25,1350,944,2.0,0,0,3,8,1050,300,2007,0,98144,47.5997,-122.312,1350,1245,-406,-105,411.54661016949154,0.041114754098360656,Very Cheap
20140918T000000,250000.0,3,1.75,1350,8548,1.0,0,0,3,7,1350,0,1985,0,98003,47.3179,-122.33,1660,8538,7198,6878,29.246607393542348,0.022950819672131147,Very Cheap
20150203T000000,455500.0,3,1.75,2290,19000,1.0,0,0,4,9,1650,640,1973,0,98042,47.3837,-122.158,2900,13034,16710,10134,23.973684210526315,0.0499016393442623,Very Cheap
20141201T000000,672000.0,3,1.0,1220,8573,1.0,0,0,4,7,1220,0,1954,0,98004,47.6088,-122.193,1390,8573,7353,7183,78.38562930129476,0.07829508196721312,Very Cheap
20140630T000000,550000.0,4,1.5,2750,128502,1.0,0,0,2,7,1500,1250,1958,0,98055,47.4345,-122.198,1470,11514,125752,10044,4.280089025851738,0.06229508196721312,Very Cheap
20150506T000000,487000.0,3,1.75,1430,12632,1.0,0,0,3,7,1430,0,1959,0,98008,47.6371,-122.123,1750,10350,11202,8600,38.55288157061431,0.054032786885245904,Very Cheap
20140820T000000,291375.0,4,2.5,2220,6233,2.0,0,0,3,7,2220,0,2001,0,98059,47.4887,-122.15,2220,5352,4013,3132,46.74715225413124,0.02837704918032787,Very Cheap
20150304T000000,225000.0,3,1.0,1490,15850,1.0,0,0,3,7,1490,0,1946,0,98133,47.7411,-122.347,1950,13228,14360,11278,14.195583596214512,0.019672131147540985,Very Cheap
20141111T000000,519950.0,5,3.5,2440,10200,2.0,0,0,4,7,2440,0,1974,0,98075,47.5814,-122.003,2000,10568,7760,8568,50.97549019607843,0.058354098360655735,Very Cheap
20140826T000000,250000.0,3,2.5,2070,8400,2.0,0,0,4,8,2070,0,1990,0,98002,47.3099,-122.206,2070,9239,6330,7169,29.761904761904763,0.022950819672131147,Very Cheap
20140918T000000,614950.0,3,1.0,1500,2400,1.5,0,0,5,7,1500,0,1900,0,98119,47.6333,-122.362,1780,3600,900,1820,256.2291666666667,0.07081311475409836,Very Cheap
20150114T000000,599500.0,4,2.25,2020,10260,2.0,0,0,4,7,2020,0,1984,0,98052,47.6801,-122.114,2020,10311,8240,8291,58.4307992202729,0.06878688524590164,Very Cheap
20140924T000000,625000.0,4,1.5,2190,13660,1.0,0,3,3,8,2190,0,1952,0,98177,47.7658,-122.37,2520,20500,11470,17980,45.75402635431918,0.07213114754098361,Very Cheap
20150506T000000,248500.0,2,1.0,780,10064,1.0,0,0,4,7,780,0,1958,0,98168,47.4913,-122.318,1090,14750,9284,13660,24.691971383147855,0.02275409836065574,Very Cheap
20140930T000000,469950.0,5,2.0,1220,4200,1.0,0,0,4,6,1090,130,1921,0,98105,47.6677,-122.321,1790,4200,2980,2410,111.89285714285714,0.05179672131147541,Very Cheap
20150422T000000,525000.0,3,1.5,1840,10956,1.0,0,0,4,8,1840,0,1970,0,98033,47.6746,-122.164,1680,10950,9116,9270,47.91894852135816,0.05901639344262295,Very Cheap
20140902T000000,787500.0,2,2.5,2390,6928,2.0,0,3,4,8,1810,580,1949,1982,98146,47.5101,-122.391,2390,12852,4538,10462,113.66916859122402,0.09344262295081968,Very Cheap
20150416T000000,485000.0,4,2.5,3710,15935,1.0,0,0,3,10,2130,1580,2005,0,98001,47.3528,-122.267,3674,17913,12225,14239,30.436146846564167,0.05377049180327869,Very Cheap
20150407T000000,310000.0,2,1.0,750,5379,1.0,0,0,3,6,750,0,1919,0,98118,47.5324,-122.272,1030,5511,4629,4481,57.63153002416806,0.03081967213114754,Very Cheap
20141010T000000,280000.0,5,2.0,2110,7919,1.0,0,0,3,7,1110,1000,1966,0,98118,47.5164,-122.267,1590,5250,5809,3660,35.35799974744286,0.026885245901639345,Very Cheap
20150402T000000,200000.0,4,1.0,1020,42966,1.5,0,0,4,6,1020,0,1922,0,98072,47.7617,-122.11,2250,37680,41946,35430,4.654843364520784,0.01639344262295082,Very Cheap
20141010T000000,490000.0,3,2.5,3080,7363,2.0,0,0,3,9,3080,0,2006,0,98055,47.4473,-122.205,2860,5273,4283,2413,66.54896102132282,0.05442622950819672,Very Cheap
20141231T000000,146000.0,3,1.0,900,4770,1.0,0,0,3,6,900,0,1969,2009,98023,47.3038,-122.362,900,3480,3870,2580,30.60796645702306,0.009311475409836066,Very Cheap
20141120T000000,500000.0,5,3.0,3720,25474,2.0,0,4,3,9,2090,1630,1986,0,98001,47.3296,-122.256,1870,14547,21754,12677,19.627855853026617,0.05573770491803279,Very Cheap
20140910T000000,242500.0,3,1.0,940,7380,1.0,0,0,3,6,940,0,1959,0,98058,47.4516,-122.175,1210,8095,6440,6885,32.859078590785906,0.021967213114754098,Very Cheap
20141006T000000,324950.0,3,1.0,1040,7288,1.0,0,0,3,7,1040,0,1959,0,98125,47.7287,-122.311,1160,7287,6248,6127,44.58699231613611,0.03278032786885246,Very Cheap
20150416T000000,231500.0,2,1.0,1000,7615,1.0,0,0,4,6,1000,0,1943,0,98056,47.49,-122.191,1060,8000,6615,6940,30.4005252790545,0.020524590163934427,Very Cheap
20140529T000000,300000.0,3,2.5,2080,9827,2.0,0,0,3,8,2080,0,1989,0,98023,47.3058,-122.394,2660,9861,7747,7201,30.52813676605271,0.029508196721311476,Very Cheap
20141202T000000,545000.0,4,2.5,2500,50595,2.0,0,0,3,9,2500,0,1997,0,98045,47.4736,-121.731,2765,33720,48095,30955,10.771815396778338,0.06163934426229508,Very Cheap
20150217T000000,350000.0,3,1.0,1050,8583,1.0,0,0,5,6,1050,0,1955,0,98133,47.7451,-122.339,1460,7351,7533,5891,40.778282651753464,0.036065573770491806,Very Cheap
20140523T000000,467100.0,3,1.75,1620,8645,1.0,0,0,3,7,1190,430,1973,0,98052,47.6651,-122.151,2010,8645,7025,6635,54.03123192596877,0.05142295081967213,Very Cheap
20150408T000000,180000.0,3,1.0,1610,8500,1.5,0,0,3,7,1610,0,1959,0,98032,47.3717,-122.297,1070,8750,6890,7680,21.176470588235293,0.01377049180327869,Very Cheap
20140710T000000,749000.0,4,1.5,2130,5000,2.0,0,0,4,8,2130,0,1920,0,98144,47.5828,-122.291,2560,5000,2870,2440,149.8,0.08839344262295082,Very Cheap
20141009T000000,245000.0,3,2.5,1460,11593,2.0,0,0,3,7,1460,0,1989,0,98023,47.2984,-122.385,1640,9703,10133,8063,21.133442594669198,0.022295081967213116,Very Cheap
20140819T000000,260000.0,5,1.0,1600,7350,1.0,0,0,5,7,1600,0,1962,0,98031,47.3943,-122.196,1600,7725,5750,6125,35.374149659863946,0.024262295081967214,Very Cheap
20140607T000000,490000.0,3,3.0,1730,2940,3.0,0,0,3,7,1730,0,1985,0,98117,47.6911,-122.392,1690,4410,1210,2720,166.66666666666666,0.05442622950819672,Very Cheap
20140827T000000,565000.0,4,2.5,2280,4602,2.0,0,0,3,8,2280,0,2003,0,98075,47.5895,-122.019,2280,4193,2322,1913,122.77270751847023,0.06426229508196721,Very Cheap
20140825T000000,330000.0,4,2.25,2430,7490,2.0,0,0,3,8,2430,0,1983,0,98058,47.4406,-122.139,2070,7469,5060,5399,44.05874499332443,0.03344262295081967,Very Cheap
20141104T000000,295000.0,3,1.0,1380,7575,1.0,0,0,4,7,1380,0,1963,0,98056,47.5139,-122.187,1320,7600,6195,6280,38.943894389438945,0.028852459016393443,Very Cheap
20141009T000000,725000.0,3,1.5,1790,6000,1.5,0,0,4,7,1790,0,1903,0,98115,47.6754,-122.325,1290,3500,4210,2210,120.83333333333333,0.08524590163934426,Very Cheap
20140903T000000,1135000.0,4,2.5,3370,10602,2.0,0,0,3,10,3370,0,1999,0,98007,47.6591,-122.147,2950,9949,7232,6999,107.05527259007735,0.13901639344262295,Cheap
20140804T000000,680000.0,3,2.25,2920,6300,1.0,0,0,3,8,1710,1210,1956,0,98177,47.7065,-122.37,1940,6300,3380,4360,107.93650793650794,0.07934426229508197,Very Cheap
20141030T000000,490000.0,2,1.0,2180,9300,1.0,0,0,4,7,1090,1090,1947,0,98177,47.7032,-122.371,1830,7378,7120,5548,52.68817204301075,0.05442622950819672,Very Cheap
20150427T000000,635000.0,3,1.75,1480,6985,1.5,0,0,4,7,1200,280,1926,0,98117,47.686,-122.374,1480,5588,5505,4108,90.9090909090909,0.07344262295081967,Very Cheap
20150406T000000,750000.0,3,2.5,2350,715690,1.5,0,0,4,9,2350,0,1979,0,98022,47.1622,-121.971,1280,325393,713340,324113,1.047939750450614,0.08852459016393442,Very Cheap
20141209T000000,330000.0,4,2.25,2440,8098,2.0,0,0,3,8,2440,0,1983,0,98023,47.3126,-122.346,2110,7911,5658,5801,40.75080266732527,0.03344262295081967,Very Cheap
20150324T000000,270000.0,3,2.5,1350,1189,2.0,0,0,3,7,1080,270,2007,0,98106,47.5218,-122.358,1300,1182,-161,-118,227.0815811606392,0.025573770491803278,Very Cheap
20140514T000000,340000.0,3,2.25,1970,3716,2.0,0,0,3,7,1970,0,1997,0,98056,47.4907,-122.167,1780,3716,1746,1936,91.49623250807319,0.03475409836065574,Very Cheap
20150304T000000,413252.0,3,0.75,1110,3960,1.0,0,0,3,7,1110,0,1951,0,98117,47.6834,-122.366,1610,5530,2850,3920,104.35656565656565,0.044360918032786884,Very Cheap
20150210T000000,600000.0,4,2.75,2950,5803,2.0,0,0,3,9,2950,0,2007,0,98028,47.7368,-122.231,2940,5803,2853,2863,103.3947957952783,0.06885245901639345,Very Cheap
20150415T000000,726888.0,5,3.0,2970,7261,2.0,0,0,3,9,2970,0,1999,0,98075,47.5994,-122.019,2970,8437,4291,5467,100.10852499655695,0.08549350819672132,Very Cheap
20141206T000000,285000.0,2,1.0,720,6400,1.0,0,0,4,6,720,0,1943,0,98126,47.5286,-122.368,1030,6400,5680,5370,44.53125,0.02754098360655738,Very Cheap
20150206T000000,365000.0,2,1.0,770,5680,1.0,0,0,4,6,770,0,1929,0,98117,47.6951,-122.366,1170,5514,4910,4344,64.2605633802817,0.0380327868852459,Very Cheap
20150309T000000,295000.0,4,2.0,1650,7200,1.0,0,0,3,7,1650,0,1964,0,98133,47.7543,-122.344,1410,7200,5550,5790,40.97222222222222,0.028852459016393443,Very Cheap
20150318T000000,460000.0,3,2.25,1620,7350,1.0,0,0,3,7,1170,450,1969,0,98034,47.7248,-122.179,1800,7350,5730,5550,62.585034013605444,0.050491803278688525,Very Cheap
20140925T000000,230000.0,3,1.5,1510,10588,1.5,0,0,3,7,1510,0,1947,0,98198,47.3775,-122.319,1360,2873,9078,1513,21.722704948998867,0.020327868852459016,Very Cheap
20140522T000000,337000.0,3,1.0,1070,6109,1.0,0,0,5,7,1070,0,1951,0,98125,47.7207,-122.32,1170,7200,5039,6030,55.164511376657394,0.034360655737704915,Very Cheap
20140908T000000,300000.0,3,1.0,1010,6300,1.0,0,0,3,7,1010,0,1957,0,98133,47.7304,-122.352,1480,7480,5290,6000,47.61904761904762,0.029508196721311476,Very Cheap
20150130T000000,2300000.0,4,2.5,3370,8402,1.0,0,0,5,10,2240,1130,1962,0,98112,47.6349,-122.29,3190,8700,5032,5510,273.7443465841466,0.29180327868852457,Cheap
20141210T000000,360000.0,4,2.5,2000,5500,2.0,0,0,3,8,2000,0,2003,0,98038,47.3552,-122.014,2000,5512,3500,3512,65.45454545454545,0.037377049180327866,Very Cheap
20150316T000000,585000.0,3,2.5,2060,10839,2.0,0,0,3,8,2060,0,1987,0,98029,47.5675,-122.016,2180,8126,8779,5946,53.971768613340714,0.06688524590163934,Very Cheap
20141008T000000,182700.0,3,2.25,1740,6650,1.0,0,0,3,7,1240,500,1978,0,98023,47.2979,-122.379,1740,7000,4910,5260,27.473684210526315,0.014124590163934426,Very Cheap
20150428T000000,305000.0,3,2.25,1740,6650,1.0,0,0,3,7,1240,500,1978,0,98023,47.2979,-122.379,1740,7000,4910,5260,45.86466165413534,0.03016393442622951,Very Cheap
20140505T000000,309950.0,3,2.5,1880,7838,2.0,0,0,3,7,1880,0,1994,0,98055,47.4439,-122.19,1810,7915,5958,6105,39.54452666496555,0.03081311475409836,Very Cheap
20150316T000000,550000.0,3,1.0,960,12527,1.0,0,0,3,7,960,0,1972,0,98033,47.6891,-122.203,1220,7579,11567,6359,43.905164843937094,0.06229508196721312,Very Cheap
20141111T000000,825000.0,3,2.5,3280,26413,1.0,0,3,3,11,2670,610,1985,0,98074,47.6395,-122.05,3280,25211,23133,21931,31.234619316245787,0.09836065573770492,Very Cheap
20141001T000000,998500.0,2,1.0,1570,4400,1.5,0,0,4,8,1570,0,1914,0,98122,47.6112,-122.293,1850,4400,2830,2550,226.9318181818182,0.12111475409836066,Cheap
20141101T000000,644500.0,4,2.5,2990,5342,2.0,0,0,3,8,2990,0,2004,0,98074,47.6124,-122.009,2990,5936,2352,2946,120.6476974915762,0.07468852459016394,Very Cheap
20150112T000000,320000.0,3,2.0,1250,8636,1.0,0,0,5,7,1250,0,1968,0,98059,47.5066,-122.159,1620,7653,7386,6033,37.05419175544233,0.032131147540983604,Very Cheap
20141015T000000,266950.0,3,2.5,1920,4803,2.0,0,0,3,7,1920,0,2005,0,98042,47.3745,-122.127,2240,5231,2883,2991,55.57984592962732,0.02517377049180328,Very Cheap
20140514T000000,633100.0,4,2.5,2470,33305,2.0,0,0,3,9,2470,0,1993,0,98053,47.6303,-121.99,2440,33305,30835,30865,19.0091577841165,0.07319344262295081,Very Cheap
20140805T000000,395000.0,2,1.0,960,6700,1.0,0,0,3,7,960,0,1951,0,98103,47.6955,-122.357,1350,6700,5740,5350,58.95522388059702,0.0419672131147541,Very Cheap
20150316T000000,259250.0,3,1.0,940,5904,1.0,0,0,3,6,940,0,1947,0,98103,47.699,-122.35,870,5728,4964,4858,43.91090785907859,0.024163934426229508,Very Cheap
20141106T000000,300000.0,3,1.0,1260,5000,1.0,0,0,4,6,1260,0,1968,0,98014,47.6492,-121.915,1180,7500,3740,6320,60.0,0.029508196721311476,Very Cheap
20150220T000000,413000.0,3,1.75,2280,139392,1.0,0,0,3,8,2280,0,1977,0,98092,47.291,-122.118,2280,117176,137112,114896,2.9628673094582187,0.04432786885245902,Very Cheap
20140801T000000,435000.0,3,2.25,1740,8491,1.0,0,0,3,8,1240,500,1958,0,98177,47.7758,-122.379,2080,8494,6751,6414,51.230714874573074,0.04721311475409836,Very Cheap
20141003T000000,500000.0,4,2.75,2630,15000,1.0,0,0,4,7,1690,940,1976,0,98072,47.7425,-122.089,1800,16500,12370,14700,33.333333333333336,0.05573770491803279,Very Cheap
20140801T000000,402000.0,4,1.75,2430,5481,1.0,0,0,3,8,1430,1000,1953,0,98108,47.5569,-122.298,2050,5508,3051,3458,73.34428024083196,0.04288524590163934,Very Cheap
20150501T000000,777700.0,3,2.5,2260,251460,1.5,0,0,3,10,2260,0,1995,0,98070,47.4096,-122.449,1610,244372,249200,242762,3.0927384076990374,0.09215737704918033,Very Cheap
20150323T000000,580000.0,2,1.5,1220,5000,1.0,0,2,4,7,1220,0,1938,0,98103,47.6624,-122.348,2090,3850,3780,1760,116.0,0.06622950819672131,Very Cheap
20140908T000000,570000.0,3,1.75,2580,40392,1.0,0,0,3,9,1390,1190,1986,0,98072,47.7637,-122.134,2460,46173,37812,43713,14.111705288175877,0.06491803278688525,Very Cheap
20141208T000000,174950.0,2,1.0,730,6000,1.0,0,0,3,6,730,0,1950,1985,98198,47.3832,-122.3,1750,7200,5270,5450,29.158333333333335,0.013108196721311475,Very Cheap
20140507T000000,300000.0,2,1.0,760,3001,1.0,0,0,3,6,760,0,1913,0,98144,47.5874,-122.311,1750,5000,2241,3250,99.96667777407531,0.029508196721311476,Very Cheap
20140923T000000,435000.0,3,1.5,1740,6988,1.0,0,0,3,7,1600,140,1950,0,98133,47.7211,-122.33,1650,7500,5248,5850,62.24957069261591,0.04721311475409836,Very Cheap
20140528T000000,840000.0,4,2.5,3420,8405,2.0,0,0,3,10,3420,0,2000,0,98074,47.6328,-122.064,3230,8460,4985,5230,99.94051160023795,0.10032786885245902,Cheap
20140618T000000,469000.0,5,2.5,2240,7543,1.0,0,0,3,7,1140,1100,1966,0,98177,47.7756,-122.372,2110,7408,5303,5298,62.1768527111229,0.05167213114754098,Very Cheap
20141112T000000,870000.0,4,1.75,1920,3600,2.0,0,0,4,8,1920,0,1907,0,98119,47.6382,-122.368,1920,3600,1680,1680,241.66666666666666,0.10426229508196722,Cheap
20140604T000000,532000.0,4,1.75,2020,7029,1.0,0,0,4,7,1430,590,1979,0,98052,47.6983,-122.127,1780,7200,5009,5420,75.68644188362498,0.059934426229508196,Very Cheap
20150326T000000,455000.0,4,1.5,1880,11400,1.0,0,0,3,7,1280,600,1955,0,98177,47.7718,-122.381,1880,11400,9520,9520,39.91228070175438,0.049836065573770495,Very Cheap
20140731T000000,201000.0,3,1.0,1010,25277,1.0,0,0,5,5,1010,0,1961,0,98019,47.7242,-121.951,1570,213879,24267,212309,7.951893025279899,0.016524590163934427,Very Cheap
20140923T000000,649000.0,5,3.25,3990,13087,2.0,0,0,3,9,2400,1590,1991,0,98042,47.3632,-122.061,2580,13633,9097,11053,49.5911973714373,0.07527868852459016,Very Cheap
20150524T000000,445500.0,2,1.75,1390,6670,1.0,0,0,3,6,720,670,1941,0,98115,47.6914,-122.308,920,6380,5280,5460,66.79160419790105,0.04859016393442623,Very Cheap
20140527T000000,475000.0,3,2.0,1230,11502,1.0,0,0,4,7,1230,0,1984,0,98052,47.7017,-122.127,1660,11727,10272,10067,41.29716571031125,0.05245901639344262,Very Cheap
20150430T000000,590000.0,4,2.5,2940,29013,2.0,0,0,3,10,2940,0,1992,0,98077,47.7635,-122.044,3010,34071,26073,31061,20.335711577568677,0.06754098360655737,Very Cheap
20150224T000000,565000.0,4,1.5,2190,8296,2.0,0,0,3,7,2190,0,1935,1963,98136,47.5158,-122.385,1160,8160,6106,7000,68.10511089681775,0.06426229508196721,Very Cheap
20140915T000000,110000.0,1,1.0,640,10280,1.0,0,0,2,5,640,0,1920,0,98126,47.5144,-122.368,1090,9000,9640,7910,10.700389105058365,0.0045901639344262295,Very Cheap
20141219T000000,375000.0,3,2.5,1670,7740,1.0,0,0,3,7,1130,540,1974,0,98126,47.5222,-122.37,1220,7740,6070,6520,48.44961240310077,0.03934426229508197,Very Cheap
20140718T000000,255000.0,3,1.5,1240,8528,1.0,0,0,4,7,1240,0,1967,0,98058,47.4478,-122.157,1570,8064,7288,6494,29.901500938086304,0.02360655737704918,Very Cheap
20150429T000000,315000.0,5,1.75,1850,14800,1.5,0,0,3,6,1760,90,1937,0,98168,47.4935,-122.321,1250,14800,12950,13550,21.283783783783782,0.031475409836065574,Very Cheap
20141120T000000,496600.0,4,2.25,2020,8400,1.0,0,0,4,8,1350,670,1961,0,98006,47.5488,-122.171,2060,8400,6380,6340,59.11904761904762,0.055291803278688524,Very Cheap
20140714T000000,380000.0,3,1.0,1020,4800,1.0,0,0,3,7,1020,0,1944,0,98118,47.5615,-122.272,1400,5465,3780,4065,79.16666666666667,0.04,Very Cheap
20141110T000000,338950.0,3,1.75,1610,22496,1.0,0,0,4,7,1610,0,1974,0,98042,47.3443,-122.073,2050,35772,20886,33722,15.067123044096729,0.03461639344262295,Very Cheap
20141019T000000,542500.0,5,3.5,2730,42500,1.0,0,0,3,8,1530,1200,1989,0,98027,47.4587,-121.996,3180,37970,39770,34790,12.764705882352942,0.061311475409836065,Very Cheap
20140816T000000,739000.0,5,2.5,2840,5000,1.0,0,0,4,7,1620,1220,1913,0,98144,47.5817,-122.291,2200,5000,2160,2800,147.8,0.08708196721311476,Very Cheap
20140619T000000,549000.0,4,1.75,1290,3060,2.0,0,0,4,7,1290,0,1906,0,98103,47.6798,-122.348,1510,4080,1770,2570,179.41176470588235,0.06216393442622951,Very Cheap
20140624T000000,252000.0,3,2.25,1670,7881,1.0,0,0,4,7,1190,480,1977,0,98031,47.4105,-122.18,1870,7820,6211,5950,31.975637609440426,0.02321311475409836,Very Cheap
20140922T000000,1698890.0,4,4.5,3860,15246,2.0,0,4,3,11,2940,920,2004,0,98006,47.56,-122.161,3750,14790,11386,11040,111.43185097730553,0.21296918032786885,Cheap
20140611T000000,735000.0,4,1.75,2460,5100,1.5,0,0,5,7,1450,1010,1909,0,98115,47.6782,-122.3,1560,5100,2640,3540,144.11764705882354,0.08655737704918033,Very Cheap
20140709T000000,270000.0,4,2.5,1660,8063,1.0,0,0,4,7,1660,0,1978,0,98198,47.3761,-122.32,1060,8437,6403,7377,33.48629542353962,0.025573770491803278,Very Cheap
20150204T000000,2250000.0,3,2.5,3420,8700,1.0,0,0,3,9,2890,530,1951,0,98112,47.6352,-122.29,3370,8700,5280,5330,258.62068965517244,0.28524590163934427,Cheap
20141010T000000,155000.0,2,1.0,1010,43056,1.5,0,0,3,5,1010,0,1990,0,98014,47.7105,-121.316,830,18297,42046,17467,3.599962839093274,0.010491803278688525,Very Cheap
20150302T000000,469000.0,4,2.5,2240,5624,1.0,0,0,3,7,1520,720,1961,0,98108,47.5574,-122.308,2240,7495,3384,5255,83.39260312944523,0.05167213114754098,Very Cheap
20150108T000000,305000.0,4,2.25,2340,5250,2.0,0,0,5,7,2340,0,1965,0,98118,47.5183,-122.266,1540,5250,2910,3710,58.095238095238095,0.03016393442622951,Very Cheap
20140710T000000,675000.0,3,1.75,1920,4500,1.0,0,0,5,7,960,960,1924,0,98107,47.6645,-122.357,1190,4000,2580,2810,150.0,0.07868852459016394,Very Cheap
20141231T000000,931000.0,3,2.5,2460,6600,1.5,0,0,4,8,1560,900,1929,0,98109,47.6364,-122.351,2090,3400,4140,1310,141.06060606060606,0.11226229508196721,Cheap
20150205T000000,385000.0,3,1.0,1470,11398,1.0,0,0,3,8,1470,0,1950,0,98155,47.746,-122.296,1710,11407,9928,9697,33.77785576416915,0.04065573770491803,Very Cheap
20150214T000000,815000.0,3,2.5,3400,12442,2.0,0,0,3,9,3400,0,2001,0,98075,47.5611,-122.032,3250,8635,9042,5385,65.50393827358945,0.09704918032786886,Very Cheap
20150330T000000,531000.0,3,2.25,1910,8390,1.0,0,0,3,7,1910,0,1979,0,98034,47.73,-122.216,2410,8390,6480,5980,63.2896305125149,0.05980327868852459,Very Cheap
20150323T000000,386500.0,4,1.0,1400,3600,1.0,0,0,4,6,700,700,1901,0,98144,47.5972,-122.295,1690,3600,2200,1910,107.36111111111111,0.04085245901639344,Very Cheap
20140626T000000,475580.0,3,1.75,1520,11085,1.0,0,0,3,8,1520,0,1983,0,98074,47.646,-122.068,2310,9647,9565,7337,42.903022101939555,0.05253508196721311,Very Cheap
20140820T000000,358000.0,2,1.0,930,5077,1.0,0,0,3,6,930,0,1939,0,98133,47.7095,-122.35,1080,5803,4147,4723,70.51408311995273,0.03711475409836065,Very Cheap
20141022T000000,677500.0,5,1.0,2340,4730,2.0,0,0,3,8,1810,530,1918,0,98116,47.5895,-122.385,2100,4970,2390,2870,143.23467230443975,0.07901639344262296,Very Cheap
20140508T000000,868500.0,3,2.5,2920,3942,3.0,0,0,3,10,2920,0,2008,0,98056,47.531,-122.204,2920,3942,1022,1022,220.31963470319636,0.1040655737704918,Cheap
20150209T000000,599380.0,3,1.75,1270,7350,1.0,0,0,4,7,1270,0,1967,0,98005,47.6046,-122.168,1880,7350,6080,5470,81.54829931972789,0.06877114754098361,Very Cheap
20141008T000000,712000.0,4,2.25,2450,11960,1.0,0,0,3,10,2450,0,1979,0,98074,47.6351,-122.06,2600,11960,9510,9360,59.531772575250834,0.08354098360655737,Very Cheap
20150430T000000,350000.0,5,1.75,1380,7620,1.0,0,0,3,7,1180,200,1955,0,98106,47.5279,-122.345,1990,7620,6240,5630,45.93175853018373,0.036065573770491806,Very Cheap
20140510T000000,875000.0,4,2.0,2520,6000,1.0,0,0,3,8,1400,1120,1921,2007,98103,47.6767,-122.35,1580,3720,3480,2140,145.83333333333334,0.10491803278688525,Cheap
20150304T000000,365000.0,3,2.25,2290,7350,2.0,0,0,3,8,2290,0,1988,0,98058,47.429,-122.162,2170,7529,5060,5359,49.65986394557823,0.0380327868852459,Very Cheap
20140521T000000,452000.0,4,2.0,1660,6150,1.0,0,0,3,6,850,810,1945,0,98126,47.5371,-122.368,1110,6250,4490,5140,73.4959349593496,0.04944262295081967,Very Cheap
20150217T000000,915000.0,3,2.75,2800,9750,1.0,0,0,5,7,1400,1400,1957,0,98004,47.5862,-122.202,2800,9530,6950,6730,93.84615384615384,0.11016393442622952,Cheap
20150105T000000,482500.0,3,2.5,1690,3068,2.0,0,0,3,7,1690,0,2005,0,98053,47.6763,-122.028,1690,3260,1378,1570,157.26857887874837,0.053442622950819675,Very Cheap
20141014T000000,425000.0,3,1.0,1180,7200,1.5,0,0,4,7,1180,0,1949,0,98133,47.7121,-122.333,2240,7875,6020,5635,59.02777777777778,0.04590163934426229,Very Cheap
20141211T000000,460000.0,2,1.75,1390,4160,1.0,0,0,5,6,790,600,1916,0,98105,47.6681,-122.324,1090,4160,2770,3070,110.57692307692308,0.050491803278688525,Very Cheap
20140720T000000,666570.0,4,2.0,2320,7400,1.5,0,0,5,7,1620,700,1913,0,98118,47.5558,-122.269,1740,4000,5080,2260,90.07702702702703,0.07758295081967213,Very Cheap
20141014T000000,390000.0,3,2.25,2270,32112,1.0,0,0,4,8,1740,530,1980,0,98042,47.3451,-122.094,2310,41606,29842,39296,12.144992526158445,0.04131147540983607,Very Cheap
20141009T000000,650000.0,4,1.75,2640,8215,1.0,0,0,4,7,1500,1140,1966,0,98008,47.5819,-122.125,2070,7875,5575,5805,79.12355447352404,0.07540983606557378,Very Cheap
20141001T000000,305000.0,3,2.0,1680,8487,1.0,0,0,3,7,1680,0,1993,0,98022,47.1959,-122.01,2080,8560,6807,6480,35.93731589489808,0.03016393442622951,Very Cheap
20140805T000000,250000.0,3,1.0,990,8100,1.0,0,0,3,6,990,0,1949,0,98146,47.4839,-122.341,1210,8100,7110,6890,30.864197530864196,0.022950819672131147,Very Cheap
20150406T000000,438800.0,4,2.5,2770,4432,2.0,0,0,3,9,2770,0,2004,0,98058,47.4541,-122.117,2770,5423,1662,2653,99.0072202166065,0.047711475409836064,Very Cheap
20141215T000000,290000.0,2,1.0,950,5650,1.0,0,0,5,6,950,0,1943,0,98118,47.5149,-122.257,1250,5650,4700,4400,51.32743362831859,0.02819672131147541,Very Cheap
20150501T000000,324950.0,4,2.0,2160,4800,2.0,0,0,4,7,1290,870,1929,0,98055,47.4777,-122.212,1570,4800,2640,3230,67.69791666666667,0.03278032786885246,Very Cheap
20141201T000000,453000.0,3,2.5,1650,1838,2.0,0,0,4,7,1270,380,1991,0,98107,47.6666,-122.367,1550,1558,188,8,246.46354733405877,0.04957377049180328,Very Cheap
20140919T000000,556000.0,3,1.0,1800,4005,1.5,0,0,4,7,1160,640,1929,0,98117,47.6876,-122.38,1240,4005,2205,2765,138.82646691635455,0.06308196721311475,Very Cheap
20141118T000000,315000.0,3,2.0,1660,11135,1.0,0,0,3,8,1660,0,1971,0,98045,47.4897,-121.787,1660,11560,9475,9900,28.289178266726537,0.031475409836065574,Very Cheap
20140527T000000,445830.0,3,2.5,1870,5449,2.0,0,0,3,8,1870,0,2003,0,98011,47.7557,-122.22,2000,7687,3579,5687,81.81868232703248,0.04863344262295082,Very Cheap
20141010T000000,1260000.0,3,3.5,3220,3960,2.0,0,4,3,10,2760,460,1991,0,98116,47.5909,-122.384,3080,4444,740,1364,318.1818181818182,0.15540983606557376,Cheap
20140502T000000,287200.0,3,3.0,1850,19966,1.0,0,0,4,7,1090,760,1992,0,98038,47.3493,-122.034,1410,6715,18116,5305,14.38445357107082,0.027829508196721312,Very Cheap
20140923T000000,525000.0,4,1.5,1580,6360,1.5,0,0,3,7,1290,290,1945,0,98115,47.6873,-122.286,1690,6360,4780,4670,82.54716981132076,0.05901639344262295,Very Cheap
20141226T000000,1135000.0,4,4.25,4590,17621,2.0,0,0,3,10,3160,1430,2003,0,98033,47.6973,-122.205,3800,12268,13031,8468,64.41178139719652,0.13901639344262295,Cheap
20141010T000000,381000.0,3,1.75,2700,18246,1.0,0,0,4,7,1510,1190,1967,0,98059,47.4817,-122.097,1620,16986,15546,15366,20.88128904965472,0.040131147540983604,Very Cheap
20140606T000000,360000.0,3,1.75,1020,7020,1.5,0,0,4,7,1020,0,1953,0,98155,47.7362,-122.314,1020,5871,6000,4851,51.282051282051285,0.037377049180327866,Very Cheap
20150504T000000,619000.0,5,3.5,2950,2932,3.0,0,0,3,8,2950,0,2004,0,98144,47.5923,-122.298,1580,2047,-18,467,211.11869031377898,0.07134426229508196,Very Cheap
20150219T000000,535000.0,2,1.75,1780,224769,1.0,0,0,4,8,1780,0,1976,0,98038,47.4158,-122.002,2060,71560,222989,69500,2.380221471822182,0.06032786885245902,Very Cheap
20141009T000000,402000.0,2,1.0,710,5100,1.0,0,0,5,7,710,0,1905,0,98117,47.6765,-122.381,1530,5100,4390,3570,78.82352941176471,0.04288524590163934,Very Cheap
20141110T000000,600000.0,4,3.5,4300,70407,2.0,0,0,3,10,2710,1590,1992,0,98058,47.4472,-122.092,3520,26727,66107,23207,8.521879926711833,0.06885245901639345,Very Cheap
20140910T000000,549950.0,3,2.5,2080,8690,1.0,0,0,3,8,1430,650,1974,0,98166,47.4424,-122.344,2400,9625,6610,7225,63.28538550057537,0.062288524590163936,Very Cheap
20140820T000000,300000.0,4,2.0,2360,7440,1.0,0,0,3,7,1180,1180,1955,0,98178,47.5044,-122.245,1680,7800,5080,6120,40.32258064516129,0.029508196721311476,Very Cheap
20150325T000000,360000.0,6,2.0,2210,9870,2.0,0,0,4,7,2210,0,1969,1995,98059,47.4751,-122.145,1390,9912,7660,8522,36.474164133738604,0.037377049180327866,Very Cheap
20140910T000000,419000.0,7,3.25,4340,8521,2.0,0,0,3,7,2550,1790,1986,0,98106,47.52,-122.338,1890,8951,4181,7061,49.172632320150214,0.04511475409836065,Very Cheap
20150407T000000,510000.0,3,3.0,1320,1012,3.0,0,0,3,8,1320,0,2009,0,98117,47.6904,-122.395,1320,1536,-308,216,503.9525691699605,0.057049180327868855,Very Cheap
20140916T000000,319950.0,3,2.5,1980,9907,2.0,0,0,3,8,1980,0,1991,0,98022,47.1903,-122.013,2050,9907,7927,7857,32.295346724538206,0.03212459016393442,Very Cheap
20141007T000000,1180000.0,5,5.0,3960,94089,2.0,0,0,3,10,3960,0,1998,0,98038,47.38,-122.011,2240,64468,90129,62228,12.54131726344206,0.14491803278688525,Cheap
20141003T000000,381000.0,4,2.5,2130,6003,2.0,0,0,3,8,2130,0,2003,0,98058,47.4518,-122.12,1940,4529,3873,2589,63.468265867066464,0.040131147540983604,Very Cheap
20150505T000000,256900.0,3,2.5,1720,3951,2.0,0,0,3,7,1720,0,1992,0,98031,47.4033,-122.187,1720,3605,2231,1885,65.02151354087573,0.023855737704918032,Very Cheap
20150219T000000,346000.0,5,1.0,1790,30456,1.0,0,0,4,7,1350,440,1964,0,98030,47.3469,-122.195,2420,35647,28666,33227,11.360651431573418,0.03554098360655738,Very Cheap
20141208T000000,465000.0,2,2.25,1390,1222,3.0,0,0,3,7,1340,50,2009,0,98052,47.6754,-122.121,1480,1369,-168,-111,380.5237315875614,0.051147540983606556,Very Cheap
20150506T000000,545000.0,3,2.0,1900,9975,1.0,0,0,3,8,1500,400,1973,0,98027,47.5307,-122.054,2140,9825,8075,7685,54.636591478696744,0.06163934426229508,Very Cheap
20140730T000000,516000.0,2,1.75,1640,3090,1.0,0,0,4,7,910,730,1925,0,98115,47.679,-122.319,1510,4120,1450,2610,166.9902912621359,0.05783606557377049,Very Cheap
20140609T000000,550000.0,4,2.5,2700,5100,1.0,0,0,4,8,1440,1260,1968,0,98136,47.5331,-122.384,1880,5100,2400,3220,107.84313725490196,0.06229508196721312,Very Cheap
20150505T000000,339950.0,4,2.25,2200,7150,2.0,0,0,4,7,2200,0,1990,0,98042,47.3595,-122.089,1740,7150,4950,5410,47.54545454545455,0.03474754098360656,Very Cheap
20150325T000000,417000.0,3,1.0,1310,8514,1.0,0,0,4,7,1310,0,1953,0,98133,47.7502,-122.353,1310,8514,7204,7204,48.97815362931642,0.04485245901639344,Very Cheap
20150225T000000,906000.0,4,2.5,2480,5000,1.0,0,3,3,8,1480,1000,1951,0,98105,47.6653,-122.272,2240,6071,2520,3831,181.2,0.10898360655737704,Cheap
20141112T000000,980000.0,4,2.25,3010,9800,2.0,0,0,4,9,3010,0,1973,0,98040,47.5336,-122.223,2510,9800,6790,7290,100.0,0.11868852459016394,Cheap
20150413T000000,555000.0,4,2.5,2450,5079,2.0,0,0,3,9,2450,0,2001,0,98056,47.5214,-122.191,2690,6675,2629,3985,109.27347903130537,0.06295081967213115,Very Cheap
20141110T000000,468000.0,2,1.75,1250,7029,1.0,0,0,4,7,1250,0,1986,0,98033,47.6936,-122.186,1680,8470,5779,6790,66.58130601792574,0.05154098360655738,Very Cheap
20141020T000000,378000.0,3,1.75,2610,117176,1.0,0,0,3,7,1390,1220,1981,0,98022,47.2585,-121.925,2140,142005,114566,139865,3.225916569946064,0.03973770491803279,Very Cheap
20141216T000000,430000.0,4,2.5,2010,16020,1.5,0,0,5,8,2010,0,1962,0,98059,47.4821,-122.108,1420,16020,14010,14600,26.841448189762797,0.04655737704918033,Very Cheap
20140516T000000,730100.0,4,2.5,3120,14300,2.0,0,0,3,9,3120,0,2003,0,98027,47.5318,-122.055,2580,10005,11180,7425,51.05594405594405,0.08591475409836065,Very Cheap
20140904T000000,219000.0,4,1.5,1370,7944,1.5,0,0,3,7,1370,0,1961,0,98198,47.4224,-122.289,1370,9181,6574,7811,27.56797583081571,0.018885245901639345,Very Cheap
20141121T000000,570000.0,3,2.5,2420,11953,1.0,0,0,3,9,2420,0,1990,0,98074,47.6285,-122.054,2420,12215,9533,9795,47.68677319501381,0.06491803278688525,Very Cheap
20141119T000000,262500.0,4,2.75,1500,7036,1.0,0,0,3,7,1060,440,1979,0,98032,47.3665,-122.276,1620,7200,5536,5580,37.30812961910176,0.02459016393442623,Very Cheap
20140529T000000,525000.0,5,2.5,2630,9216,2.0,0,0,3,8,2630,0,2003,0,98019,47.7379,-121.966,2020,4980,6586,2960,56.966145833333336,0.05901639344262295,Very Cheap
20150402T000000,520000.0,2,1.0,950,3880,1.0,0,0,4,6,950,0,1919,0,98117,47.687,-122.389,1660,3880,2930,2220,134.02061855670104,0.058360655737704915,Very Cheap
20141209T000000,417400.0,3,3.0,2680,12285,1.0,0,0,4,8,2680,0,1970,0,98055,47.4633,-122.196,2610,9558,9605,6948,33.97639397639398,0.044904918032786886,Very Cheap
20140512T000000,788000.0,4,3.25,3680,5759,2.0,0,0,3,9,2840,840,2003,0,98027,47.5367,-122.067,3620,6006,2079,2386,136.82931064420907,0.09350819672131147,Very Cheap
20141224T000000,320000.0,3,1.0,1270,7400,1.0,0,2,4,7,1270,0,1956,0,98056,47.4831,-122.191,1800,7400,6130,5600,43.24324324324324,0.032131147540983604,Very Cheap
20140905T000000,950000.0,6,1.0,2330,5000,1.5,0,0,4,7,2330,0,1920,0,98117,47.6789,-122.397,1570,5000,2670,3430,190.0,0.11475409836065574,Cheap
20140527T000000,255000.0,3,1.0,960,8100,1.0,0,0,3,7,960,0,1955,0,98155,47.7766,-122.307,1120,8100,7140,6980,31.48148148148148,0.02360655737704918,Very Cheap
20140520T000000,260000.0,4,2.5,1990,6671,2.0,0,0,3,7,1990,0,1989,0,98023,47.3078,-122.358,1862,6566,4681,4704,38.974666466796585,0.024262295081967214,Very Cheap
20150312T000000,394000.0,3,1.0,1450,7930,1.0,0,0,4,6,1150,300,1923,0,98126,47.5212,-122.371,1040,7740,6480,6700,49.68474148802018,0.041836065573770495,Very Cheap
20141231T000000,575000.0,4,2.5,2280,27441,2.0,0,0,3,8,2280,0,1996,0,98072,47.7628,-122.123,2350,35020,25161,32670,20.954046864181336,0.06557377049180328,Very Cheap
20150319T000000,1250000.0,4,2.25,1830,7200,2.0,0,2,3,8,1750,80,1923,0,98112,47.6315,-122.282,3100,7200,5370,4100,173.61111111111111,0.1540983606557377,Cheap
20140804T000000,385000.0,3,2.25,1650,7800,1.0,0,0,3,7,1260,390,1969,0,98011,47.7377,-122.197,1760,8268,6150,6508,49.35897435897436,0.04065573770491803,Very Cheap
20141107T000000,456000.0,5,2.75,2720,193406,1.0,0,4,4,7,1700,1020,1968,0,98092,47.2838,-122.121,2820,248292,190686,245472,2.3577345066854183,0.0499672131147541,Very Cheap
20150506T000000,637000.0,4,2.5,1710,5000,1.0,0,0,3,8,1110,600,1979,0,98115,47.6772,-122.285,1750,5304,3290,3554,127.4,0.07370491803278688,Very Cheap
20141110T000000,485000.0,5,1.5,1420,9900,1.0,0,0,3,7,1050,370,1964,0,98008,47.6348,-122.118,1580,8075,8480,6495,48.98989898989899,0.05377049180327869,Very Cheap
20140512T000000,315275.0,3,1.75,1440,8040,1.0,0,0,3,7,960,480,1951,0,98125,47.7128,-122.306,1500,8040,6600,6540,39.21330845771144,0.031511475409836065,Very Cheap
20140923T000000,252500.0,2,1.5,1280,8710,1.0,0,0,3,7,1280,0,1967,0,98058,47.4472,-122.16,1520,9375,7430,7855,28.989667049368542,0.023278688524590165,Very Cheap
20150323T000000,240000.0,2,1.0,1320,24319,1.0,0,0,3,7,1320,0,1966,0,98027,47.4741,-122.015,1430,98445,22999,97015,9.868826843209014,0.021639344262295083,Very Cheap
20141112T000000,790000.0,4,2.5,2560,12760,1.0,0,0,4,7,1760,800,1949,0,98115,47.6947,-122.303,1760,6384,10200,4624,61.912225705329156,0.09377049180327869,Very Cheap
20140514T000000,310000.0,3,1.0,1480,7830,1.0,0,0,3,7,1480,0,1952,0,98133,47.7703,-122.336,1450,7830,6350,6380,39.59131545338442,0.03081967213114754,Very Cheap
20141212T000000,1250000.0,4,2.5,2960,20240,2.0,0,4,4,10,2960,0,1985,0,98146,47.5075,-122.389,2500,14960,17280,12460,61.758893280632414,0.1540983606557377,Cheap
20150128T000000,425000.0,2,1.0,1160,5038,1.0,0,0,5,7,740,420,1942,0,98126,47.5304,-122.38,1160,5076,3878,3916,84.35887256847955,0.04590163934426229,Very Cheap
20140603T000000,548000.0,3,2.5,2110,4099,2.0,0,0,3,8,2110,0,2001,0,98072,47.7508,-122.17,2110,4871,1989,2761,133.6911441815077,0.062032786885245904,Very Cheap
20140503T000000,379880.0,3,2.5,1650,14054,1.0,0,0,4,7,1130,520,1986,0,98027,47.4821,-122.017,1940,87555,12404,85615,27.03002703856553,0.039984262295081965,Very Cheap
20140530T000000,530000.0,3,2.5,1950,9906,2.0,0,0,3,8,1950,0,1988,0,98074,47.6363,-122.025,1860,7689,7956,5829,53.50292751867555,0.05967213114754098,Very Cheap
20150420T000000,695000.0,3,2.25,2600,220300,1.5,0,0,5,8,2120,480,1977,0,98027,47.4562,-122.016,2760,215600,217700,212840,3.1547889241942806,0.08131147540983606,Very Cheap
20140527T000000,435000.0,3,1.0,1270,4000,1.5,0,2,3,7,1270,0,1928,0,98126,47.5695,-122.376,1560,4000,2730,2440,108.75,0.04721311475409836,Very Cheap
20140521T000000,540000.0,3,1.75,1300,62290,1.0,0,0,3,7,1300,0,1983,0,98053,47.6529,-121.979,1850,52272,60990,50422,8.669128270990528,0.06098360655737705,Very Cheap
20140620T000000,425000.0,3,2.25,1790,10209,1.0,0,0,3,7,1290,500,1967,0,98072,47.7492,-122.086,1840,9900,8419,8060,41.62993437163287,0.04590163934426229,Very Cheap
20140715T000000,490000.0,3,2.5,1930,7266,2.0,0,0,3,8,1930,0,2005,0,98125,47.7191,-122.309,1930,7266,5336,5336,67.4373795761079,0.05442622950819672,Very Cheap
20140703T000000,220000.0,4,1.0,1200,6000,1.5,0,0,3,6,1200,0,1923,0,98106,47.5307,-122.352,950,4000,4800,3050,36.666666666666664,0.01901639344262295,Very Cheap
20150107T000000,540000.0,4,2.5,2050,3784,2.0,0,0,3,8,2050,0,2001,0,98034,47.7189,-122.181,2050,3366,1734,1316,142.7061310782241,0.06098360655737705,Very Cheap
20141222T000000,670000.0,3,1.0,1710,6195,1.0,0,0,3,7,1410,300,1946,0,98105,47.6706,-122.265,1610,6195,4485,4585,108.15173527037933,0.0780327868852459,Very Cheap
20141119T000000,667500.0,3,1.75,2130,20423,1.0,0,0,3,9,2130,0,1953,0,98004,47.6339,-122.192,2370,20875,18293,18505,32.68373892180385,0.07770491803278688,Very Cheap
20140916T000000,585000.0,3,3.5,1700,2197,2.0,0,0,3,8,1260,440,2010,0,98116,47.5767,-122.41,1360,1418,497,58,266.2721893491124,0.06688524590163934,Very Cheap
20141118T000000,225000.0,3,1.5,1390,12500,1.0,0,0,4,6,1390,0,1976,0,98014,47.6496,-121.908,1390,9000,11110,7610,18.0,0.019672131147540985,Very Cheap
20140819T000000,375000.0,3,1.0,1230,9877,1.0,0,0,3,7,1230,0,1954,0,98006,47.5745,-122.136,1240,9965,8647,8725,37.96699402652627,0.03934426229508197,Very Cheap
20141124T000000,335000.0,3,2.0,1490,8847,1.0,0,0,4,7,1490,0,1967,0,98177,47.7639,-122.363,1640,7572,7357,5932,37.865943257601444,0.03409836065573771,Very Cheap
20150311T000000,680000.0,5,3.25,2440,15815,2.0,0,0,3,8,1990,450,2014,0,98155,47.774,-122.28,2500,14201,13375,11701,42.99715460006323,0.07934426229508197,Very Cheap
20150123T000000,600000.0,3,1.0,970,4800,1.0,0,0,3,6,970,0,1950,0,98112,47.6212,-122.298,1500,2042,3830,542,125.0,0.06885245901639345,Very Cheap
20140805T000000,161000.0,4,2.0,1700,8043,1.0,0,0,3,7,850,850,1954,0,98168,47.4758,-122.288,1540,13260,6343,11720,20.017406440382942,0.011278688524590163,Very Cheap
20150114T000000,220000.0,4,2.0,1700,8043,1.0,0,0,3,7,850,850,1954,0,98168,47.4758,-122.288,1540,13260,6343,11720,27.352977744622653,0.01901639344262295,Very Cheap
20141204T000000,420000.0,3,1.75,1720,5000,1.5,0,0,3,8,1720,0,1932,2009,98019,47.738,-121.983,1410,8300,3280,6890,84.0,0.04524590163934426,Very Cheap
20150327T000000,710000.0,3,1.0,1400,2250,1.5,0,0,3,7,1400,0,1909,0,98119,47.6373,-122.358,1630,3600,850,1970,315.55555555555554,0.08327868852459017,Very Cheap
20150122T000000,626000.0,4,2.5,2570,7221,1.0,0,0,4,8,1570,1000,1958,0,98117,47.6921,-122.387,2440,7274,4651,4834,86.69159396205512,0.07226229508196721,Very Cheap
20140722T000000,279500.0,3,1.5,1200,8040,1.0,0,0,4,7,1200,0,1959,0,98146,47.4901,-122.341,1450,9315,6840,7865,34.7636815920398,0.02681967213114754,Very Cheap
20140523T000000,1610000.0,4,3.5,4390,11600,2.0,0,3,3,11,3060,1330,1990,0,98040,47.5862,-122.246,3240,12000,7210,8760,138.79310344827587,0.20131147540983607,Cheap
20140801T000000,325000.0,2,1.0,1080,5000,1.0,0,0,3,7,1080,0,1954,0,98106,47.5682,-122.359,1010,5000,3920,3990,65.0,0.03278688524590164,Very Cheap
20140717T000000,380000.0,4,2.25,1860,7980,1.0,0,0,4,8,1860,0,1966,0,98058,47.4524,-122.15,1860,8814,6120,6954,47.61904761904762,0.04,Very Cheap
20140826T000000,470000.0,4,2.75,2150,9820,1.0,0,0,4,8,1220,930,1979,0,98011,47.7758,-122.2,2060,9830,7670,7770,47.86150712830957,0.05180327868852459,Very Cheap
20141205T000000,363000.0,4,3.0,2250,12142,2.0,0,0,3,8,2250,0,1986,0,98058,47.4338,-122.16,2300,9003,9892,6703,29.89622796903311,0.03777049180327869,Very Cheap
20150219T000000,245000.0,4,2.25,2050,7700,2.0,0,0,3,7,2050,0,1977,0,98023,47.3009,-122.375,1780,7700,5650,5920,31.818181818181817,0.022295081967213116,Very Cheap
20150226T000000,525000.0,3,1.0,1010,3520,1.0,0,0,3,7,1010,0,1902,0,98102,47.6208,-122.319,1300,1233,2510,-67,149.14772727272728,0.05901639344262295,Very Cheap
20140625T000000,1700000.0,5,3.5,5850,22885,2.0,0,2,4,11,4670,1180,1978,0,98004,47.606,-122.211,3240,19020,17035,15780,74.28446580729735,0.21311475409836064,Cheap
20150504T000000,658500.0,4,2.25,1900,5000,1.0,0,0,3,7,1400,500,1963,0,98199,47.6456,-122.387,1710,4994,3100,3284,131.7,0.07652459016393443,Very Cheap
20150424T000000,680000.0,2,1.0,1020,8442,1.0,0,4,4,7,920,100,1941,0,98136,47.5145,-122.391,2550,10323,7422,7773,80.54963278843876,0.07934426229508197,Very Cheap
20150225T000000,835000.0,4,2.0,3390,16025,2.0,0,0,4,10,3390,0,1987,0,98077,47.7222,-122.056,3950,15277,12635,11327,52.106084243369736,0.09967213114754099,Very Cheap
20140606T000000,595000.0,4,2.5,1990,2175,2.0,0,0,3,8,1680,310,2005,0,98107,47.6696,-122.371,1560,2087,185,527,273.5632183908046,0.06819672131147542,Very Cheap
20150416T000000,419000.0,4,2.5,3190,4980,2.0,0,0,3,9,3190,0,2005,0,98038,47.3657,-122.034,2830,6720,1790,3890,84.13654618473896,0.04511475409836065,Very Cheap
20140915T000000,198900.0,2,1.0,1210,18700,1.0,0,0,4,7,1210,0,1940,0,98042,47.3752,-122.166,2250,10048,17490,7798,10.636363636363637,0.016249180327868852,Very Cheap
20140515T000000,1085000.0,4,3.25,3740,12080,1.0,0,0,3,10,2000,1740,1988,0,98077,47.7214,-122.056,4210,15277,8340,11067,89.81788079470199,0.13245901639344262,Cheap
20150423T000000,500000.0,3,3.5,2150,4368,2.0,0,0,3,8,1610,540,1998,0,98074,47.6213,-122.065,2390,16630,2218,14240,114.46886446886447,0.05573770491803279,Very Cheap
20140711T000000,575000.0,4,1.75,2440,8100,1.0,0,0,4,9,1620,820,1960,0,98177,47.7201,-122.361,2030,8100,5660,6070,70.98765432098766,0.06557377049180328,Very Cheap
20150402T000000,324950.0,2,1.5,1230,1516,3.0,0,0,3,8,1230,0,2000,0,98125,47.7265,-122.314,1352,1411,286,59,214.34696569920845,0.03278032786885246,Very Cheap
20150226T000000,259000.0,3,2.5,2740,7980,2.0,0,0,4,7,2740,0,1964,0,98168,47.473,-122.3,1470,8611,5240,7141,32.45614035087719,0.024131147540983607,Very Cheap
20140516T000000,551000.0,2,2.0,2260,9604,1.0,0,0,3,9,2260,0,1990,0,98011,47.7718,-122.208,2260,10747,7344,8487,57.37192836318201,0.06242622950819672,Very Cheap
20140808T000000,488000.0,2,1.5,1000,5125,1.0,0,0,3,7,1000,0,1942,1968,98103,47.6926,-122.347,1090,5100,4125,4010,95.21951219512195,0.05416393442622951,Very Cheap
20150305T000000,635000.0,4,2.25,2350,46173,2.0,0,0,4,8,2350,0,1980,0,98053,47.6657,-122.067,2390,36567,43823,34177,13.752625993546012,0.07344262295081967,Very Cheap
20150311T000000,395000.0,3,2.5,2300,8938,2.0,0,0,3,9,2300,0,1989,0,98031,47.4181,-122.211,2570,9694,6638,7124,44.193331841575294,0.0419672131147541,Very Cheap
20140818T000000,370000.0,3,1.0,1440,8287,1.5,0,0,4,7,1440,0,1928,0,98155,47.7438,-122.315,1330,8285,6847,6955,44.64824423796308,0.038688524590163934,Very Cheap
20141024T000000,675000.0,4,3.0,2780,5000,1.5,0,0,5,7,1710,1070,1919,0,98116,47.5721,-122.381,1150,5000,2220,3850,135.0,0.07868852459016394,Very Cheap
20150402T000000,402000.0,3,1.0,1200,6825,1.0,0,0,3,7,1200,0,1954,2013,98133,47.7491,-122.353,1470,8100,5625,6630,58.9010989010989,0.04288524590163934,Very Cheap
20140813T000000,825000.0,3,2.75,3040,24192,2.0,0,0,4,10,3040,0,1987,0,98034,47.7108,-122.225,2770,5728,21152,2958,34.10218253968254,0.09836065573770492,Very Cheap
20150217T000000,579000.0,3,2.75,2660,223027,1.0,0,0,3,8,1330,1330,1962,2015,98038,47.4127,-122.071,1560,222591,220367,221031,2.5960982302591167,0.06609836065573771,Very Cheap
20150225T000000,455000.0,5,2.0,1510,3000,2.0,0,0,3,6,1510,0,1983,0,98122,47.6029,-122.304,1610,3600,1490,1990,151.66666666666666,0.049836065573770495,Very Cheap
20140722T000000,265000.0,3,2.5,1780,6527,2.0,0,0,3,8,1780,0,1989,0,98092,47.2578,-122.217,2040,8840,4747,6800,40.600582197027734,0.024918032786885248,Very Cheap
20141201T000000,713500.0,5,2.75,2920,9163,1.0,0,0,4,8,1520,1400,1976,0,98006,47.5668,-122.169,2250,9163,6243,6913,77.86751064061988,0.08373770491803278,Very Cheap
20150106T000000,240000.0,3,1.0,1550,12670,1.0,0,0,4,7,1550,0,1962,0,98056,47.5024,-122.169,1550,8880,11120,7330,18.94238358326756,0.021639344262295083,Very Cheap
20140911T000000,570000.0,4,3.0,2710,217800,2.5,0,0,3,9,2710,0,2006,0,98022,47.2411,-121.932,2710,217800,215090,215090,2.6170798898071626,0.06491803278688525,Very Cheap
20140626T000000,243800.0,3,1.0,1140,27760,1.0,0,0,4,6,1140,0,1981,0,98027,47.5372,-121.972,1690,87300,26620,85610,8.782420749279538,0.022137704918032786,Very Cheap
20141212T000000,543000.0,2,1.0,940,3864,1.0,0,0,4,8,940,0,1918,0,98103,47.6631,-122.345,1440,3956,2924,2516,140.527950310559,0.06137704918032787,Very Cheap
20141008T000000,1010000.0,3,2.25,2160,7500,2.0,0,0,3,10,2160,0,1982,0,98112,47.6232,-122.299,1550,3839,5340,2289,134.66666666666666,0.12262295081967213,Cheap
20140721T000000,625000.0,4,2.25,2470,17008,2.0,0,0,4,8,2470,0,1979,0,98075,47.5924,-122.048,2470,31798,14538,29328,36.74741298212606,0.07213114754098361,Very Cheap
20140925T000000,459950.0,4,2.5,2800,6567,2.0,0,0,3,9,2800,0,2006,0,98038,47.3555,-122.002,3400,5900,3767,2500,70.03959189888837,0.050485245901639345,Very Cheap
20141031T000000,370000.0,4,2.75,2420,39704,1.0,0,0,3,9,2420,0,1985,0,98038,47.4053,-122.03,2760,36303,37284,33543,9.318960306266371,0.038688524590163934,Very Cheap
20141031T000000,150000.0,4,2.0,1460,7254,1.0,0,0,3,6,1460,0,1959,0,98178,47.5056,-122.254,1460,7236,5794,5776,20.678246484698096,0.009836065573770493,Very Cheap
20140624T000000,683500.0,3,1.5,1820,5756,1.5,0,0,3,7,1640,180,1946,0,98119,47.6479,-122.367,1760,6169,3936,4409,118.74565670604586,0.07980327868852459,Very Cheap
20140604T000000,499950.0,3,2.5,1520,2208,2.0,0,0,3,8,1040,480,2007,0,98119,47.6419,-122.374,1610,1618,688,8,226.4266304347826,0.05573114754098361,Very Cheap
20140630T000000,255000.0,2,1.0,1320,9967,1.0,0,0,3,6,940,380,1919,0,98108,47.5693,-122.296,1970,7587,8647,5617,25.584428614427612,0.02360655737704918,Very Cheap
20150326T000000,279000.0,3,2.5,1920,7779,2.0,0,0,3,7,1920,0,1989,0,98031,47.4024,-122.171,1960,7536,5859,5576,35.86579251831855,0.02675409836065574,Very Cheap
20141201T000000,910000.0,5,3.0,2640,5096,2.0,0,0,3,10,2640,0,2009,0,98115,47.6809,-122.288,1610,5217,2456,3607,178.57142857142858,0.10950819672131147,Cheap
20140520T000000,699000.0,4,2.5,2650,7945,2.0,0,0,3,9,2650,0,2006,0,98125,47.7113,-122.296,1200,7920,5295,6720,87.97986154814349,0.08183606557377049,Very Cheap
20150408T000000,1651000.0,4,3.25,3640,13530,1.0,0,0,3,9,2570,1070,1924,2000,98039,47.6293,-122.238,2760,15000,9890,12240,122.02512934220252,0.20668852459016393,Cheap
20150325T000000,248000.0,3,1.0,1420,8800,1.0,0,0,4,6,1090,330,1981,0,98030,47.3746,-122.181,1480,8000,7380,6520,28.181818181818183,0.022688524590163933,Very Cheap
20141107T000000,429000.0,3,1.0,1540,37950,1.0,0,0,4,7,1090,450,1959,0,98001,47.3259,-122.289,1820,24375,36410,22555,11.304347826086957,0.04642622950819672,Very Cheap
20141027T000000,685000.0,4,1.0,1550,15239,1.5,1,4,3,6,1370,180,1930,0,98166,47.4502,-122.378,1790,22047,13689,20257,44.950456066671045,0.08,Very Cheap
20140731T000000,316000.0,2,1.0,730,5040,1.0,0,0,3,6,730,0,1927,0,98126,47.5387,-122.374,790,5040,4310,4250,62.698412698412696,0.03160655737704918,Very Cheap
20150310T000000,410000.0,2,1.0,2020,7540,1.0,0,0,3,7,1010,1010,1921,0,98118,47.5359,-122.28,1270,4652,5520,3382,54.37665782493369,0.043934426229508196,Very Cheap
20140808T000000,299000.0,3,1.0,1200,15843,1.0,0,2,3,7,1200,0,1955,0,98045,47.4991,-121.779,1410,15843,14643,14433,18.872688253487343,0.02937704918032787,Very Cheap
20140618T000000,559000.0,2,1.0,1240,6400,1.0,0,1,4,7,1060,180,1938,0,98126,47.5493,-122.377,1240,6400,5160,5160,87.34375,0.06347540983606557,Very Cheap
20140723T000000,575000.0,3,2.25,2680,100188,2.0,0,0,4,8,1580,1100,1978,0,98027,47.4776,-122.02,2540,60548,97508,58008,5.73921028466483,0.06557377049180328,Very Cheap
20140714T000000,602000.0,3,2.5,1640,3804,2.0,0,0,3,8,1640,0,1998,0,98122,47.6103,-122.3,1440,3230,2164,1790,158.25446898002102,0.06911475409836065,Very Cheap
20140522T000000,492000.0,4,2.0,1640,5000,2.0,0,0,3,7,1640,0,1907,1983,98107,47.6662,-122.365,1240,5000,3360,3760,98.4,0.054688524590163934,Very Cheap
20150327T000000,293500.0,3,2.5,1610,5024,2.0,0,0,3,7,1610,0,2004,0,98038,47.3833,-122.043,1790,3717,3414,1927,58.419585987261144,0.028655737704918034,Very Cheap
20140722T000000,481000.0,3,2.75,2290,14810,1.0,0,0,5,7,1400,890,1967,0,98056,47.5343,-122.185,2540,8640,12520,6100,32.4780553679946,0.05324590163934426,Very Cheap
20140509T000000,311100.0,4,2.25,2130,8078,1.0,0,0,4,7,1380,750,1977,0,98055,47.4482,-122.209,2300,8112,5948,5812,38.512007922753156,0.03096393442622951,Very Cheap
20150417T000000,375000.0,3,1.75,2140,13598,1.5,0,0,4,7,1620,520,1970,0,98014,47.7139,-121.321,930,10150,11458,9220,27.57758493896161,0.03934426229508197,Very Cheap
20150210T000000,1075000.0,3,3.0,4020,435600,1.5,0,2,3,10,4020,0,1999,0,98045,47.4418,-121.731,2590,283140,431580,280550,2.467860422405877,0.13114754098360656,Cheap
20150428T000000,500000.0,5,2.5,2030,8400,1.0,0,0,3,7,1330,700,1968,0,98052,47.6713,-122.152,1920,8400,6370,6480,59.523809523809526,0.05573770491803279,Very Cheap
20150401T000000,553000.0,3,1.0,1380,6250,1.0,0,0,4,7,1380,0,1918,0,98136,47.5514,-122.385,2270,6250,4870,3980,88.48,0.06268852459016394,Very Cheap
20141206T000000,760000.0,3,2.0,1780,1750,1.0,0,2,3,8,1400,380,1927,2014,98103,47.6797,-122.357,1780,3750,-30,1970,434.2857142857143,0.0898360655737705,Very Cheap
20150509T000000,589500.0,4,1.5,1440,3200,1.0,0,1,4,7,960,480,1960,0,98136,47.5269,-122.383,1650,6400,1760,4750,184.21875,0.06747540983606558,Very Cheap
20141114T000000,840000.0,5,2.75,2790,20824,1.0,0,0,3,9,1680,1110,1959,0,98115,47.6948,-122.282,2380,10465,18034,8085,40.338071456012294,0.10032786885245902,Cheap
20140801T000000,2546000.0,4,3.0,4190,8805,2.5,0,2,5,9,3490,700,1928,0,98112,47.6181,-122.284,3780,8558,4615,4778,289.15388983532085,0.3240655737704918,Medium
20140707T000000,1275000.0,3,2.5,3870,46609,2.0,0,3,3,9,3870,0,1997,0,98008,47.5966,-122.112,4030,17880,42739,13850,27.355231822180265,0.15737704918032788,Cheap
20141201T000000,260000.0,3,2.5,1850,7875,1.0,0,0,3,7,1250,600,1968,0,98058,47.434,-122.171,1930,8062,6025,6132,33.01587301587302,0.024262295081967214,Very Cheap
20140716T000000,430000.0,3,2.25,1550,1469,3.0,0,0,3,8,1550,0,2004,0,98103,47.6911,-122.341,1520,1465,-81,-55,292.716133424098,0.04655737704918033,Very Cheap
20150304T000000,781000.0,3,2.5,1920,1896,3.0,0,3,3,8,1920,0,2000,0,98103,47.6616,-122.356,1670,2994,-24,1324,411.9198312236287,0.09259016393442623,Very Cheap
20150328T000000,280000.0,2,1.0,790,13170,1.0,0,0,3,6,790,0,1947,0,98106,47.5487,-122.357,970,12700,12380,11730,21.26044039483675,0.026885245901639345,Very Cheap
20140701T000000,392000.0,5,2.25,3740,32481,1.5,0,0,3,8,2240,1500,1958,0,98198,47.3965,-122.314,2040,11398,28741,9358,12.068593947230688,0.04157377049180328,Very Cheap
20150210T000000,466200.0,3,1.5,1340,8856,1.0,0,0,4,7,1340,0,1959,0,98008,47.6094,-122.126,1850,8740,7516,6890,52.642276422764226,0.05130491803278688,Very Cheap
20140523T000000,641000.0,3,1.75,1620,3975,1.0,0,0,5,7,940,680,1926,0,98117,47.6786,-122.368,1320,3922,2355,2602,161.25786163522014,0.0742295081967213,Very Cheap
20150324T000000,350000.0,3,1.0,1680,8010,1.0,0,0,3,7,840,840,1951,0,98117,47.6993,-122.376,1890,8778,6330,6888,43.69538077403246,0.036065573770491806,Very Cheap
20150204T000000,450000.0,3,2.0,1610,4364,2.0,0,0,3,8,1610,0,1996,0,98029,47.5672,-122.004,2010,4364,2754,2354,103.11640696608616,0.04918032786885246,Very Cheap
20140520T000000,1800000.0,4,3.5,4460,16953,1.0,0,0,3,9,2550,1910,1962,1994,98039,47.6338,-122.232,1980,13370,12493,11390,106.17589807113785,0.2262295081967213,Cheap
20150309T000000,185000.0,3,1.5,1200,1848,2.0,0,0,3,8,1200,0,1966,0,98055,47.4658,-122.191,1270,1848,648,578,100.10822510822511,0.014426229508196721,Very Cheap
20150123T000000,290000.0,2,1.0,1250,12507,1.0,0,0,5,7,1250,0,1958,0,98056,47.4972,-122.176,1250,12498,11257,11248,23.18701527144799,0.02819672131147541,Very Cheap
20150430T000000,964000.0,3,2.5,3630,9475,2.0,0,0,3,11,3630,0,1999,0,98074,47.6544,-122.085,3250,11605,5845,8355,101.74142480211081,0.11659016393442623,Cheap
20140528T000000,2000000.0,4,3.0,4260,18000,2.0,0,2,3,11,4260,0,2000,0,98040,47.5355,-122.24,3540,17015,13740,13475,111.11111111111111,0.25245901639344265,Cheap
20140611T000000,545000.0,3,2.5,2180,15693,1.0,0,0,4,8,1850,330,1979,0,98075,47.592,-122.082,2270,24000,13513,21730,34.728860001274455,0.06163934426229508,Very Cheap
20150312T000000,609950.0,3,2.25,1760,10350,1.0,0,0,4,7,1330,430,1979,0,98033,47.6605,-122.188,2210,11337,8590,9127,58.932367149758456,0.07015737704918033,Very Cheap
20140804T000000,605000.0,4,2.0,1820,7626,1.0,0,0,5,7,990,830,1941,0,98103,47.6878,-122.342,1390,5904,5806,4514,79.33385785470757,0.06950819672131148,Very Cheap
20140908T000000,550000.0,4,2.5,2120,9163,1.0,0,0,4,8,1450,670,1961,0,98006,47.5551,-122.172,2120,9166,7043,7046,60.024009603841534,0.06229508196721312,Very Cheap
20150120T000000,905000.0,4,2.75,2730,4268,2.0,0,1,3,9,2730,0,2009,0,98199,47.6397,-122.395,2340,5000,1538,2660,212.0431115276476,0.10885245901639344,Cheap
20141023T000000,384200.0,3,2.5,2430,7613,2.0,0,0,4,8,2430,0,1986,0,98058,47.4383,-122.135,2440,8342,5183,5902,50.466307631682646,0.040550819672131144,Very Cheap
20140711T000000,370000.0,3,1.0,1170,1105,1.0,0,0,3,7,1170,0,1965,0,98126,47.5448,-122.375,1380,1399,-65,19,334.841628959276,0.038688524590163934,Very Cheap
20141204T000000,717500.0,3,1.0,2090,4000,1.5,0,2,3,8,1890,200,1931,0,98199,47.6393,-122.392,2090,4000,1910,1910,179.375,0.08426229508196721,Very Cheap
20150501T000000,1999000.0,4,3.25,3910,7500,2.0,0,2,4,11,2550,1360,1933,0,98199,47.6448,-122.409,3070,7500,3590,4430,266.53333333333336,0.252327868852459,Cheap
20141203T000000,365500.0,2,1.0,1140,15624,1.0,0,0,4,6,1140,0,1909,0,98177,47.7673,-122.367,2110,15493,14484,13383,23.393497183819765,0.038098360655737705,Very Cheap
20150128T000000,580000.0,2,1.5,1460,5700,1.5,0,0,3,7,1460,0,1912,0,98115,47.6838,-122.312,1780,3800,4240,2020,101.75438596491227,0.06622950819672131,Very Cheap
20141107T000000,415000.0,4,1.5,2700,14760,1.5,0,0,5,9,2700,0,1940,0,98022,47.1996,-122.003,1670,7200,12060,5530,28.116531165311653,0.04459016393442623,Very Cheap
20150113T000000,272000.0,2,1.0,670,6300,1.0,0,0,4,6,670,0,1942,0,98126,47.5145,-122.374,740,6300,5630,5560,43.17460317460318,0.02583606557377049,Very Cheap
20140505T000000,600000.0,3,1.75,1880,6360,1.0,0,0,4,7,1040,840,1945,0,98115,47.6878,-122.286,1770,6175,4480,4405,94.33962264150944,0.06885245901639345,Very Cheap
20140515T000000,744000.0,4,3.0,1980,5352,2.5,0,0,3,8,1980,0,1941,2005,98136,47.532,-122.385,1680,5352,3372,3672,139.0134529147982,0.08773770491803279,Very Cheap
20140603T000000,830000.0,3,3.0,2080,10521,1.5,0,0,3,9,2080,0,2004,0,98034,47.6987,-122.228,3730,11840,8441,8110,78.88983936888128,0.09901639344262295,Very Cheap
20141029T000000,322000.0,3,3.25,1380,1225,3.0,0,0,3,7,1380,0,2000,0,98133,47.7035,-122.351,1380,1704,-155,324,262.85714285714283,0.03239344262295082,Very Cheap
20140917T000000,270000.0,3,2.5,1808,19200,1.0,0,0,3,8,1808,0,2005,0,98001,47.2598,-122.281,1450,14400,17392,12950,14.0625,0.025573770491803278,Very Cheap
20150306T000000,272450.0,3,1.0,1350,7973,1.5,0,0,3,7,1350,0,1954,0,98188,47.4323,-122.292,1310,7491,6623,6181,34.17157907939295,0.025895081967213116,Very Cheap
20150408T000000,605000.0,3,3.0,1760,2114,2.0,0,0,3,7,1400,360,2008,0,98107,47.6666,-122.37,1300,1500,354,200,286.18732261116367,0.06950819672131148,Very Cheap
20150511T000000,510000.0,3,1.75,1950,8325,1.0,0,0,4,7,1950,0,1962,0,98011,47.7685,-122.2,1950,8325,6375,6375,61.26126126126126,0.057049180327868855,Very Cheap
20150423T000000,1125000.0,4,3.5,3170,4000,2.0,0,0,3,10,2340,830,1999,0,98112,47.6265,-122.298,1770,4000,830,2230,281.25,0.1377049180327869,Cheap
20140612T000000,1688000.0,4,2.5,3000,7500,2.0,0,0,3,9,3000,0,1937,1994,98105,47.6571,-122.277,2580,5000,4500,2420,225.06666666666666,0.21154098360655738,Cheap
20150107T000000,162000.0,4,1.0,1460,16638,1.0,0,0,4,6,1460,0,1975,0,98010,47.3431,-122.048,1460,16638,15178,15178,9.736747205192932,0.01140983606557377,Very Cheap
20150506T000000,337500.0,3,1.75,1350,5850,1.0,0,0,4,7,1050,300,1973,0,98198,47.4225,-122.328,1710,7757,4500,6047,57.69230769230769,0.03442622950819672,Very Cheap
20150331T000000,312000.0,3,2.25,1470,7857,1.0,0,0,4,7,1180,290,1973,0,98055,47.4547,-122.209,1900,7600,6387,5700,39.7098129056892,0.031081967213114754,Very Cheap
20140813T000000,740000.0,4,3.0,3350,199253,2.0,0,0,3,10,3350,0,2004,0,98010,47.3602,-121.988,3350,183897,195903,180547,3.7138713093403863,0.08721311475409836,Very Cheap
20150305T000000,700000.0,4,3.0,3350,199253,2.0,0,0,3,10,3350,0,2004,0,98010,47.3602,-121.988,3350,183897,195903,180547,3.513121508835501,0.08196721311475409,Very Cheap
20140925T000000,328000.0,4,1.0,1360,8136,1.0,0,0,3,7,1360,0,1948,0,98133,47.7366,-122.333,1570,8132,6776,6562,40.31465093411996,0.03318032786885246,Very Cheap
20150213T000000,241000.0,3,1.0,1020,7538,1.0,0,0,3,7,1020,0,1981,0,98032,47.3587,-122.288,1650,7201,6518,5551,31.971345184399045,0.02177049180327869,Very Cheap
20140731T000000,265000.0,3,2.25,1840,6750,1.0,0,0,4,7,1270,570,1980,0,98031,47.4075,-122.172,1750,7004,4910,5254,39.25925925925926,0.024918032786885248,Very Cheap
20150327T000000,246000.0,5,1.75,2030,10200,1.0,0,0,4,7,2030,0,1958,0,98002,47.2867,-122.209,1760,11550,8170,9790,24.11764705882353,0.02242622950819672,Very Cheap
20140930T000000,271000.0,4,1.75,1490,9112,1.0,0,0,3,6,970,520,1940,0,98146,47.4991,-122.345,1650,8411,7622,6761,29.741000877963124,0.025704918032786885,Very Cheap
20140625T000000,270000.0,2,1.0,2060,8398,1.0,0,0,3,7,1260,800,1962,0,98168,47.509,-122.324,1690,13495,6338,11805,32.15051202667302,0.025573770491803278,Very Cheap
20141117T000000,395000.0,4,2.0,2240,7085,1.5,0,0,3,7,2240,0,1944,1992,98125,47.7309,-122.305,1440,7085,4845,5645,55.7515878616796,0.0419672131147541,Very Cheap
20140731T000000,340000.0,3,2.0,1460,5715,1.0,0,0,3,7,1460,0,1957,2014,98118,47.54,-122.276,1400,5715,4255,4315,59.492563429571305,0.03475409836065574,Very Cheap
20141016T000000,340000.0,3,1.75,2140,13260,1.0,0,0,3,7,1240,900,1948,0,98146,47.5074,-122.353,1640,13260,11120,11620,25.641025641025642,0.03475409836065574,Very Cheap
20150306T000000,335000.0,2,2.25,1420,1246,2.0,0,0,3,8,1420,0,2007,0,98106,47.5394,-122.368,1420,1826,-174,406,268.86035313001605,0.03409836065573771,Very Cheap
20140625T000000,435000.0,2,1.0,1060,3036,1.5,0,0,4,6,1060,0,1943,0,98105,47.6578,-122.324,1730,5535,1976,3805,143.2806324110672,0.04721311475409836,Very Cheap
20141009T000000,527950.0,4,1.75,1760,3600,1.0,0,0,5,7,880,880,1926,0,98103,47.6889,-122.33,1500,5580,1840,4080,146.65277777777777,0.05940327868852459,Very Cheap
20150227T000000,600000.0,2,2.25,2320,18919,2.0,1,4,4,8,2320,0,1976,0,98070,47.3905,-122.462,1610,18919,16599,17309,31.714149796500873,0.06885245901639345,Very Cheap
20140716T000000,667000.0,3,1.75,1770,3880,1.0,0,0,3,8,1300,470,1963,0,98117,47.6846,-122.392,1430,3880,2110,2450,171.90721649484536,0.07763934426229509,Very Cheap
20140814T000000,1148000.0,10,5.25,4590,10920,1.0,0,2,3,9,2500,2090,2008,0,98004,47.5861,-122.113,2730,10400,6330,7670,105.12820512820512,0.14072131147540984,Cheap
20150408T000000,417000.0,3,2.5,2040,11211,2.0,0,0,3,8,2040,0,2000,0,98055,47.4867,-122.223,1830,11964,9171,10134,37.195611453037195,0.04485245901639344,Very Cheap
20150310T000000,451000.0,4,1.75,1260,7250,1.0,0,0,3,6,1260,0,1943,0,98027,47.5267,-122.032,1880,7250,5990,5370,62.206896551724135,0.04931147540983607,Very Cheap
20150218T000000,580000.0,2,1.0,1650,9780,1.0,0,0,3,7,950,700,1943,0,98199,47.6549,-122.394,1650,5458,8130,3808,59.304703476482615,0.06622950819672131,Very Cheap
20141217T000000,570000.0,4,2.25,2380,36446,2.0,0,0,4,8,2380,0,1977,0,98077,47.7644,-122.072,2790,40005,34066,37215,15.639576359545629,0.06491803278688525,Very Cheap
20140610T000000,750000.0,5,3.25,2750,7500,2.0,0,1,3,7,2150,600,1937,1997,98033,47.6636,-122.203,2750,7500,4750,4750,100.0,0.08852459016393442,Very Cheap
20140527T000000,685000.0,3,2.5,2810,7700,2.0,0,0,3,9,2810,0,2001,0,98006,47.5464,-122.191,2910,8250,4890,5340,88.96103896103897,0.08,Very Cheap
20141226T000000,275000.0,3,2.0,1340,9764,1.0,0,0,3,7,1340,0,1944,0,98052,47.6786,-122.161,1310,9764,8424,8454,28.164686603850882,0.02622950819672131,Very Cheap
20140618T000000,739888.0,3,2.5,2420,43177,2.0,0,4,4,8,1690,730,1989,0,98075,47.569,-122.058,3740,8717,40757,4977,17.136160455798226,0.0871984262295082,Very Cheap
20140527T000000,715000.0,2,2.5,2160,5581,1.0,0,0,3,8,2160,0,2002,0,98053,47.7017,-122.023,2315,5652,3421,3337,128.11324135459594,0.0839344262295082,Very Cheap
20150325T000000,800000.0,4,2.0,2450,4400,1.0,0,0,3,7,1450,1000,1913,1980,98102,47.6414,-122.327,1890,1386,1950,-504,181.8181818181818,0.09508196721311475,Very Cheap
20141124T000000,350000.0,3,1.5,1870,9000,1.0,0,0,3,7,1120,750,1923,0,98108,47.5224,-122.318,1850,6000,7130,4150,38.888888888888886,0.036065573770491806,Very Cheap
20141124T000000,220000.0,3,1.0,1000,223462,1.0,0,2,4,6,1000,0,1933,0,98022,47.2099,-122.043,1710,105850,222462,104140,0.9845074330311194,0.01901639344262295,Very Cheap
20141009T000000,452500.0,3,2.5,2240,7791,2.0,0,0,3,7,2240,0,2002,0,98065,47.5361,-121.88,2480,5018,5551,2538,58.07983570786805,0.04950819672131147,Very Cheap
20150316T000000,280000.0,4,2.5,2200,5893,2.0,0,0,3,7,2200,0,2008,0,98042,47.3333,-122.055,2200,5757,3693,3557,47.51399966061429,0.026885245901639345,Very Cheap
20141023T000000,248000.0,1,1.0,790,12000,1.0,0,0,3,6,790,0,1918,0,98118,47.5146,-122.265,1900,6000,11210,4100,20.666666666666668,0.022688524590163933,Very Cheap
20150417T000000,305000.0,2,1.0,890,7200,1.0,0,0,3,7,740,150,1949,0,98115,47.6998,-122.278,1290,7200,6310,5910,42.361111111111114,0.03016393442622951,Very Cheap
20150312T000000,435010.0,3,1.0,1270,4000,1.0,0,0,3,7,1120,150,1954,0,98106,47.5293,-122.354,1220,4600,2730,3380,108.7525,0.047214426229508194,Very Cheap
20140718T000000,678100.0,3,1.75,1850,2860,1.5,0,0,5,8,1210,640,1931,0,98116,47.5853,-122.39,1660,3120,1010,1460,237.0979020979021,0.07909508196721311,Very Cheap
20140509T000000,325000.0,3,2.25,1352,1694,3.0,0,0,3,8,1352,0,2007,0,98125,47.7265,-122.315,1439,1387,342,-52,191.85360094451005,0.03278688524590164,Very Cheap
20140714T000000,529950.0,3,2.0,1540,8400,1.0,0,0,3,7,1180,360,1968,0,98052,47.6554,-122.129,1550,8760,6860,7210,63.089285714285715,0.0596655737704918,Very Cheap
20141223T000000,440000.0,3,1.75,1640,8529,1.0,0,0,5,7,1640,0,1951,0,98155,47.7751,-122.32,1730,7769,6889,6039,51.58869738539102,0.04786885245901639,Very Cheap
20150316T000000,585000.0,3,1.0,1350,4800,1.5,0,0,3,7,1350,0,1928,0,98116,47.5749,-122.412,1360,4800,3450,3440,121.875,0.06688524590163934,Very Cheap
20140820T000000,462608.0,3,2.5,2010,2778,2.0,0,0,3,8,1390,620,2014,0,98029,47.5528,-121.999,1540,1689,768,149,166.52555795536358,0.05083383606557377,Very Cheap
20150407T000000,350500.0,3,1.75,2080,5200,1.0,0,0,3,7,1040,1040,1974,0,98166,47.4738,-122.35,1410,6550,3120,5140,67.40384615384616,0.03613114754098361,Very Cheap
20141110T000000,210000.0,3,1.0,1040,8125,1.0,0,0,3,7,1040,0,1956,0,98003,47.3171,-122.316,1200,9375,7085,8175,25.846153846153847,0.017704918032786884,Very Cheap
20150206T000000,510000.0,3,2.5,1890,5929,2.0,0,0,3,8,1890,0,1993,0,98029,47.5697,-121.994,2060,5775,4039,3715,86.01787822567043,0.057049180327868855,Very Cheap
20150506T000000,280000.0,3,2.25,1810,7630,1.0,0,0,4,7,1810,0,1959,0,98056,47.497,-122.18,1830,7594,5820,5764,36.69724770642202,0.026885245901639345,Very Cheap
20150303T000000,385000.0,3,1.75,1930,14389,1.0,0,0,3,7,1130,800,1963,1998,98155,47.7733,-122.317,1730,14378,12459,12648,26.75655014246994,0.04065573770491803,Very Cheap
20140625T000000,349000.0,3,1.0,1010,8184,1.0,0,0,4,6,1010,0,1947,0,98155,47.7416,-122.319,1010,8184,7174,7174,42.64418377321603,0.035934426229508196,Very Cheap
20140826T000000,252000.0,3,2.25,1740,10836,1.0,0,0,3,7,910,830,1981,0,98031,47.3976,-122.166,2090,7500,9096,5410,23.25581395348837,0.02321311475409836,Very Cheap
20141030T000000,1100000.0,4,2.5,2910,8881,2.0,0,1,3,10,1940,970,1932,0,98199,47.6424,-122.411,2540,5250,5971,2710,123.85992568404458,0.13442622950819672,Cheap
20141211T000000,375000.0,3,2.25,1330,8004,2.0,0,0,3,7,1330,0,1985,0,98034,47.7098,-122.217,1300,7971,6674,6671,46.85157421289355,0.03934426229508197,Very Cheap
20140714T000000,336000.0,4,2.25,2210,11700,2.0,0,0,4,8,2210,0,1967,0,98032,47.3648,-122.284,2040,9000,9490,6960,28.71794871794872,0.03422950819672131,Very Cheap
20140702T000000,732000.0,3,3.75,2670,6517,2.5,0,4,4,8,2020,650,1977,0,98126,47.5702,-122.38,2010,6073,3847,4063,112.3216203774743,0.08616393442622951,Very Cheap
20140806T000000,200000.0,2,1.0,1000,6227,1.0,0,0,3,6,1000,0,1949,0,98168,47.513,-122.333,1240,6250,5227,5010,32.11819495744339,0.01639344262295082,Very Cheap
20140528T000000,681716.0,4,2.5,3150,7277,2.0,0,0,3,9,3150,0,2006,0,98056,47.5159,-122.202,3030,8643,4127,5613,93.68091246392744,0.07956931147540984,Very Cheap
20150225T000000,235000.0,3,1.75,1520,12246,1.0,0,0,4,6,1520,0,1971,0,98010,47.3434,-122.049,1460,12246,10726,10786,19.189939572105178,0.02098360655737705,Very Cheap
20141009T000000,257500.0,3,1.0,1690,13825,1.0,0,0,3,7,1210,480,1955,0,98148,47.4256,-122.322,1190,9450,12135,8260,18.625678119349004,0.023934426229508195,Very Cheap
20140929T000000,315000.0,3,1.0,1070,9497,1.0,0,0,3,7,1070,0,1955,0,98028,47.7425,-122.23,1710,9561,8427,7851,33.16836895861851,0.031475409836065574,Very Cheap
20140520T000000,299950.0,3,1.0,910,8000,1.0,0,0,4,6,740,170,1950,0,98177,47.7746,-122.378,2090,9007,7090,6917,37.49375,0.029501639344262295,Very Cheap
20140711T000000,530000.0,4,2.25,2130,8640,1.0,0,0,3,7,1430,700,1969,0,98034,47.7087,-122.198,2120,8826,6510,6706,61.342592592592595,0.05967213114754098,Very Cheap
20140915T000000,766500.0,2,1.75,2230,6930,1.0,0,0,4,8,1530,700,1947,0,98105,47.6705,-122.277,1970,6930,4700,4960,110.60606060606061,0.09068852459016394,Very Cheap
20140513T000000,860000.0,4,2.5,3560,11119,1.0,0,2,3,10,2290,1270,1986,0,98004,47.6456,-122.19,3290,11385,7559,8095,77.34508498965734,0.10295081967213114,Cheap
20150131T000000,690000.0,3,2.5,2590,4961,2.0,0,0,3,9,2590,0,1944,2007,98126,47.5271,-122.381,1230,4961,2371,3731,139.0848619229994,0.08065573770491803,Very Cheap
20150318T000000,551000.0,4,1.75,2040,6348,1.0,0,0,3,7,1020,1020,1962,0,98103,47.6964,-122.336,1770,5047,4308,3277,86.7989918084436,0.06242622950819672,Very Cheap
20141121T000000,530000.0,3,2.75,2100,20150,1.0,0,0,4,7,2100,0,1955,0,98034,47.7206,-122.248,2100,15500,18050,13400,26.30272952853598,0.05967213114754098,Very Cheap
20150420T000000,568000.0,3,1.0,1340,7260,1.5,0,0,3,7,1340,0,1953,0,98125,47.7016,-122.295,1830,6822,5920,4992,78.23691460055096,0.06465573770491803,Very Cheap
20140520T000000,749950.0,3,2.5,2770,10773,2.0,0,2,3,9,2770,0,1992,0,98008,47.5754,-122.12,2530,10423,8003,7893,69.61384943841084,0.08851803278688525,Very Cheap
20141006T000000,535000.0,3,2.5,2400,12546,1.0,0,0,3,9,2400,0,1983,0,98074,47.6317,-122.041,2940,12150,10146,9210,42.643073489558425,0.06032786885245902,Very Cheap
20150409T000000,234300.0,3,1.0,1140,9779,1.0,0,0,3,7,1140,0,1963,0,98055,47.424,-122.201,1520,9814,8639,8294,23.959505061867265,0.020891803278688524,Very Cheap
20140821T000000,190000.0,2,1.0,930,11450,1.0,0,0,3,6,930,0,1946,0,98178,47.4862,-122.264,1150,11450,10520,10300,16.593886462882097,0.015081967213114755,Very Cheap
20141010T000000,525000.0,4,1.75,1820,6600,1.0,0,0,5,7,1820,0,1960,0,98007,47.606,-122.135,1430,8800,4780,7370,79.54545454545455,0.05901639344262295,Very Cheap
20141106T000000,610000.0,4,1.0,1390,3708,1.5,0,0,4,7,1390,0,1926,0,98117,47.685,-122.363,1430,3708,2318,2278,164.5091693635383,0.07016393442622951,Very Cheap
20141003T000000,520000.0,3,2.5,1480,1165,3.0,0,0,3,8,1480,0,2006,0,98144,47.6199,-122.3,1480,1231,-315,-249,446.3519313304721,0.058360655737704915,Very Cheap
20150422T000000,375000.0,2,1.0,760,6000,1.0,0,0,3,6,760,0,1942,0,98199,47.646,-122.384,1360,6000,5240,4640,62.5,0.03934426229508197,Very Cheap
20140528T000000,600000.0,3,1.75,1580,7416,1.0,0,0,3,7,1150,430,1967,0,98005,47.6056,-122.173,1730,7416,5836,5686,80.90614886731392,0.06885245901639345,Very Cheap
20141023T000000,664000.0,4,2.5,1870,16200,1.0,0,0,5,8,1250,620,1974,0,98033,47.6651,-122.174,2000,11250,14330,9250,40.98765432098765,0.07724590163934426,Very Cheap
20150504T000000,698000.0,2,1.0,1510,4080,1.0,0,0,3,7,1010,500,1923,0,98103,47.6742,-122.329,1660,4080,2570,2420,171.07843137254903,0.08170491803278689,Very Cheap
20140827T000000,418000.0,3,2.0,1250,1306,3.0,0,0,3,7,1250,0,2001,0,98107,47.6705,-122.39,1320,1250,56,-70,320.0612557427259,0.04498360655737705,Very Cheap
20140818T000000,271675.0,3,1.75,2140,13068,1.0,0,0,4,7,1460,680,1974,0,98092,47.3099,-122.197,2090,17424,10928,15334,20.789332721150902,0.02579344262295082,Very Cheap
20150507T000000,450000.0,3,1.0,1540,9028,1.0,0,0,4,6,1540,0,1968,0,98033,47.6698,-122.177,1450,9028,7488,7578,49.844926894107225,0.04918032786885246,Very Cheap
20140509T000000,759000.0,3,2.25,2950,78843,1.5,0,0,3,9,2950,0,2006,0,98075,47.5917,-122.068,3880,78843,75893,74963,9.626726532475933,0.08970491803278688,Very Cheap
20150115T000000,599950.0,6,3.0,2020,4129,1.0,0,0,3,7,1230,790,1994,0,98105,47.6648,-122.324,2080,4080,2109,2000,145.30152579317027,0.06884590163934426,Very Cheap
20150122T000000,810000.0,4,2.75,2820,5000,1.5,0,0,3,8,2170,650,1927,0,98199,47.6376,-122.394,1740,5000,2180,3260,162.0,0.09639344262295083,Very Cheap
20140729T000000,331292.0,3,1.75,1660,10000,1.0,0,0,3,7,1660,0,1972,0,98019,47.741,-121.978,1770,10000,8340,8230,33.1292,0.03361206557377049,Very Cheap
20150406T000000,348000.0,3,1.75,1830,2417,1.0,0,0,3,7,930,900,1919,0,98144,47.5723,-122.309,1320,3200,587,1880,143.98014067025238,0.03580327868852459,Very Cheap
20140919T000000,435000.0,2,1.0,720,5600,1.0,0,0,4,7,720,0,1920,0,98116,47.5641,-122.391,1330,5600,4880,4270,77.67857142857143,0.04721311475409836,Very Cheap
20150219T000000,530000.0,3,2.5,2160,9063,2.0,0,0,3,8,2160,0,1992,0,98133,47.7296,-122.333,2160,9063,6903,6903,58.47953216374269,0.05967213114754098,Very Cheap
20140922T000000,227000.0,3,1.75,1510,9837,2.0,0,0,3,7,1510,0,1989,0,98001,47.2576,-122.255,1470,8054,8327,6584,23.07614109992884,0.019934426229508195,Very Cheap
20141003T000000,285000.0,3,1.5,1870,42070,1.0,0,0,3,7,1870,0,1953,0,98168,47.509,-122.313,1870,19965,40200,18095,6.7744235797480385,0.02754098360655738,Very Cheap
20150317T000000,740000.0,4,2.25,2860,26136,1.0,0,0,3,8,1640,1220,1977,0,98005,47.6033,-122.158,2670,25040,23276,22370,28.313437404346494,0.08721311475409836,Very Cheap
20150311T000000,246000.0,3,1.0,990,9145,1.5,0,0,4,6,990,0,1939,0,98146,47.5022,-122.36,1640,8320,8155,6680,26.89994532531438,0.02242622950819672,Very Cheap
20150217T000000,260000.0,3,1.0,1910,8710,1.0,0,0,3,7,1080,830,1954,0,98168,47.5038,-122.3,1460,8944,6800,7484,29.850746268656717,0.024262295081967214,Very Cheap
20140811T000000,366000.0,3,2.0,1350,10200,1.0,0,0,3,7,1350,0,1977,0,98074,47.6159,-122.05,1820,9600,8850,7780,35.88235294117647,0.03816393442622951,Very Cheap
20141026T000000,594950.0,4,3.25,2557,9480,2.0,0,2,3,7,2557,0,1948,1993,98118,47.5449,-122.262,2220,8340,6923,6120,62.7584388185654,0.06819016393442623,Very Cheap
20150327T000000,608000.0,3,2.75,2610,5000,2.0,0,0,4,7,1710,900,1946,0,98107,47.6729,-122.373,1500,5000,2390,3500,121.6,0.0699016393442623,Very Cheap
20150408T000000,313100.0,3,2.0,1720,11875,1.0,0,0,5,6,1720,0,1905,0,98056,47.5068,-122.191,1860,7500,10155,5640,26.366315789473685,0.031226229508196722,Very Cheap
20141003T000000,185000.0,3,1.75,1170,9085,1.0,0,0,3,7,1170,0,1967,0,98023,47.2808,-122.354,1230,9085,7915,7855,20.363236103467255,0.014426229508196721,Very Cheap
20150504T000000,455000.0,2,1.0,1140,11480,1.0,0,0,3,6,1140,0,1907,0,98118,47.5328,-122.274,1550,8150,10340,6600,39.63414634146341,0.049836065573770495,Very Cheap
20140711T000000,235000.0,3,2.5,2350,9051,1.0,0,0,4,8,1570,780,1966,0,98023,47.3126,-122.364,2270,8748,6701,6478,25.963981880455197,0.02098360655737705,Very Cheap
20141030T000000,230000.0,3,1.0,1020,12289,1.0,0,0,4,7,1020,0,1967,0,98058,47.4235,-122.155,1300,9894,11269,8594,18.715924810806413,0.020327868852459016,Very Cheap
20141120T000000,770000.0,4,2.25,2730,5000,1.0,0,0,5,7,1460,1270,1955,0,98116,47.5843,-122.393,2010,5000,2270,2990,154.0,0.09114754098360656,Very Cheap
20141002T000000,240000.0,4,2.25,1830,7614,2.0,0,0,3,7,1830,0,1991,0,98030,47.3682,-122.179,1860,6930,5784,5070,31.52088258471237,0.021639344262295083,Very Cheap
20150219T000000,461000.0,3,2.5,1690,3026,2.0,0,0,3,7,1690,0,2002,0,98053,47.6885,-122.043,1650,3161,1336,1511,152.34633179114343,0.05062295081967213,Very Cheap
20150327T000000,1580000.0,4,2.5,2900,10500,1.0,0,3,5,8,1450,1450,1963,0,98040,47.5838,-122.246,2900,9201,7600,6301,150.47619047619048,0.19737704918032786,Cheap
20141009T000000,1822500.0,4,4.5,6380,88714,2.0,0,0,3,12,6380,0,2006,0,98029,47.5592,-122.015,3040,7113,82334,4073,20.54354442365354,0.22918032786885245,Cheap
20141123T000000,452000.0,3,2.5,1690,4000,2.0,0,0,3,7,1690,0,2004,0,98053,47.6788,-122.034,1690,4000,2310,2310,113.0,0.04944262295081967,Very Cheap
20141003T000000,765000.0,4,2.5,2660,5043,2.0,0,2,3,9,2660,0,2003,0,98029,47.5445,-121.996,3010,5500,2383,2490,151.69541939321832,0.09049180327868853,Very Cheap
20150422T000000,1050000.0,4,4.0,4550,54013,1.0,0,1,4,9,2300,2250,1989,0,98075,47.5964,-122.077,3540,39634,49463,36094,19.439764501138615,0.12786885245901639,Cheap
20150505T000000,546000.0,3,3.0,1530,9999,1.0,0,0,4,7,1150,380,1983,0,98033,47.6869,-122.186,1530,8556,8469,7026,54.60546054605461,0.06177049180327869,Very Cheap
20150122T000000,781000.0,3,2.5,2070,4463,1.5,0,0,5,8,1780,290,1931,0,98115,47.6853,-122.305,2070,5000,2393,2930,174.99439838673538,0.09259016393442623,Very Cheap
20150120T000000,538000.0,4,1.75,1880,7953,1.0,0,0,4,7,1880,0,1965,0,98008,47.5838,-122.123,1750,8591,6073,6841,67.64742864327927,0.06072131147540984,Very Cheap
20140819T000000,790000.0,4,2.5,2240,8664,1.0,0,0,5,8,1470,770,1975,0,98033,47.6621,-122.189,2210,8860,6424,6650,91.18190212373038,0.09377049180327869,Very Cheap
20141021T000000,696500.0,4,2.75,2540,4400,1.5,0,0,5,7,1630,910,1925,0,98103,47.6832,-122.343,1560,3920,1860,2360,158.29545454545453,0.08150819672131147,Very Cheap
20150430T000000,276000.0,3,2.0,1370,8137,1.0,0,0,4,7,1370,0,1988,0,98003,47.2802,-122.303,1660,8840,6767,7180,33.91913481627135,0.026360655737704918,Very Cheap
20140902T000000,269000.0,2,1.0,770,8612,1.0,0,0,3,6,770,0,1953,0,98155,47.7547,-122.323,1290,8407,7842,7117,31.235485369252206,0.02544262295081967,Very Cheap
20150130T000000,2415000.0,5,4.75,7880,24250,2.0,0,2,3,13,7880,0,1996,0,98177,47.7334,-122.362,2740,10761,16370,8021,99.58762886597938,0.30688524590163935,Medium
20150102T000000,829000.0,4,2.75,2970,59677,1.0,0,2,4,8,1610,1360,1973,0,98075,47.5953,-122.08,2930,42489,56707,39559,13.891448966938686,0.09888524590163934,Very Cheap
20150306T000000,122000.0,2,1.0,740,6840,1.0,0,0,3,6,740,0,1942,0,98126,47.5168,-122.373,740,6840,6100,6100,17.83625730994152,0.0061639344262295085,Very Cheap
20140821T000000,352500.0,3,1.5,1360,7680,1.0,0,0,3,7,1360,0,1955,0,98133,47.7441,-122.337,1630,7679,6320,6049,45.8984375,0.03639344262295082,Very Cheap
20141021T000000,249000.0,4,2.0,1280,7560,1.0,0,0,5,6,1280,0,1959,0,98058,47.45,-122.175,1250,7690,6280,6440,32.93650793650794,0.02281967213114754,Very Cheap
20141208T000000,360000.0,4,2.0,1920,7803,1.0,0,0,3,7,1080,840,1962,0,98155,47.758,-122.325,1940,8147,5883,6207,46.1361014994233,0.037377049180327866,Very Cheap
20150504T000000,629500.0,3,2.0,2020,10584,1.0,0,0,3,10,2020,0,1994,0,98075,47.5851,-122.028,3030,9870,8564,6840,59.47656840513984,0.07272131147540983,Very Cheap
20140625T000000,1140000.0,4,2.25,3310,127631,2.0,0,0,5,9,3310,0,1924,1956,98072,47.732,-122.134,3830,43959,124321,40129,8.931999279171988,0.13967213114754098,Cheap
20141017T000000,1550000.0,2,2.25,2950,15593,1.0,0,0,4,8,1560,1390,1942,1986,98039,47.6209,-122.236,2060,19855,12643,17795,99.40357852882704,0.19344262295081968,Cheap
20140718T000000,275000.0,3,1.5,1320,7695,1.0,0,0,4,7,1320,0,1959,0,98056,47.4908,-122.181,1370,8295,6375,6925,35.73749187784276,0.02622950819672131,Very Cheap
20140909T000000,697000.0,4,2.5,3160,6961,2.0,0,0,3,8,3160,0,2005,0,98074,47.6125,-122.01,3110,5058,3801,1948,100.12929176842408,0.08157377049180328,Very Cheap
20140507T000000,379500.0,2,1.0,1640,17335,1.0,0,0,3,7,840,800,1978,0,98053,47.6397,-121.953,2440,17850,15695,15410,21.892125757138736,0.0399344262295082,Very Cheap
20141110T000000,720000.0,3,2.75,2440,76531,1.0,0,0,3,10,1640,800,1980,0,98072,47.7672,-122.161,1890,10042,74091,8152,9.407952333041512,0.08459016393442623,Very Cheap
20140513T000000,675000.0,4,2.5,3000,5548,2.0,0,0,3,9,3000,0,2006,0,98059,47.5399,-122.188,2870,5000,2548,2130,121.66546503244412,0.07868852459016394,Very Cheap
20141029T000000,1169000.0,5,2.5,2810,6000,2.5,0,0,3,9,2810,0,1907,0,98109,47.6367,-122.35,2240,4800,3190,2560,194.83333333333334,0.14347540983606558,Cheap
20140520T000000,1100000.0,3,2.0,2390,6888,2.0,0,1,5,8,2390,0,1939,0,98115,47.6839,-122.274,2390,7920,4498,5530,159.69802555168408,0.13442622950819672,Cheap
20140612T000000,520000.0,4,1.0,2080,3500,1.5,0,0,5,7,1260,820,1926,0,98136,47.5445,-122.383,1380,5900,1420,4520,148.57142857142858,0.058360655737704915,Very Cheap
20141003T000000,415000.0,3,1.75,2650,7500,1.5,0,0,4,7,1590,1060,1962,0,98155,47.7716,-122.317,1340,7500,4850,6160,55.333333333333336,0.04459016393442623,Very Cheap
20140627T000000,415000.0,3,2.5,1060,1536,2.0,0,0,3,8,1060,0,2000,0,98117,47.6907,-122.395,1220,1316,476,96,270.1822916666667,0.04459016393442623,Very Cheap
20150407T000000,450000.0,3,2.25,1940,8312,1.0,0,1,4,7,1220,720,1963,0,98166,47.4556,-122.346,2060,9503,6372,7443,54.1385948026949,0.04918032786885246,Very Cheap
20150427T000000,485000.0,2,1.0,1080,4080,1.0,0,0,3,8,1080,0,1948,0,98115,47.6899,-122.32,1890,4080,3000,2190,118.87254901960785,0.05377049180327869,Very Cheap
20150427T000000,294000.0,3,2.25,1700,9600,2.0,0,0,3,7,1700,0,1984,0,98042,47.39,-122.158,1930,9600,7900,7670,30.625,0.028721311475409836,Very Cheap
20140709T000000,1037000.0,4,3.5,4440,10660,2.0,0,0,3,11,4440,0,2003,0,98059,47.5294,-122.137,4390,9976,6220,5586,97.2795497185741,0.1261639344262295,Cheap
20140728T000000,690000.0,3,1.0,1580,4000,2.0,0,0,3,8,1580,0,1905,0,98102,47.6363,-122.32,2190,4000,2420,1810,172.5,0.08065573770491803,Very Cheap
20141009T000000,716500.0,5,2.75,3630,38461,2.0,0,0,3,11,3630,0,2000,0,98058,47.4289,-122.094,4440,50378,34831,45938,18.629260809651335,0.08413114754098361,Very Cheap
20140903T000000,481000.0,2,2.25,1290,1137,3.0,0,0,3,8,1290,0,2007,0,98107,47.6718,-122.382,1290,1332,-153,42,423.04309586631484,0.05324590163934426,Very Cheap
20150419T000000,575000.0,4,2.75,1960,4635,1.0,0,0,4,7,1000,960,1968,0,98118,47.5693,-122.285,1830,6180,2675,4350,124.05609492988134,0.06557377049180328,Very Cheap
20140815T000000,785000.0,3,2.0,2090,5015,1.5,0,0,5,7,2090,0,1920,0,98112,47.6378,-122.301,1930,4250,2925,2320,156.53040877367897,0.09311475409836066,Very Cheap
20150325T000000,480000.0,3,1.75,1960,43995,1.0,0,0,3,7,1960,0,1970,0,98059,47.4915,-122.106,1960,42253,42035,40293,10.910330719399932,0.05311475409836065,Very Cheap
20140819T000000,720000.0,3,2.25,2120,9297,2.0,0,0,4,8,2120,0,1981,0,98006,47.5561,-122.154,2620,10352,7177,7732,77.44433688286544,0.08459016393442623,Very Cheap
20150512T000000,536000.0,3,2.75,2290,34548,2.0,0,3,4,7,2290,0,1984,0,98042,47.3691,-122.163,399,275299,32258,274900,15.514646289220794,0.06045901639344262,Very Cheap
20140613T000000,324900.0,4,2.5,1880,7965,2.0,0,0,3,7,1880,0,2000,0,98038,47.3642,-122.052,1570,7584,6085,6014,40.7909604519774,0.03277377049180328,Very Cheap
20140815T000000,265000.0,2,1.0,770,5160,1.0,0,0,3,6,770,0,1943,0,98106,47.5304,-122.356,920,5160,4390,4240,51.35658914728682,0.024918032786885248,Very Cheap
20140701T000000,545000.0,3,2.5,1530,3210,1.5,0,0,5,7,1010,520,1928,0,98117,47.6913,-122.393,1330,4410,1680,3080,169.78193146417445,0.06163934426229508,Very Cheap
20150115T000000,465000.0,2,1.5,1450,27075,1.0,0,0,3,7,1450,0,1940,0,98133,47.7281,-122.353,1890,10599,25625,8709,17.174515235457065,0.051147540983606556,Very Cheap
20150109T000000,292500.0,3,2.25,1690,7320,2.0,0,0,3,7,1690,0,1987,0,98198,47.3889,-122.316,1520,7450,5630,5930,39.959016393442624,0.028524590163934428,Very Cheap
20140702T000000,860000.0,4,1.75,1880,3720,1.5,0,0,4,7,1880,0,1924,0,98109,47.6431,-122.356,2090,4095,1840,2005,231.18279569892474,0.10295081967213114,Cheap
20141216T000000,1045000.0,4,3.25,4160,47480,2.0,0,0,3,10,4160,0,1995,0,98072,47.7266,-122.115,3400,40428,43320,37028,22.009267059814658,0.12721311475409836,Cheap
20140612T000000,495000.0,4,2.5,2140,7245,2.0,0,0,3,7,2140,0,2003,0,98133,47.729,-122.35,2080,7875,5105,5795,68.32298136645963,0.05508196721311476,Very Cheap
20150507T000000,342000.0,2,2.0,1320,1462,3.0,0,0,3,7,1320,0,1997,0,98125,47.7223,-122.29,1430,1650,142,220,233.92612859097127,0.03501639344262295,Very Cheap
20140625T000000,320000.0,4,2.5,2000,10051,2.0,0,0,3,7,2000,0,1997,0,98038,47.3625,-122.025,2000,6686,8051,4686,31.837628096706794,0.032131147540983604,Very Cheap
20140924T000000,444000.0,3,2.0,1460,2610,2.0,0,0,3,8,1460,0,1987,0,98103,47.6864,-122.345,1320,3000,1150,1680,170.11494252873564,0.04839344262295082,Very Cheap
20140625T000000,804100.0,4,2.5,3070,8086,2.0,0,0,3,10,3070,0,2005,0,98059,47.5399,-122.16,3320,10738,5016,7418,99.44348256245362,0.09561967213114754,Very Cheap
20140919T000000,432000.0,3,2.5,1660,15000,1.0,0,0,4,7,1660,0,1970,0,98075,47.5803,-122.05,2060,15015,13340,12955,28.8,0.046819672131147544,Very Cheap
20141230T000000,230000.0,6,1.5,1810,4838,1.5,0,0,4,5,1050,760,1905,0,98055,47.4874,-122.202,1300,4838,3028,3538,47.54030591153369,0.020327868852459016,Very Cheap
20140827T000000,935000.0,4,3.5,3510,11200,2.0,0,0,3,11,3510,0,2001,0,98059,47.5193,-122.15,3600,12124,7690,8524,83.48214285714286,0.11278688524590164,Cheap
20140807T000000,634950.0,3,3.0,2180,2650,1.5,0,0,5,8,1410,770,1930,0,98117,47.6891,-122.375,1570,4820,470,3250,239.60377358490567,0.0734360655737705,Very Cheap
20150112T000000,780000.0,6,4.0,3300,5720,1.0,0,0,3,8,1960,1340,1963,0,98115,47.676,-122.309,2030,4080,2420,2050,136.36363636363637,0.09245901639344262,Very Cheap
20140519T000000,611000.0,4,2.5,2460,4200,2.0,0,0,3,8,2460,0,1998,0,98074,47.6031,-122.021,2330,4200,1740,1870,145.47619047619048,0.07029508196721311,Very Cheap
20141121T000000,475999.0,4,1.75,1880,4175,1.5,0,0,3,7,1090,790,1944,0,98107,47.6646,-122.364,1700,3758,2295,2058,114.01173652694611,0.052590032786885246,Very Cheap
20141216T000000,565000.0,3,2.0,2290,9450,1.0,0,0,3,9,1670,620,1979,0,98008,47.5692,-122.1,2750,11700,7160,8950,59.78835978835979,0.06426229508196721,Very Cheap
20140808T000000,630000.0,4,2.5,2290,26720,2.0,0,0,3,8,2290,0,1977,0,98177,47.7502,-122.374,2290,26720,24430,24430,23.577844311377245,0.07278688524590164,Very Cheap
20140617T000000,840000.0,4,3.5,3860,18334,2.0,0,0,3,10,3120,740,1996,0,98077,47.7095,-122.075,3550,18334,14474,14784,45.81651576306316,0.10032786885245902,Cheap
20141107T000000,790000.0,3,2.5,2640,432036,1.5,0,3,3,10,2640,0,1996,0,98022,47.1795,-122.036,1500,560617,429396,559117,1.8285513244266682,0.09377049180327869,Very Cheap
20140709T000000,450000.0,5,2.5,2850,209523,1.0,0,0,4,7,1930,920,1925,1968,98058,47.3939,-122.089,2220,209523,206673,207303,2.1477355707965233,0.04918032786885246,Very Cheap
20141223T000000,1272000.0,4,3.25,3020,4000,1.5,0,0,5,8,1920,1100,1927,0,98112,47.6395,-122.279,2400,4000,980,1600,318.0,0.15698360655737706,Cheap
20150422T000000,520000.0,3,2.0,1510,3760,1.0,0,0,5,7,930,580,1925,0,98136,47.5425,-122.39,1510,3760,2250,2250,138.29787234042553,0.058360655737704915,Very Cheap
20141017T000000,446800.0,4,2.0,2410,8712,1.0,0,0,3,7,1260,1150,1958,0,98144,47.5729,-122.302,2220,6038,6302,3818,51.28558310376492,0.04876065573770492,Very Cheap
20150129T000000,652000.0,3,1.0,1470,6122,1.0,0,0,3,8,1200,270,1948,0,98199,47.6517,-122.406,2200,6122,4652,3922,106.50114341718393,0.07567213114754098,Very Cheap
20140522T000000,1170000.0,3,2.75,2890,12130,2.0,0,3,4,10,2830,60,1987,0,98033,47.6505,-122.203,2415,11538,9240,9123,96.45507007419621,0.1436065573770492,Cheap
20140610T000000,745000.0,4,3.25,3490,7024,2.0,0,0,3,10,3490,0,2006,0,98075,47.5834,-121.972,3450,6866,3534,3416,106.06492027334852,0.08786885245901639,Very Cheap
20140625T000000,594000.0,3,2.25,1270,1406,2.0,0,0,3,8,1060,210,2014,0,98105,47.6647,-122.284,1160,1327,136,167,422.475106685633,0.0680655737704918,Very Cheap
20150310T000000,257000.0,2,1.0,1000,3700,1.0,0,0,3,6,800,200,1929,0,98118,47.552,-122.29,1270,5000,2700,3730,69.45945945945945,0.023868852459016394,Very Cheap
20140701T000000,485000.0,4,1.75,1430,4096,2.0,0,0,3,7,1430,0,1900,0,98122,47.604,-122.306,1640,3377,2666,1737,118.408203125,0.05377049180327869,Very Cheap
20150506T000000,330000.0,3,1.0,1060,20040,1.0,0,0,3,6,1060,0,1943,0,98034,47.7281,-122.235,1768,10800,18980,9032,16.46706586826347,0.03344262295081967,Very Cheap
20140731T000000,381000.0,3,2.0,1680,8946,1.0,0,0,3,6,940,740,1996,0,98053,47.6379,-121.966,1550,11625,7266,10075,42.588866532528506,0.040131147540983604,Very Cheap
20140613T000000,849900.0,2,2.0,2280,641203,2.0,0,0,3,9,2280,0,1990,0,98070,47.4125,-122.455,2030,224334,638923,222304,1.3254772669497803,0.10162622950819672,Cheap
20150402T000000,793000.0,4,2.5,2450,4080,1.5,0,0,4,8,1490,960,1930,0,98115,47.6899,-122.319,2000,4080,1630,2080,194.36274509803923,0.09416393442622951,Very Cheap
20140728T000000,920000.0,3,2.25,3650,5353,2.0,0,4,4,7,2200,1450,1947,0,98144,47.5949,-122.291,1950,4970,1703,3020,171.8662432280964,0.11081967213114755,Cheap
20150422T000000,455000.0,2,1.0,830,4000,1.0,0,0,4,6,830,0,1947,0,98117,47.6909,-122.381,1420,4000,3170,2580,113.75,0.049836065573770495,Very Cheap
20140513T000000,975000.0,4,2.5,3490,7494,2.0,0,3,3,11,3490,0,2000,0,98006,47.559,-122.127,3260,8437,4004,5177,130.1040832666133,0.1180327868852459,Cheap
20141203T000000,375000.0,2,1.5,1050,1046,2.0,0,0,3,8,960,90,2007,0,98122,47.6028,-122.309,1470,1768,-4,298,358.50860420650093,0.03934426229508197,Very Cheap
20150311T000000,400000.0,2,2.5,1170,1811,2.0,0,0,3,8,1170,0,2001,0,98122,47.6132,-122.297,1250,3146,641,1896,220.87244616234125,0.04262295081967213,Very Cheap
20150211T000000,447000.0,3,1.0,1220,7200,1.0,0,0,4,7,1220,0,1965,0,98008,47.6218,-122.116,1320,7200,5980,5880,62.083333333333336,0.04878688524590164,Very Cheap
20141031T000000,470000.0,3,1.75,1310,8600,1.0,0,0,4,7,1310,0,1987,0,98033,47.686,-122.185,2510,8515,7290,6005,54.651162790697676,0.05180327868852459,Very Cheap
20141015T000000,665000.0,4,2.5,3130,7582,2.0,0,0,3,8,3130,0,2004,0,98075,47.577,-122.055,2990,6441,4452,3451,87.70772883144289,0.07737704918032787,Very Cheap
20140903T000000,295500.0,3,1.75,1590,41550,1.5,0,0,3,6,1290,300,1933,1989,98168,47.4817,-122.28,2990,6464,39960,3474,7.111913357400722,0.028918032786885244,Very Cheap
20150115T000000,200000.0,4,2.5,1720,8638,2.0,0,0,3,8,1720,0,1994,0,98003,47.2704,-122.313,1870,7455,6918,5585,23.1535077564251,0.01639344262295082,Very Cheap
20140911T000000,620000.0,3,2.25,2520,212137,2.0,0,0,3,9,1590,930,2005,0,98019,47.7384,-121.878,2000,212137,209617,210137,2.9226396149658003,0.07147540983606557,Very Cheap
20140829T000000,434900.0,3,2.0,1520,11067,1.0,0,0,3,7,1140,380,1983,0,98074,47.6326,-122.033,1280,11371,9547,10091,39.29700912623114,0.0472,Very Cheap
20150324T000000,1328000.0,4,2.25,3260,4640,2.0,0,0,5,9,2360,900,1907,0,98112,47.6272,-122.312,3240,5800,1380,2560,286.2068965517241,0.164327868852459,Cheap
20150109T000000,1650000.0,4,3.25,3910,7500,2.0,0,0,3,10,3910,0,2006,0,98033,47.6527,-122.198,2600,9235,3590,6635,220.0,0.20655737704918034,Cheap
20140905T000000,852500.0,4,2.5,3480,6315,2.0,0,0,3,9,2360,1120,2000,0,98052,47.6841,-122.161,3620,5233,2835,1613,134.99604117181315,0.1019672131147541,Cheap
20141209T000000,790000.0,3,2.5,3040,34670,2.0,0,0,4,10,3040,0,1983,0,98072,47.7565,-122.129,3480,35001,31630,31521,22.786270550908565,0.09377049180327869,Very Cheap
20150313T000000,565000.0,4,1.75,2030,7350,1.0,0,0,3,8,2030,0,1966,0,98008,47.6274,-122.094,2000,7998,5320,5998,76.87074829931973,0.06426229508196721,Very Cheap
20150325T000000,1127500.0,6,3.25,3870,24700,2.0,0,0,3,10,2520,1350,1989,0,98028,47.7517,-122.233,2360,30030,20830,27670,45.64777327935223,0.1380327868852459,Cheap
20141222T000000,289950.0,3,2.5,1870,1436,2.0,0,0,3,7,1870,0,2004,0,98059,47.4899,-122.166,1720,1852,-434,132,201.91504178272982,0.028190163934426228,Very Cheap
20141105T000000,850000.0,2,2.0,2640,13939,1.0,0,1,5,8,1640,1000,1963,0,98006,47.5647,-122.165,2880,14810,11299,11930,60.97998421694526,0.10163934426229508,Cheap
20140512T000000,505000.0,4,1.75,1940,4800,1.0,0,0,5,7,1030,910,1922,0,98122,47.6054,-122.314,1450,4800,2860,3350,105.20833333333333,0.05639344262295082,Very Cheap
20141028T000000,372000.0,3,2.5,1710,5633,2.0,0,0,3,7,1710,0,1981,0,98034,47.7232,-122.161,1540,5000,3923,3460,66.03941061601279,0.03895081967213115,Very Cheap
20141023T000000,207000.0,4,2.0,1690,7728,1.5,0,0,4,7,1690,0,1967,0,98198,47.3666,-122.318,1480,8009,6038,6529,26.785714285714285,0.017311475409836064,Very Cheap
20140513T000000,780000.0,3,1.75,2340,10495,1.0,0,0,4,8,2340,0,1967,0,98040,47.5386,-122.226,3120,11068,8155,7948,74.32110528823249,0.09245901639344262,Very Cheap
20140623T000000,400000.0,4,1.75,1700,20283,1.5,0,0,3,7,1340,360,1965,0,98019,47.7694,-121.903,1680,21369,18583,19689,19.720948577626583,0.04262295081967213,Very Cheap
20150223T000000,440250.0,3,1.5,1850,8124,1.0,0,0,4,7,1850,0,1948,0,98177,47.7275,-122.359,1530,8123,6274,6593,54.19128508124077,0.047901639344262295,Very Cheap
20150303T000000,585000.0,2,2.0,1370,7920,1.0,0,0,3,8,950,420,1949,0,98199,47.6589,-122.397,1370,4680,6550,3310,73.86363636363636,0.06688524590163934,Very Cheap
20140918T000000,850000.0,4,2.5,2900,9972,2.0,0,0,3,9,2900,0,1993,0,98006,47.5536,-122.121,2901,8567,7072,5666,85.23866827115924,0.10163934426229508,Cheap
20140925T000000,570000.0,3,3.0,2400,3192,2.0,0,0,3,7,2400,0,1991,0,98103,47.6963,-122.348,1360,3192,792,1832,178.57142857142858,0.06491803278688525,Very Cheap
20140620T000000,869000.0,4,3.0,3740,30884,2.0,0,0,3,9,3060,680,1988,0,98072,47.7505,-122.117,3240,37031,27144,33791,28.13754694987696,0.10413114754098361,Cheap
20140924T000000,551000.0,4,2.75,2170,5988,2.0,0,0,3,8,2170,0,2014,0,98155,47.7484,-122.317,1170,8147,3818,6977,92.01736806947228,0.06242622950819672,Very Cheap
20150313T000000,172380.0,3,1.0,970,8378,1.0,0,0,4,6,970,0,1962,0,98023,47.3078,-122.365,1050,8563,7408,7513,20.575316304607306,0.012771147540983607,Very Cheap
20150326T000000,355000.0,3,2.5,2620,78843,1.0,0,3,4,7,1310,1310,1964,0,98092,47.2584,-122.093,2330,130244,76223,127914,4.50261912915541,0.036721311475409836,Very Cheap
20150225T000000,728935.0,4,2.5,2980,10194,2.0,0,0,3,9,2980,0,1993,0,98006,47.5515,-122.12,2980,10053,7214,7073,71.50627820286444,0.08576196721311476,Very Cheap
20150306T000000,850000.0,3,2.5,2340,1919,2.0,0,2,4,9,2340,0,1981,0,98033,47.6512,-122.203,2415,2166,-421,-249,442.93903074517976,0.10163934426229508,Cheap
20141223T000000,515000.0,5,1.75,1880,48787,2.0,0,0,3,6,1880,0,1922,0,98059,47.5094,-122.165,1690,8401,46907,6711,10.556090761883288,0.057704918032786885,Very Cheap
20141205T000000,215000.0,2,1.0,1480,5325,1.0,0,0,4,7,1120,360,1925,0,98022,47.2079,-121.993,1670,5800,3845,4130,40.375586854460096,0.018360655737704918,Very Cheap
20140616T000000,220000.0,4,2.5,2240,9826,1.0,0,0,4,7,1370,870,1988,0,98023,47.314,-122.364,1980,9826,7586,7846,22.38957866883778,0.01901639344262295,Very Cheap
20140724T000000,845000.0,4,2.5,2940,7675,2.0,0,0,3,9,2940,0,2004,0,98052,47.7054,-122.129,3120,6574,4735,3454,110.09771986970684,0.10098360655737705,Cheap
20150223T000000,390000.0,1,1.0,710,4000,1.0,0,0,4,6,610,100,1928,0,98103,47.6562,-122.354,1440,4500,3290,3060,97.5,0.04131147540983607,Very Cheap
20150313T000000,135000.0,4,1.0,1460,18599,1.5,0,0,3,5,1460,0,1940,0,98146,47.5006,-122.351,1320,8100,17139,6780,7.258454755632023,0.007868852459016393,Very Cheap
20150401T000000,439000.0,3,1.0,1530,19007,1.0,0,0,4,8,1290,240,1949,0,98166,47.4508,-122.352,2090,20962,17477,18872,23.096753827537224,0.04773770491803279,Very Cheap
20140708T000000,585000.0,4,2.5,2630,6185,2.0,0,0,3,9,2630,0,1999,0,98056,47.5229,-122.192,2720,6185,3555,3465,94.58367016976557,0.06688524590163934,Very Cheap
20150309T000000,620000.0,5,1.0,2230,16800,1.5,0,3,4,7,1700,530,1923,0,98136,47.5161,-122.395,2730,18400,14570,15670,36.904761904761905,0.07147540983606557,Very Cheap
20140902T000000,477000.0,3,1.0,960,3600,1.0,0,0,4,7,960,0,1906,0,98117,47.6758,-122.369,1580,5000,2640,3420,132.5,0.052721311475409836,Very Cheap
20141014T000000,399500.0,2,1.5,1180,1722,2.0,0,0,3,8,1180,0,2006,0,98116,47.5626,-122.384,1490,1469,542,-21,231.99767711962835,0.04255737704918033,Very Cheap
20140927T000000,500000.0,2,1.0,1760,27332,1.0,1,4,4,7,1300,460,1951,0,98198,47.3799,-122.325,2590,16630,25572,14040,18.293575296355918,0.05573770491803279,Very Cheap
20140909T000000,432500.0,3,2.5,1340,8867,2.0,0,0,3,8,1340,0,1984,0,98125,47.724,-122.327,1630,7287,7527,5657,48.776361790910116,0.046885245901639346,Very Cheap
20141028T000000,940000.0,4,2.25,2800,18673,1.0,0,0,5,9,1650,1150,1965,0,98005,47.5893,-122.177,2800,15300,15873,12500,50.340063192845285,0.11344262295081967,Cheap
20140828T000000,3168750.0,5,3.5,4330,11979,1.0,0,4,3,12,2090,2240,2008,0,98004,47.6251,-122.218,4320,12000,7649,7680,264.52541948409714,0.4057377049180328,High
20140512T000000,1080000.0,3,2.5,3720,11610,2.0,0,0,3,11,3720,0,1982,0,98074,47.636,-122.049,3530,11877,7890,8347,93.02325581395348,0.1318032786885246,Cheap
20140815T000000,229999.0,4,2.0,1670,5200,1.0,0,0,4,7,1030,640,1977,0,98042,47.3652,-122.09,1500,5200,3530,3700,44.230576923076924,0.020327737704918032,Very Cheap
20140811T000000,233000.0,3,1.0,1100,7657,1.0,0,0,3,7,1100,0,1955,0,98188,47.4374,-122.285,1300,8000,6557,6700,30.429672195376778,0.020721311475409836,Very Cheap
20140626T000000,600000.0,3,2.5,3240,8016,2.0,0,0,3,8,2910,330,2004,0,98065,47.5382,-121.877,2990,7561,4776,4571,74.8502994011976,0.06885245901639345,Very Cheap
20150508T000000,334000.0,4,1.5,1680,7620,1.0,0,0,4,7,1180,500,1965,0,98166,47.4578,-122.351,1460,7620,5940,6160,43.83202099737533,0.0339672131147541,Very Cheap
20140716T000000,332500.0,3,1.0,1030,8164,1.0,0,0,4,7,1030,0,1950,0,98133,47.7353,-122.334,1340,8164,7134,6824,40.72758451739343,0.033770491803278686,Very Cheap
20140626T000000,249900.0,3,2.5,1630,7700,1.0,0,0,3,7,1120,510,1978,0,98031,47.3876,-122.211,1640,8160,6070,6520,32.45454545454545,0.02293770491803279,Very Cheap
20141023T000000,310000.0,3,2.0,2610,12180,1.0,0,0,3,7,1670,940,1918,0,98146,47.5063,-122.346,1520,12180,9570,10660,25.451559934318556,0.03081967213114754,Very Cheap
20141105T000000,200000.0,2,1.0,1250,8520,1.0,0,0,3,6,1250,0,1928,0,98126,47.5158,-122.378,1040,8520,7270,7480,23.474178403755868,0.01639344262295082,Very Cheap
20140725T000000,310000.0,4,1.75,1480,11200,1.0,0,0,4,7,1480,0,1969,0,98059,47.5064,-122.141,1480,20310,9720,18830,27.678571428571427,0.03081967213114754,Very Cheap
20140707T000000,230000.0,3,1.0,1390,6000,1.0,0,0,3,5,1390,0,1954,0,98056,47.4977,-122.175,1170,6000,4610,4830,38.333333333333336,0.020327868852459016,Very Cheap
20141020T000000,420000.0,4,2.5,1940,5414,2.0,0,0,3,8,1940,0,1997,0,98108,47.5461,-122.299,2050,6307,3474,4257,77.57665312153675,0.04524590163934426,Very Cheap
20141012T000000,785000.0,4,2.5,2960,4750,2.0,0,0,3,9,2960,0,2005,0,98029,47.5544,-121.993,2960,4750,1790,1790,165.26315789473685,0.09311475409836066,Very Cheap
20141014T000000,1775000.0,3,2.25,4320,19225,1.0,0,0,4,10,2160,2160,1972,0,98004,47.6368,-122.216,3430,18469,14905,15039,92.32769830949285,0.22295081967213115,Cheap
20140507T000000,265000.0,5,1.5,1500,7112,1.0,0,0,5,6,760,740,1920,0,98166,47.4692,-122.35,1200,7112,5612,5912,37.26096737907761,0.024918032786885248,Very Cheap
20140923T000000,295000.0,2,1.0,840,10465,1.0,0,0,3,6,840,0,1951,0,98155,47.755,-122.317,1320,8515,9625,7195,28.18920210224558,0.028852459016393443,Very Cheap
20150218T000000,896000.0,4,2.5,3560,46644,2.0,0,0,3,11,3560,0,1992,0,98077,47.7268,-122.05,3520,50261,43084,46741,19.209330246119542,0.10767213114754098,Cheap
20150112T000000,415000.0,4,2.75,2390,9968,1.0,0,0,4,9,1390,1000,1989,0,98038,47.3706,-122.056,2560,12385,7578,9825,41.63322632423756,0.04459016393442623,Very Cheap
20150212T000000,250000.0,3,1.75,1200,5478,1.0,0,0,5,6,1200,0,1955,0,98056,47.4959,-122.174,1270,6855,4278,5585,45.63709382986492,0.022950819672131147,Very Cheap
20150421T000000,1475000.0,3,2.5,2570,5000,2.0,0,0,3,11,2570,0,1984,0,98102,47.6295,-122.32,1570,5000,2430,3430,295.0,0.18360655737704917,Cheap
20150407T000000,635000.0,5,2.25,2180,6000,1.0,0,0,4,8,1430,750,1966,0,98007,47.6235,-122.143,2160,8800,3820,6640,105.83333333333333,0.07344262295081967,Very Cheap
20150401T000000,905000.0,3,2.5,3450,48787,2.0,0,0,3,10,3450,0,1987,0,98072,47.739,-122.129,2810,41040,45337,38230,18.550023571853156,0.10885245901639344,Cheap
20140721T000000,528000.0,3,2.5,2020,5613,2.0,0,0,3,7,2020,0,2003,0,98053,47.6835,-122.035,2020,4609,3593,2589,94.06734366648851,0.05940983606557377,Very Cheap
20140825T000000,530000.0,3,2.5,2480,7480,2.0,0,0,3,9,2480,0,1992,0,98072,47.771,-122.166,2480,7480,5000,5000,70.85561497326204,0.05967213114754098,Very Cheap
20140807T000000,310000.0,3,1.5,1140,3104,2.0,0,0,3,7,1140,0,1988,0,98029,47.5707,-122.018,1150,2981,1964,1831,99.87113402061856,0.03081967213114754,Very Cheap
20150126T000000,252000.0,3,1.0,1530,9465,1.0,0,0,4,7,1530,0,1960,0,98059,47.4915,-122.151,1530,9465,7935,7935,26.624405705229794,0.02321311475409836,Very Cheap
20140811T000000,334500.0,3,2.0,1700,8160,1.0,0,0,3,7,1120,580,1961,0,98133,47.74,-122.339,1740,8181,6460,6441,40.99264705882353,0.0340327868852459,Very Cheap
20150506T000000,370000.0,3,1.0,2150,8480,1.0,0,0,3,8,1610,540,1951,0,98115,47.6996,-122.308,1620,5203,6330,3583,43.632075471698116,0.038688524590163934,Very Cheap
20141219T000000,311000.0,3,2.0,1190,7840,1.5,0,0,4,6,1190,0,1918,0,98108,47.5531,-122.312,1460,3240,6650,1780,39.66836734693877,0.030950819672131147,Very Cheap
20150414T000000,260000.0,3,2.75,1730,4131,2.0,0,2,3,7,1480,250,1975,0,98106,47.5327,-122.346,1570,4120,2401,2550,62.938755749213264,0.024262295081967214,Very Cheap
20140701T000000,217500.0,3,1.75,1400,9546,1.0,0,0,4,7,1400,0,1984,0,98003,47.3179,-122.331,1660,8550,8146,6890,22.78441231929604,0.018688524590163933,Very Cheap
20150218T000000,290000.0,3,2.5,2200,4240,2.0,0,0,3,7,2200,0,2003,0,98042,47.3715,-122.127,2200,4311,2040,2111,68.39622641509433,0.02819672131147541,Very Cheap
20141007T000000,500000.0,3,1.5,960,4600,1.0,0,0,3,6,960,0,1944,0,98033,47.6937,-122.213,2230,9350,3640,7120,108.69565217391305,0.05573770491803279,Very Cheap
20150420T000000,423500.0,3,2.0,1770,6000,1.0,0,3,3,7,1100,670,1984,0,98118,47.5644,-122.29,1300,3000,4230,1700,70.58333333333333,0.04570491803278689,Very Cheap
20141224T000000,715000.0,4,2.5,2970,5722,2.0,0,0,3,9,2970,0,2005,0,98074,47.6134,-122.042,3940,4848,2752,908,124.95630898287313,0.0839344262295082,Very Cheap
20140728T000000,299000.0,3,2.5,1590,3121,2.0,0,0,3,7,1590,0,1994,0,98118,47.5515,-122.284,1090,4900,1531,3810,95.80262736302467,0.02937704918032787,Very Cheap
20140630T000000,635000.0,3,2.5,3350,4007,2.0,0,0,3,8,2550,800,2005,0,98034,47.7277,-122.207,2340,4167,657,1827,158.47267282256053,0.07344262295081967,Very Cheap
20140826T000000,806000.0,4,2.5,3370,9629,2.0,0,0,3,10,3370,0,1999,0,98075,47.5896,-121.978,3360,10335,6259,6975,83.70547305016098,0.0958688524590164,Very Cheap
20140531T000000,289950.0,3,2.5,1960,3480,2.0,0,0,3,7,1960,0,2004,0,98056,47.4802,-122.18,2560,3500,1520,940,83.31896551724138,0.028190163934426228,Very Cheap
20141010T000000,280000.0,3,1.75,1360,6603,1.0,0,0,4,7,1360,0,1981,0,98058,47.4619,-122.168,1770,7107,5243,5337,42.404967439042856,0.026885245901639345,Very Cheap
20150330T000000,479950.0,3,2.5,2780,6000,2.0,0,0,3,9,2780,0,2004,0,98058,47.4569,-122.118,1940,3466,3220,1526,79.99166666666666,0.05310819672131147,Very Cheap
20140627T000000,394000.0,4,2.5,3000,9793,2.0,0,0,3,7,3000,0,2002,0,98038,47.3655,-122.028,1890,7557,6793,5667,40.2328193607679,0.041836065573770495,Very Cheap
20150129T000000,682000.0,4,2.5,3600,203425,2.0,0,0,3,9,3400,200,1979,0,98077,47.7597,-122.018,3150,202989,199825,199839,3.3525869485068207,0.07960655737704918,Very Cheap
20140724T000000,409950.0,2,1.0,990,3000,1.0,0,0,4,6,990,0,1918,0,98103,47.6839,-122.345,1120,3000,2010,1880,136.65,0.043927868852459015,Very Cheap
20140911T000000,1000000.0,4,3.5,2990,4200,2.0,0,4,5,9,2000,990,1925,0,98144,47.593,-122.289,2390,4200,1210,1810,238.0952380952381,0.12131147540983607,Cheap
20150120T000000,436000.0,4,1.0,1200,6600,1.5,0,2,3,7,1200,0,1908,0,98136,47.5372,-122.382,1810,6600,5400,4790,66.06060606060606,0.047344262295081964,Very Cheap
20140909T000000,279000.0,3,1.0,1530,15975,1.0,0,0,3,7,970,560,1952,0,98168,47.4766,-122.326,1540,15975,14445,14435,17.464788732394368,0.02675409836065574,Very Cheap
20140715T000000,390000.0,1,1.75,1440,4920,1.0,0,0,3,7,720,720,1923,0,98126,47.534,-122.376,1440,4920,3480,3480,79.26829268292683,0.04131147540983607,Very Cheap
20141216T000000,635000.0,3,1.75,1940,167125,1.0,1,1,4,7,1480,460,1955,0,98070,47.459,-122.504,1910,127195,165185,125285,3.799551234106208,0.07344262295081967,Very Cheap
20140718T000000,304400.0,4,2.75,2140,8100,2.0,0,0,4,7,2140,0,1990,0,98023,47.3075,-122.359,1960,7002,5960,5042,37.58024691358025,0.030085245901639343,Very Cheap
20150325T000000,780000.0,5,1.75,2330,3800,1.5,0,0,3,7,1360,970,1927,0,98115,47.6835,-122.308,2100,3800,1470,1700,205.26315789473685,0.09245901639344262,Very Cheap
20141001T000000,520000.0,4,3.5,2734,210201,2.0,0,0,5,8,2734,0,1974,0,98070,47.3652,-122.504,2270,187308,207467,185038,2.473822674487752,0.058360655737704915,Very Cheap
20150319T000000,580000.0,3,1.75,1950,10633,1.0,0,0,3,7,1250,700,1978,0,98125,47.7019,-122.313,1290,6380,8683,5090,54.54716448791498,0.06622950819672131,Very Cheap
20140908T000000,274000.0,3,1.75,1440,7198,1.0,0,0,3,7,990,450,1981,0,98055,47.4333,-122.194,1550,7156,5758,5606,38.06612948041123,0.026098360655737705,Very Cheap
20150209T000000,315000.0,3,2.25,1530,7906,1.0,0,0,3,7,1150,380,1980,0,98058,47.4418,-122.136,1460,7875,6376,6415,39.84315709587655,0.031475409836065574,Very Cheap
20140806T000000,390000.0,4,1.75,1910,77574,1.0,0,0,4,8,1910,0,1971,0,98042,47.3932,-122.12,2130,37026,75664,34896,5.027457653337459,0.04131147540983607,Very Cheap
20140911T000000,340000.0,5,2.0,1750,8220,1.0,0,0,3,7,1750,0,1956,0,98155,47.7694,-122.321,1210,6760,6470,5550,41.3625304136253,0.03475409836065574,Very Cheap
20140701T000000,502000.0,3,2.25,1600,45613,2.0,0,0,4,8,1600,0,1983,0,98072,47.7523,-122.117,2320,43005,44013,40685,11.00563435862583,0.056,Very Cheap
20140806T000000,260000.0,3,1.75,1750,11180,1.0,0,0,3,8,1750,0,1968,0,98059,47.4713,-122.117,1730,11180,9430,9450,23.25581395348837,0.024262295081967214,Very Cheap
20140530T000000,399000.0,2,1.0,940,4800,1.0,0,0,4,6,940,0,1911,1955,98116,47.5756,-122.414,980,5900,3860,4920,83.125,0.042491803278688525,Very Cheap
20140515T000000,312500.0,2,1.0,880,6345,1.0,0,0,3,7,880,0,1919,0,98106,47.5341,-122.358,1440,6345,5465,4905,49.25137903861308,0.03114754098360656,Very Cheap
20140513T000000,370000.0,3,1.75,1650,8254,1.0,0,0,5,7,1060,590,1951,0,98155,47.7596,-122.304,2280,9450,6604,7170,44.82675066634359,0.038688524590163934,Very Cheap
20140619T000000,1240000.0,4,3.5,3820,13224,2.0,0,0,3,10,3280,540,1990,0,98004,47.6005,-122.199,3340,9700,9404,6360,93.76890502117362,0.15278688524590164,Cheap
20150220T000000,230000.0,3,1.5,1900,9630,1.0,0,0,3,8,1900,0,1967,0,98023,47.3352,-122.344,2010,9630,7730,7620,23.883696780893043,0.020327868852459016,Very Cheap
20141003T000000,1275000.0,4,1.75,3720,8448,1.0,0,3,4,9,1960,1760,1947,0,98199,47.6425,-122.406,2540,7064,4728,4524,150.92329545454547,0.15737704918032788,Cheap
20140820T000000,294350.0,3,1.0,1410,5120,1.5,0,0,3,6,1210,200,1925,0,98106,47.5238,-122.355,1330,5120,3710,3790,57.490234375,0.0287672131147541,Very Cheap
20141013T000000,208950.0,3,1.0,960,5700,1.0,0,0,4,5,960,0,1956,0,98056,47.4983,-122.172,960,5700,4740,4740,36.6578947368421,0.017567213114754097,Very Cheap
20141106T000000,515000.0,2,1.75,1930,5570,1.0,0,0,3,8,1930,0,2005,0,98053,47.7173,-122.034,1810,5178,3640,3368,92.45960502692998,0.057704918032786885,Very Cheap
20150408T000000,965000.0,4,2.5,3420,9575,2.0,0,0,3,11,3420,0,1994,0,98027,47.5527,-122.095,3310,8192,6155,4882,100.78328981723237,0.11672131147540983,Cheap
20150326T000000,925000.0,4,2.75,3010,3400,2.0,0,2,3,9,2240,770,1923,2009,98122,47.6142,-122.284,1940,5080,390,3140,272.05882352941177,0.11147540983606558,Cheap
20150318T000000,654500.0,4,1.0,1780,5000,1.5,0,0,3,8,1780,0,1947,0,98115,47.6761,-122.297,2030,5000,3220,2970,130.9,0.076,Very Cheap
20140814T000000,364000.0,4,2.5,2080,11050,1.0,0,0,4,8,2080,0,1969,0,98059,47.472,-122.119,1850,11050,8970,9200,32.94117647058823,0.03790163934426229,Very Cheap
20150324T000000,150000.0,2,1.0,1250,5208,1.0,0,0,3,7,1050,200,1951,0,98002,47.3063,-122.219,1030,5354,3958,4324,28.80184331797235,0.009836065573770493,Very Cheap
20140514T000000,349950.0,5,3.0,2257,10117,1.0,0,0,3,8,1363,894,2005,0,98188,47.4524,-122.284,1540,10700,7860,9160,34.59029356528615,0.036059016393442625,Very Cheap
20140825T000000,585000.0,3,1.5,1670,5000,1.5,0,0,4,7,1670,0,1912,0,98117,47.678,-122.36,1750,5000,3330,3250,117.0,0.06688524590163934,Very Cheap
20150317T000000,801501.0,4,2.25,2250,13500,2.0,0,0,4,9,2250,0,1980,0,98007,47.621,-122.151,2730,13500,11250,10770,59.370444444444445,0.09527881967213114,Very Cheap
20141010T000000,610000.0,3,1.75,1650,221720,1.0,0,0,3,7,1650,0,1992,0,98024,47.5297,-121.901,2520,221284,220070,218764,2.751217752119791,0.07016393442622951,Very Cheap
20140521T000000,382000.0,5,2.25,2880,11965,2.0,0,0,4,8,2880,0,1990,0,98042,47.3734,-122.124,2370,10715,9085,8345,31.926452152110322,0.040262295081967214,Very Cheap
20141201T000000,495000.0,4,3.0,3620,403693,2.0,0,2,3,9,3620,0,1980,0,98022,47.2527,-121.98,2230,148811,400073,146581,1.2261792996162926,0.05508196721311476,Very Cheap
20141103T000000,447500.0,3,1.75,1950,6504,1.0,0,0,3,8,1530,420,1953,0,98115,47.6934,-122.328,1660,6552,4554,4892,68.80381303813039,0.04885245901639344,Very Cheap
20150220T000000,575000.0,4,2.5,2280,9491,1.0,0,0,4,7,1290,990,1966,0,98008,47.6297,-122.117,1560,8050,7211,6490,60.583710883995366,0.06557377049180328,Very Cheap
20141007T000000,565000.0,2,1.75,1740,4736,1.5,0,2,4,7,1040,700,1907,0,98144,47.5994,-122.287,2020,4215,2996,2195,119.29898648648648,0.06426229508196721,Very Cheap
20140522T000000,348580.0,3,1.0,1220,7876,1.0,0,0,3,7,1220,0,1966,0,98034,47.7317,-122.201,1340,7876,6656,6536,44.25850685627222,0.03587934426229508,Very Cheap
20141016T000000,459000.0,4,1.75,2260,9703,1.0,0,0,2,8,1660,600,1978,0,98052,47.6622,-122.145,2390,8455,7443,6065,47.30495722972277,0.050360655737704915,Very Cheap
20150402T000000,375000.0,4,2.0,1790,61419,2.0,0,2,2,7,1790,0,1988,0,98019,47.7216,-121.907,1790,62290,59629,60500,6.1056025008547845,0.03934426229508197,Very Cheap
20140904T000000,310000.0,4,2.5,2440,7093,2.0,0,0,3,7,2440,0,1999,0,98030,47.3817,-122.204,1860,6072,4653,4212,43.70506132806993,0.03081967213114754,Very Cheap
20141118T000000,210000.0,3,1.5,1400,9600,1.0,0,0,4,7,1400,0,1964,0,98003,47.2878,-122.297,2210,15000,8200,12790,21.875,0.017704918032786884,Very Cheap
20140911T000000,384205.0,3,2.75,1810,3292,2.0,0,0,3,8,1810,0,2014,0,98065,47.5164,-121.877,1810,2769,1482,959,116.70868772782504,0.040551475409836064,Very Cheap
20140522T000000,180000.0,2,1.0,1400,4500,1.0,0,0,3,7,900,500,1922,0,98055,47.4866,-122.219,1400,5500,3100,4100,40.0,0.01377049180327869,Very Cheap
20141224T000000,310000.0,2,1.0,1400,4500,1.0,0,0,3,7,900,500,1922,0,98055,47.4866,-122.219,1400,5500,3100,4100,68.88888888888889,0.03081967213114754,Very Cheap
20150203T000000,427500.0,4,2.5,2010,6294,2.0,0,0,3,7,2010,0,2000,0,98028,47.776,-122.24,1870,4394,4284,2524,67.92183031458532,0.04622950819672131,Very Cheap
20140527T000000,780000.0,3,3.0,2520,2152,1.5,0,0,3,8,1560,960,1925,2006,98119,47.6363,-122.371,1140,2152,-368,1012,362.453531598513,0.09245901639344262,Very Cheap
20140821T000000,1762000.0,3,2.25,3060,16000,2.0,0,0,3,10,3060,0,1988,0,98039,47.6189,-122.23,3510,13162,12940,9652,110.125,0.22124590163934427,Cheap
20150303T000000,339950.0,4,2.5,2150,4000,2.0,0,0,3,7,2150,0,2010,0,98038,47.3655,-122.018,1610,4000,1850,2390,84.9875,0.03474754098360656,Very Cheap
20140701T000000,820000.0,3,2.25,2880,9750,2.0,0,0,3,10,2880,0,1989,0,98006,47.5575,-122.119,2920,11090,6870,8170,84.1025641025641,0.09770491803278689,Very Cheap
20140924T000000,398000.0,2,2.0,1300,3865,1.0,0,0,3,8,1300,0,2006,0,98053,47.7193,-122.024,1350,4199,2565,2849,102.97542043984475,0.042360655737704915,Very Cheap
20140602T000000,492000.0,3,1.75,2770,39927,1.0,0,0,4,8,1580,1190,1978,0,98027,47.4669,-122.003,2420,36384,37157,33964,12.322488541588399,0.054688524590163934,Very Cheap
20150108T000000,240000.0,4,1.5,1780,14810,1.0,0,0,4,8,1180,600,1950,0,98032,47.3581,-122.288,1450,6728,13030,5278,16.205266711681297,0.021639344262295083,Very Cheap
20140609T000000,599950.0,4,3.5,3730,15029,2.0,0,2,3,10,2440,1290,1991,0,98042,47.3804,-122.163,3440,14280,11299,10840,39.91948898795662,0.06884590163934426,Very Cheap
20140716T000000,105500.0,2,1.0,930,7740,1.0,0,0,1,5,930,0,1932,0,98148,47.4611,-122.324,1620,8584,6810,6964,13.630490956072352,0.004,Very Cheap
20150316T000000,445000.0,2,1.0,930,7740,1.0,0,0,1,5,930,0,1932,0,98148,47.4611,-122.324,1620,8584,6810,6964,57.49354005167959,0.04852459016393443,Very Cheap
20140911T000000,390500.0,2,1.75,1460,426450,1.0,0,0,5,7,960,500,1966,0,98022,47.2079,-121.967,1810,17350,424990,15540,0.9156993785906906,0.04137704918032787,Very Cheap
20150224T000000,255000.0,3,2.0,1310,8454,1.0,0,0,3,7,1310,0,1994,0,98042,47.3697,-122.075,1310,8454,7144,7144,30.16323633782825,0.02360655737704918,Very Cheap
20140626T000000,675750.0,4,2.5,2770,10274,2.0,0,0,3,9,2770,0,1989,0,98029,47.5748,-122.018,2270,7210,7504,4940,65.77282460580105,0.07878688524590163,Very Cheap
20140701T000000,1640000.0,3,3.25,3140,5445,2.0,0,3,4,10,2240,900,1913,0,98109,47.6406,-122.347,2950,5250,2305,2300,301.1937557392103,0.20524590163934425,Cheap
20140930T000000,353500.0,4,2.5,1770,9239,2.0,0,0,3,7,1770,0,2004,0,98038,47.3512,-122.006,2150,5450,7469,3300,38.26171663599957,0.036524590163934424,Very Cheap
20141020T000000,765000.0,3,1.0,1220,7585,1.0,0,0,4,7,1220,0,1954,0,98004,47.6094,-122.194,1380,8918,6365,7538,100.8569545154911,0.09049180327868853,Very Cheap
20150303T000000,563500.0,4,2.5,2190,4944,2.0,0,0,3,8,2190,0,1999,0,98065,47.5341,-121.866,2190,5108,2754,2918,113.97653721682848,0.06406557377049181,Very Cheap
20150121T000000,439000.0,4,2.0,1800,5465,1.0,0,0,3,7,900,900,1942,0,98118,47.561,-122.272,1400,5400,3665,4000,80.32936870997256,0.04773770491803279,Very Cheap
20140613T000000,975000.0,5,2.75,3100,10014,1.0,0,2,4,9,1660,1440,1973,0,98040,47.5734,-122.213,3230,10279,6914,7049,97.36369083283404,0.1180327868852459,Cheap
20150406T000000,469900.0,3,2.5,2270,4399,2.0,0,0,3,7,2270,0,2007,0,98065,47.5415,-121.884,2060,4399,2129,2339,106.81973175721755,0.05179016393442623,Very Cheap
20150423T000000,252000.0,3,1.0,1300,8184,2.0,0,0,3,6,1300,0,1947,0,98155,47.7469,-122.319,1120,8184,6884,7064,30.791788856304986,0.02321311475409836,Very Cheap
20140612T000000,495000.0,3,2.0,1769,9300,1.0,0,0,4,7,1769,0,1955,2009,98166,47.441,-122.342,1870,10226,7531,8356,53.225806451612904,0.05508196721311476,Very Cheap
20141202T000000,570000.0,6,2.5,3370,15625,1.0,0,0,3,8,1770,1600,1964,0,98166,47.4223,-122.343,2790,15681,12255,12891,36.48,0.06491803278688525,Very Cheap
20140812T000000,327000.0,4,2.5,1630,5361,2.0,0,0,3,7,1630,0,1999,0,98144,47.5704,-122.294,1920,5046,3731,3126,60.99608282036933,0.033049180327868855,Very Cheap
20141014T000000,898000.0,2,2.25,2470,7658,1.0,0,0,4,8,1480,990,1954,0,98199,47.653,-122.416,2070,7270,5188,5200,117.26299294855053,0.10793442622950819,Cheap
20150109T000000,300000.0,4,2.5,2600,8572,2.0,0,0,3,8,2600,0,2003,0,98001,47.3155,-122.266,2170,5288,5972,3118,34.997666822211855,0.029508196721311476,Very Cheap
20150413T000000,418500.0,3,2.0,1800,12440,1.0,0,0,3,8,1220,580,1978,0,98074,47.6254,-122.05,2460,12352,10640,9892,33.641479099678456,0.04504918032786885,Very Cheap
20150325T000000,450000.0,4,2.5,2240,4616,2.0,0,0,3,7,1840,400,2001,0,98056,47.5118,-122.194,2260,5200,2376,2940,97.48700173310225,0.04918032786885246,Very Cheap
20140502T000000,403000.0,3,2.0,1960,13100,1.0,0,2,5,8,1650,310,1957,0,98166,47.4419,-122.34,1960,10518,11140,8558,30.763358778625953,0.04301639344262295,Very Cheap
20140612T000000,440000.0,3,1.0,1710,6556,1.5,0,0,4,7,1200,510,1926,0,98133,47.7185,-122.354,1410,6563,4846,5153,67.11409395973155,0.04786885245901639,Very Cheap
20150429T000000,350000.0,4,1.75,2140,4959,1.0,0,0,3,7,1080,1060,1965,0,98118,47.5166,-122.266,1590,5250,2819,3660,70.57874571486187,0.036065573770491806,Very Cheap
20140515T000000,240000.0,3,2.0,1400,6200,1.0,0,0,3,6,700,700,1948,0,98133,47.7634,-122.34,1410,7564,4800,6154,38.70967741935484,0.021639344262295083,Very Cheap
20140616T000000,460000.0,2,1.0,890,2100,1.0,0,0,4,6,760,130,1919,0,98107,47.656,-122.359,1600,4250,1210,2650,219.04761904761904,0.050491803278688525,Very Cheap
20140919T000000,825000.0,4,1.0,1820,4000,2.0,0,0,3,8,1820,0,1923,0,98102,47.6259,-122.321,2050,4000,2180,1950,206.25,0.09836065573770492,Very Cheap
20150226T000000,267500.0,3,2.25,1860,12000,1.0,0,0,4,7,1860,0,1976,0,98092,47.2942,-122.19,1815,9604,10140,7789,22.291666666666668,0.025245901639344263,Very Cheap
20140904T000000,201000.0,3,1.0,1220,22443,1.0,0,0,4,7,1220,0,1972,0,98001,47.2633,-122.245,1260,19950,21223,18690,8.956021922202915,0.016524590163934427,Very Cheap
20140617T000000,479500.0,3,2.75,2300,4637,2.0,0,0,3,8,2300,0,2008,0,98065,47.5216,-121.878,2420,5699,2337,3279,103.40737545827044,0.05304918032786885,Very Cheap
20150402T000000,210000.0,2,1.0,1520,4700,2.0,0,0,4,7,1520,0,1978,0,98092,47.3187,-122.182,1140,3906,3180,2766,44.680851063829785,0.017704918032786884,Very Cheap
20140608T000000,445000.0,2,1.0,1440,3225,1.0,0,0,3,7,960,480,1915,0,98103,47.6653,-122.338,1160,3630,1785,2470,137.984496124031,0.04852459016393443,Very Cheap
20140714T000000,265000.0,3,1.75,1170,8148,1.0,0,0,3,7,1170,0,1952,0,98155,47.7479,-122.318,1200,8147,6978,6947,32.52331860579283,0.024918032786885248,Very Cheap
20141111T000000,399000.0,3,1.75,1170,8148,1.0,0,0,3,7,1170,0,1952,0,98155,47.7479,-122.318,1200,8147,6978,6947,48.96907216494845,0.042491803278688525,Very Cheap
20141010T000000,785000.0,4,2.25,3200,53357,2.0,0,0,4,9,3200,0,1972,0,98077,47.755,-122.035,2650,54014,50157,51364,14.712221451730795,0.09311475409836066,Very Cheap
20140623T000000,831500.0,5,2.5,4470,35124,2.5,0,0,3,11,4470,0,1984,0,98072,47.7377,-122.084,4050,34118,30654,30068,23.673271836920623,0.09921311475409836,Very Cheap
20150403T000000,360000.0,4,2.5,2570,4557,2.0,0,0,3,7,2570,0,2009,0,98042,47.367,-122.115,2200,4500,1987,2300,78.99934167215274,0.037377049180327866,Very Cheap
20150423T000000,655000.0,3,2.5,2370,7916,2.0,0,0,3,9,2370,0,1990,0,98056,47.528,-122.171,2500,8221,5546,5721,82.74381000505306,0.0760655737704918,Very Cheap
20150504T000000,449950.0,4,1.5,1800,10150,1.5,0,0,4,7,1800,0,1958,0,98034,47.7325,-122.242,1630,10660,8350,9030,44.330049261083744,0.04917377049180328,Very Cheap
20150429T000000,612000.0,5,2.5,2300,7000,1.0,0,0,3,8,1290,1010,1975,0,98052,47.6875,-122.122,2080,7280,4700,5200,87.42857142857143,0.07042622950819673,Very Cheap
20140729T000000,575000.0,3,2.5,3240,33661,2.0,0,0,3,8,3240,0,2001,0,98059,47.4785,-122.095,1870,43560,30421,41690,17.082083122901874,0.06557377049180328,Very Cheap
20150212T000000,557000.0,3,2.5,2280,18241,1.0,0,0,3,9,960,1320,1995,0,98011,47.7453,-122.213,3100,12465,15961,9365,30.535606600515322,0.06321311475409835,Very Cheap
20150128T000000,375000.0,4,1.75,1870,12500,1.0,0,1,5,6,1030,840,1943,0,98056,47.511,-122.197,2060,14141,10630,12081,30.0,0.03934426229508197,Very Cheap
20150227T000000,369000.0,3,2.25,1820,99752,1.0,0,0,4,7,1820,0,1969,0,98092,47.2838,-122.006,1850,117612,97932,115762,3.699173951399471,0.03855737704918033,Very Cheap
20150420T000000,330000.0,5,2.75,2390,6282,1.0,0,0,4,7,1290,1100,1966,0,98118,47.5149,-122.263,1690,5202,3892,3512,52.53104106972302,0.03344262295081967,Very Cheap
20150427T000000,1031000.0,4,1.75,2110,6708,1.0,0,3,3,8,1410,700,1941,0,98105,47.67,-122.274,2140,7006,4598,4866,153.69707811568276,0.12537704918032788,Cheap
20150326T000000,550000.0,2,1.0,980,4800,1.0,0,0,4,7,980,0,1910,0,98103,47.6569,-122.348,1570,2640,3820,1070,114.58333333333333,0.06229508196721312,Very Cheap
20141110T000000,338000.0,3,1.75,1250,7710,1.0,0,0,4,7,1250,0,1947,0,98155,47.7623,-122.317,1340,7710,6460,6370,43.83916990920882,0.034491803278688525,Very Cheap
20140731T000000,1900000.0,4,2.5,3680,13351,2.0,0,2,5,9,3680,0,1946,1982,98004,47.6154,-122.214,3410,11700,9671,8290,142.3114373455172,0.23934426229508196,Cheap
20140820T000000,235000.0,3,1.0,2230,8163,1.0,0,0,3,7,1230,1000,1966,0,98118,47.5215,-122.275,2380,6874,5933,4494,28.788435624157785,0.02098360655737705,Very Cheap
20141125T000000,349950.0,1,1.0,1230,9300,1.5,0,0,4,6,1230,0,1918,0,98133,47.7055,-122.348,1190,6820,8070,5630,37.62903225806452,0.036059016393442625,Very Cheap
20140729T000000,300000.0,5,2.5,2093,10350,1.5,0,0,5,7,2093,0,1963,0,98058,47.4495,-122.17,1520,10350,8257,8830,28.985507246376812,0.029508196721311476,Very Cheap
20141103T000000,431000.0,3,1.75,1660,12865,1.0,0,0,5,7,1660,0,1967,0,98056,47.5375,-122.175,1610,12400,11205,10790,33.50174893120871,0.046688524590163934,Very Cheap
20150411T000000,280000.0,5,2.5,1630,20750,1.0,0,0,4,7,1100,530,1975,0,98042,47.3657,-122.113,1630,8640,19120,7010,13.493975903614459,0.026885245901639345,Very Cheap
20150326T000000,295000.0,4,2.5,1677,7209,2.0,0,0,3,7,1677,0,2011,0,98023,47.2957,-122.357,2236,7209,5532,4973,40.9210708836177,0.028852459016393443,Very Cheap
20150423T000000,445000.0,4,2.5,2990,6383,2.0,0,0,3,7,2990,0,2003,0,98038,47.3499,-122.027,2640,6454,3393,3814,69.7164342785524,0.04852459016393443,Very Cheap
20140826T000000,550000.0,5,1.0,2150,262231,1.5,0,0,3,7,2150,0,1900,2000,98065,47.5519,-121.803,1460,46609,260081,45149,2.097387417963551,0.06229508196721312,Very Cheap
20140826T000000,515000.0,4,2.5,2890,15067,2.0,0,0,3,9,2890,0,2003,0,98024,47.5666,-121.907,3090,15398,12177,12308,34.1806597199177,0.057704918032786885,Very Cheap
20140520T000000,555000.0,3,2.5,3050,158558,1.0,0,0,4,9,3050,0,1987,0,98055,47.4326,-122.208,2960,31050,155508,28090,3.5002964214987577,0.06295081967213115,Very Cheap
20140908T000000,265000.0,3,2.5,1410,2500,2.0,0,0,3,7,1410,0,2006,0,98146,47.5132,-122.358,1290,5190,1090,3900,106.0,0.024918032786885248,Very Cheap
20140924T000000,597000.0,4,2.5,2280,2432,2.0,0,0,5,8,1520,760,1921,0,98103,47.6605,-122.355,1690,2099,152,409,245.47697368421052,0.06845901639344262,Very Cheap
20140815T000000,661000.0,2,1.0,1260,5800,1.0,0,0,4,7,1260,0,1939,0,98199,47.6501,-122.409,1830,5800,4540,3970,113.96551724137932,0.07685245901639344,Very Cheap
20140715T000000,362764.0,3,2.0,1460,4350,2.0,0,0,3,7,1460,0,2008,0,98053,47.696,-122.026,1740,4622,2890,2882,83.39402298850575,0.03773954098360656,Very Cheap
20140821T000000,427000.0,4,2.5,1600,14000,1.0,0,0,3,8,1310,290,1950,0,98125,47.7258,-122.326,1600,10200,12400,8600,30.5,0.04616393442622951,Very Cheap
20141205T000000,405000.0,3,1.75,2020,8531,1.0,0,0,3,7,2020,0,1965,0,98011,47.7691,-122.199,1950,8449,6511,6499,47.47391864963076,0.043278688524590166,Very Cheap
20141224T000000,157000.0,3,1.5,1170,11530,1.0,0,0,3,7,1170,0,1960,0,98198,47.4211,-122.29,1550,8605,10360,7055,13.616652211621856,0.010754098360655738,Very Cheap
20150319T000000,246500.0,3,1.5,1170,11530,1.0,0,0,3,7,1170,0,1960,0,98198,47.4211,-122.29,1550,8605,10360,7055,21.379011274934953,0.022491803278688525,Very Cheap
20150108T000000,386500.0,2,1.5,1280,11071,1.0,0,0,3,7,850,430,1984,0,98074,47.6351,-122.033,1280,10879,9791,9599,34.91102881401861,0.04085245901639344,Very Cheap
20140606T000000,300000.0,4,2.5,2680,15508,2.0,0,0,3,8,2680,0,1999,0,98023,47.3025,-122.39,1960,15586,12828,13626,19.344854268764507,0.029508196721311476,Very Cheap
20141107T000000,240000.0,3,1.75,1770,8571,1.0,0,0,3,8,1270,500,1978,0,98023,47.3109,-122.339,2120,7711,6801,5591,28.0014000700035,0.021639344262295083,Very Cheap
20140909T000000,818500.0,5,3.5,4790,12957,2.0,0,1,3,9,3110,1680,2005,0,98006,47.5469,-122.194,2620,13538,8167,10918,63.170486995446474,0.09750819672131147,Very Cheap
20140809T000000,249000.0,3,1.75,1300,8500,1.0,0,0,4,7,1300,0,1964,0,98022,47.209,-122.005,1410,7800,7200,6390,29.294117647058822,0.02281967213114754,Very Cheap
20140929T000000,580000.0,4,2.25,2610,7700,1.0,0,0,3,8,1700,910,1977,0,98027,47.5659,-122.089,2260,8266,5090,6006,75.32467532467533,0.06622950819672131,Very Cheap
20150420T000000,2340000.0,4,2.5,4500,35200,1.0,0,0,3,13,4500,0,1988,0,98006,47.5477,-122.126,4760,35200,30700,30440,66.47727272727273,0.29704918032786887,Cheap
20140926T000000,333000.0,4,2.5,2100,7366,2.0,0,0,3,8,2100,0,1997,0,98042,47.3703,-122.107,2060,7324,5266,5264,45.20771110507738,0.033836065573770495,Very Cheap
20140823T000000,230000.0,2,2.0,1340,7605,1.0,0,0,3,7,1340,0,1992,0,98022,47.1936,-121.981,1670,7136,6265,5466,30.243261012491782,0.020327868852459016,Very Cheap
20150213T000000,360500.0,3,1.0,970,6180,1.0,0,3,3,6,970,0,1974,0,98118,47.5658,-122.291,1120,4500,5210,3380,58.333333333333336,0.037442622950819675,Very Cheap
20140722T000000,265000.0,3,1.75,2200,7200,1.0,0,0,3,8,1270,930,1962,0,98032,47.3745,-122.276,1800,8000,5000,6200,36.80555555555556,0.024918032786885248,Very Cheap
20141025T000000,490000.0,2,1.0,990,5000,1.0,0,0,3,7,990,0,1941,0,98116,47.5666,-122.403,2250,6032,4010,3782,98.0,0.05442622950819672,Very Cheap
20150506T000000,600000.0,2,1.75,1180,5000,1.0,0,0,2,7,880,300,1925,0,98107,47.6749,-122.398,1470,5000,3820,3530,120.0,0.06885245901639345,Very Cheap
20140915T000000,307500.0,3,1.0,980,6530,1.0,0,0,3,7,980,0,1969,0,98034,47.7133,-122.213,1220,6723,5550,5503,47.09035222052067,0.030491803278688525,Very Cheap
20141217T000000,670000.0,4,2.25,2370,9636,1.0,0,0,3,8,1660,710,1976,0,98033,47.6497,-122.194,2350,9588,7266,7238,69.53092569530925,0.0780327868852459,Very Cheap
20141021T000000,247200.0,3,1.5,1910,10583,1.5,0,0,4,7,1910,0,1922,1967,98002,47.2782,-122.212,1770,9068,8673,7298,23.358216006803364,0.02258360655737705,Very Cheap
20141216T000000,2600000.0,4,4.5,5270,12195,2.0,1,4,3,11,3400,1870,1979,0,98027,47.5696,-122.09,3390,9905,6925,6515,213.2021320213202,0.33114754098360655,Medium
20140820T000000,440000.0,3,1.75,1430,8400,1.0,0,0,4,7,1430,0,1961,0,98008,47.6073,-122.127,1570,7800,6970,6230,52.38095238095238,0.04786885245901639,Very Cheap
20150506T000000,700000.0,4,2.5,2490,7694,2.0,0,0,3,8,2490,0,1987,0,98029,47.567,-122.016,2140,8126,5204,5986,90.97998440343125,0.08196721311475409,Very Cheap
20150311T000000,756100.0,4,2.0,2000,8317,1.5,0,0,4,8,2000,0,1917,0,98126,47.5394,-122.379,1390,6001,6317,4611,90.9101839605627,0.08932459016393443,Very Cheap
20141020T000000,555000.0,4,2.75,2600,19275,1.0,0,0,3,8,1620,980,1978,0,98006,47.5523,-122.162,2230,10119,16675,7889,28.79377431906615,0.06295081967213115,Very Cheap
20150424T000000,830000.0,5,3.5,2880,3750,2.0,0,2,3,8,2270,610,2001,0,98144,47.5905,-122.292,2060,4000,870,1940,221.33333333333334,0.09901639344262295,Very Cheap
20141212T000000,180000.0,3,1.0,1010,8863,1.0,0,0,4,6,1010,0,1990,0,98022,47.1955,-121.999,1090,8410,7853,7320,20.309150400541576,0.01377049180327869,Very Cheap
20141006T000000,775000.0,5,3.5,3290,5600,2.0,0,0,3,9,2670,620,2004,0,98052,47.7056,-122.119,3130,5600,2310,2470,138.39285714285714,0.09180327868852459,Very Cheap
20140805T000000,220000.0,4,1.75,1530,18400,1.5,0,0,4,6,1530,0,1938,0,98002,47.329,-122.219,1620,13535,16870,11915,11.956521739130435,0.01901639344262295,Very Cheap
20140724T000000,650000.0,4,2.75,2020,15810,1.0,0,0,4,9,1620,400,1967,0,98005,47.5921,-122.155,2210,10160,13790,7950,41.11321948134092,0.07540983606557378,Very Cheap
20141224T000000,410000.0,3,1.75,1340,9975,1.0,0,0,4,7,1340,0,1961,0,98033,47.7012,-122.169,1340,10050,8635,8710,41.10275689223057,0.043934426229508196,Very Cheap
20141021T000000,339995.0,4,2.5,2180,5367,2.0,0,0,3,7,2180,0,2000,0,98038,47.3775,-122.022,2180,5130,3187,2950,63.34917085895286,0.03475344262295082,Very Cheap
20150219T000000,1160000.0,5,1.75,2870,9680,1.0,0,4,5,9,1440,1430,1966,0,98008,47.6122,-122.111,2940,9729,6810,6789,119.83471074380165,0.1422950819672131,Cheap
20140723T000000,440000.0,3,2.75,2070,9697,2.0,0,0,4,7,1330,740,1929,0,98188,47.4327,-122.283,2000,14436,7627,12436,45.37485820356812,0.04786885245901639,Very Cheap
20140730T000000,275000.0,2,1.75,930,7080,1.0,0,0,3,6,930,0,1923,2006,98106,47.5224,-122.36,1100,7680,6150,6580,38.84180790960452,0.02622950819672131,Very Cheap
20140829T000000,766000.0,3,2.5,2270,9822,2.0,0,0,3,9,2270,0,1988,0,98052,47.6685,-122.137,2790,8089,7552,5299,77.98818977804927,0.09062295081967213,Very Cheap
20140710T000000,231500.0,3,2.25,1630,7900,1.0,0,0,4,7,1130,500,1973,0,98023,47.3076,-122.377,1630,8200,6270,6570,29.303797468354432,0.020524590163934427,Very Cheap
20141229T000000,472000.0,3,2.0,2770,89298,2.0,0,0,3,9,2770,0,2004,0,98045,47.4291,-121.842,2040,109771,86528,107731,5.285672691437658,0.052065573770491806,Very Cheap
20140808T000000,1325000.0,4,2.5,4010,37076,2.0,0,0,4,12,4010,0,1990,0,98052,47.7139,-122.106,4280,35326,33066,31046,35.73740425072823,0.16393442622950818,Cheap
20150306T000000,265000.0,4,1.75,1970,8390,1.0,0,0,3,7,1140,830,1955,0,98178,47.4861,-122.251,1710,10890,6420,9180,31.58522050059595,0.024918032786885248,Very Cheap
20141113T000000,325000.0,2,1.0,790,6000,1.0,0,0,3,7,790,0,1948,0,98118,47.5543,-122.273,960,6000,5210,5040,54.166666666666664,0.03278688524590164,Very Cheap
20140729T000000,364500.0,3,1.75,1740,8424,1.0,0,0,5,7,1040,700,1954,0,98133,47.7508,-122.352,1370,8424,6684,7054,43.26923076923077,0.0379672131147541,Very Cheap
20150129T000000,322500.0,2,1.0,1130,8184,1.0,0,0,3,6,1130,0,1947,0,98155,47.7473,-122.32,1010,8184,7054,7174,39.40615835777126,0.032459016393442626,Very Cheap
20150416T000000,338900.0,3,1.75,1180,4000,1.0,0,0,3,7,1040,140,1929,0,98118,47.5226,-122.284,1430,4000,2820,2570,84.725,0.034609836065573774,Very Cheap
20140613T000000,910000.0,5,2.5,2350,4000,2.0,0,0,3,9,2350,0,1993,0,98112,47.6265,-122.296,1840,4000,1650,2160,227.5,0.10950819672131147,Cheap
20150424T000000,1015000.0,5,2.5,2350,4000,2.0,0,0,3,9,2350,0,1993,0,98112,47.6265,-122.296,1840,4000,1650,2160,253.75,0.12327868852459016,Cheap
20140613T000000,459950.0,3,1.75,1850,6869,1.0,0,2,5,6,1100,750,1919,1934,98166,47.4648,-122.363,1850,10096,5019,8246,66.96025622361334,0.050485245901639345,Very Cheap
20141014T000000,584950.0,4,3.0,3220,6224,1.5,0,0,3,9,3220,0,2009,0,98059,47.4813,-122.129,2950,6224,3004,3274,93.98296915167096,0.06687868852459017,Very Cheap
20141223T000000,252000.0,3,1.75,2050,11313,1.0,0,0,3,7,1520,530,1987,0,98023,47.2837,-122.358,1620,8065,9263,6445,22.275258552108195,0.02321311475409836,Very Cheap
20150429T000000,270000.0,3,2.5,1430,8470,1.0,0,0,3,7,1190,240,1992,0,98022,47.1943,-121.991,1670,8418,7040,6748,31.877213695395515,0.025573770491803278,Very Cheap
20141030T000000,750000.0,4,2.5,3210,8938,2.0,0,0,3,10,3210,0,2005,0,98075,47.582,-121.971,3740,8108,5728,4368,83.91138957261133,0.08852459016393442,Very Cheap
20141201T000000,775000.0,3,1.75,3520,12350,1.0,0,4,4,8,1530,1990,1960,0,98116,47.5837,-122.382,2140,7800,8830,5660,62.75303643724696,0.09180327868852459,Very Cheap
20150218T000000,325000.0,3,2.5,2260,8120,2.0,0,0,3,8,2260,0,2004,0,98023,47.2924,-122.357,2250,7784,5860,5534,40.02463054187192,0.03278688524590164,Very Cheap
20141026T000000,810000.0,5,3.25,3290,6422,2.0,0,0,3,9,3290,0,2012,0,98074,47.5933,-122.061,3210,6891,3132,3681,126.128931796948,0.09639344262295083,Very Cheap
20140715T000000,409000.0,2,2.25,1640,2128,2.0,0,0,4,8,1640,0,1974,0,98028,47.753,-122.252,1640,2128,488,488,192.19924812030075,0.04380327868852459,Very Cheap
20140616T000000,400000.0,4,1.75,1580,5340,1.0,0,0,3,7,1130,450,1947,0,98144,47.6003,-122.306,830,980,3760,150,74.90636704119851,0.04262295081967213,Very Cheap
20150512T000000,530000.0,4,2.25,1940,8270,2.0,0,0,5,7,1940,0,1962,0,98133,47.7567,-122.333,1800,7743,6330,5943,64.08706166868198,0.05967213114754098,Very Cheap
20150313T000000,580000.0,3,2.25,1580,8506,2.0,0,0,3,7,1580,0,1987,0,98033,47.686,-122.185,2253,8515,6926,6262,68.18716200329179,0.06622950819672131,Very Cheap
20140509T000000,491300.0,3,1.75,1750,11340,1.0,0,1,4,7,1300,450,1987,0,98074,47.6099,-122.058,2310,11340,9590,9030,43.32451499118166,0.05459672131147541,Very Cheap
20141231T000000,272000.0,4,2.75,1810,7350,1.0,0,0,4,7,1200,610,1980,0,98030,47.3703,-122.171,1750,7350,5540,5600,37.006802721088434,0.02583606557377049,Very Cheap
20150401T000000,599950.0,3,2.5,1970,106722,1.0,0,4,3,9,1970,0,1985,0,98022,47.2498,-122.003,2910,101494,104752,98584,5.621615037199453,0.06884590163934426,Very Cheap
20150226T000000,464000.0,3,2.5,1770,5146,2.0,0,0,3,8,1770,0,1992,0,98029,47.5704,-121.999,1870,5146,3376,3276,90.16712009327632,0.05101639344262295,Very Cheap
20140623T000000,471001.0,3,1.75,1800,6000,1.0,0,0,5,7,900,900,1905,0,98103,47.6867,-122.349,1800,3000,4200,1200,78.50016666666667,0.05193455737704918,Very Cheap
20141117T000000,230000.0,3,1.5,1500,11616,1.0,0,0,3,7,1100,400,1980,0,98031,47.4062,-122.174,1830,8288,10116,6458,19.800275482093664,0.020327868852459016,Very Cheap
20140714T000000,358000.0,3,1.0,940,6695,1.0,0,0,4,6,940,0,1959,0,98008,47.6195,-122.12,1230,7400,5755,6170,53.47274085138163,0.03711475409836065,Very Cheap
20140820T000000,510000.0,3,2.25,2340,6183,1.0,0,0,3,7,1210,1130,1929,0,98115,47.6979,-122.31,1970,6183,3843,4213,82.48423095584667,0.057049180327868855,Very Cheap
20140722T000000,86500.0,3,1.0,840,9480,1.0,0,0,3,6,840,0,1960,0,98023,47.3277,-122.341,840,9420,8640,8580,9.124472573839663,0.0015081967213114755,Very Cheap
20150403T000000,199950.0,3,1.0,840,9480,1.0,0,0,3,6,840,0,1960,0,98023,47.3277,-122.341,840,9420,8640,8580,21.091772151898734,0.01638688524590164,Very Cheap
20140616T000000,1712500.0,3,3.25,2940,5432,3.0,0,3,4,10,2440,500,1978,0,98109,47.6299,-122.354,4400,5500,2492,1100,315.2614138438881,0.21475409836065573,Cheap
20150313T000000,850000.0,3,2.75,3180,3680,2.0,0,0,4,9,2190,990,1918,0,98126,47.577,-122.38,2000,3680,500,1680,230.97826086956522,0.10163934426229508,Cheap
20140923T000000,542000.0,4,2.5,2020,3440,1.5,0,0,4,7,1480,540,1928,0,98117,47.6885,-122.376,1520,5080,1420,3560,157.5581395348837,0.06124590163934426,Very Cheap
20140701T000000,102500.0,2,1.0,820,4320,1.0,0,0,3,5,820,0,1937,0,98106,47.514,-122.359,780,7424,3500,6644,23.72685185185185,0.0036065573770491803,Very Cheap
20150401T000000,718000.0,3,1.75,4060,136290,1.0,0,0,3,8,2810,1250,1995,0,98045,47.4843,-121.719,1300,51836,132230,50536,5.268178149534082,0.08432786885245902,Very Cheap
20141222T000000,625000.0,4,2.25,2660,22194,1.0,0,0,4,8,2180,480,1977,0,98008,47.6142,-122.107,2660,18135,19534,15475,28.16076417049653,0.07213114754098361,Very Cheap
20140523T000000,350000.0,3,1.0,1010,11244,1.0,0,0,4,7,1010,0,1947,0,98155,47.7467,-122.321,1220,11242,10234,10022,31.12771255780861,0.036065573770491806,Very Cheap
20150209T000000,216000.0,2,1.0,710,5120,1.0,0,0,3,6,710,0,1918,0,98106,47.5224,-122.357,1150,1252,4410,102,42.1875,0.018491803278688525,Very Cheap
20140905T000000,340000.0,3,1.0,980,7228,1.5,0,0,3,7,980,0,1946,0,98133,47.7294,-122.353,1070,7228,6248,6158,47.03929164360819,0.03475409836065574,Very Cheap
20141114T000000,505000.0,3,1.0,1100,5400,1.5,0,0,3,7,1100,0,1908,0,98199,47.6604,-122.396,1770,4400,4300,2630,93.51851851851852,0.05639344262295082,Very Cheap
20150513T000000,372000.0,5,2.5,2840,6010,2.0,0,0,3,8,2840,0,2003,0,98001,47.3161,-122.27,2740,5509,3170,2769,61.89683860232945,0.03895081967213115,Very Cheap
20140904T000000,263850.0,4,2.25,2300,7524,2.0,0,0,4,8,2300,0,1978,0,98023,47.313,-122.388,2270,8025,5224,5755,35.067783094098885,0.0247672131147541,Very Cheap
20140903T000000,1350000.0,4,3.25,5370,20388,2.0,0,4,4,11,5370,0,1990,0,98198,47.405,-122.331,2770,22270,15018,19500,66.21542083578575,0.16721311475409836,Cheap
20141119T000000,325000.0,4,2.5,2280,9899,2.0,0,0,3,8,2280,0,1987,0,98058,47.461,-122.148,1970,9451,7619,7481,32.83159915142944,0.03278688524590164,Very Cheap
20141027T000000,289000.0,2,1.0,1010,7740,1.0,0,0,3,6,890,120,1924,0,98106,47.5323,-122.355,1030,6000,6730,4970,37.338501291989665,0.028065573770491802,Very Cheap
20150226T000000,364000.0,3,2.25,1420,6600,1.0,0,0,3,7,1160,260,1987,0,98028,47.77,-122.265,1920,7902,5180,5982,55.15151515151515,0.03790163934426229,Very Cheap
20140822T000000,610000.0,4,2.5,2100,8800,1.0,0,0,5,8,1250,850,1980,0,98033,47.6909,-122.186,2100,9000,6700,6900,69.31818181818181,0.07016393442622951,Very Cheap
20140625T000000,531500.0,4,2.75,3110,49765,1.0,0,0,4,8,3110,0,1958,1972,98010,47.3343,-122.044,1880,19709,46655,17829,10.680196925550085,0.059868852459016395,Very Cheap
20150430T000000,402500.0,3,2.25,2160,9540,2.0,0,0,3,8,2160,0,1979,0,98028,47.7668,-122.243,1720,12593,7380,10873,42.19077568134172,0.04295081967213115,Very Cheap
20140604T000000,375000.0,2,1.0,820,6250,1.0,0,0,4,5,820,0,1922,0,98136,47.5479,-122.384,1300,6250,5430,4950,60.0,0.03934426229508197,Very Cheap
20150126T000000,537500.0,5,2.5,4340,9108,1.0,0,0,5,8,2170,2170,1979,0,98118,47.5384,-122.276,2030,6812,4768,4782,59.01405357927097,0.060655737704918035,Very Cheap
20140731T000000,375000.0,3,1.75,2100,9066,1.0,0,0,3,8,1440,660,1962,0,98188,47.4294,-122.292,2000,9132,6966,7132,41.36333553937789,0.03934426229508197,Very Cheap
20140820T000000,293550.0,4,1.75,1250,8840,1.0,0,0,4,7,910,340,1979,0,98198,47.4138,-122.317,1410,8378,7590,6968,33.207013574660635,0.02866229508196721,Very Cheap
20150120T000000,585000.0,6,3.0,3870,43787,2.0,0,0,3,8,2700,1170,1976,0,98077,47.7642,-122.098,2600,35381,39917,32781,13.36012971886633,0.06688524590163934,Very Cheap
20140812T000000,225000.0,2,2.5,1360,2693,2.0,0,0,3,6,1360,0,2003,0,98038,47.3492,-122.025,1360,2693,1333,1333,83.54994430003714,0.019672131147540985,Very Cheap
20150108T000000,185000.0,4,1.0,1400,8684,1.5,0,0,3,7,1400,0,1957,0,98146,47.4887,-122.344,1520,8712,7284,7192,21.30354675264855,0.014426229508196721,Very Cheap
20140617T000000,402000.0,3,1.5,1450,7375,1.0,0,0,3,7,1010,440,1968,0,98034,47.7212,-122.179,1350,7440,5925,6090,54.50847457627118,0.04288524590163934,Very Cheap
20150409T000000,585000.0,5,1.75,1880,16617,1.0,0,0,3,7,960,920,1963,0,98007,47.6003,-122.132,1720,8400,14737,6680,35.20491063368839,0.06688524590163934,Very Cheap
20140617T000000,549000.0,2,2.5,1380,953,3.0,0,0,3,9,1380,0,2006,0,98103,47.6654,-122.355,1430,3400,-427,1970,576.0755508919202,0.06216393442622951,Very Cheap
20150414T000000,1810000.0,3,2.25,2910,15626,1.5,0,0,4,9,2510,400,1923,0,98199,47.6534,-122.412,2370,6519,12716,4149,115.83258671445027,0.2275409836065574,Cheap
20150406T000000,345000.0,3,1.75,1380,10529,1.0,0,0,3,7,1380,0,1967,0,98034,47.7119,-122.233,1670,5694,9149,4024,32.76664450565106,0.03540983606557377,Very Cheap
20141117T000000,302500.0,3,2.25,3100,11985,1.0,0,0,4,7,1790,1310,1963,0,98198,47.3825,-122.31,1770,7954,8885,6184,25.23988318731748,0.02983606557377049,Very Cheap
20141014T000000,218500.0,4,1.75,1400,25500,1.0,0,0,4,7,1400,0,1964,0,98042,47.36,-122.164,2170,25500,24100,23330,8.568627450980392,0.01881967213114754,Very Cheap
20141001T000000,705000.0,2,2.0,1650,6840,1.5,0,0,5,7,1650,0,1916,0,98103,47.6512,-122.338,1700,4560,5190,2860,103.0701754385965,0.08262295081967214,Very Cheap
20150428T000000,191000.0,3,1.0,840,5525,1.0,0,0,5,6,840,0,1969,0,98042,47.3607,-122.085,920,5330,4685,4410,34.57013574660633,0.01521311475409836,Very Cheap
20140610T000000,695000.0,3,2.5,2550,45254,2.0,0,0,3,9,2550,0,2001,0,98053,47.6498,-121.964,2190,49222,42704,47032,15.357758430194016,0.08131147540983606,Very Cheap
20150402T000000,350000.0,2,2.75,2820,11770,2.0,0,0,3,7,1630,1190,1947,0,98168,47.5102,-122.324,1690,12500,8950,10810,29.73661852166525,0.036065573770491806,Very Cheap
20140807T000000,480000.0,3,1.75,1710,4080,1.0,0,0,4,7,1130,580,1979,0,98136,47.5563,-122.392,1200,4080,2370,2880,117.6470588235294,0.05311475409836065,Very Cheap
20150302T000000,220000.0,3,1.0,820,5200,1.0,0,0,4,6,820,0,1977,0,98042,47.363,-122.094,1120,5200,4380,4080,42.30769230769231,0.01901639344262295,Very Cheap
20141029T000000,535000.0,4,2.25,2620,33578,2.0,0,0,3,7,2620,0,1977,0,98075,47.5921,-122.013,2520,35160,30958,32640,15.933051402704152,0.06032786885245902,Very Cheap
20140519T000000,1000000.0,2,1.75,2430,23400,1.0,0,4,3,10,2430,0,1951,0,98177,47.7616,-122.372,3150,23600,20970,20450,42.73504273504273,0.12131147540983607,Cheap
20141125T000000,592000.0,3,1.75,1560,7424,1.0,0,0,5,8,1560,0,1940,0,98117,47.6981,-122.374,1370,7424,5864,6054,79.74137931034483,0.06780327868852459,Very Cheap
20141124T000000,775000.0,4,2.5,3060,6826,2.0,0,0,3,9,3060,0,2004,0,98052,47.7006,-122.112,3110,6932,3766,3822,113.53647817169646,0.09180327868852459,Very Cheap
20140917T000000,320000.0,3,2.5,1680,4584,2.0,0,0,3,7,1680,0,2003,0,98056,47.4794,-122.182,2160,4621,2904,2461,69.80802792321117,0.032131147540983604,Very Cheap
20150317T000000,760000.0,3,3.25,3320,15022,2.0,0,0,3,10,3320,0,1989,0,98166,47.429,-122.341,3430,15018,11702,11588,50.59246438556784,0.0898360655737705,Very Cheap
20140722T000000,640000.0,3,2.5,2390,8315,2.0,0,0,4,9,2390,0,1990,0,98074,47.6271,-122.028,2370,7816,5925,5446,76.96933253156945,0.0740983606557377,Very Cheap
20150502T000000,253200.0,3,1.0,1360,5840,1.0,0,0,4,5,1360,0,1953,0,98056,47.4945,-122.166,1250,6708,4480,5458,43.35616438356164,0.023370491803278687,Very Cheap
20140716T000000,228000.0,2,1.0,1800,9236,1.0,0,0,3,7,1800,0,1954,0,98030,47.3792,-122.198,1730,5701,7436,3971,24.686011260285838,0.020065573770491802,Very Cheap
20141104T000000,325000.0,3,1.0,1160,9525,1.0,0,0,4,7,1160,0,1968,0,98077,47.7431,-122.073,1160,10640,8365,9480,34.120734908136484,0.03278688524590164,Very Cheap
20140605T000000,530000.0,4,3.25,4160,35654,2.0,0,0,3,8,2760,1400,1973,0,98027,47.4683,-122.008,2500,35675,31494,33175,14.865092275761485,0.05967213114754098,Very Cheap
20150211T000000,300000.0,4,2.25,1660,3200,2.0,0,0,3,7,1660,0,2011,0,98038,47.3666,-122.019,1960,3558,1540,1598,93.75,0.029508196721311476,Very Cheap
20140505T000000,418000.0,3,2.0,1410,6030,1.5,0,0,4,7,1410,0,1930,0,98103,47.6994,-122.347,1410,6300,4620,4890,69.32006633499171,0.04498360655737705,Very Cheap
20141217T000000,415000.0,4,1.75,2230,9625,1.0,0,4,3,8,1180,1050,1955,0,98178,47.508,-122.244,2300,8211,7395,5911,43.116883116883116,0.04459016393442623,Very Cheap
20140520T000000,384000.0,3,2.5,1700,4000,2.0,0,0,3,7,1700,0,2003,0,98065,47.5327,-121.871,1700,4417,2300,2717,96.0,0.04052459016393443,Very Cheap
20140613T000000,325000.0,3,2.5,2070,8337,2.0,0,0,3,8,2070,0,1997,0,98030,47.3658,-122.176,2030,7248,6267,5218,38.98284754707929,0.03278688524590164,Very Cheap
20141222T000000,600000.0,3,1.75,2300,12682,1.0,0,2,3,8,2300,0,1955,0,98028,47.7588,-122.27,2720,14643,10382,11923,47.31114966093676,0.06885245901639345,Very Cheap
20141010T000000,760000.0,4,2.25,3040,9690,1.0,0,0,4,9,1940,1100,1978,0,98005,47.5923,-122.169,2430,9690,6650,7260,78.43137254901961,0.0898360655737705,Very Cheap
20140530T000000,168000.0,2,1.5,1220,3568,1.5,0,0,4,8,1220,0,1976,0,98198,47.3804,-122.318,1180,3678,2348,2498,47.08520179372197,0.01219672131147541,Very Cheap
20141020T000000,405000.0,3,1.0,960,3960,1.0,0,0,3,7,960,0,1943,0,98199,47.6465,-122.404,1550,6050,3000,4500,102.27272727272727,0.043278688524590166,Very Cheap
20150504T000000,479000.0,3,1.0,1480,10094,1.0,0,0,4,7,1480,0,1956,0,98007,47.5942,-122.136,1430,10083,8614,8653,47.45393302952249,0.05298360655737705,Very Cheap
20140826T000000,549000.0,3,2.0,1560,5130,1.0,0,0,5,7,1150,410,1915,0,98103,47.6913,-122.333,1560,4500,3570,2940,107.01754385964912,0.06216393442622951,Very Cheap
20141209T000000,215000.0,3,1.5,1100,33600,1.0,0,0,3,7,1100,0,1967,0,98001,47.3185,-122.29,1570,32700,32500,31130,6.398809523809524,0.018360655737704918,Very Cheap
20150129T000000,550000.0,2,1.5,900,5750,1.0,0,2,3,7,900,0,1940,0,98116,47.5623,-122.384,1300,1413,4850,113,95.65217391304348,0.06229508196721312,Very Cheap
20140702T000000,389000.0,4,1.75,2400,7700,1.5,0,0,4,7,1500,900,1927,0,98133,47.7125,-122.332,1530,7700,5300,6170,50.51948051948052,0.04118032786885246,Very Cheap
20140722T000000,447500.0,3,2.5,2320,15024,2.0,0,0,3,8,2320,0,1990,0,98045,47.4829,-121.766,2300,15145,12704,12845,29.785676251331203,0.04885245901639344,Very Cheap
20141013T000000,540000.0,5,3.0,2570,5590,1.0,0,0,3,8,1580,990,2009,0,98034,47.7271,-122.228,2020,10500,3020,8480,96.6010733452594,0.06098360655737705,Very Cheap
20150428T000000,273500.0,4,2.75,1300,9638,1.0,0,0,2,7,1300,0,1983,0,98042,47.3683,-122.109,1670,9638,8338,7968,28.377256692259806,0.026032786885245903,Very Cheap
20141017T000000,257000.0,5,2.75,2930,10148,2.0,0,0,3,9,2930,0,2002,0,98059,47.4887,-122.145,2930,8425,7218,5495,25.32518722901064,0.023868852459016394,Very Cheap
20140524T000000,199000.0,2,1.0,720,7200,1.0,0,0,5,6,720,0,1943,0,98058,47.4763,-122.177,970,8027,6480,7057,27.63888888888889,0.016262295081967214,Very Cheap
20150304T000000,339100.0,4,2.5,2350,10655,2.0,0,0,3,8,2350,0,1992,0,98092,47.3284,-122.171,2210,7028,8305,4818,31.825434068512436,0.03463606557377049,Very Cheap
20141223T000000,435000.0,4,2.5,2940,7590,2.0,0,0,3,9,2940,0,1991,0,98058,47.4341,-122.16,2550,8360,4650,5810,57.312252964426875,0.04721311475409836,Very Cheap
20140711T000000,400000.0,3,2.5,2020,3000,1.0,0,0,4,6,1010,1010,1910,0,98118,47.5621,-122.291,1670,3000,980,1330,133.33333333333334,0.04262295081967213,Very Cheap
20141124T000000,356000.0,2,1.0,1430,365904,1.0,0,0,3,7,1010,420,1991,0,98065,47.513,-121.857,2300,253519,364474,251219,0.9729327911146093,0.03685245901639344,Very Cheap
20150406T000000,395000.0,3,1.0,950,6951,1.0,0,0,4,7,950,0,1950,0,98125,47.7263,-122.3,1410,7200,6001,5790,56.82635592001151,0.0419672131147541,Very Cheap
20150304T000000,575000.0,2,1.0,1250,4320,1.0,0,0,4,7,850,400,1911,0,98103,47.6549,-122.352,1520,4320,3070,2800,133.10185185185185,0.06557377049180328,Very Cheap
20150423T000000,515000.0,3,1.75,1300,5120,1.5,0,0,4,6,1300,0,1925,0,98116,47.5589,-122.394,1090,5124,3820,4034,100.5859375,0.057704918032786885,Very Cheap
20140619T000000,618250.0,4,3.25,2520,3360,1.5,0,0,4,8,1550,970,1931,0,98115,47.6801,-122.315,1730,3360,840,1630,184.0029761904762,0.07124590163934426,Very Cheap
20150219T000000,245000.0,3,1.5,1330,7125,2.0,0,0,3,7,1330,0,1968,0,98034,47.7308,-122.194,1570,7350,5795,5780,34.3859649122807,0.022295081967213116,Very Cheap
20141010T000000,690000.0,3,2.75,2480,3240,1.5,0,0,3,9,1890,590,1929,0,98112,47.6399,-122.311,2160,3240,760,1080,212.96296296296296,0.08065573770491803,Very Cheap
20141106T000000,465000.0,5,2.25,3020,10010,1.0,0,0,3,7,1510,1510,1959,0,98027,47.5249,-122.044,1760,10878,6990,9118,46.45354645354645,0.051147540983606556,Very Cheap
20141120T000000,280000.0,3,1.75,1770,8240,1.0,0,0,4,7,1240,530,1978,0,98023,47.3066,-122.378,2060,8250,6470,6190,33.980582524271846,0.026885245901639345,Very Cheap
20150316T000000,285000.0,3,1.75,1930,6533,1.0,0,0,3,7,1230,700,1960,0,98055,47.4883,-122.221,2030,5954,4603,3924,43.624674728302466,0.02754098360655738,Very Cheap
20150316T000000,320000.0,3,2.25,1650,7047,2.0,0,0,3,7,1650,0,1994,0,98038,47.3826,-122.027,2010,7763,5397,5753,45.4093940683979,0.032131147540983604,Very Cheap
20150213T000000,355000.0,4,3.0,2580,9601,2.0,0,0,4,7,2130,450,1992,0,98070,47.3726,-122.433,1900,10092,7021,8192,36.975315071346735,0.036721311475409836,Very Cheap
20150427T000000,670000.0,3,2.0,2570,10078,1.5,0,0,3,8,2570,0,1965,0,98008,47.6275,-122.12,2660,8013,7508,5353,66.48144473109744,0.0780327868852459,Very Cheap
20140924T000000,550000.0,1,1.0,2880,7560,1.0,0,0,3,7,1440,1440,1925,2014,98126,47.537,-122.375,1400,5040,4680,3640,72.75132275132275,0.06229508196721312,Very Cheap
20141015T000000,765000.0,4,2.75,2660,4500,1.5,0,0,5,8,1860,800,1909,0,98103,47.6864,-122.347,1830,4000,1840,2170,170.0,0.09049180327868853,Very Cheap
20141030T000000,430000.0,3,1.0,1560,5225,1.5,0,0,3,7,1260,300,1927,0,98118,47.5554,-122.279,1560,5322,3665,3762,82.29665071770334,0.04655737704918033,Very Cheap
20140827T000000,950000.0,3,2.5,3080,8448,2.0,0,2,3,9,3080,0,2000,0,98199,47.6469,-122.389,2500,6400,5368,3900,112.45265151515152,0.11475409836065574,Cheap
20141015T000000,525000.0,4,1.75,2540,7200,1.0,0,0,4,7,1270,1270,1947,0,98118,47.5579,-122.271,1650,7200,4660,5550,72.91666666666667,0.05901639344262295,Very Cheap
20141020T000000,300000.0,6,2.5,3080,8163,1.0,0,0,3,7,1580,1500,1985,0,98030,47.3859,-122.221,1850,8658,5083,6808,36.751194413818446,0.029508196721311476,Very Cheap
20150417T000000,345000.0,3,2.75,2190,7258,2.0,0,0,3,8,2190,0,2000,0,98003,47.3486,-122.301,2190,8645,5068,6455,47.5337558556076,0.03540983606557377,Very Cheap
20150420T000000,838000.0,3,3.75,2930,150945,2.0,0,0,3,8,2930,0,1972,2000,98058,47.4658,-122.115,2070,43935,148015,41865,5.5516910132829835,0.1000655737704918,Cheap
20141211T000000,1795000.0,5,2.75,2880,20274,1.0,0,3,4,9,1660,1220,1959,0,98004,47.6267,-122.222,3750,20220,17394,16470,88.53704251751012,0.22557377049180327,Cheap
20150327T000000,390000.0,3,1.75,2160,98445,2.0,0,0,3,8,2160,0,1978,0,98042,47.35,-122.162,2004,44431,96285,42427,3.961602925491391,0.04131147540983607,Very Cheap
20140625T000000,1150000.0,3,2.0,2110,18815,2.0,0,0,5,7,2110,0,1979,0,98075,47.5836,-122.042,2690,21010,16705,18320,61.12144565506245,0.14098360655737704,Cheap
20140723T000000,295000.0,4,2.25,1830,5720,2.0,0,0,3,7,1830,0,2003,0,98030,47.3604,-122.179,1960,5754,3890,3794,51.57342657342657,0.028852459016393443,Very Cheap
20141017T000000,775000.0,4,4.0,3180,7650,2.0,0,0,3,8,2530,650,1920,0,98115,47.6887,-122.319,2000,4080,4470,2080,101.30718954248366,0.09180327868852459,Very Cheap
20150318T000000,380000.0,3,2.5,1880,6047,2.0,0,0,3,8,1880,0,1993,0,98038,47.3722,-122.044,2120,7188,4167,5068,62.84107822060526,0.04,Very Cheap
20150427T000000,550000.0,3,1.0,1140,8180,1.0,0,0,3,7,1140,0,1959,0,98005,47.5851,-122.172,1510,8588,7040,7078,67.23716381418093,0.06229508196721312,Very Cheap
20140717T000000,199900.0,5,1.75,1798,11232,1.0,0,0,3,7,1798,0,1967,0,98001,47.3266,-122.291,1300,15582,9434,14282,17.797364672364672,0.01638032786885246,Very Cheap
20140916T000000,329900.0,3,1.75,1670,5209,1.5,0,0,5,7,1670,0,1908,0,98118,47.5362,-122.271,1990,4960,3539,2970,63.33269341524285,0.03342950819672131,Very Cheap
20140901T000000,898000.0,3,2.25,2580,11060,1.0,0,0,3,8,2580,0,1964,0,98005,47.6113,-122.164,2580,13868,8480,11288,81.19349005424955,0.10793442622950819,Cheap
20140603T000000,875000.0,4,2.25,3720,12384,1.0,0,2,5,8,1860,1860,1970,0,98075,47.5836,-122.074,3180,15541,8664,12361,70.65568475452196,0.10491803278688525,Cheap
20140516T000000,375000.0,4,2.5,2790,7956,2.0,0,0,3,9,2790,0,2005,0,98198,47.3681,-122.31,1660,8192,5166,6532,47.1342383107089,0.03934426229508197,Very Cheap
20140808T000000,365000.0,3,2.5,2190,5091,2.0,0,0,3,8,2190,0,2004,0,98038,47.3506,-122.039,2200,5948,2901,3748,71.6951483009232,0.0380327868852459,Very Cheap
20140508T000000,530000.0,4,2.75,2280,2850,1.5,0,0,4,7,1540,740,1930,0,98115,47.6871,-122.307,1680,3800,570,2120,185.96491228070175,0.05967213114754098,Very Cheap
20150318T000000,225500.0,3,1.0,1100,5200,1.0,0,0,4,6,1100,0,1969,0,98042,47.3643,-122.081,920,5200,4100,4280,43.36538461538461,0.019737704918032787,Very Cheap
20141117T000000,318000.0,4,2.25,2180,7000,1.0,0,0,3,8,1680,500,1969,0,98055,47.4651,-122.192,2000,8000,4820,6000,45.42857142857143,0.03186885245901639,Very Cheap
20150401T000000,910000.0,4,2.5,2770,9798,2.0,0,0,4,9,2770,0,1986,0,98027,47.562,-122.081,3040,11100,7028,8060,92.87609716268626,0.10950819672131147,Cheap
20141008T000000,207000.0,3,1.0,1980,18730,1.0,0,0,4,7,1280,700,1943,0,98001,47.3221,-122.282,1356,9450,16750,8094,11.051788574479446,0.017311475409836064,Very Cheap
20140530T000000,1886700.0,5,3.5,4180,17935,2.0,0,0,3,11,4180,0,2004,0,98004,47.5873,-122.202,2950,13760,13755,10810,105.19654307220519,0.2376,Cheap
20140905T000000,624500.0,6,3.0,3030,31920,1.0,0,0,4,8,1670,1360,1980,0,98075,47.575,-122.033,2890,35100,28890,32210,19.56453634085213,0.0720655737704918,Very Cheap
20140604T000000,640000.0,3,2.5,1690,1553,2.5,0,0,3,8,1690,0,2007,0,98199,47.6443,-122.385,1910,1553,-137,-357,412.105602060528,0.0740983606557377,Very Cheap
20150410T000000,500000.0,3,2.0,1990,65340,2.0,0,0,3,8,1990,0,1986,0,98027,47.4726,-121.99,2120,59241,63350,57121,7.6522803795531065,0.05573770491803279,Very Cheap
20150304T000000,390000.0,5,1.75,2250,8970,1.0,0,0,4,7,1500,750,1966,0,98034,47.7217,-122.188,1940,8710,6720,6770,43.47826086956522,0.04131147540983607,Very Cheap
20140729T000000,284000.0,3,2.25,2080,2050,1.5,0,0,3,7,1550,530,2003,0,98042,47.4199,-122.157,2080,2275,-30,195,138.53658536585365,0.027409836065573772,Very Cheap
20140626T000000,620000.0,3,2.0,2460,41343,1.0,0,0,4,8,2460,0,1988,0,98027,47.5142,-122.021,2500,53885,38883,51385,14.996492755726484,0.07147540983606557,Very Cheap
20150317T000000,306000.0,3,2.5,2588,5702,2.0,0,0,3,8,2588,0,2008,0,98042,47.3453,-122.151,2403,5703,3114,3300,53.66538056822168,0.030295081967213113,Very Cheap
20140919T000000,495000.0,4,1.75,2570,12039,1.0,0,0,3,8,1910,660,1978,0,98074,47.626,-122.048,2200,12384,9469,10184,41.11637179167705,0.05508196721311476,Very Cheap
20140605T000000,499950.0,3,2.5,2370,12753,2.0,0,0,3,7,2370,0,2001,0,98019,47.7359,-121.984,2280,16808,10383,14528,39.20254057868737,0.05573114754098361,Very Cheap
20141110T000000,330000.0,3,1.0,1070,10563,1.0,0,0,3,7,1070,0,1969,0,98072,47.7687,-122.166,1840,9638,9493,7798,31.241124680488497,0.03344262295081967,Very Cheap
20140513T000000,665000.0,3,2.0,1940,5820,1.5,0,0,5,7,1150,790,1944,0,98107,47.6638,-122.362,990,3880,3880,2890,114.26116838487972,0.07737704918032787,Very Cheap
20140630T000000,850000.0,3,2.5,2650,2387,2.0,0,0,3,8,1830,820,1920,0,98119,47.6315,-122.362,1870,2216,-263,346,356.09551738583997,0.10163934426229508,Cheap
20140911T000000,599950.0,4,2.5,2290,6318,2.0,0,0,4,8,2290,0,1988,0,98029,47.57,-122.02,2150,7350,4028,5200,94.95884773662551,0.06884590163934426,Very Cheap
20141022T000000,360000.0,4,2.5,2050,9143,2.0,0,0,3,8,2050,0,1992,0,98166,47.4597,-122.355,1510,9484,7093,7974,39.374384775237885,0.037377049180327866,Very Cheap
20140827T000000,699000.0,3,2.5,2680,5497,2.0,0,0,3,9,2680,0,2001,0,98052,47.7043,-122.128,2780,5497,2817,2717,127.16026923776606,0.08183606557377049,Very Cheap
20150313T000000,475000.0,3,1.75,1520,8100,1.0,0,0,5,6,760,760,1945,0,98117,47.6966,-122.375,1040,8100,6580,7060,58.641975308641975,0.05245901639344262,Very Cheap
20141203T000000,575000.0,3,2.0,2690,435600,2.0,0,0,3,8,2690,0,1992,0,98070,47.3477,-122.519,1700,163350,432910,161650,1.320018365472911,0.06557377049180328,Very Cheap
20140527T000000,345000.0,2,1.5,1180,844,2.0,0,0,3,7,990,190,2005,0,98144,47.5998,-122.3,1170,1400,-336,230,408.76777251184836,0.03540983606557377,Very Cheap
20150430T000000,367950.0,4,2.5,3030,9500,2.0,0,0,3,8,3030,0,1989,0,98001,47.3511,-122.287,2650,9500,6470,6850,38.73157894736842,0.03841967213114754,Very Cheap
20140625T000000,374500.0,3,2.25,1400,11400,2.0,0,0,3,8,1400,0,1984,0,98028,47.7428,-122.231,2180,9248,10000,7068,32.85087719298246,0.03927868852459016,Very Cheap
20140804T000000,607500.0,4,2.5,3000,8100,2.0,0,0,3,8,3000,0,1992,0,98125,47.7151,-122.305,1550,8100,5100,6550,75.0,0.06983606557377049,Very Cheap
20140530T000000,374000.0,3,1.0,1200,9800,1.0,0,0,4,7,1200,0,1971,0,98072,47.7412,-122.109,1220,10220,8600,9000,38.16326530612245,0.03921311475409836,Very Cheap
20140903T000000,390000.0,3,1.0,1000,6947,1.0,0,0,3,7,1000,0,1947,0,98125,47.7142,-122.319,1000,6947,5947,5947,56.13934072261408,0.04131147540983607,Very Cheap
20150407T000000,705000.0,4,3.25,2740,5339,2.5,0,0,3,9,2740,0,2004,0,98103,47.6706,-122.356,1770,4820,2599,3050,132.04719985015922,0.08262295081967214,Very Cheap
20141029T000000,467000.0,3,2.5,1990,4978,2.0,0,0,3,8,1990,0,2004,0,98065,47.5323,-121.856,2650,6816,2988,4166,93.81277621534753,0.05140983606557377,Very Cheap
20140814T000000,243500.0,3,3.0,2110,7794,1.0,0,0,3,6,2110,0,1981,0,98198,47.4005,-122.293,1330,10044,5684,8714,31.241981011034127,0.022098360655737705,Very Cheap
20140707T000000,593000.0,3,2.75,1830,1850,2.0,0,0,3,10,1690,140,2011,0,98027,47.5307,-122.074,2310,2680,20,370,320.5405405405405,0.0679344262295082,Very Cheap
20141114T000000,223000.0,3,1.0,940,7980,1.0,0,0,3,6,940,0,1961,0,98146,47.5107,-122.345,1050,7980,7040,6930,27.94486215538847,0.019409836065573772,Very Cheap
20150420T000000,574000.0,4,2.5,2980,10179,2.0,0,2,3,9,2980,0,2003,0,98038,47.3895,-122.033,2980,8828,7199,5848,56.390608114746044,0.06544262295081968,Very Cheap
20140604T000000,400000.0,3,2.0,2260,11305,1.0,0,0,3,7,1130,1130,1986,0,98055,47.4544,-122.204,2080,10248,9045,8168,35.38257408226448,0.04262295081967213,Very Cheap
20141103T000000,772000.0,4,2.75,3470,70131,1.0,0,0,4,8,1750,1720,1962,0,98005,47.6339,-122.18,2950,43560,66661,40610,11.007970797507522,0.09140983606557378,Very Cheap
20150501T000000,593777.0,3,1.75,1510,10450,1.0,0,0,4,7,1510,0,1964,0,98052,47.684,-122.113,1310,9450,8940,8140,56.82076555023924,0.06803632786885246,Very Cheap
20141223T000000,539500.0,4,3.5,2710,5722,2.0,0,0,4,8,2040,670,1997,0,98108,47.5591,-122.302,2500,5722,3012,3222,94.28521495980426,0.06091803278688525,Very Cheap
20150401T000000,550000.0,3,2.5,2080,2625,2.0,0,0,3,8,2080,0,2006,0,98029,47.5469,-121.997,1760,2772,545,1012,209.52380952380952,0.06229508196721312,Very Cheap
20140630T000000,265000.0,2,2.0,1860,10856,1.0,0,0,3,8,1260,600,1952,0,98178,47.4989,-122.265,1250,10008,8996,8758,24.410464259395727,0.024918032786885248,Very Cheap
20141002T000000,428000.0,3,1.75,2120,9350,1.0,0,0,3,7,1280,840,1979,0,98072,47.7562,-122.145,2200,9000,7230,6800,45.775401069518715,0.04629508196721312,Very Cheap
20150428T000000,505000.0,3,2.0,1110,8375,1.0,0,0,5,7,1110,0,1951,0,98115,47.6978,-122.297,1410,7734,7265,6324,60.298507462686565,0.05639344262295082,Very Cheap
20140701T000000,925000.0,5,5.5,5190,12637,2.0,0,2,3,11,5190,0,2001,0,98065,47.5424,-121.872,3840,12637,7447,8797,73.19775263116246,0.11147540983606558,Cheap
20150102T000000,230000.0,3,1.75,1520,15344,1.0,0,0,3,8,1520,0,1968,0,98023,47.3308,-122.365,2270,14981,13824,12711,14.989572471324296,0.020327868852459016,Very Cheap
20140820T000000,695000.0,4,2.5,2650,9990,2.0,0,0,3,10,2650,0,1990,0,98029,47.5605,-122.016,2710,8012,7340,5302,69.56956956956957,0.08131147540983606,Very Cheap
20150414T000000,700000.0,4,2.75,3350,7857,2.0,0,2,3,9,3350,0,2004,0,98065,47.5398,-121.859,3870,7886,4507,4016,89.09252895507191,0.08196721311475409,Very Cheap
20150425T000000,712500.0,3,1.75,1770,2800,1.5,0,0,3,7,1770,0,1914,0,98103,47.6631,-122.357,1630,3254,1030,1624,254.46428571428572,0.08360655737704918,Very Cheap
20150403T000000,480000.0,3,2.5,2200,4692,2.0,0,0,3,8,2200,0,2005,0,98011,47.7761,-122.169,2440,3833,2492,1393,102.30179028132993,0.05311475409836065,Very Cheap
20140922T000000,470000.0,3,2.5,2000,8424,1.0,0,0,4,7,1300,700,1968,0,98034,47.7089,-122.201,2110,8400,6424,6290,55.792972459639124,0.05180327868852459,Very Cheap
20140724T000000,335000.0,3,1.75,1730,15003,1.0,0,0,3,7,1150,580,1980,0,98014,47.6923,-121.92,1900,15483,13273,13583,22.32886755982137,0.03409836065573771,Very Cheap
20150417T000000,270000.0,3,1.5,1300,7907,1.0,0,0,3,7,900,400,1970,0,98030,47.3737,-122.224,1630,7600,6607,5970,34.14695839129885,0.025573770491803278,Very Cheap
20150324T000000,810000.0,5,3.25,2950,67475,1.0,0,0,3,8,2530,420,1981,2004,98072,47.7233,-122.117,2620,39820,64525,37200,12.00444609114487,0.09639344262295083,Very Cheap
20140812T000000,589000.0,3,3.0,1720,954,3.0,0,0,3,8,1460,260,2006,0,98119,47.648,-122.358,1720,1294,-766,-426,617.4004192872118,0.06740983606557377,Very Cheap
20140926T000000,415000.0,2,1.0,880,4558,1.0,0,0,3,7,880,0,1951,0,98115,47.6803,-122.287,1370,5243,3678,3873,91.04870557261957,0.04459016393442623,Very Cheap
20150311T000000,197000.0,4,2.25,1790,13200,1.0,0,0,3,7,1220,570,1979,0,98058,47.4672,-122.185,1740,8950,11410,7210,14.924242424242424,0.016,Very Cheap
20140825T000000,235500.0,3,1.5,1380,7600,1.0,0,0,4,7,790,590,1971,0,98003,47.3489,-122.306,1570,7904,6220,6334,30.986842105263158,0.02104918032786885,Very Cheap
20150407T000000,460000.0,3,2.25,1530,1840,2.0,0,0,3,8,1240,290,2008,0,98144,47.587,-122.301,1800,3431,310,1631,250.0,0.050491803278688525,Very Cheap
20141029T000000,572500.0,5,1.75,2330,4947,1.0,0,0,4,8,1380,950,1955,0,98136,47.5352,-122.392,2120,5605,2617,3485,115.72670305235496,0.06524590163934427,Very Cheap
20140924T000000,302000.0,5,2.0,1540,9629,1.0,0,0,4,7,1540,0,1960,0,98059,47.4915,-122.143,2260,9600,8089,7340,31.36358915775262,0.02977049180327869,Very Cheap
20140813T000000,870000.0,3,2.5,3210,8630,2.0,0,0,4,10,2530,680,1990,0,98033,47.6939,-122.189,2630,8630,5420,6000,100.81112398609501,0.10426229508196722,Cheap
20141007T000000,485000.0,3,1.0,1130,5758,1.0,0,0,3,7,960,170,1939,0,98199,47.6413,-122.401,1510,6000,4628,4490,84.23063563737409,0.05377049180327869,Very Cheap
20150205T000000,240000.0,3,2.0,1460,7526,1.0,0,0,3,7,1460,0,1968,0,98003,47.3463,-122.304,1580,7526,6066,5946,31.889449906989103,0.021639344262295083,Very Cheap
20141022T000000,383000.0,3,1.75,1410,7215,1.0,0,0,3,7,1410,0,1967,0,98034,47.7343,-122.193,1550,7600,5805,6050,53.083853083853086,0.04039344262295082,Very Cheap
20140626T000000,750000.0,4,2.75,1750,5080,1.5,0,0,3,8,1750,0,1903,0,98122,47.6143,-122.305,1700,4572,3330,2872,147.63779527559055,0.08852459016393442,Very Cheap
20140603T000000,409950.0,2,1.75,1370,5125,1.0,0,0,5,6,1370,0,1944,0,98103,47.6926,-122.346,1200,5100,3755,3900,79.99024390243902,0.043927868852459015,Very Cheap
20140521T000000,246000.0,3,1.5,1780,23819,1.0,0,0,3,7,1780,0,1953,0,98168,47.4912,-122.312,1130,14450,22039,13320,10.327889499979008,0.02242622950819672,Very Cheap
20150403T000000,860000.0,4,1.75,1890,4500,2.0,0,0,5,7,1490,400,1937,0,98115,47.6751,-122.289,1890,5000,2610,3110,191.11111111111111,0.10295081967213114,Cheap
20140507T000000,339950.0,3,2.25,1630,12295,2.0,0,0,4,7,1630,0,1985,0,98058,47.4279,-122.161,1730,9948,10665,8218,27.649450996339976,0.03474754098360656,Very Cheap
20140509T000000,315000.0,5,1.75,2320,8100,1.0,0,0,4,7,1160,1160,1956,0,98166,47.4631,-122.341,1410,7271,5780,5861,38.888888888888886,0.031475409836065574,Very Cheap
20140813T000000,698000.0,3,2.5,2580,4636,2.0,0,0,3,9,2580,0,2006,0,98074,47.6201,-122.025,2480,4500,2056,2020,150.56082830025883,0.08170491803278689,Very Cheap
20140822T000000,419000.0,2,2.5,1470,2034,2.0,0,0,4,8,1470,0,1985,0,98007,47.6213,-122.153,1510,2055,564,545,205.99803343166175,0.04511475409836065,Very Cheap
20150122T000000,372000.0,3,1.0,2298,10140,1.0,0,0,3,7,2298,0,1969,0,98052,47.6909,-122.083,2580,24724,7842,22144,36.68639053254438,0.03895081967213115,Very Cheap
20140911T000000,425000.0,3,2.5,1960,4709,2.0,0,0,3,7,1960,0,2003,0,98065,47.5322,-121.871,1700,4444,2749,2744,90.25270758122744,0.04590163934426229,Very Cheap
20140724T000000,386500.0,3,2.25,2950,8036,1.5,0,0,3,8,1950,1000,1963,0,98125,47.7239,-122.313,2060,7200,5086,5140,48.096067695370834,0.04085245901639344,Very Cheap
20141117T000000,348000.0,2,1.0,670,7312,1.0,0,0,3,5,670,0,1942,0,98125,47.7145,-122.285,860,8242,6642,7382,47.59299781181619,0.03580327868852459,Very Cheap
20150424T000000,754000.0,5,3.5,3020,15305,2.0,0,0,3,10,2230,790,1978,0,98040,47.5627,-122.216,3680,14486,12285,10806,49.26494609604704,0.08904918032786885,Very Cheap
20141215T000000,269950.0,4,3.0,2390,7309,2.0,0,0,4,7,2390,0,1944,1981,98002,47.294,-122.218,930,7308,4919,6378,36.933917088521,0.025567213114754097,Very Cheap
20141211T000000,891500.0,3,2.5,3090,20785,2.0,0,0,4,10,3090,0,1991,0,98075,47.5602,-122.03,3400,7566,17695,4166,42.89150829925427,0.10708196721311475,Cheap
20141009T000000,349950.0,4,1.75,1780,5000,1.0,0,0,5,7,890,890,1903,0,98108,47.5329,-122.292,1860,5000,3220,3140,69.99,0.036059016393442625,Very Cheap
20140509T000000,360000.0,2,1.0,1420,81892,1.0,0,0,3,7,1180,240,1956,0,98055,47.4342,-122.195,1490,1863,80472,373,4.396033800615445,0.037377049180327866,Very Cheap
20141209T000000,975000.0,4,2.25,2420,15482,2.0,0,0,4,8,2420,0,1925,1997,98004,47.5907,-122.196,2870,13905,13062,11035,62.97635964345692,0.1180327868852459,Cheap
20140505T000000,449250.0,4,2.0,1480,3844,1.5,0,0,5,7,1480,0,1928,0,98133,47.7042,-122.352,1480,3844,2364,2364,116.87044745057231,0.04908196721311475,Very Cheap
20141201T000000,350000.0,4,2.25,2190,3850,2.0,0,0,3,7,2190,0,2006,0,98059,47.4854,-122.16,1900,3850,1660,1950,90.9090909090909,0.036065573770491806,Very Cheap
20150401T000000,790000.0,4,1.75,1820,6137,1.5,0,3,4,7,1690,130,1911,0,98107,47.6681,-122.36,2130,5100,4317,2970,128.72739123350172,0.09377049180327869,Very Cheap
20140909T000000,990000.0,3,1.75,1810,24586,1.0,0,4,4,9,930,880,1983,0,98040,47.5314,-122.222,3540,14200,22776,10660,40.26681851460181,0.12,Cheap
20141201T000000,834000.0,3,2.25,2550,4089,2.0,0,0,3,9,2550,0,1983,0,98112,47.6272,-122.297,1680,4089,1539,2409,203.96184886280264,0.09954098360655737,Very Cheap
20140814T000000,466950.0,3,1.0,1360,3880,1.0,0,0,3,7,1060,300,1963,0,98117,47.6837,-122.391,1110,3880,2520,2770,120.3479381443299,0.05140327868852459,Very Cheap
20140717T000000,262500.0,3,1.75,2259,26831,1.5,0,3,5,7,1491,768,1908,0,98001,47.2741,-122.266,1980,15794,24572,13814,9.783459431254892,0.02459016393442623,Very Cheap
20140506T000000,762300.0,4,2.5,3880,14550,2.0,0,0,3,10,3880,0,1987,0,98074,47.6378,-122.04,3240,14045,10670,10805,52.391752577319586,0.09013770491803279,Very Cheap
20150126T000000,733000.0,6,2.75,2730,5000,1.0,0,0,3,8,1780,950,1962,0,98107,47.6751,-122.38,2090,5000,2270,2910,146.6,0.08629508196721311,Very Cheap
20150414T000000,439000.0,4,2.5,2800,17279,1.0,0,2,3,7,1560,1240,1957,0,98028,47.7596,-122.269,3060,13423,14479,10363,25.406562879796283,0.04773770491803279,Very Cheap
20141112T000000,1160000.0,5,3.25,4290,7019,2.5,0,0,4,10,3590,700,1927,0,98112,47.6439,-122.302,1920,4000,2729,2080,165.26570736572162,0.1422950819672131,Cheap
20141008T000000,420000.0,3,2.5,1770,3993,2.0,0,0,3,8,1770,0,1999,0,98074,47.6027,-122.02,1820,4046,2223,2226,105.18407212622088,0.04524590163934426,Very Cheap
20140718T000000,549000.0,3,2.25,1920,10961,2.0,0,0,3,8,1920,0,1981,0,98074,47.6432,-122.057,2000,10706,9041,8706,50.086670924185746,0.06216393442622951,Very Cheap
20140826T000000,518000.0,4,2.5,2320,4000,1.5,0,0,5,8,1510,810,1905,0,98122,47.6048,-122.298,1490,4500,1680,3010,129.5,0.0580983606557377,Very Cheap
20140603T000000,695000.0,4,2.5,2961,12146,2.0,0,0,3,9,2961,0,1998,0,98075,47.5839,-122.052,2620,17749,9185,15129,57.22048410999506,0.08131147540983606,Very Cheap
20150105T000000,485000.0,3,2.5,1680,7385,2.0,0,0,3,8,1680,0,1988,0,98074,47.6194,-122.041,1970,7470,5705,5500,65.67366283006093,0.05377049180327869,Very Cheap
20140603T000000,280000.0,3,1.75,1590,27200,1.5,0,0,4,6,1590,0,1926,0,98038,47.4238,-122.052,1820,74052,25610,72232,10.294117647058824,0.026885245901639345,Very Cheap
20150507T000000,306500.0,2,1.0,1420,16400,1.5,0,0,4,6,1420,0,1943,0,98023,47.3221,-122.344,1900,16400,14980,14500,18.6890243902439,0.03036065573770492,Very Cheap
20150321T000000,720000.0,2,1.0,1370,9460,1.0,0,0,3,6,1370,0,1950,0,98004,47.6238,-122.191,1690,9930,8090,8240,76.10993657505286,0.08459016393442623,Very Cheap
20141118T000000,277500.0,3,2.5,2620,4558,2.0,0,3,3,7,2620,0,2010,0,98022,47.1944,-121.974,1670,4558,1938,2888,60.881965774462486,0.026557377049180327,Very Cheap
20140905T000000,649000.0,3,2.0,1810,17006,2.0,1,4,3,8,1810,0,1913,1987,98166,47.4663,-122.369,2180,24911,15196,22731,38.16300129366106,0.07527868852459016,Very Cheap
20150303T000000,3395000.0,4,3.5,4730,47870,1.0,1,4,3,10,2940,1790,1954,0,98033,47.6967,-122.216,3250,49346,43140,46096,70.92124503864633,0.43540983606557376,High
20140514T000000,267800.0,2,1.0,700,6000,1.0,0,0,4,6,700,0,1949,0,98155,47.7515,-122.316,920,6000,5300,5080,44.63333333333333,0.025285245901639344,Very Cheap
20150325T000000,625000.0,4,2.75,2390,6979,2.0,0,0,3,8,2390,0,1993,0,98029,47.5703,-121.996,2090,6321,4589,4231,89.55437741796818,0.07213114754098361,Very Cheap
20140917T000000,600000.0,4,2.5,2070,8127,1.5,0,0,3,9,1590,480,1924,2003,98125,47.7316,-122.289,2050,8131,6057,6081,73.82798080472499,0.06885245901639345,Very Cheap
20141017T000000,395000.0,4,2.0,1780,8149,1.5,0,0,4,7,1780,0,1948,0,98155,47.745,-122.302,1180,8149,6369,6969,48.472205178549515,0.0419672131147541,Very Cheap
20150427T000000,212000.0,4,2.5,1900,21780,1.5,0,0,3,7,1900,0,1940,1987,98198,47.3776,-122.314,1240,9166,19880,7926,9.733700642791552,0.017967213114754098,Very Cheap
20141212T000000,425000.0,2,1.0,1040,4040,1.0,0,0,3,7,940,100,1928,0,98117,47.6829,-122.393,1420,4040,3000,2620,105.1980198019802,0.04590163934426229,Very Cheap
20150511T000000,870000.0,4,1.75,2370,5000,1.5,0,2,3,8,1770,600,1919,0,98103,47.6779,-122.357,2100,4550,2630,2450,174.0,0.10426229508196722,Cheap
20150325T000000,420000.0,3,2.5,1970,3667,2.0,0,0,3,7,1970,0,2004,0,98065,47.5321,-121.851,1970,3739,1697,1769,114.53504226888465,0.04524590163934426,Very Cheap
20150403T000000,800000.0,4,2.25,2120,9921,2.0,0,0,3,8,2120,0,1981,0,98027,47.5593,-122.082,1890,7845,7801,5955,80.63703255720189,0.09508196721311475,Very Cheap
20150506T000000,575000.0,3,2.5,1960,9535,2.0,0,0,3,8,1960,0,1989,0,98011,47.7371,-122.215,2520,9206,7575,6686,60.30414263240692,0.06557377049180328,Very Cheap
20140620T000000,915000.0,3,3.25,2660,4000,2.0,0,0,3,9,2170,490,2003,0,98122,47.6186,-122.288,2660,4000,1340,1340,228.75,0.11016393442622952,Cheap
20140903T000000,400000.0,3,2.25,1180,14258,2.0,0,0,3,7,1180,0,1987,0,98034,47.7112,-122.238,1860,10390,13078,8530,28.054425585636135,0.04262295081967213,Very Cheap
20140502T000000,750000.0,3,2.5,2390,6550,1.0,0,2,4,8,1440,950,1955,0,98116,47.5714,-122.408,2010,6550,4160,4540,114.50381679389314,0.08852459016393442,Very Cheap
20141103T000000,235000.0,3,1.0,1250,7592,1.0,0,0,5,7,1250,0,1961,0,98042,47.3604,-122.111,1250,7592,6342,6342,30.9536354056902,0.02098360655737705,Very Cheap
20141112T000000,599950.0,5,3.0,2600,13674,1.0,0,0,5,8,1300,1300,1967,0,98125,47.7176,-122.302,2150,7800,11074,5650,43.87523767734386,0.06884590163934426,Very Cheap
20150327T000000,481203.0,2,1.0,940,3800,1.0,0,0,3,7,940,0,1929,0,98115,47.6798,-122.292,1680,3800,2860,2120,126.63236842105263,0.05327252459016393,Very Cheap
20140619T000000,1815000.0,5,3.0,3880,13000,2.0,0,0,3,10,3880,0,1972,2003,98040,47.5467,-122.234,3470,13701,9120,10231,139.6153846153846,0.22819672131147542,Cheap
20140709T000000,379000.0,3,2.5,1530,2913,2.0,0,0,4,7,1530,0,1986,0,98033,47.6939,-122.184,1370,3783,1383,2413,130.1064194987985,0.03986885245901639,Very Cheap
20140626T000000,626000.0,3,1.75,2430,5000,2.0,0,0,4,7,1760,670,1945,0,98117,47.6785,-122.372,1320,4062,2570,2742,125.2,0.07226229508196721,Very Cheap
20140521T000000,535000.0,2,1.0,1030,4841,1.0,0,0,3,7,920,110,1939,0,98103,47.686,-122.341,1530,4944,3811,3414,110.51435653790539,0.06032786885245902,Very Cheap
20140609T000000,1225000.0,4,2.5,2740,16007,2.0,0,0,3,9,2740,0,1984,0,98039,47.6353,-122.229,2760,16008,13267,13248,76.52901855438246,0.15081967213114755,Cheap
20140724T000000,410000.0,2,1.5,1180,1034,2.0,0,0,3,7,1120,60,2001,0,98115,47.678,-122.322,1137,1034,-146,-103,396.5183752417795,0.043934426229508196,Very Cheap
20150210T000000,940000.0,4,2.5,3090,9238,1.0,0,3,4,8,1680,1410,1967,0,98006,47.5654,-122.163,2690,8500,6148,5810,101.7536263260446,0.11344262295081967,Cheap
20140721T000000,326250.0,3,1.0,1060,9663,1.0,0,0,3,7,1060,0,1967,0,98034,47.7244,-122.226,1320,10162,8603,8842,33.76280658180689,0.03295081967213115,Very Cheap
20140905T000000,200000.0,2,1.0,790,5985,1.0,0,0,3,6,790,0,1944,0,98178,47.4941,-122.24,1030,5985,5195,4955,33.41687552213868,0.01639344262295082,Very Cheap
20140813T000000,880000.0,4,2.5,3070,8250,1.0,0,0,5,8,2100,970,1958,0,98005,47.5935,-122.172,2270,8800,5180,6530,106.66666666666667,0.10557377049180328,Cheap
20141103T000000,370000.0,2,2.0,2100,58488,2.0,0,0,3,9,2100,0,2005,0,98014,47.72,-121.402,1440,59346,56388,57906,6.326083983039256,0.038688524590163934,Very Cheap
20140801T000000,190000.0,2,2.5,1100,1737,2.0,0,0,3,8,1100,0,2006,0,98055,47.4499,-122.189,1610,2563,637,953,109.3839953943581,0.015081967213114755,Very Cheap
20150129T000000,160000.0,2,1.0,1070,4200,1.0,0,0,4,6,1070,0,1983,0,98002,47.3336,-122.215,1150,4200,3130,3050,38.095238095238095,0.011147540983606558,Very Cheap
20140823T000000,625000.0,4,3.0,2190,12825,1.0,0,0,3,9,1520,670,1989,0,98034,47.7107,-122.229,3050,4673,10635,1623,48.732943469785575,0.07213114754098361,Very Cheap
20150507T000000,590000.0,4,3.5,3450,6873,2.0,0,0,3,10,2750,700,2004,0,98058,47.459,-122.118,3450,6873,3423,3423,85.843154372181,0.06754098360655737,Very Cheap
20140805T000000,575000.0,3,2.5,2070,3599,2.0,0,0,3,8,2070,0,1999,0,98033,47.6679,-122.165,2070,6844,1529,4774,159.76660183384274,0.06557377049180328,Very Cheap
20141013T000000,470000.0,2,1.0,1190,5200,1.0,0,0,5,7,1190,0,1912,0,98103,47.6939,-122.348,1550,5100,4010,3550,90.38461538461539,0.05180327868852459,Very Cheap
20150311T000000,130000.0,2,1.0,600,1500,1.0,0,0,4,4,600,0,1900,0,98027,47.5289,-122.033,1130,6000,900,4870,86.66666666666667,0.007213114754098361,Very Cheap
20150421T000000,229000.0,3,1.0,940,8400,1.0,0,0,3,7,940,0,1958,0,98056,47.5108,-122.165,1190,8400,7460,7210,27.261904761904763,0.02019672131147541,Very Cheap
20140822T000000,279900.0,3,1.0,1280,12928,1.5,0,0,3,6,1280,0,1942,0,98023,47.3215,-122.399,1610,19467,11648,17857,21.650680693069308,0.026872131147540983,Very Cheap
20140519T000000,307000.0,3,1.0,1370,7500,1.0,0,0,3,7,1370,0,1960,0,98014,47.6499,-121.915,1160,7500,6130,6340,40.93333333333333,0.03042622950819672,Very Cheap
20141023T000000,399950.0,3,1.75,2450,15001,1.0,0,0,3,7,1980,470,1989,0,98014,47.6957,-121.913,1790,15323,12551,13533,26.661555896273583,0.04261639344262295,Very Cheap
20140801T000000,405000.0,4,2.25,1970,15743,1.0,0,0,3,7,1370,600,1962,0,98011,47.7673,-122.202,2390,11336,13773,8946,25.725719367337863,0.043278688524590166,Very Cheap
20141007T000000,539950.0,4,2.75,2910,9000,1.0,0,0,4,8,2130,780,1966,0,98006,47.544,-122.176,1970,9000,6090,7030,59.99444444444445,0.06097704918032787,Very Cheap
20141107T000000,129000.0,2,1.0,760,5240,1.0,0,0,3,6,760,0,1949,0,98032,47.388,-122.234,980,5080,4480,4100,24.61832061068702,0.007081967213114754,Very Cheap
20140917T000000,340000.0,3,1.75,1270,8422,1.0,0,0,3,7,1270,0,1967,0,98011,47.7601,-122.197,1470,8500,7152,7030,40.37045832343861,0.03475409836065574,Very Cheap
20140611T000000,214950.0,3,1.75,1570,4875,1.0,0,0,4,7,1310,260,1977,0,98042,47.3621,-122.094,1380,5200,3305,3820,44.09230769230769,0.018354098360655737,Very Cheap
20140625T000000,450000.0,4,2.75,2310,5650,1.0,0,2,3,8,1330,980,1952,2012,98118,47.513,-122.252,2300,5650,3340,3350,79.64601769911505,0.04918032786885246,Very Cheap
20150304T000000,515000.0,3,1.75,1900,5000,1.0,0,0,4,7,950,950,1925,0,98106,47.5677,-122.363,1420,5000,3100,3580,103.0,0.057704918032786885,Very Cheap
20140822T000000,1400000.0,4,2.25,3780,5160,2.0,0,0,4,9,2510,1270,1907,0,98112,47.6275,-122.308,2740,5160,1380,2420,271.3178294573643,0.1737704918032787,Cheap
20140626T000000,230000.0,3,1.0,1060,9946,1.0,0,0,4,7,1060,0,1956,0,98188,47.4432,-122.282,1310,10619,8886,9309,23.12487432133521,0.020327868852459016,Very Cheap
20140707T000000,681000.0,3,1.75,1880,10032,1.0,0,0,4,8,1880,0,1984,0,98006,47.5527,-122.16,2430,9732,8152,7302,67.88277511961722,0.07947540983606557,Very Cheap
20140929T000000,255000.0,3,1.0,1160,8636,1.0,0,0,3,6,1160,0,1923,0,98146,47.5097,-122.357,1300,8636,7476,7336,29.52755905511811,0.02360655737704918,Very Cheap
20150313T000000,580000.0,2,1.0,860,4013,1.0,0,0,3,7,860,0,1925,0,98103,47.6652,-122.338,1490,4013,3153,2523,144.5302766010466,0.06622950819672131,Very Cheap
20150317T000000,295000.0,2,2.0,1590,8000,1.0,0,0,3,7,910,680,1984,0,98055,47.459,-122.205,1590,8364,6410,6774,36.875,0.028852459016393443,Very Cheap
20140730T000000,286000.0,2,1.0,1170,6543,1.0,0,0,3,7,1170,0,1913,0,98136,47.537,-122.385,1550,7225,5373,5675,43.71083600794743,0.027672131147540982,Very Cheap
20150108T000000,425000.0,3,1.5,1190,8100,1.0,0,0,3,7,830,360,1947,0,98125,47.7146,-122.311,1256,8100,6910,6844,52.46913580246913,0.04590163934426229,Very Cheap
20141212T000000,170000.0,2,1.0,1300,11400,1.0,0,0,3,7,1300,0,1961,0,98003,47.3459,-122.299,1360,9750,10100,8390,14.912280701754385,0.012459016393442624,Very Cheap
20140528T000000,380000.0,3,2.0,1660,8281,1.0,0,0,3,7,1660,0,1949,0,98136,47.5568,-122.382,1660,7559,6621,5899,45.888177756309624,0.04,Very Cheap
20150506T000000,506000.0,3,2.0,1160,6120,1.0,0,0,3,7,1160,0,1947,0,98115,47.6853,-122.293,1150,5100,4960,3950,82.6797385620915,0.05652459016393443,Very Cheap
20140922T000000,315000.0,3,2.5,1950,9618,2.0,0,0,3,7,1950,0,1992,0,98031,47.4068,-122.18,1890,7133,7668,5243,32.751091703056765,0.031475409836065574,Very Cheap
20140617T000000,449950.0,4,2.5,2470,3811,2.0,0,0,3,8,2470,0,1999,0,98065,47.5362,-121.877,2400,4266,1341,1866,118.06612437680398,0.04917377049180328,Very Cheap
20150331T000000,255000.0,3,1.0,1430,12420,1.0,0,0,3,7,1430,0,1964,0,98056,47.5116,-122.191,1900,10350,10990,8450,20.531400966183575,0.02360655737704918,Very Cheap
20140624T000000,289000.0,3,2.5,1970,9607,2.0,0,0,3,7,1090,880,1988,0,98001,47.3462,-122.286,2020,9608,7637,7588,30.082231706047672,0.028065573770491802,Very Cheap
20140828T000000,389000.0,3,1.75,1400,10018,1.0,0,0,4,7,1400,0,1962,0,98027,47.5327,-122.032,1350,9300,8618,7950,38.83010580954282,0.04118032786885246,Very Cheap
20140721T000000,327000.0,3,1.5,1510,344124,1.0,0,2,4,7,1510,0,1964,0,98022,47.2156,-122.029,1750,169884,342614,168134,0.9502388673850124,0.033049180327868855,Very Cheap
20140926T000000,2885000.0,7,3.0,5350,14400,2.5,0,0,4,10,5020,330,1910,0,98112,47.6295,-122.285,3050,7469,9050,4419,200.34722222222223,0.3685245901639344,Medium
20140714T000000,210000.0,3,1.0,920,6612,1.0,0,0,3,6,920,0,1948,0,98118,47.548,-122.284,1860,8424,5692,6564,31.76043557168784,0.017704918032786884,Very Cheap
20141125T000000,1680000.0,4,3.75,7620,29536,2.0,0,3,3,11,5980,1640,2005,0,98006,47.5571,-122.14,2840,20809,21916,17969,56.87973997833153,0.21049180327868852,Cheap
20141229T000000,360000.0,4,2.5,2490,4751,2.0,0,0,3,7,2490,0,2001,0,98056,47.4813,-122.188,2510,5233,2261,2723,75.77352136392338,0.037377049180327866,Very Cheap
20150427T000000,875000.0,4,2.5,3030,16000,2.0,0,0,3,11,3030,0,1990,0,98077,47.7125,-122.081,3670,16641,12970,12971,54.6875,0.10491803278688525,Cheap
20141104T000000,550000.0,4,2.25,1650,7200,1.0,0,0,3,8,1650,0,1967,0,98008,47.6384,-122.116,2180,7950,5550,5770,76.38888888888889,0.06229508196721312,Very Cheap
20140717T000000,257500.0,3,1.5,1210,12500,1.0,0,0,3,7,1210,0,1962,0,98146,47.503,-122.351,1210,12500,11290,11290,20.6,0.023934426229508195,Very Cheap
20141210T000000,1075000.0,4,2.75,2990,7389,1.5,0,0,4,8,2090,900,1923,0,98144,47.5711,-122.284,2510,6157,4399,3647,145.48653403708215,0.13114754098360656,Cheap
20141028T000000,202950.0,2,1.0,1060,5144,1.0,0,0,5,6,1060,0,1969,0,98042,47.3613,-122.088,1130,5200,4084,4070,39.45373250388803,0.01678032786885246,Very Cheap
20141030T000000,622000.0,4,1.75,2680,6120,1.0,0,0,5,8,1340,1340,1959,0,98117,47.6965,-122.393,2320,6840,3440,4520,101.63398692810458,0.07173770491803279,Very Cheap
20150213T000000,455000.0,4,1.75,1790,45738,1.0,0,0,3,8,1410,380,1976,0,98072,47.7453,-122.129,1870,47480,43948,45610,9.94796449341904,0.049836065573770495,Very Cheap
20141117T000000,805000.0,3,2.5,2690,17461,2.0,0,3,3,10,2690,0,1997,0,98074,47.654,-122.088,3610,16887,14771,13277,46.102743256399975,0.09573770491803278,Very Cheap
20140908T000000,257000.0,2,1.0,770,9497,1.0,0,0,3,6,770,0,1950,0,98133,47.7407,-122.351,1550,7532,8727,5982,27.061177213857007,0.023868852459016394,Very Cheap
20140625T000000,744500.0,5,2.5,2700,16570,1.0,0,0,4,8,1750,950,1967,0,98005,47.6144,-122.167,2570,11840,13870,9270,44.93059746529873,0.0878032786885246,Very Cheap
20150413T000000,885000.0,4,2.5,2620,9157,2.0,0,0,3,8,2620,0,1996,0,98033,47.6916,-122.203,2240,7405,6537,5165,96.64737359397182,0.1062295081967213,Cheap
20140624T000000,355000.0,2,2.25,930,747,2.0,0,0,3,8,630,300,2007,0,98144,47.5844,-122.316,940,6000,-183,5060,475.2342704149933,0.036721311475409836,Very Cheap
20140820T000000,240000.0,3,1.0,1340,7000,1.0,0,0,4,7,1340,0,1978,0,98042,47.3742,-122.149,1850,7904,5660,6054,34.285714285714285,0.021639344262295083,Very Cheap
20140819T000000,169000.0,3,1.5,1470,18459,2.0,0,0,4,6,1470,0,1916,0,98023,47.3302,-122.36,1750,16074,16989,14324,9.155425537678097,0.012327868852459017,Very Cheap
20150328T000000,639900.0,3,2.5,2330,4160,2.0,0,0,4,8,2330,0,1992,0,98052,47.6367,-122.109,2940,4500,1830,1560,153.8221153846154,0.07408524590163934,Very Cheap
20140604T000000,292000.0,3,1.75,1730,11325,1.0,0,0,5,7,1730,0,1972,0,98031,47.3921,-122.182,2030,17859,9595,15829,25.783664459161148,0.028459016393442622,Very Cheap
20140922T000000,563500.0,4,2.5,2780,7838,2.0,0,3,3,9,2780,0,2004,0,98065,47.5312,-121.861,3160,7848,5058,4688,71.89334013779025,0.06406557377049181,Very Cheap
20150126T000000,389000.0,2,2.0,1200,7131,1.0,0,0,3,8,1200,0,2006,0,98053,47.7199,-122.022,1670,4601,5931,2931,54.55055391950638,0.04118032786885246,Very Cheap
20140529T000000,2750000.0,4,3.25,4430,21000,2.0,0,0,3,10,4430,0,1952,2007,98039,47.6398,-122.237,3930,20000,16570,16070,130.95238095238096,0.35081967213114756,Medium
20140821T000000,661000.0,3,2.0,1820,4418,2.0,0,0,4,8,1820,0,1994,0,98033,47.6947,-122.19,1920,13402,2598,11482,149.61521050248982,0.07685245901639344,Very Cheap
20140912T000000,344000.0,2,2.0,1300,4659,1.0,0,0,3,8,1300,0,2005,0,98053,47.7132,-122.033,1640,4780,3359,3140,73.8355870358446,0.035278688524590165,Very Cheap
20150422T000000,510000.0,1,1.0,680,6600,1.0,0,0,3,5,480,200,1916,0,98199,47.6567,-122.392,1170,5500,5920,4330,77.27272727272727,0.057049180327868855,Very Cheap
20140916T000000,289000.0,2,1.0,780,4132,1.0,0,0,3,7,780,0,1942,0,98136,47.5324,-122.387,1100,5100,3352,4000,69.94191674733786,0.028065573770491802,Very Cheap
20140827T000000,365000.0,3,2.25,2430,7614,1.5,0,0,3,8,1900,530,1979,0,98056,47.5065,-122.191,1720,11250,5184,9530,47.93800893091673,0.0380327868852459,Very Cheap
20140730T000000,410000.0,3,1.5,1750,32500,1.0,0,0,4,7,1750,0,1966,0,98027,47.5316,-121.959,1820,102801,30750,100981,12.615384615384615,0.043934426229508196,Very Cheap
20140724T000000,535610.0,3,1.0,1610,5100,1.5,0,0,5,7,1010,600,1901,0,98117,47.6765,-122.386,1270,5100,3490,3830,105.02156862745097,0.06040786885245902,Very Cheap
20141113T000000,397950.0,4,1.75,2120,7620,2.0,0,0,3,8,2120,0,1971,2002,98166,47.457,-122.346,1820,7620,5500,5800,52.224409448818896,0.04235409836065574,Very Cheap
20140827T000000,284000.0,3,1.75,1430,4850,1.0,0,0,3,7,930,500,1978,0,98108,47.5472,-122.303,1430,4850,3420,3420,58.55670103092783,0.027409836065573772,Very Cheap
20141217T000000,201000.0,4,1.5,1360,8100,1.5,0,0,3,7,1360,0,1962,0,98168,47.4931,-122.305,1300,8100,6740,6800,24.814814814814813,0.016524590163934427,Very Cheap
20141215T000000,734000.0,4,2.25,2530,5000,1.5,0,0,4,7,1690,840,1925,0,98117,47.6806,-122.36,1530,5000,2470,3470,146.8,0.08642622950819673,Very Cheap
20150108T000000,357500.0,5,3.0,3270,9146,2.0,0,0,3,7,3270,0,2002,0,98092,47.3342,-122.169,3200,6300,5876,3100,39.088125956702385,0.03704918032786885,Very Cheap
20141015T000000,550120.0,5,2.5,2620,8050,1.0,0,0,3,8,1520,1100,1975,0,98052,47.6919,-122.115,2030,7676,5430,5646,68.33788819875777,0.062310819672131146,Very Cheap
20150310T000000,300000.0,3,1.5,1810,8232,1.0,0,0,3,8,1810,0,1988,0,98001,47.3195,-122.273,2260,8491,6422,6231,36.44314868804665,0.029508196721311476,Very Cheap
20140819T000000,374950.0,3,2.5,2120,9653,2.0,0,0,3,8,2120,0,1992,0,98030,47.3843,-122.213,1780,9801,7533,8021,38.8428467833834,0.03933770491803279,Very Cheap
20150413T000000,602500.0,4,1.75,2190,41000,2.0,0,0,3,8,2190,0,1980,0,98075,47.5755,-122.033,2590,35370,38810,32780,14.695121951219512,0.06918032786885246,Very Cheap
20141222T000000,221000.0,3,1.0,980,7606,1.0,0,0,3,7,980,0,1954,0,98188,47.4356,-122.29,980,8125,6626,7145,29.056008414409675,0.01914754098360656,Very Cheap
20150410T000000,920000.0,5,3.0,2230,4400,2.0,0,0,3,7,1730,500,1913,0,98102,47.6404,-122.325,1280,1800,2170,520,209.0909090909091,0.11081967213114755,Cheap
20150306T000000,235000.0,4,2.0,1540,9279,1.0,0,0,3,7,1540,0,1955,0,98118,47.5163,-122.268,1540,5110,7739,3570,25.326004957430758,0.02098360655737705,Very Cheap
20140804T000000,375000.0,3,1.0,980,7296,1.0,0,0,3,7,980,0,1967,0,98034,47.7292,-122.231,1280,7296,6316,6016,51.39802631578947,0.03934426229508197,Very Cheap
20140827T000000,599000.0,4,2.5,2120,3640,2.0,0,0,3,8,2120,0,2005,0,98029,47.5521,-121.996,2190,3640,1520,1450,164.56043956043956,0.06872131147540983,Very Cheap
20140603T000000,562100.0,3,2.25,2090,12112,2.0,0,0,3,8,2090,0,1983,0,98052,47.7015,-122.13,1760,12112,10022,10352,46.408520475561424,0.06388196721311476,Very Cheap
20150316T000000,640000.0,3,2.5,1620,1377,2.0,0,0,3,8,1100,520,2009,0,98112,47.6195,-122.299,1620,1251,-243,-369,464.77850399419026,0.0740983606557377,Very Cheap
20141120T000000,294000.0,3,2.0,1650,11256,1.0,0,0,4,7,1250,400,1957,0,98168,47.4707,-122.26,1860,11256,9606,9396,26.119402985074625,0.028721311475409836,Very Cheap
20141229T000000,714000.0,4,2.5,3230,7766,2.0,0,0,3,9,3230,0,2005,0,98052,47.7069,-122.131,3740,8344,4536,4604,91.93922225083698,0.0838032786885246,Very Cheap
20140521T000000,970000.0,4,3.25,2790,5420,1.0,0,3,3,9,1130,1660,1963,2013,98177,47.7698,-122.386,2530,7200,2630,4670,178.96678966789668,0.11737704918032787,Cheap
20150428T000000,280000.0,4,2.25,1600,7916,2.0,0,0,3,7,1600,0,1991,0,98022,47.194,-121.981,1540,7242,6316,5702,35.371399696816574,0.026885245901639345,Very Cheap
20141112T000000,260000.0,4,2.5,1790,4358,2.0,0,0,3,7,1790,0,1993,0,98031,47.3994,-122.204,1790,4305,2568,2515,59.66039467645709,0.024262295081967214,Very Cheap
20141119T000000,294000.0,3,1.5,2060,15050,1.5,0,0,4,7,2060,0,1938,0,98023,47.3321,-122.373,1900,15674,12990,13774,19.53488372093023,0.028721311475409836,Very Cheap
20140728T000000,255500.0,4,1.0,1370,41194,1.5,0,2,5,5,1370,0,1900,0,98092,47.2716,-122.144,1590,84070,39824,82480,6.202359566927222,0.023672131147540982,Very Cheap
20140904T000000,3300000.0,5,4.75,6200,13873,2.0,1,4,4,11,4440,1760,1989,0,98008,47.605,-122.112,2940,13525,7673,10585,237.8721257118143,0.42295081967213116,High
20140508T000000,450000.0,3,2.0,1510,43560,1.0,0,0,3,7,1510,0,1954,0,98077,47.7218,-122.079,2060,67756,42050,65696,10.330578512396695,0.04918032786885246,Very Cheap
20140512T000000,368000.0,3,1.0,1280,9898,1.0,0,0,3,7,1280,0,1968,0,98072,47.7677,-122.163,1290,9625,8618,8335,37.17922812689432,0.03842622950819672,Very Cheap
20141110T000000,830000.0,4,2.25,2180,11056,1.0,0,0,3,8,1370,810,1963,0,98004,47.6042,-122.193,2090,8747,8876,6657,75.07235890014472,0.09901639344262295,Very Cheap
20140715T000000,282500.0,2,1.75,1440,11210,1.0,0,0,4,6,1130,310,1935,0,98146,47.498,-122.35,1250,9381,9770,8131,25.2007136485281,0.02721311475409836,Very Cheap
20140502T000000,335000.0,3,2.25,1580,16215,1.0,0,0,4,7,1580,0,1978,0,98024,47.5643,-121.897,1450,16215,14635,14765,20.659882824545175,0.03409836065573771,Very Cheap
20140707T000000,558000.0,2,2.0,1580,5750,1.0,0,0,5,6,790,790,1910,0,98116,47.5668,-122.384,1580,5750,4170,4170,97.04347826086956,0.06334426229508197,Very Cheap
20150224T000000,270000.0,4,1.5,1730,8505,1.5,0,0,4,7,1730,0,1961,0,98146,47.4905,-122.347,1510,8505,6775,6995,31.746031746031747,0.025573770491803278,Very Cheap
20140725T000000,152000.0,2,1.0,700,13500,1.0,0,0,3,4,700,0,1920,0,98031,47.3882,-122.208,1600,10124,12800,8524,11.25925925925926,0.010098360655737704,Very Cheap
20140617T000000,493000.0,4,1.75,2030,18295,1.5,0,0,4,7,2030,0,1975,0,98034,47.7326,-122.179,1970,7307,16265,5337,26.947253347909264,0.054819672131147544,Very Cheap
20140815T000000,740000.0,4,2.5,2500,10330,2.0,0,0,3,10,2500,0,1992,0,98006,47.5595,-122.114,2710,8375,7830,5665,71.63601161665053,0.08721311475409836,Very Cheap
20150313T000000,789800.0,3,2.5,2605,2216,2.0,0,2,3,9,2090,515,1979,0,98033,47.6536,-122.203,2605,2300,-389,-305,356.40794223826714,0.09374426229508197,Very Cheap
20150508T000000,275000.0,2,1.0,910,4191,1.0,0,0,3,6,910,0,1910,0,98117,47.6929,-122.36,1480,6050,3281,4570,65.61679790026247,0.02622950819672131,Very Cheap
20140507T000000,1500000.0,6,2.5,3560,6480,2.5,0,0,4,11,3560,0,1914,0,98112,47.627,-122.304,2780,6480,2920,3700,231.4814814814815,0.18688524590163935,Cheap
20140929T000000,424000.0,3,1.75,1140,3395,1.0,0,0,5,7,620,520,1925,0,98107,47.6712,-122.393,1480,3500,2255,2020,124.88954344624447,0.04577049180327869,Very Cheap
20150327T000000,715000.0,2,1.0,1000,3513,1.0,0,4,4,5,1000,0,1914,0,98116,47.5935,-122.39,1930,4920,2513,2990,203.52974665528038,0.0839344262295082,Very Cheap
20140730T000000,600000.0,4,2.5,3010,7953,2.0,0,0,3,9,3010,0,2000,0,98056,47.522,-122.19,2670,6202,4943,3532,75.44322897019993,0.06885245901639345,Very Cheap
20140813T000000,802000.0,2,1.75,2110,8700,1.0,0,4,4,9,1760,350,1960,0,98146,47.4912,-122.365,2120,9500,6590,7380,92.183908045977,0.09534426229508197,Very Cheap
20140726T000000,165000.0,3,1.0,910,8700,1.0,0,0,4,6,910,0,1943,0,98188,47.449,-122.29,1090,8700,7790,7610,18.96551724137931,0.01180327868852459,Very Cheap
20140609T000000,750000.0,4,3.25,2050,5000,2.0,0,0,4,8,1370,680,1987,0,98112,47.6235,-122.298,1720,5000,2950,3280,150.0,0.08852459016393442,Very Cheap
20140812T000000,405000.0,2,1.0,1090,10481,1.0,0,0,2,7,780,310,1981,0,98074,47.632,-122.03,1160,10533,9391,9373,38.64135101612442,0.043278688524590166,Very Cheap
20141203T000000,521900.0,3,2.5,2100,12338,2.0,0,0,3,9,2100,0,1997,0,98072,47.7412,-122.168,2320,6257,10238,3937,42.30021073107473,0.05860983606557377,Very Cheap
20140722T000000,275000.0,3,1.0,1000,8018,1.0,0,0,3,7,1000,0,1969,0,98034,47.7285,-122.198,1270,8000,7018,6730,34.29782988276378,0.02622950819672131,Very Cheap
20141015T000000,600000.0,5,3.25,4410,58157,2.0,0,0,4,9,2330,2080,2001,0,98058,47.4395,-122.111,2460,42565,53747,40105,10.316900802998779,0.06885245901639345,Very Cheap
20140519T000000,442500.0,3,1.75,1800,10200,1.0,0,0,3,8,1800,0,1967,0,98058,47.4496,-122.146,2140,10128,8400,7988,43.38235294117647,0.04819672131147541,Very Cheap
20140909T000000,229950.0,2,1.0,920,7716,1.0,0,0,3,6,920,0,1944,0,98178,47.5028,-122.243,1410,7128,6796,5718,29.801710730948678,0.020321311475409835,Very Cheap
20150120T000000,274950.0,3,2.0,1410,7265,1.0,0,0,4,7,1410,0,1983,0,98042,47.3654,-122.076,1390,8060,5855,6670,37.845836200963525,0.02622295081967213,Very Cheap
20141107T000000,407185.0,3,1.75,1860,48076,1.5,0,0,4,8,1860,0,1929,0,98070,47.5051,-122.461,1410,23066,46216,21656,8.469610616523838,0.04356524590163934,Very Cheap
20140709T000000,468000.0,4,2.5,2100,8400,1.0,0,0,4,7,1240,860,1976,0,98072,47.735,-122.17,1980,8610,6300,6630,55.714285714285715,0.05154098360655738,Very Cheap
20140930T000000,450000.0,2,1.0,1030,4365,1.0,0,0,3,7,1030,0,1942,0,98117,47.6875,-122.387,1420,4268,3335,2848,103.09278350515464,0.04918032786885246,Very Cheap
20141023T000000,219950.0,2,1.0,940,8997,1.0,0,0,5,7,940,0,1955,0,98022,47.2005,-121.999,1110,9126,8057,8016,24.44703790152273,0.01900983606557377,Very Cheap
20150122T000000,275000.0,2,2.5,1340,5995,2.0,0,0,3,7,1340,0,1989,0,98028,47.7366,-122.233,1540,6616,4655,5076,45.87155963302752,0.02622950819672131,Very Cheap
20150410T000000,229950.0,2,1.0,850,6000,1.0,0,0,3,6,850,0,1924,0,98178,47.4972,-122.224,1100,6000,5150,4900,38.325,0.020321311475409835,Very Cheap
20141125T000000,675000.0,3,1.75,2130,4400,1.0,0,0,3,7,1430,700,1922,0,98102,47.6417,-122.325,1710,3300,2270,1590,153.4090909090909,0.07868852459016394,Very Cheap
20150323T000000,412950.0,4,2.5,2430,6796,2.0,0,0,3,8,2430,0,1993,0,98058,47.4499,-122.127,2450,8400,4366,5950,60.763684520306064,0.04432131147540984,Very Cheap
20150429T000000,670000.0,5,2.25,2290,39000,2.0,0,0,3,8,2290,0,1979,0,98052,47.7012,-122.12,2750,39900,36710,37150,17.17948717948718,0.0780327868852459,Very Cheap
20140923T000000,420000.0,3,1.75,1230,10005,1.0,0,0,4,7,1230,0,1963,0,98008,47.621,-122.114,1530,8560,8775,7030,41.97901049475262,0.04524590163934426,Very Cheap
20150113T000000,358000.0,3,1.5,1150,27319,1.0,0,0,4,6,1150,0,1976,0,98070,47.3933,-122.454,1700,30691,26169,28991,13.104432812328415,0.03711475409836065,Very Cheap
20150424T000000,680000.0,3,2.5,2120,3600,2.0,0,0,3,9,2120,0,2005,0,98052,47.6649,-122.082,2540,4592,1480,2052,188.88888888888889,0.07934426229508197,Very Cheap
20141104T000000,380000.0,2,1.0,980,3400,1.0,0,0,3,7,980,0,1923,0,98105,47.6688,-122.323,1200,3420,2420,2220,111.76470588235294,0.04,Very Cheap
20141205T000000,515000.0,3,2.5,2130,219978,2.0,0,0,3,8,2130,0,1986,0,98077,47.7754,-122.032,3340,217800,217848,214460,2.341143205229614,0.057704918032786885,Very Cheap
20140819T000000,325000.0,2,1.0,1050,4800,1.0,0,0,4,7,1050,0,1969,0,98146,47.5128,-122.388,1230,4800,3750,3570,67.70833333333333,0.03278688524590164,Very Cheap
20141204T000000,875000.0,3,2.5,1820,6848,1.0,0,0,4,7,1820,0,1953,0,98004,47.6287,-122.207,2080,11700,5028,9620,127.77453271028037,0.10491803278688525,Cheap
20150420T000000,426000.0,3,2.5,2210,5750,2.0,0,0,3,7,1710,500,1914,2000,98106,47.5525,-122.366,1350,5750,3540,4400,74.08695652173913,0.046032786885245904,Very Cheap
20140915T000000,868500.0,5,2.5,2490,9639,1.0,0,0,4,8,1610,880,1959,0,98040,47.551,-122.22,2290,9958,7149,7668,90.10270774976658,0.1040655737704918,Cheap
20140611T000000,657500.0,4,2.75,4140,24190,2.0,0,0,3,11,4140,0,2002,0,98092,47.3062,-122.15,3950,24190,20050,20240,27.180653162463827,0.07639344262295082,Very Cheap
20140918T000000,366000.0,2,1.0,1210,3090,1.0,0,0,3,6,860,350,1926,0,98118,47.5532,-122.277,1210,3348,1880,2138,118.44660194174757,0.03816393442622951,Very Cheap
20140916T000000,385000.0,2,1.0,1010,4000,1.0,0,0,3,6,1010,0,1911,0,98118,47.5536,-122.267,1040,4000,2990,2960,96.25,0.04065573770491803,Very Cheap
20140908T000000,300000.0,4,2.0,2050,8750,1.0,0,0,3,7,1300,750,1967,0,98058,47.4324,-122.171,2050,8750,6700,6700,34.285714285714285,0.029508196721311476,Very Cheap
20150320T000000,810000.0,3,1.75,2060,3300,2.0,0,0,4,9,1500,560,1918,0,98102,47.6498,-122.32,1830,3712,1240,1882,245.45454545454547,0.09639344262295083,Very Cheap
20150417T000000,460000.0,4,1.75,1560,7200,1.0,0,0,3,6,860,700,1943,0,98115,47.7001,-122.279,1420,7200,5640,5780,63.888888888888886,0.050491803278688525,Very Cheap
20141021T000000,459000.0,3,2.5,1780,4000,2.0,0,0,4,8,1780,0,1995,0,98029,47.5677,-122.003,1730,4000,2220,2270,114.75,0.050360655737704915,Very Cheap
20150319T000000,260000.0,3,1.75,1460,10000,1.0,0,0,4,8,1460,0,1967,0,98092,47.342,-122.195,1930,14175,8540,12245,26.0,0.024262295081967214,Very Cheap
20141112T000000,557865.0,4,2.5,3030,6813,2.0,0,0,3,9,3030,0,1987,0,98074,47.6296,-122.029,2310,8682,3783,6372,81.88243064729194,0.06332655737704918,Very Cheap
20150420T000000,295000.0,4,1.0,980,3000,1.5,0,0,4,7,980,0,1914,0,98144,47.5892,-122.312,1525,3000,2020,1475,98.33333333333333,0.028852459016393443,Very Cheap
20140905T000000,375000.0,4,2.25,1450,7245,1.0,0,0,5,7,1450,0,1950,1983,98133,47.7643,-122.343,1660,7800,5795,6140,51.75983436853002,0.03934426229508197,Very Cheap
20140620T000000,2110000.0,3,2.25,3230,17833,2.0,0,0,4,9,3230,0,1973,0,98006,47.5683,-122.188,3690,17162,14603,13472,118.31996859754388,0.26688524590163937,Cheap
20140819T000000,307300.0,2,2.0,1520,1020,3.0,0,0,3,7,1520,0,1999,0,98133,47.7292,-122.343,1500,1245,-500,-255,301.27450980392155,0.0304655737704918,Very Cheap
20140827T000000,225000.0,4,1.0,1410,7000,1.5,0,0,3,7,1410,0,1963,0,98032,47.3767,-122.287,1540,7000,5590,5460,32.142857142857146,0.019672131147540985,Very Cheap
20141107T000000,290000.0,3,1.75,1390,13200,2.0,0,0,3,7,1390,0,1979,0,98045,47.4429,-121.771,1430,10725,11810,9295,21.96969696969697,0.02819672131147541,Very Cheap
20141120T000000,690000.0,4,2.0,2230,5000,1.5,0,0,4,7,1510,720,1922,0,98144,47.5772,-122.292,2140,5000,2770,2860,138.0,0.08065573770491803,Very Cheap
20140705T000000,825000.0,4,2.25,2110,12653,2.0,0,0,4,8,2110,0,1972,0,98040,47.536,-122.225,2350,10980,10543,8630,65.20192839642772,0.09836065573770492,Very Cheap
20140702T000000,645000.0,3,1.75,2270,11472,1.0,0,0,4,7,1370,900,1956,0,98177,47.7057,-122.374,2270,8340,9202,6070,56.22384937238494,0.07475409836065573,Very Cheap
20150217T000000,590000.0,4,2.25,2530,10611,1.0,0,0,5,8,1320,1210,1977,0,98006,47.5698,-122.132,2530,10125,8081,7595,55.602676467816416,0.06754098360655737,Very Cheap
20140725T000000,667000.0,5,2.0,1900,5470,1.0,0,0,3,7,1180,720,1930,1965,98105,47.6666,-122.303,1300,3250,3570,1950,121.93784277879342,0.07763934426229509,Very Cheap
20140925T000000,664000.0,4,2.5,2390,8432,2.0,0,0,3,9,2390,0,1998,0,98074,47.6027,-122.024,2710,7417,6042,4707,78.74762808349146,0.07724590163934426,Very Cheap
20150428T000000,452100.0,4,2.5,3160,6540,1.0,0,3,3,8,1580,1580,1959,0,98178,47.5037,-122.24,1990,7090,3380,5100,69.12844036697248,0.04945573770491803,Very Cheap
20141202T000000,290000.0,2,1.0,900,2728,2.0,0,0,3,7,900,0,1998,0,98144,47.5877,-122.298,900,2728,1828,1828,106.30498533724341,0.02819672131147541,Very Cheap
20150422T000000,950000.0,3,3.0,3610,17483,2.0,0,2,4,8,3610,0,1954,0,98146,47.4852,-122.357,2230,12600,13873,10370,54.338500257392894,0.11475409836065574,Cheap
20150130T000000,662500.0,3,2.0,2070,4200,1.5,0,0,4,7,1670,400,1906,0,98103,47.6624,-122.333,1490,4560,2130,3070,157.73809523809524,0.07704918032786885,Very Cheap
20140702T000000,475000.0,4,2.5,1850,5444,2.0,0,0,5,7,1850,0,1981,0,98034,47.7227,-122.16,1540,5000,3594,3460,87.25202057310801,0.05245901639344262,Very Cheap
20140915T000000,450000.0,3,1.5,1440,9711,1.0,0,0,3,7,1140,300,1956,0,98028,47.7394,-122.252,1590,9711,8271,8121,46.33920296570899,0.04918032786885246,Very Cheap
20140707T000000,538250.0,3,2.25,2590,15229,2.0,0,3,3,8,2590,0,1984,0,98198,47.3948,-122.325,2590,15229,12639,12639,35.34375205200604,0.06075409836065574,Very Cheap
20140505T000000,329950.0,2,1.0,1140,5250,1.5,0,0,4,6,1140,0,1949,0,98133,47.731,-122.341,1450,5250,4110,3800,62.84761904761905,0.03343606557377049,Very Cheap
20150122T000000,1103990.0,4,3.5,2760,5040,2.0,0,2,3,9,2760,0,1955,2005,98117,47.6756,-122.401,2370,5760,2280,3390,219.0456349206349,0.1349495081967213,Cheap
20141020T000000,307000.0,5,1.5,1310,4800,1.5,0,0,3,6,1110,200,1929,0,98106,47.5545,-122.365,960,4800,3490,3840,63.958333333333336,0.03042622950819672,Very Cheap
20140610T000000,433000.0,3,1.75,1870,7189,1.0,0,0,3,7,1270,600,1959,0,98118,47.5412,-122.27,1780,6200,5319,4420,60.23090833217415,0.04695081967213115,Very Cheap
20150114T000000,212000.0,3,2.25,1900,18000,1.0,0,0,4,7,1280,620,1968,0,98023,47.3251,-122.354,1920,15000,16100,13080,11.777777777777779,0.017967213114754098,Very Cheap
20140908T000000,750000.0,5,2.75,2860,6000,2.5,0,0,4,8,2380,480,1902,0,98144,47.5906,-122.316,2240,6000,3140,3760,125.0,0.08852459016393442,Very Cheap
20141125T000000,279000.0,3,2.0,1640,5650,1.0,0,0,3,7,1640,0,2003,0,98042,47.3736,-122.13,2250,5488,4010,3238,49.38053097345133,0.02675409836065574,Very Cheap
20140611T000000,476000.0,3,1.0,1140,5500,1.5,0,0,4,6,1140,0,1908,0,98199,47.6606,-122.395,1690,4400,4360,2710,86.54545454545455,0.052590163934426226,Very Cheap
20150326T000000,368000.0,5,1.75,2590,9394,1.0,0,0,4,7,1390,1200,1963,0,98198,47.3941,-122.307,2580,9049,6804,6469,39.17394081328508,0.03842622950819672,Very Cheap
20141015T000000,228950.0,4,3.0,2160,5200,1.0,0,0,3,7,1320,840,1978,0,98042,47.3627,-122.091,1460,5144,3040,3684,44.02884615384615,0.020190163934426228,Very Cheap
20140618T000000,568450.0,5,3.5,3260,58806,2.0,0,0,4,8,3260,0,1969,0,98042,47.3703,-122.159,1810,17927,55546,16117,9.666530626126585,0.06471475409836065,Very Cheap
20140605T000000,619000.0,4,1.75,1660,3800,1.5,0,0,3,7,1660,0,1926,0,98115,47.6883,-122.314,1660,3767,2140,2107,162.89473684210526,0.07134426229508196,Very Cheap
20140729T000000,275000.0,3,2.25,1640,6044,2.0,0,0,3,7,1640,0,1996,0,98002,47.2844,-122.205,1600,7418,4404,5818,45.49966909331569,0.02622950819672131,Very Cheap
20141027T000000,321500.0,4,2.5,2620,5457,2.0,0,0,3,8,2620,0,2003,0,98001,47.3148,-122.27,2740,5816,2837,3076,58.91515484698552,0.032327868852459016,Very Cheap
20140508T000000,230000.0,3,1.75,950,6000,1.0,0,0,3,6,790,160,1939,0,98108,47.5271,-122.316,1360,6000,5050,4640,38.333333333333336,0.020327868852459016,Very Cheap
20150128T000000,179500.0,3,1.0,900,8100,1.0,0,0,4,6,900,0,1959,0,98002,47.2866,-122.221,1000,7830,7200,6830,22.160493827160494,0.013704918032786886,Very Cheap
20140818T000000,460000.0,3,2.25,1650,7313,1.0,0,0,3,7,1220,430,1975,0,98011,47.7375,-122.194,1690,7252,5663,5562,62.90168193627786,0.050491803278688525,Very Cheap
20150226T000000,286000.0,3,2.5,1800,3980,2.0,0,0,3,7,1800,0,2006,0,98042,47.4006,-122.162,2580,4307,2180,1727,71.85929648241206,0.027672131147540982,Very Cheap
20141031T000000,427500.0,3,1.0,1480,4200,1.5,0,0,3,7,1480,0,1925,0,98122,47.6147,-122.298,1460,3600,2720,2140,101.78571428571429,0.04622950819672131,Very Cheap
20140522T000000,400000.0,3,1.0,1040,6250,1.0,0,0,3,7,1040,0,1942,0,98136,47.5526,-122.385,1770,6250,5210,4480,64.0,0.04262295081967213,Very Cheap
20140624T000000,675000.0,3,3.5,2300,5611,1.0,0,0,3,8,2300,0,2004,0,98053,47.7122,-122.026,2170,5926,3311,3756,120.29941186954197,0.07868852459016394,Very Cheap
20150226T000000,350000.0,3,1.0,2480,8906,1.0,0,0,3,7,1240,1240,1969,0,98118,47.5366,-122.289,1800,8906,6426,7106,39.29934875364923,0.036065573770491806,Very Cheap
20141122T000000,385000.0,4,1.75,1970,10358,1.0,0,0,3,8,1540,430,1977,0,98028,47.7719,-122.255,1900,10358,8388,8458,37.16933770998262,0.04065573770491803,Very Cheap
20140702T000000,525000.0,2,1.75,1530,3503,1.0,0,1,4,7,830,700,1916,0,98119,47.6368,-122.371,1280,1531,1973,251,149.87153868113046,0.05901639344262295,Very Cheap
20150121T000000,315000.0,2,1.0,970,18557,1.0,0,0,3,6,970,0,1939,0,98146,47.5116,-122.37,1150,7200,17587,6050,16.974726518294982,0.031475409836065574,Very Cheap
20140729T000000,820000.0,4,2.5,2920,252648,2.0,0,0,3,10,2920,0,2002,0,98027,47.4784,-122.048,2180,71874,249728,69694,3.245622367879421,0.09770491803278689,Very Cheap
20150415T000000,205000.0,3,1.0,970,7700,1.0,0,0,4,7,970,0,1959,0,98032,47.3793,-122.304,1160,8250,6730,7090,26.623376623376622,0.017049180327868854,Very Cheap
20141205T000000,500000.0,2,1.0,680,5250,1.0,0,0,4,6,680,0,1922,0,98177,47.7013,-122.359,1620,5461,4570,3841,95.23809523809524,0.05573770491803279,Very Cheap
20140822T000000,599000.0,4,2.5,2640,6738,2.0,0,0,4,8,2640,0,1989,0,98029,47.5787,-122.0,2180,5782,4098,3602,88.89878302166815,0.06872131147540983,Very Cheap
20150304T000000,2225000.0,3,4.0,4200,30120,2.0,0,2,4,11,3600,600,1933,0,98112,47.6379,-122.311,2760,12200,25920,9440,73.87118193891102,0.2819672131147541,Cheap
20150421T000000,299000.0,1,2.5,1980,7521,1.0,0,0,4,7,1180,800,1979,0,98055,47.4343,-122.192,1980,8000,5541,6020,39.75535168195719,0.02937704918032787,Very Cheap
20140512T000000,947500.0,3,2.75,2980,27144,1.5,1,2,5,8,2180,800,1917,0,98166,47.4522,-122.378,1890,12514,24164,10624,34.90642499263189,0.11442622950819673,Cheap
20140623T000000,385000.0,3,3.25,1630,1677,3.0,0,0,3,8,1630,0,2007,0,98133,47.7048,-122.353,1220,1677,47,457,229.57662492546214,0.04065573770491803,Very Cheap
20140811T000000,639950.0,2,1.75,1780,4520,1.0,0,0,5,7,890,890,1925,0,98116,47.5798,-122.404,1560,4520,2740,2960,141.58185840707964,0.07409180327868853,Very Cheap
20141110T000000,824000.0,2,1.0,1210,8400,1.0,0,0,3,8,780,430,2000,0,98199,47.6503,-122.393,1860,6000,7190,4140,98.0952380952381,0.09822950819672131,Very Cheap
20140602T000000,199950.0,3,1.0,1010,7245,1.0,0,0,3,7,1010,0,1969,0,98003,47.3338,-122.306,1300,8236,6235,6936,27.598343685300208,0.01638688524590164,Very Cheap
20150408T000000,1005000.0,3,2.5,2570,5000,1.0,0,0,4,8,1480,1090,1940,0,98105,47.6578,-122.285,2420,5484,2430,3064,201.0,0.1219672131147541,Cheap
20150403T000000,950000.0,4,2.25,2770,5320,2.0,0,1,3,9,2440,330,2013,0,98136,47.5283,-122.385,2100,6011,2550,3911,178.57142857142858,0.11475409836065574,Cheap
20140923T000000,822000.0,3,2.5,2290,9158,2.0,0,0,4,8,2290,0,1984,0,98006,47.5476,-122.14,2210,9588,6868,7378,89.75758899322996,0.09796721311475409,Very Cheap
20141106T000000,473600.0,4,1.5,1780,8400,1.0,0,0,3,7,1080,700,1969,0,98136,47.5173,-122.385,1660,8400,6620,6740,56.38095238095238,0.05227540983606557,Very Cheap
20150202T000000,490000.0,5,2.0,2150,4500,1.5,0,0,3,8,2150,0,1938,0,98116,47.5582,-122.388,1300,4500,2350,3200,108.88888888888889,0.05442622950819672,Very Cheap
20140505T000000,245000.0,3,1.75,1920,9306,1.0,0,0,3,7,1000,920,1984,0,98001,47.3319,-122.267,1860,8458,7386,6598,26.327100795185903,0.022295081967213116,Very Cheap
20140828T000000,199000.0,4,1.0,1220,11730,1.0,0,0,4,7,1220,0,1960,0,98001,47.3229,-122.283,1270,9520,10510,8250,16.965046888320547,0.016262295081967214,Very Cheap
20140507T000000,1340000.0,3,3.0,2960,5500,2.0,0,2,3,10,2440,520,1937,1990,98199,47.6356,-122.402,2960,5876,2540,2916,243.63636363636363,0.1659016393442623,Cheap
20141017T000000,418000.0,3,1.75,1500,19113,1.0,0,0,3,7,1500,0,1984,0,98014,47.6976,-121.916,1820,18151,17613,16331,21.86993146026265,0.04498360655737705,Very Cheap
20150311T000000,450000.0,7,3.5,2830,8625,1.0,0,0,4,8,1830,1000,1957,0,98133,47.7493,-122.355,1570,8400,5795,6830,52.17391304347826,0.04918032786885246,Very Cheap
20140718T000000,280000.0,3,2.5,1580,7000,2.0,0,0,3,8,1580,0,1992,0,98030,47.3659,-122.17,2110,7062,5420,4952,40.0,0.026885245901639345,Very Cheap
20150303T000000,273000.0,3,2.25,1230,11601,1.0,0,0,4,7,910,320,1992,0,98022,47.1955,-121.991,1820,8465,10371,6645,23.532454098784587,0.025967213114754098,Very Cheap
20140505T000000,549000.0,4,2.5,2910,6338,2.0,0,0,3,8,2910,0,2008,0,98059,47.4804,-122.126,2500,5877,3428,3377,86.6203849794888,0.06216393442622951,Very Cheap
20140625T000000,913888.0,5,2.25,2370,15512,2.0,0,0,4,9,2370,0,1981,0,98006,47.5555,-122.15,2380,15100,13142,12720,58.91490458999484,0.11001809836065574,Cheap
20140718T000000,689888.0,4,2.25,1930,3500,1.5,0,0,5,8,1540,390,1916,0,98122,47.6167,-122.29,1800,5000,1570,3200,197.11085714285716,0.08064104918032787,Very Cheap
20141212T000000,305000.0,4,2.0,1780,5043,1.0,0,0,3,7,870,910,1993,0,98133,47.7045,-122.342,1350,5044,3263,3694,60.47987309141384,0.03016393442622951,Very Cheap
20140529T000000,602500.0,4,2.5,2760,6850,2.0,0,0,3,9,2760,0,1999,0,98056,47.5346,-122.185,2640,9803,4090,7163,87.95620437956204,0.06918032786885246,Very Cheap
20150424T000000,355000.0,2,1.75,1620,3640,1.0,0,0,3,7,900,720,1929,0,98108,47.543,-122.299,1590,5538,2020,3948,97.52747252747253,0.036721311475409836,Very Cheap
20140821T000000,756000.0,3,2.5,2160,7525,2.0,0,0,3,9,2160,0,1986,0,98052,47.6608,-122.145,2470,7941,5365,5471,100.46511627906976,0.08931147540983607,Very Cheap
20150423T000000,289950.0,4,2.25,2190,6906,1.0,0,0,4,7,1040,1150,1977,0,98023,47.319,-122.373,1250,6440,4716,5190,41.98523023457863,0.028190163934426228,Very Cheap
20140505T000000,800000.0,3,2.5,3240,7857,2.0,0,0,3,10,3240,0,1994,0,98075,47.5857,-122.038,2970,7857,4617,4887,101.82003309151075,0.09508196721311475,Very Cheap
20141202T000000,403000.0,2,1.0,720,3255,1.0,0,0,4,6,720,0,1905,0,98103,47.6823,-122.348,1430,3170,2535,1740,123.80952380952381,0.04301639344262295,Very Cheap
20150413T000000,350000.0,3,2.25,1410,1340,2.0,0,0,3,8,1370,40,1967,0,98008,47.6108,-122.113,1730,2748,-70,1018,261.1940298507463,0.036065573770491806,Very Cheap
20150326T000000,1285000.0,5,3.5,2980,5100,2.0,0,0,3,10,2370,610,2015,0,98115,47.6782,-122.299,1780,5100,2120,3320,251.9607843137255,0.15868852459016394,Cheap
20140918T000000,525126.0,5,2.25,1950,8025,1.0,0,2,3,7,1150,800,1960,0,98008,47.6159,-122.114,1780,8560,6075,6780,65.43626168224299,0.05903291803278689,Very Cheap
20140812T000000,241450.0,3,1.0,1100,8138,1.0,0,0,3,7,1100,0,1949,0,98155,47.7393,-122.325,1440,8131,7038,6691,29.669451953797,0.02182950819672131,Very Cheap
20150122T000000,320000.0,3,1.5,1400,9087,1.0,0,0,3,7,1400,0,1954,0,98133,47.7711,-122.34,1490,8380,7687,6890,35.21514251127985,0.032131147540983604,Very Cheap
20141023T000000,234000.0,4,2.0,1710,7455,1.0,0,0,3,7,1030,680,1975,0,98031,47.3965,-122.173,1710,7350,5745,5640,31.388329979879277,0.020852459016393442,Very Cheap
20141121T000000,441000.0,5,2.5,2000,3600,1.0,0,0,3,6,1150,850,1987,0,98144,47.5971,-122.295,1410,3600,1600,2190,122.5,0.048,Very Cheap
20150317T000000,474500.0,5,2.5,2000,3600,1.0,0,0,3,6,1150,850,1987,0,98144,47.5971,-122.295,1410,3600,1600,2190,131.80555555555554,0.05239344262295082,Very Cheap
20150422T000000,705000.0,3,1.0,1440,2618,1.5,0,0,4,7,1440,0,1906,0,98103,47.6582,-122.336,1850,3990,1178,2140,269.2895339954163,0.08262295081967214,Very Cheap
20150409T000000,517500.0,4,2.5,1520,3370,2.0,0,0,3,8,1520,0,1994,0,98029,47.5696,-122.004,1860,4486,1850,2626,153.5608308605341,0.0580327868852459,Very Cheap
20140617T000000,142500.0,4,0.75,1440,13300,1.0,0,0,3,6,1440,0,1948,0,98166,47.4761,-122.337,1460,11100,11860,9640,10.714285714285714,0.008852459016393442,Very Cheap
20141106T000000,310000.0,2,1.5,1010,10005,2.0,0,0,3,7,1010,0,1981,0,98056,47.5118,-122.189,1210,7794,8995,6584,30.984507746126937,0.03081967213114754,Very Cheap
20141028T000000,749500.0,4,2.5,2440,9727,2.0,0,0,3,9,2440,0,1987,0,98052,47.6613,-122.132,2370,11503,7287,9133,77.05356224940886,0.08845901639344263,Very Cheap
20150429T000000,360000.0,5,3.0,2480,7200,1.0,0,0,3,7,1560,920,1999,0,98188,47.4586,-122.283,1910,9432,4720,7522,50.0,0.037377049180327866,Very Cheap
20141121T000000,267500.0,3,1.0,1090,22080,1.0,0,0,5,7,1090,0,1967,0,98038,47.3991,-121.964,1590,19457,20990,17867,12.115036231884059,0.025245901639344263,Very Cheap
20141009T000000,290000.0,3,1.0,1480,32700,1.0,0,0,4,6,1380,100,1942,0,98168,47.4949,-122.327,1500,22600,31220,21100,8.868501529051988,0.02819672131147541,Very Cheap
20141105T000000,850000.0,5,2.5,2800,11325,1.0,0,0,4,8,1400,1400,1970,0,98005,47.6166,-122.172,2510,13700,8525,11190,75.0551876379691,0.10163934426229508,Cheap
20141029T000000,815000.0,4,1.75,1820,4500,1.5,0,0,3,8,1820,0,1921,0,98119,47.6429,-122.36,1870,3600,2680,1730,181.11111111111111,0.09704918032786886,Very Cheap
20150108T000000,2200000.0,5,4.0,5840,11652,2.0,0,1,3,11,4410,1430,1988,0,98004,47.5835,-122.202,3120,13639,5812,10519,188.8087881908685,0.2786885245901639,Cheap
20140703T000000,1625000.0,4,3.25,2980,3600,2.0,0,0,3,9,2150,830,1999,0,98112,47.6352,-122.284,2980,4800,620,1820,451.3888888888889,0.20327868852459016,Cheap
20140616T000000,175000.0,3,1.5,1220,7300,1.0,0,0,3,7,1220,0,1973,0,98001,47.3341,-122.279,1260,7347,6080,6087,23.972602739726028,0.013114754098360656,Very Cheap
20141002T000000,429950.0,3,1.75,1830,9758,1.0,0,0,3,8,1300,530,1977,0,98034,47.7107,-122.23,1850,8000,7928,6150,44.06128304980529,0.04655081967213115,Very Cheap
20140714T000000,675000.0,4,2.5,2900,5505,2.0,0,0,3,8,2900,0,2002,0,98074,47.6063,-122.02,2970,5251,2605,2281,122.6158038147139,0.07868852459016394,Very Cheap
20140708T000000,580000.0,3,2.25,1940,5980,1.0,0,0,3,7,1520,420,1987,0,98027,47.5476,-122.075,1910,6309,4040,4399,96.98996655518394,0.06622950819672131,Very Cheap
20150224T000000,240000.0,4,2.0,1750,7800,1.0,0,0,4,6,1750,0,1944,0,98166,47.4791,-122.347,1270,7800,6050,6530,30.76923076923077,0.021639344262295083,Very Cheap
20140820T000000,374000.0,3,2.5,1850,17808,1.0,0,0,4,8,1210,640,1982,0,98032,47.3631,-122.271,2260,16754,15958,14494,21.00179694519317,0.03921311475409836,Very Cheap
20141212T000000,862500.0,4,2.5,3220,4400,2.0,0,2,3,9,2180,1040,1937,0,98199,47.6325,-122.394,3000,5000,1180,2000,196.02272727272728,0.10327868852459017,Cheap
20150121T000000,140000.0,2,1.0,1080,6052,1.0,0,0,5,6,1080,0,1908,0,98030,47.3857,-122.215,1810,7830,4972,6020,23.13284864507601,0.008524590163934427,Very Cheap
20140530T000000,740000.0,5,3.75,3990,18897,2.0,0,0,3,8,3090,900,1937,2010,98125,47.7228,-122.31,2080,9793,14907,7713,39.159654971688624,0.08721311475409836,Very Cheap
20150224T000000,589000.0,3,1.75,920,3600,1.0,0,0,4,6,820,100,1904,0,98119,47.6386,-122.365,1620,3600,2680,1980,163.61111111111111,0.06740983606557377,Very Cheap
20150223T000000,275000.0,3,1.75,1290,9760,1.0,0,0,3,7,1290,0,1979,0,98058,47.4265,-122.148,1410,8034,8470,6624,28.17622950819672,0.02622950819672131,Very Cheap
20140711T000000,489900.0,4,2.5,2090,4196,2.0,0,0,3,8,2090,0,2006,0,98011,47.7453,-122.192,2640,4503,2106,1863,116.75405147759771,0.05441311475409836,Very Cheap
20140813T000000,545000.0,3,2.5,1900,3366,2.0,0,0,3,9,1900,0,1996,0,98033,47.6679,-122.184,2500,3954,1466,1454,161.91325014854428,0.06163934426229508,Very Cheap
20150325T000000,235000.0,4,1.0,1360,7132,1.5,0,0,3,6,1360,0,1941,0,98168,47.5054,-122.301,1280,7175,5772,5895,32.95008412787437,0.02098360655737705,Very Cheap
20150217T000000,230000.0,3,1.0,1000,4000,1.5,0,0,4,6,1000,0,1915,0,98118,47.5523,-122.286,1040,4240,3000,3200,57.5,0.020327868852459016,Very Cheap
20140710T000000,655000.0,4,2.25,2170,4080,2.0,0,0,3,7,1920,250,1980,0,98122,47.6124,-122.293,1890,4400,1910,2510,160.5392156862745,0.0760655737704918,Very Cheap
20140822T000000,185000.0,2,1.0,820,16030,1.0,0,0,4,5,820,0,1923,0,98022,47.2039,-122.003,1880,14046,15210,12166,11.540860885839052,0.014426229508196721,Very Cheap
20150326T000000,196000.0,3,1.0,1090,7400,1.0,0,0,4,7,1090,0,1962,0,98092,47.2923,-122.19,1140,8165,6310,7025,26.486486486486488,0.015868852459016394,Very Cheap
20140604T000000,572000.0,3,2.25,1830,7897,1.0,0,0,4,8,1290,540,1986,0,98052,47.6914,-122.103,1990,8306,6067,6316,72.43256933012536,0.06518032786885246,Very Cheap
20150430T000000,615000.0,4,2.5,3010,6903,2.0,0,0,3,9,3010,0,2001,0,98056,47.5213,-122.193,2860,6435,3893,3575,89.09169926119078,0.07081967213114754,Very Cheap
20150305T000000,1950000.0,4,3.75,4150,17424,1.0,0,0,3,9,3130,1020,1963,2000,98039,47.639,-122.236,3930,21420,13274,17490,111.91460055096418,0.2459016393442623,Cheap
20150320T000000,1225000.0,6,2.25,2930,4320,2.0,0,0,3,9,2130,800,1913,0,98112,47.6295,-122.306,2860,4320,1390,1460,283.56481481481484,0.15081967213114755,Cheap
20140819T000000,375000.0,3,2.5,1520,5649,2.0,0,0,4,7,1520,0,1989,0,98034,47.7221,-122.162,1540,5000,4129,3460,66.38343069569835,0.03934426229508197,Very Cheap
20140905T000000,295000.0,3,1.75,1250,9486,1.0,0,0,4,6,1250,0,1971,0,98070,47.4341,-122.446,1270,9600,8236,8330,31.098460889732237,0.028852459016393443,Very Cheap
20140625T000000,760000.0,4,2.5,2760,6000,2.0,0,0,5,7,2230,530,1942,0,98115,47.6877,-122.295,1600,6000,3240,4400,126.66666666666667,0.0898360655737705,Very Cheap
20150407T000000,347000.0,3,1.75,1330,7848,1.0,0,0,3,8,1330,0,1978,0,98058,47.4463,-122.127,2110,8497,6518,6387,44.2150866462793,0.03567213114754098,Very Cheap
20150504T000000,712000.0,3,2.0,1700,5100,1.5,0,0,4,7,1500,200,1924,0,98117,47.679,-122.39,1700,5100,3400,3400,139.6078431372549,0.08354098360655737,Very Cheap
20140515T000000,495000.0,4,2.0,2050,4000,1.5,0,0,5,7,1210,840,1941,0,98144,47.5799,-122.306,1310,4000,1950,2690,123.75,0.05508196721311476,Very Cheap
20140620T000000,925000.0,4,2.0,3140,10437,1.0,0,0,4,8,2040,1100,1959,0,98040,47.5786,-122.229,2010,10437,7297,8427,88.62700009581297,0.11147540983606558,Cheap
20150402T000000,775000.0,3,1.0,2030,4080,1.5,0,0,4,7,1840,190,1908,0,98115,47.6765,-122.308,2030,4080,2050,2050,189.95098039215685,0.09180327868852459,Very Cheap
20140801T000000,429000.0,4,2.5,2100,7920,1.5,0,0,4,6,1400,700,1916,0,98126,47.5293,-122.371,1230,7920,5820,6690,54.166666666666664,0.04642622950819672,Very Cheap
20141218T000000,229000.0,3,1.0,1010,12705,1.0,0,0,4,7,1010,0,1959,0,98003,47.3348,-122.303,1490,10200,11695,8710,18.024399842581662,0.02019672131147541,Very Cheap
20140922T000000,400000.0,4,1.5,1980,113691,1.0,0,0,3,7,1980,0,1962,0,98024,47.5606,-121.853,1980,89298,111711,87318,3.5183083973225675,0.04262295081967213,Very Cheap
20140729T000000,625000.0,4,2.25,2100,8290,2.0,0,0,4,8,2100,0,1978,0,98006,47.5595,-122.129,2100,8290,6190,6190,75.39203860072377,0.07213114754098361,Very Cheap
20141021T000000,130000.0,2,1.0,840,6654,1.0,0,0,3,7,840,0,1951,0,98133,47.7319,-122.335,1350,5831,5814,4481,19.537120529005108,0.007213114754098361,Very Cheap
20141104T000000,349000.0,3,1.75,1690,5080,1.0,0,0,3,7,1190,500,1976,0,98106,47.5312,-122.348,1300,5080,3390,3780,68.7007874015748,0.035934426229508196,Very Cheap
20140922T000000,365000.0,3,2.0,2140,26600,1.0,0,0,4,7,2140,0,1983,0,98031,47.4066,-122.169,2310,8783,24460,6473,13.721804511278195,0.0380327868852459,Very Cheap
20150317T000000,487500.0,3,2.5,1810,1988,2.0,0,0,3,7,1350,460,1997,0,98199,47.6513,-122.385,1600,1525,178,-75,245.22132796780684,0.054098360655737705,Very Cheap
20140603T000000,475000.0,3,2.5,2600,7210,2.0,0,0,3,8,2600,0,1989,0,98059,47.5123,-122.151,2350,7225,4610,4875,65.88072122052705,0.05245901639344262,Very Cheap
20140924T000000,685000.0,3,1.75,1650,8400,1.0,0,0,3,8,1470,180,1959,0,98040,47.5766,-122.236,2020,7777,6750,5757,81.54761904761905,0.08,Very Cheap
20140811T000000,960000.0,3,1.75,2460,4800,1.0,0,0,4,7,1230,1230,1938,0,98112,47.6343,-122.282,2860,4800,2340,1940,200.0,0.1160655737704918,Cheap
20141113T000000,1100000.0,5,2.25,4320,7620,2.0,0,0,3,7,2880,1440,1973,2014,98115,47.6824,-122.287,1880,7620,3300,5740,144.35695538057743,0.13442622950819672,Cheap
20150320T000000,428000.0,3,2.25,2600,15000,2.0,0,0,3,9,2600,0,1978,0,98038,47.3719,-122.056,2380,15000,12400,12620,28.533333333333335,0.04629508196721312,Very Cheap
20150510T000000,435000.0,3,2.5,1930,5790,2.0,0,0,4,7,1930,0,1988,0,98011,47.7733,-122.17,1790,4901,3860,3111,75.12953367875647,0.04721311475409836,Very Cheap
20141028T000000,769950.0,3,2.0,2190,5400,1.0,0,2,5,7,1260,930,1952,0,98107,47.6737,-122.4,2160,5400,3210,3240,142.58333333333334,0.09114098360655738,Very Cheap
20140929T000000,385000.0,3,1.0,1420,10980,1.0,0,0,4,7,1200,220,1954,0,98006,47.574,-122.138,1630,9763,9560,8133,35.06375227686703,0.04065573770491803,Very Cheap
20141118T000000,352000.0,3,2.5,2090,3002,2.0,0,0,3,7,1670,420,2005,0,98019,47.745,-121.984,2090,3163,912,1073,117.25516322451699,0.03632786885245902,Very Cheap
20140911T000000,622500.0,3,2.5,2290,14374,2.0,0,0,3,8,2290,0,1983,2012,98075,47.5886,-122.074,2290,33450,12084,31160,43.30736051203562,0.0718032786885246,Very Cheap
20150212T000000,660000.0,3,3.0,2470,11900,2.0,0,0,3,9,2290,180,1976,0,98074,47.641,-122.057,2590,11900,9430,9310,55.46218487394958,0.07672131147540984,Very Cheap
20140902T000000,105000.0,3,1.0,840,8400,1.0,0,0,3,6,840,0,1959,0,98023,47.3277,-122.343,840,9450,7560,8610,12.5,0.003934426229508197,Very Cheap
20141202T000000,420000.0,2,1.0,2100,4480,1.0,0,0,5,7,1400,700,1908,0,98126,47.574,-122.372,1570,4400,2380,2830,93.75,0.04524590163934426,Very Cheap
20140903T000000,499950.0,3,1.5,1360,11250,1.0,0,0,4,7,1360,0,1955,0,98006,47.5697,-122.177,1440,11250,9890,9810,44.44,0.05573114754098361,Very Cheap
20140814T000000,975000.0,6,3.0,3420,22421,1.0,0,0,5,9,2270,1150,1948,0,98006,47.5508,-122.189,2430,15560,19001,13130,43.48601757281121,0.1180327868852459,Cheap
20141001T000000,665000.0,3,2.75,1930,2960,1.5,0,0,5,7,1490,440,1929,0,98105,47.6659,-122.287,2080,3760,1030,1680,224.66216216216216,0.07737704918032787,Very Cheap
20140701T000000,540000.0,4,2.5,2180,10140,1.0,0,0,4,7,1180,1000,1968,0,98052,47.6822,-122.111,1840,9375,7960,7535,53.25443786982248,0.06098360655737705,Very Cheap
20140529T000000,400000.0,4,2.0,1670,12056,1.0,0,0,3,7,1670,0,1955,0,98028,47.7418,-122.244,1860,12056,10386,10196,33.178500331785,0.04262295081967213,Very Cheap
20141215T000000,469950.0,4,2.75,2720,6427,1.0,0,0,3,8,1650,1070,2008,0,98146,47.4931,-122.354,2720,8484,3707,5764,73.12120740625487,0.05179672131147541,Very Cheap
20141016T000000,777000.0,4,2.5,3170,9900,2.0,0,0,4,8,3170,0,1979,0,98007,47.6181,-122.147,2540,12400,6730,9860,78.48484848484848,0.09206557377049181,Very Cheap
20140625T000000,346500.0,2,1.75,1610,6300,1.0,0,0,3,7,1010,600,1941,0,98108,47.554,-122.304,1370,5225,4690,3855,55.0,0.03560655737704918,Very Cheap
20150311T000000,685000.0,3,2.5,2370,4950,2.0,0,0,3,8,2370,0,2003,0,98029,47.5465,-122.013,2230,4950,2580,2720,138.3838383838384,0.08,Very Cheap
20140624T000000,396500.0,3,2.5,2590,18980,1.0,0,0,4,10,2590,0,1976,0,98042,47.3839,-122.153,3110,14652,16390,11542,20.89041095890411,0.04216393442622951,Very Cheap
20140504T000000,783500.0,3,2.5,2850,7130,2.0,0,0,3,10,1990,860,1980,0,98122,47.603,-122.289,2280,6459,4280,4179,109.88779803646564,0.09291803278688525,Very Cheap
20140702T000000,575000.0,4,2.0,1660,4800,1.5,0,0,3,7,1660,0,1922,0,98103,47.6556,-122.345,1660,4800,3140,3140,119.79166666666667,0.06557377049180328,Very Cheap
20141106T000000,1500000.0,4,4.25,5550,12968,2.0,0,0,3,11,5550,0,2005,0,98059,47.5305,-122.135,4750,13001,7418,8251,115.66933991363356,0.18688524590163935,Cheap
20150408T000000,515000.0,3,1.5,2200,7620,1.0,0,0,4,7,1130,1070,1942,0,98177,47.7263,-122.363,2170,7672,5420,5502,67.58530183727034,0.057704918032786885,Very Cheap
20140805T000000,300000.0,3,2.5,2020,6628,1.0,0,0,4,7,1250,770,1963,0,98168,47.4934,-122.332,1540,9995,4608,8455,45.26252263126131,0.029508196721311476,Very Cheap
20150114T000000,272000.0,3,1.5,1760,9600,1.0,0,0,4,7,1760,0,1966,0,98031,47.4085,-122.195,1450,9600,7840,8150,28.333333333333332,0.02583606557377049,Very Cheap
20140527T000000,355000.0,4,2.25,1810,4970,2.0,0,0,3,7,1810,0,2003,0,98059,47.5003,-122.156,1810,4858,3160,3048,71.42857142857143,0.036721311475409836,Very Cheap
20140731T000000,223000.0,3,2.0,1310,8440,1.0,0,0,5,6,1310,0,1951,0,98178,47.5003,-122.269,1790,10775,7130,8985,26.421800947867297,0.019409836065573772,Very Cheap
20140820T000000,397000.0,4,2.5,3000,8584,2.0,0,0,3,7,3000,0,2003,0,98038,47.369,-122.032,2610,7570,5584,4960,46.24883504193849,0.04222950819672131,Very Cheap
20150318T000000,460000.0,2,2.0,1080,5000,1.0,0,0,5,6,1080,0,1923,0,98117,47.6826,-122.394,1530,5000,3920,3470,92.0,0.050491803278688525,Very Cheap
20150206T000000,848000.0,3,2.75,2170,2738,1.5,0,0,4,9,1550,620,1930,0,98109,47.6389,-122.349,1170,1062,568,-108,309.71512052593135,0.10137704918032787,Cheap
20141007T000000,392800.0,2,1.0,740,4275,1.0,0,0,5,6,740,0,1924,0,98115,47.688,-122.308,1900,4275,3535,2375,91.88304093567251,0.04167868852459016,Very Cheap
20141001T000000,1690000.0,3,3.25,5290,224442,2.0,0,0,4,11,4540,750,1988,0,98053,47.6671,-122.051,3750,84936,219152,81186,7.5297849778561945,0.21180327868852458,Cheap
20150326T000000,1800000.0,3,3.25,5290,224442,2.0,0,0,4,11,4540,750,1988,0,98053,47.6671,-122.051,3750,84936,219152,81186,8.019889325527307,0.2262295081967213,Cheap
20150122T000000,577000.0,3,2.25,2370,7878,2.0,0,0,3,8,2370,0,1985,0,98034,47.7281,-122.168,1870,7766,5508,5896,73.24193957857324,0.06583606557377049,Very Cheap
20140707T000000,570000.0,3,1.0,1890,3330,1.5,0,0,4,7,1390,500,1901,0,98103,47.6597,-122.352,1530,3330,1440,1800,171.17117117117118,0.06491803278688525,Very Cheap
20140617T000000,250000.0,3,1.75,1160,6134,1.0,0,0,3,7,1160,0,1998,0,98002,47.3414,-122.218,1330,6301,4974,4971,40.75643951744376,0.022950819672131147,Very Cheap
20140904T000000,645000.0,4,1.75,1550,7350,1.5,0,0,4,8,1550,0,1958,0,98040,47.5795,-122.235,1860,7350,5800,5490,87.75510204081633,0.07475409836065573,Very Cheap
20141024T000000,567500.0,3,2.5,3090,67082,2.0,0,0,3,9,3090,0,1990,0,98038,47.4032,-122.023,3650,62290,63992,58640,8.45979547419576,0.06459016393442622,Very Cheap
20140722T000000,337000.0,4,2.5,2610,5240,2.0,0,0,3,8,2610,0,2004,0,98038,47.345,-122.042,2480,5240,2630,2760,64.31297709923665,0.034360655737704915,Very Cheap
20140625T000000,280000.0,3,1.75,1230,8250,1.0,0,0,3,7,1230,0,1966,0,98058,47.4526,-122.176,1250,8250,7020,7000,33.93939393939394,0.026885245901639345,Very Cheap
20140728T000000,167000.0,3,1.5,1280,5547,2.0,0,0,4,6,1280,0,1985,0,98002,47.3344,-122.215,1150,4500,4267,3350,30.10636380025239,0.012065573770491804,Very Cheap
20140530T000000,280000.0,2,1.0,1880,7560,1.0,0,0,3,6,940,940,1919,0,98126,47.5261,-122.374,1280,7560,5680,6280,37.03703703703704,0.026885245901639345,Very Cheap
20141222T000000,317500.0,2,1.5,1220,8409,1.0,0,0,4,6,1220,0,1948,0,98155,47.7534,-122.324,1130,8409,7189,7279,37.7571649423237,0.03180327868852459,Very Cheap
20140703T000000,405500.0,2,2.75,1350,1252,2.0,0,0,3,8,1120,230,2006,0,98136,47.522,-122.39,1410,1265,-98,-145,323.88178913738017,0.04334426229508197,Very Cheap
20150123T000000,495000.0,4,2.5,2370,15336,2.0,0,0,3,8,2370,0,1995,0,98024,47.5633,-121.901,2110,15925,12966,13815,32.27699530516432,0.05508196721311476,Very Cheap
20150128T000000,691000.0,4,3.0,3040,11651,2.0,0,0,3,10,3040,0,1987,0,98074,47.6348,-122.038,2540,11815,8611,9275,59.30821388721998,0.08078688524590164,Very Cheap
20141103T000000,480000.0,5,1.75,2080,217800,1.0,0,0,5,7,2080,0,1963,0,98070,47.3884,-122.404,1670,213008,215720,211338,2.203856749311295,0.05311475409836065,Very Cheap
20150211T000000,549010.0,2,1.75,1560,4141,1.0,0,0,4,7,880,680,1942,0,98117,47.6863,-122.382,1210,4141,2581,2931,132.5790871770104,0.06216524590163935,Very Cheap
20150422T000000,750000.0,5,3.5,2980,5809,2.0,0,2,3,8,2980,0,2005,0,98029,47.5537,-121.996,2120,3416,2829,1296,129.1100017214667,0.08852459016393442,Very Cheap
20150224T000000,365000.0,2,1.0,870,5689,1.0,0,0,4,7,870,0,1948,0,98103,47.6988,-122.351,1100,5711,4819,4611,64.15890314642292,0.0380327868852459,Very Cheap
20150305T000000,412500.0,3,1.75,1660,10716,1.0,0,0,3,7,1100,560,1988,0,98034,47.7326,-122.234,1630,7626,9056,5996,38.49384098544233,0.04426229508196721,Very Cheap
20140603T000000,425000.0,3,2.25,1870,9000,1.0,0,0,3,7,1440,430,1978,0,98011,47.7373,-122.198,1870,8640,7130,6770,47.22222222222222,0.04590163934426229,Very Cheap
20150331T000000,920000.0,3,1.0,1410,9656,1.0,0,0,3,7,960,450,1953,0,98004,47.6354,-122.208,2410,9384,8246,6974,95.27754763877383,0.11081967213114755,Cheap
20141222T000000,340000.0,4,2.25,2180,8000,1.0,0,0,4,9,1630,550,1975,0,98023,47.317,-122.378,2310,8000,5820,5690,42.5,0.03475409836065574,Very Cheap
20141105T000000,405000.0,4,2.5,2620,8960,1.0,0,0,5,7,1520,1100,1955,0,98133,47.7642,-122.335,1880,8960,6340,7080,45.200892857142854,0.043278688524590166,Very Cheap
20150324T000000,537100.0,3,2.5,2450,7051,1.0,0,0,3,8,1870,580,1990,0,98056,47.5308,-122.171,2450,8788,4601,6338,76.17359239824138,0.06060327868852459,Very Cheap
20150318T000000,353500.0,4,2.5,3250,4650,2.0,0,0,3,8,3250,0,2007,0,98031,47.4004,-122.203,2960,4650,1400,1690,76.02150537634408,0.036524590163934424,Very Cheap
20140912T000000,522000.0,3,1.0,1150,7080,1.0,0,0,3,7,1150,0,1952,0,98125,47.7106,-122.288,1490,7921,5930,6431,73.72881355932203,0.05862295081967213,Very Cheap
20141010T000000,710000.0,4,2.75,2780,6978,2.0,0,0,3,8,2780,0,2001,0,98053,47.6881,-122.04,2760,5460,4198,2700,101.74835196331327,0.08327868852459017,Very Cheap
20150312T000000,329950.0,3,1.75,1360,13320,1.0,0,0,4,7,1360,0,1985,0,98059,47.4625,-122.069,1580,13625,11960,12045,24.77102102102102,0.03343606557377049,Very Cheap
20150420T000000,830000.0,5,2.5,2810,14207,1.0,0,3,3,9,1540,1270,1979,0,98008,47.5742,-122.11,3190,14000,11397,10810,58.42190469486873,0.09901639344262295,Very Cheap
20150219T000000,800500.0,4,2.5,1780,11130,1.0,0,0,5,8,1780,0,1962,0,98005,47.5931,-122.178,2610,11130,9350,8520,71.92273135669362,0.09514754098360656,Very Cheap
20140528T000000,168500.0,3,1.0,1100,10125,1.0,0,0,3,7,1100,0,1969,0,98042,47.367,-122.107,1570,10650,9025,9080,16.641975308641975,0.012262295081967214,Very Cheap
20140627T000000,490000.0,3,2.5,2230,5348,2.0,0,0,3,8,2230,0,2000,0,98065,47.5347,-121.866,2190,5205,3118,3015,91.62303664921465,0.05442622950819672,Very Cheap
20141006T000000,579000.0,3,2.5,1710,1904,2.0,0,0,3,8,1140,570,2003,0,98116,47.5827,-122.387,1260,1316,194,56,304.0966386554622,0.06609836065573771,Very Cheap
20140603T000000,600000.0,4,2.5,2620,9873,2.0,0,0,3,8,2620,0,1987,0,98075,47.5822,-122.051,2520,9935,7253,7415,60.77180188392586,0.06885245901639345,Very Cheap
20140529T000000,445000.0,4,1.75,1990,4725,1.5,0,0,4,7,1190,800,1944,0,98126,47.5275,-122.38,1240,4961,2735,3721,94.17989417989418,0.04852459016393443,Very Cheap
20140624T000000,362500.0,4,1.75,1450,8450,1.0,0,0,3,7,1450,0,1960,0,98027,47.5289,-122.028,1540,8450,7000,6910,42.89940828402367,0.03770491803278689,Very Cheap
20140514T000000,234000.0,4,2.0,1630,9010,1.0,0,0,4,7,1050,580,1975,0,98092,47.317,-122.196,1670,7820,7380,6150,25.971143174250834,0.020852459016393442,Very Cheap
20140709T000000,321500.0,1,1.0,730,1942,1.0,0,0,3,7,730,0,2008,0,98144,47.5939,-122.299,1020,2183,1212,1163,165.55097837281153,0.032327868852459016,Very Cheap
20140606T000000,660000.0,3,1.75,1980,3300,1.5,0,0,4,7,1140,840,1926,0,98115,47.6733,-122.298,1590,5000,1320,3410,200.0,0.07672131147540984,Very Cheap
20140925T000000,319000.0,4,1.0,1730,36356,1.5,0,0,4,6,1730,0,1954,0,98031,47.4135,-122.199,1380,14060,34626,12680,8.774342611948509,0.032,Very Cheap
20141020T000000,314000.0,3,1.75,1350,217852,1.0,0,0,3,8,1100,250,1953,0,98022,47.2628,-122.03,2190,217800,216502,215610,1.4413455006150966,0.03134426229508197,Very Cheap
20141006T000000,517950.0,3,2.0,1410,5000,1.0,0,0,5,7,740,670,1908,0,98107,47.6752,-122.361,1830,4000,3590,2170,103.59,0.05809180327868853,Very Cheap
20140714T000000,525000.0,5,2.5,2360,10081,1.0,0,0,4,7,1180,1180,1961,0,98006,47.5552,-122.178,2200,10461,7721,8261,52.078166848526934,0.05901639344262295,Very Cheap
20150211T000000,319500.0,3,1.0,1190,8450,1.0,0,0,5,6,1190,0,1961,0,98059,47.4807,-122.157,1660,8450,7260,6790,37.81065088757396,0.0320655737704918,Very Cheap
20140506T000000,1580000.0,4,3.25,3760,10920,1.5,0,0,5,9,2400,1360,1950,0,98105,47.6687,-122.264,3430,11050,7160,7620,144.6886446886447,0.19737704918032786,Cheap
20140822T000000,325000.0,1,1.0,1220,12426,1.0,0,4,4,6,1220,0,1946,0,98198,47.4047,-122.331,2770,22270,11206,19500,26.15483663286657,0.03278688524590164,Very Cheap
20140731T000000,795000.0,4,2.5,2920,32219,2.0,0,0,5,10,2920,0,1995,0,98077,47.7439,-122.041,3420,37206,29299,33786,24.67488128123157,0.09442622950819672,Very Cheap
20140619T000000,850000.0,2,1.75,1590,5136,1.5,0,3,3,9,1320,270,1927,0,98199,47.6424,-122.411,2520,5243,3546,2723,165.49844236760126,0.10163934426229508,Cheap
20141208T000000,1010000.0,5,3.25,3510,10930,2.0,0,0,3,9,3510,0,2013,0,98033,47.6914,-122.21,1970,7488,7420,5518,92.40622140896615,0.12262295081967213,Cheap
20140804T000000,475000.0,3,2.5,1320,1310,3.0,0,0,3,8,1320,0,2006,0,98107,47.6719,-122.38,1350,1250,-10,-100,362.59541984732823,0.05245901639344262,Very Cheap
20140724T000000,375000.0,3,1.0,1610,11250,1.0,0,0,3,7,1090,520,1975,0,98028,47.7391,-122.256,2040,10692,9640,8652,33.333333333333336,0.03934426229508197,Very Cheap
20140624T000000,405000.0,3,1.0,1410,8053,1.0,0,0,4,7,1410,0,1951,0,98177,47.704,-122.367,1170,8042,6643,6872,50.29181671426797,0.043278688524590166,Very Cheap
20141015T000000,420000.0,4,2.5,2170,10500,1.0,0,0,3,7,1570,600,1962,0,98155,47.7512,-122.295,1850,11127,8330,9277,40.0,0.04524590163934426,Very Cheap
20141016T000000,775000.0,4,1.75,1890,4800,1.5,0,0,3,7,1390,500,1906,0,98119,47.6405,-122.367,1890,4800,2910,2910,161.45833333333334,0.09180327868852459,Very Cheap
20150407T000000,800000.0,4,2.75,3260,5000,2.0,0,0,3,9,3260,0,2007,0,98027,47.5395,-121.997,3450,6218,1740,2768,160.0,0.09508196721311475,Very Cheap
20150401T000000,436800.0,3,1.75,2080,12714,2.0,0,0,4,8,1540,540,1984,0,98052,47.7056,-122.162,2080,12107,10634,10027,34.355828220858896,0.04744918032786885,Very Cheap
20141203T000000,620000.0,3,1.75,2040,4005,1.5,0,0,4,8,1740,300,1930,0,98117,47.6885,-122.38,1380,4005,1965,2625,154.80649188514357,0.07147540983606557,Very Cheap
20150325T000000,230000.0,3,1.0,1250,9035,1.0,0,0,4,7,1250,0,1970,0,98003,47.275,-122.302,1350,10425,7785,9075,25.45655783065855,0.020327868852459016,Very Cheap
20140708T000000,165000.0,1,1.0,850,8050,1.0,0,0,2,6,850,0,1906,0,98118,47.5427,-122.288,1590,5180,7200,3590,20.496894409937887,0.01180327868852459,Very Cheap
20150122T000000,490000.0,1,1.0,850,8050,1.0,0,0,2,6,850,0,1906,0,98118,47.5427,-122.288,1590,5180,7200,3590,60.869565217391305,0.05442622950819672,Very Cheap
20140806T000000,480000.0,3,1.75,1600,8400,1.0,0,0,5,8,1600,0,1963,0,98006,47.5479,-122.179,2210,8400,6800,6190,57.142857142857146,0.05311475409836065,Very Cheap
20140606T000000,570000.0,3,2.5,2400,6975,2.0,0,0,3,9,2400,0,1993,0,98056,47.534,-122.179,2640,11172,4575,8532,81.72043010752688,0.06491803278688525,Very Cheap
20150124T000000,615000.0,3,2.25,1870,4894,2.0,0,0,4,8,1750,120,1992,0,98033,47.6943,-122.19,1920,5988,3024,4068,125.6640784634246,0.07081967213114754,Very Cheap
20140924T000000,280000.0,3,1.0,1720,9605,1.0,0,0,3,7,860,860,1969,0,98028,47.7439,-122.242,1720,9998,7885,8278,29.151483602290472,0.026885245901639345,Very Cheap
20140623T000000,326000.0,3,1.0,1030,9834,1.0,0,0,3,7,1030,0,1969,0,98072,47.7676,-122.164,1210,9875,8804,8665,33.15029489526134,0.032918032786885244,Very Cheap
20150216T000000,550700.0,2,2.25,1190,1499,2.0,0,0,3,9,1100,90,2004,0,98105,47.6666,-122.285,1430,1332,309,-98,367.37825216811206,0.06238688524590164,Very Cheap
20140701T000000,600000.0,2,1.0,910,2002,1.5,0,0,3,6,910,0,1900,0,98112,47.6188,-122.306,1190,1208,1092,18,299.7002997002997,0.06885245901639345,Very Cheap
20140910T000000,450000.0,3,1.0,1290,47044,1.0,0,0,3,7,1150,140,1968,0,98029,47.5655,-121.998,1960,49658,45754,47698,9.56551313663804,0.04918032786885246,Very Cheap
20150309T000000,546000.0,2,2.25,1530,1324,2.0,0,0,3,8,1280,250,2010,0,98122,47.6032,-122.311,1410,1689,-206,279,412.3867069486405,0.06177049180327869,Very Cheap
20150121T000000,585000.0,3,2.5,2330,33750,2.0,0,0,3,9,2330,0,1983,2001,98045,47.4787,-121.723,2270,35000,31420,32730,17.333333333333332,0.06688524590163934,Very Cheap
20141117T000000,489000.0,3,1.75,2090,7667,1.0,0,2,3,7,1200,890,1952,0,98115,47.7007,-122.312,1480,7666,5577,6186,63.77983565931916,0.05429508196721312,Very Cheap
20140617T000000,765000.0,3,2.0,1570,7000,2.0,0,2,4,8,1050,520,1971,0,98122,47.6061,-122.286,1990,6675,5430,4685,109.28571428571429,0.09049180327868853,Very Cheap
20150102T000000,519000.0,3,1.75,1560,26099,1.0,0,3,4,8,1560,0,1973,0,98070,47.5023,-122.467,1760,19687,24539,17927,19.885819380052876,0.05822950819672131,Very Cheap
20140529T000000,262000.0,2,1.0,1500,4120,1.5,0,0,3,5,880,620,1928,0,98055,47.4857,-122.2,1300,4120,2620,2820,63.592233009708735,0.024524590163934427,Very Cheap
20140702T000000,550000.0,4,2.75,2160,5005,1.0,0,0,3,7,1430,730,1987,0,98115,47.6971,-122.302,1770,5326,2845,3556,109.89010989010988,0.06229508196721312,Very Cheap
20140606T000000,285000.0,2,1.0,780,5000,1.0,0,0,4,6,780,0,1943,0,98146,47.5112,-122.357,1030,5000,4220,3970,57.0,0.02754098360655738,Very Cheap
20150204T000000,476000.0,4,1.75,2340,17541,1.0,0,0,4,7,1360,980,1956,0,98028,47.745,-122.229,2250,9212,15201,6962,27.13642323698763,0.052590163934426226,Very Cheap
20140825T000000,2200000.0,3,2.0,3570,30456,1.0,0,1,3,8,2070,1500,1946,1982,98039,47.6413,-122.24,3570,27418,26886,23848,72.23535592329918,0.2786885245901639,Cheap
20140623T000000,335000.0,1,1.0,720,5100,1.0,0,0,3,6,720,0,1907,0,98117,47.6821,-122.38,1320,5100,4380,3780,65.68627450980392,0.03409836065573771,Very Cheap
20141023T000000,510000.0,4,2.0,2990,102366,1.0,0,0,4,8,2990,0,1974,0,98092,47.3068,-122.088,2820,57140,99376,54320,4.982122970517555,0.057049180327868855,Very Cheap
20140918T000000,291000.0,3,2.25,1860,13939,1.0,0,0,4,7,1860,0,1961,0,98030,47.3746,-122.217,1530,10018,12079,8488,20.876676949565965,0.028327868852459016,Very Cheap
20140821T000000,335000.0,4,1.75,1950,13440,1.5,0,0,4,6,1950,0,1931,0,98065,47.5232,-121.821,1300,7432,11490,6132,24.925595238095237,0.03409836065573771,Very Cheap
20140829T000000,415000.0,3,1.5,1860,9003,1.0,0,0,3,7,1490,370,1955,0,98028,47.7624,-122.26,2090,11574,7143,9484,46.09574586249028,0.04459016393442623,Very Cheap
20140708T000000,430000.0,3,2.0,1550,6039,1.0,0,0,5,7,830,720,1942,0,98126,47.5436,-122.378,1330,6042,4489,4712,71.20384169564497,0.04655737704918033,Very Cheap
20150407T000000,270000.0,3,1.75,1610,6205,1.0,0,0,4,7,1210,400,1979,0,98023,47.3004,-122.383,1780,8056,4595,6276,43.51329572925061,0.025573770491803278,Very Cheap
20150407T000000,760000.0,3,2.0,1810,4500,1.0,0,0,4,7,980,830,1906,0,98117,47.681,-122.359,1800,4500,2690,2700,168.88888888888889,0.0898360655737705,Very Cheap
20150508T000000,450000.0,2,2.0,1730,4248,2.0,0,0,3,7,1730,0,1905,0,98144,47.5933,-122.308,1380,4000,2518,2620,105.9322033898305,0.04918032786885246,Very Cheap
20150403T000000,425000.0,3,2.5,1230,23522,1.0,0,0,4,7,1230,0,1978,0,98059,47.515,-122.162,2340,23522,22292,21182,18.0681914803163,0.04590163934426229,Very Cheap
20141121T000000,725000.0,4,2.5,2130,3420,1.5,0,0,4,7,1730,400,1916,0,98103,47.649,-122.336,1520,3420,1290,1900,211.98830409356725,0.08524590163934426,Very Cheap
20140721T000000,700000.0,3,2.75,2190,11060,1.0,0,0,4,7,1610,580,1973,0,98033,47.6893,-122.208,2020,8588,8870,6568,63.29113924050633,0.08196721311475409,Very Cheap
20140826T000000,998000.0,5,4.5,4130,10404,2.0,0,0,3,10,4130,0,2004,0,98029,47.5556,-122.03,3890,11531,6274,7641,95.92464436755094,0.12104918032786885,Cheap
20150508T000000,396000.0,3,2.25,1680,9766,2.0,0,0,3,7,1680,0,1989,0,98019,47.7341,-121.981,1590,9757,8086,8167,40.5488429244317,0.0420983606557377,Very Cheap
20140605T000000,547000.0,3,2.5,1480,8381,1.0,0,0,4,7,1480,0,1968,0,98125,47.7078,-122.288,1710,8050,6901,6340,65.26667462116693,0.061901639344262294,Very Cheap
20150415T000000,302000.0,4,1.5,1790,10200,1.0,0,0,4,8,1210,580,1963,0,98030,47.3774,-122.225,1540,6600,8410,5060,29.607843137254903,0.02977049180327869,Very Cheap
20141021T000000,999000.0,5,3.5,2810,2700,2.0,0,0,5,9,1900,910,1910,0,98117,47.6799,-122.363,1510,3800,-110,2290,370.0,0.12118032786885245,Cheap
20140703T000000,633000.0,4,2.5,2360,10000,1.0,0,3,3,8,1980,380,1977,0,98126,47.573,-122.374,2480,5000,7640,2520,63.3,0.07318032786885247,Very Cheap
20141211T000000,265800.0,3,1.75,1460,7361,1.0,0,0,3,6,1460,0,1982,0,98019,47.7436,-121.979,1460,7505,5901,6045,36.10922429017796,0.02502295081967213,Very Cheap
20141016T000000,530000.0,3,2.25,2160,8114,1.0,0,0,3,8,1460,700,1960,0,98133,47.7176,-122.35,2160,8000,5954,5840,65.3192013803303,0.05967213114754098,Very Cheap
20150501T000000,605000.0,6,2.0,2610,9132,1.0,0,0,4,8,1320,1290,1965,0,98007,47.622,-122.14,2170,8000,6522,5830,66.25054752518616,0.06950819672131148,Very Cheap
20150421T000000,489000.0,4,2.5,2170,4587,2.0,0,0,3,7,2170,0,2006,0,98065,47.5396,-121.889,2170,5211,2417,3041,106.60562459123611,0.05429508196721312,Very Cheap
20140702T000000,305000.0,2,1.0,2160,12960,1.0,0,0,3,7,1360,800,1968,0,98168,47.4702,-122.261,2070,12960,10800,10890,23.53395061728395,0.03016393442622951,Very Cheap
20140613T000000,513000.0,4,2.75,2020,7070,1.0,0,0,5,7,1010,1010,1958,0,98126,47.5202,-122.378,1390,6000,5050,4610,72.56011315417256,0.05744262295081967,Very Cheap
20140716T000000,765000.0,4,2.5,2980,5000,2.0,0,0,3,10,2980,0,2006,0,98027,47.5431,-121.997,3140,5500,2020,2360,153.0,0.09049180327868853,Very Cheap
20140916T000000,550000.0,2,1.5,1300,2970,1.0,0,0,3,7,990,310,1903,0,98102,47.6233,-122.319,1700,3000,1670,1300,185.1851851851852,0.06229508196721312,Very Cheap
20140724T000000,974350.0,4,2.5,3090,10730,2.0,0,0,5,8,2420,670,1985,0,98006,47.5458,-122.141,2220,7875,7640,5655,90.80615097856477,0.11794754098360656,Cheap
20150327T000000,653675.0,4,2.25,2280,7229,2.0,0,0,4,8,2280,0,1984,0,98027,47.5609,-122.081,2320,7735,4949,5415,90.42398672015493,0.07589180327868852,Very Cheap
20141015T000000,245000.0,3,1.75,1260,8614,1.0,0,0,4,7,1260,0,1985,0,98038,47.3586,-122.056,1600,8614,7354,7014,28.442071047132576,0.022295081967213116,Very Cheap
20150505T000000,700180.0,2,1.75,1530,4387,1.0,0,0,3,8,1020,510,1952,0,98115,47.6726,-122.264,1870,5029,2857,3159,159.6033736038295,0.08199081967213115,Very Cheap
20150430T000000,510000.0,3,2.5,1830,8133,1.0,0,0,3,8,1390,440,1996,0,98028,47.7478,-122.247,2310,11522,6303,9212,62.70748801180376,0.057049180327868855,Very Cheap
20141025T000000,390000.0,3,2.5,1610,10292,1.0,0,0,4,7,1190,420,1969,0,98056,47.5349,-122.174,1940,8700,8682,6760,37.893509521958805,0.04131147540983607,Very Cheap
20150504T000000,606500.0,3,2.5,2170,5500,2.0,0,0,3,8,2170,0,2000,0,98075,47.5975,-122.018,2170,5862,3330,3692,110.27272727272727,0.06970491803278689,Very Cheap
20140909T000000,1500000.0,4,4.25,5020,26319,2.0,0,0,3,12,5020,0,1998,0,98074,47.6008,-122.01,4930,26319,21299,21389,56.99304684828451,0.18688524590163935,Cheap
20150507T000000,290000.0,3,2.25,1620,7772,2.0,0,0,4,8,1620,0,1988,0,98003,47.3521,-122.302,1710,6455,6152,4745,37.3134328358209,0.02819672131147541,Very Cheap
20150224T000000,115000.0,3,1.75,1080,7942,1.0,0,0,3,7,1080,0,1981,0,98023,47.3141,-122.355,1380,8244,6862,6864,14.479979853941073,0.005245901639344262,Very Cheap
20140507T000000,500000.0,3,2.5,1940,37565,1.0,0,0,4,8,1940,0,1987,0,98027,47.4801,-122.063,2560,37565,35625,35005,13.31026221216558,0.05573770491803279,Very Cheap
20150413T000000,139950.0,0,0.0,844,4269,1.0,0,0,4,7,844,0,1913,0,98001,47.2781,-122.25,1380,9600,3425,8220,32.78285312719606,0.008518032786885246,Very Cheap
20140515T000000,580050.0,3,2.5,2360,4638,2.0,0,3,3,9,2360,0,1996,0,98115,47.6837,-122.321,1620,4638,2278,3018,125.0646830530401,0.06623606557377049,Very Cheap
20150306T000000,550000.0,3,2.5,2010,2261,2.0,0,0,3,8,1390,620,2014,0,98029,47.5514,-121.998,1690,1899,251,209,243.25519681556833,0.06229508196721312,Very Cheap
20150409T000000,465000.0,3,1.0,800,3060,1.5,0,0,4,6,800,0,1903,0,98117,47.6769,-122.389,1180,3060,2260,1880,151.9607843137255,0.051147540983606556,Very Cheap
20150324T000000,354950.0,3,1.0,970,5922,1.5,0,0,3,7,970,0,1949,0,98125,47.719,-122.321,1730,6128,4952,4398,59.93752110773387,0.036714754098360655,Very Cheap
20141107T000000,980000.0,4,3.25,3720,7150,2.0,0,2,3,11,3720,0,2007,0,98027,47.5359,-122.069,4040,7442,3430,3402,137.06293706293707,0.11868852459016394,Cheap
20140905T000000,500000.0,3,2.25,2010,7447,2.0,0,0,3,8,2010,0,1985,0,98028,47.747,-122.248,2230,7846,5437,5616,67.14113065664026,0.05573770491803279,Very Cheap
20150329T000000,667750.0,4,1.0,1430,4080,1.5,0,0,3,7,1430,0,1924,0,98105,47.6696,-122.324,1760,4080,2650,2320,163.6642156862745,0.0777377049180328,Very Cheap
20150428T000000,735000.0,3,1.75,2250,11520,1.0,0,1,3,8,2250,0,1956,0,98028,47.7619,-122.268,2730,12445,9270,9715,63.802083333333336,0.08655737704918033,Very Cheap
20140917T000000,361000.0,3,1.75,2130,8742,1.0,0,3,3,7,1330,800,1955,0,98178,47.5057,-122.231,2380,7448,6612,5068,41.29489819263326,0.037508196721311476,Very Cheap
20150105T000000,276750.0,3,2.0,1620,12482,1.0,0,0,4,7,1290,330,1989,0,98042,47.3584,-122.086,1560,8499,10862,6939,22.17192757570902,0.026459016393442624,Very Cheap
20140822T000000,760000.0,4,3.25,3140,3680,2.0,0,0,3,10,2310,830,2009,0,98027,47.5319,-122.076,2620,2664,540,44,206.52173913043478,0.0898360655737705,Very Cheap
20140829T000000,475000.0,2,1.0,870,7975,1.0,0,2,3,7,870,0,1946,0,98107,47.6698,-122.361,1080,5722,7105,4642,59.56112852664577,0.05245901639344262,Very Cheap
20140827T000000,234000.0,4,2.5,1820,8217,1.0,0,0,3,7,1120,700,1987,0,98001,47.263,-122.242,1310,8217,6397,6907,28.477546549835708,0.020852459016393442,Very Cheap
20141117T000000,234950.0,3,2.0,1510,9153,1.0,0,0,4,7,1510,0,1974,0,98001,47.3412,-122.273,1780,9286,7643,7506,25.669179503987763,0.02097704918032787,Very Cheap
20150222T000000,269950.0,2,1.75,1320,7540,1.0,0,0,3,7,1320,0,1968,0,98038,47.3634,-122.052,1570,7540,6220,5970,35.80238726790451,0.025567213114754097,Very Cheap
20150112T000000,495000.0,3,2.5,1800,7318,2.0,0,0,3,8,1800,0,1989,0,98029,47.5747,-122.008,1800,5414,5518,3614,67.6414320852692,0.05508196721311476,Very Cheap
20150318T000000,438000.0,2,1.0,1120,6380,1.0,0,0,3,7,1120,0,1942,1994,98115,47.6951,-122.316,1230,6380,5260,5150,68.65203761755485,0.04760655737704918,Very Cheap
20150224T000000,260000.0,3,1.75,2160,22702,1.0,0,0,4,7,2160,0,1981,0,98019,47.7355,-121.982,1820,22687,20542,20867,11.452735441811294,0.024262295081967214,Very Cheap
20141208T000000,697000.0,4,2.5,3220,6399,2.0,0,0,3,9,3220,0,2004,0,98075,47.5883,-121.991,2850,6399,3179,3549,108.923269260822,0.08157377049180328,Very Cheap
20150310T000000,212625.0,2,1.0,960,5000,1.0,0,0,3,6,960,0,1951,0,98126,47.5188,-122.372,930,5000,4040,4070,42.525,0.01804918032786885,Very Cheap
20141110T000000,593000.0,5,2.5,2640,4400,1.5,0,0,5,7,1840,800,1925,0,98122,47.605,-122.3,1720,4400,1760,2680,134.77272727272728,0.0679344262295082,Very Cheap
20141212T000000,410000.0,4,3.0,2430,7243,2.0,0,0,3,8,2430,0,2003,0,98038,47.3533,-122.016,2430,7084,4813,4654,56.60637857241475,0.043934426229508196,Very Cheap
20140610T000000,445434.0,2,1.0,1470,7137,1.0,0,0,3,7,1020,450,1941,0,98103,47.7008,-122.352,1470,7067,5667,5597,62.41193778898697,0.04858150819672131,Very Cheap
20140911T000000,200126.0,3,2.5,2040,15463,1.0,0,0,3,8,1340,700,1968,0,98003,47.3334,-122.322,2370,12672,13423,10302,12.94224924012158,0.016409967213114753,Very Cheap
20140811T000000,290700.0,3,2.5,1670,6666,2.0,0,0,4,7,1670,0,1992,0,98038,47.3488,-122.033,1370,6170,4996,4800,43.60936093609361,0.028288524590163934,Very Cheap
20150129T000000,248000.0,4,1.0,1010,7515,1.0,0,0,4,6,1010,0,1955,0,98198,47.4174,-122.316,1330,7515,6505,6185,33.000665335994675,0.022688524590163933,Very Cheap
20141013T000000,345000.0,1,1.0,540,10125,1.0,0,0,3,5,540,0,1961,0,98177,47.7739,-122.358,1840,10125,9585,8285,34.074074074074076,0.03540983606557377,Very Cheap
20140820T000000,525000.0,3,1.0,1240,4800,1.0,0,0,3,7,800,440,1951,0,98103,47.6563,-122.353,1440,4800,3560,3360,109.375,0.05901639344262295,Very Cheap
20141212T000000,400000.0,3,1.75,1510,8385,1.0,0,0,3,7,1510,0,1968,0,98034,47.7279,-122.195,1570,7480,6875,5910,47.70423375074538,0.04262295081967213,Very Cheap
20150408T000000,532000.0,3,1.0,1820,5750,1.0,0,0,3,7,1120,700,1918,0,98116,47.5773,-122.383,1500,5750,3930,4250,92.52173913043478,0.059934426229508196,Very Cheap
20141028T000000,159995.0,2,1.0,1000,5026,1.0,0,0,5,5,760,240,1915,0,98002,47.297,-122.225,990,5026,4026,4036,31.833465976920017,0.01114688524590164,Very Cheap
20141016T000000,287000.0,5,1.5,2040,11772,1.0,0,0,4,7,1030,1010,1963,0,98056,47.5015,-122.166,1560,9435,9732,7875,24.37988447162759,0.02780327868852459,Very Cheap
20150420T000000,1115000.0,4,2.5,3690,11191,1.0,0,3,4,10,2190,1500,1951,0,98199,47.6434,-122.412,3460,8160,7501,4700,99.63363417031543,0.13639344262295083,Cheap
20150423T000000,765000.0,3,2.5,2310,11993,2.0,0,0,3,9,2310,0,1988,0,98006,47.5438,-122.139,2830,10031,9683,7201,63.7872092053698,0.09049180327868853,Very Cheap
20141114T000000,185000.0,3,1.5,1090,9605,1.0,0,0,4,6,1090,0,1969,0,98038,47.3609,-122.028,1160,10487,8515,9327,19.260801665799065,0.014426229508196721,Very Cheap
20140521T000000,430000.0,3,1.0,1150,3000,1.0,0,0,5,6,1150,0,1906,0,98103,47.6867,-122.345,1460,3200,1850,1740,143.33333333333334,0.04655737704918033,Very Cheap
20140526T000000,346000.0,4,2.5,2100,3916,2.0,0,0,3,8,2100,0,2009,0,98058,47.4324,-122.185,2100,3916,1816,1816,88.35546475995915,0.03554098360655738,Very Cheap
20140715T000000,607000.0,4,2.75,2150,16728,1.0,0,0,4,8,1240,910,1982,0,98033,47.6915,-122.183,2200,9257,14578,7057,36.28646580583453,0.06977049180327868,Very Cheap
20140804T000000,417000.0,3,1.5,2500,6000,1.5,0,0,5,7,1730,770,1941,1984,98106,47.5297,-122.354,1340,5000,3500,3660,69.5,0.04485245901639344,Very Cheap
20140619T000000,930000.0,5,2.0,3530,9385,1.5,0,0,3,9,3530,0,1925,0,98144,47.5774,-122.285,4100,9203,5855,5103,99.09429941395844,0.1121311475409836,Cheap
20150423T000000,573300.0,2,1.75,1290,6600,1.0,0,2,3,7,870,420,1951,0,98136,47.531,-122.39,2380,7370,5310,4990,86.86363636363636,0.06535081967213115,Very Cheap
20150406T000000,260000.0,4,1.75,2010,10816,1.0,0,0,3,7,1410,600,1955,0,98178,47.5048,-122.251,1610,9360,8806,7750,24.03846153846154,0.024262295081967214,Very Cheap
20140612T000000,280000.0,1,0.75,420,6720,1.0,0,0,3,5,420,0,1922,0,98108,47.552,-122.311,1420,6720,6300,5300,41.666666666666664,0.026885245901639345,Very Cheap
20141218T000000,825000.0,4,2.5,2180,4000,2.0,0,0,3,8,2180,0,1920,2005,98122,47.6186,-122.288,2660,4000,1820,1340,206.25,0.09836065573770492,Very Cheap
20140610T000000,307000.0,4,1.0,1150,8184,1.5,0,0,3,6,1150,0,1947,0,98155,47.7431,-122.319,990,8184,7034,7194,37.51221896383187,0.03042622950819672,Very Cheap
20140813T000000,595000.0,4,1.75,2000,5100,1.0,0,0,4,7,1130,870,1949,0,98117,47.6798,-122.391,1540,5100,3100,3560,116.66666666666667,0.06819672131147542,Very Cheap
20150415T000000,528000.0,5,1.75,2780,7786,1.0,0,0,3,8,1390,1390,1966,0,98052,47.6694,-122.157,2130,7918,5006,5788,67.81402517338813,0.05940983606557377,Very Cheap
20140822T000000,600000.0,2,1.75,1550,7764,1.0,1,4,4,8,1550,0,1965,1986,98070,47.358,-122.446,1690,11620,6214,9930,77.27975270479135,0.06885245901639345,Very Cheap
20150302T000000,275000.0,2,1.0,2180,12875,1.0,0,0,3,7,1480,700,1959,0,98198,47.3757,-122.303,1800,7447,10695,5647,21.359223300970875,0.02622950819672131,Very Cheap
20140702T000000,782000.0,2,1.5,1570,3600,1.5,0,2,4,7,1320,250,1906,0,98119,47.6366,-122.363,2140,3600,2030,1460,217.22222222222223,0.09272131147540984,Very Cheap
20140808T000000,610000.0,3,2.5,2260,33042,1.0,0,0,3,9,1660,600,1986,0,98077,47.7634,-122.086,2600,40115,30782,37515,18.46135221838872,0.07016393442622951,Very Cheap
20141125T000000,488000.0,3,1.0,1600,3200,1.5,0,0,3,7,1600,0,1909,0,98103,47.653,-122.331,1860,3420,1600,1560,152.5,0.05416393442622951,Very Cheap
20150403T000000,320000.0,3,1.0,1630,5000,1.0,0,0,3,7,930,700,1954,0,98108,47.5497,-122.295,1630,5480,3370,3850,64.0,0.032131147540983604,Very Cheap
20150318T000000,153500.0,3,1.0,890,4810,1.0,0,0,3,6,890,0,1910,0,98118,47.5153,-122.266,1230,6057,3920,4827,31.91268191268191,0.010295081967213114,Very Cheap
20150319T000000,414500.0,3,1.0,1350,9450,1.0,0,0,3,7,1350,0,1979,0,98034,47.7186,-122.236,1460,9461,8100,8001,43.86243386243386,0.044524590163934424,Very Cheap
20140804T000000,750000.0,5,1.75,2850,11860,1.0,0,0,3,9,2850,0,1951,0,98155,47.7503,-122.28,2640,11604,9010,8964,63.23777403035413,0.08852459016393442,Very Cheap
20150313T000000,349990.0,3,1.0,1350,165092,1.0,0,3,5,6,1350,0,1925,0,98022,47.2217,-122.063,2300,211266,163742,208966,2.1199694715673685,0.036064262295081966,Very Cheap
20141201T000000,645000.0,3,2.25,3280,79279,1.0,0,0,3,10,3280,0,2001,0,98003,47.3207,-122.293,1860,24008,75999,22148,8.13582411483495,0.07475409836065573,Very Cheap
20150406T000000,425000.0,2,1.0,1090,6000,1.0,0,0,3,7,1090,0,1922,0,98144,47.5886,-122.292,1960,5000,4910,3040,70.83333333333333,0.04590163934426229,Very Cheap
20140805T000000,785000.0,4,2.5,2990,9374,2.0,0,0,3,9,2990,0,2003,0,98074,47.6287,-122.024,2440,8711,6384,6271,83.74226584168979,0.09311475409836066,Very Cheap
20141107T000000,290000.0,3,1.75,1340,63597,1.0,0,0,4,7,1340,0,1963,0,98038,47.4379,-122.011,1950,87120,62257,85170,4.559963520291838,0.02819672131147541,Very Cheap
20150401T000000,415000.0,3,1.75,1340,63597,1.0,0,0,4,7,1340,0,1963,0,98038,47.4379,-122.011,1950,87120,62257,85170,6.525465037659009,0.04459016393442623,Very Cheap
20140814T000000,248500.0,2,1.0,720,5160,1.0,0,0,3,6,720,0,1949,0,98106,47.5274,-122.357,990,5160,4440,4170,48.15891472868217,0.02275409836065574,Very Cheap
20140723T000000,325000.0,3,2.5,2330,8627,1.0,0,0,4,7,1480,850,1980,0,98055,47.4543,-122.21,1940,9607,6297,7667,37.6724237857888,0.03278688524590164,Very Cheap
20140723T000000,272925.0,2,1.0,1280,5728,1.5,0,0,5,6,1280,0,1941,0,98028,47.7477,-122.232,2480,9775,4448,7295,47.64752094972067,0.025957377049180327,Very Cheap
20140826T000000,500000.0,2,2.25,1570,1269,2.0,0,0,3,9,1280,290,2015,0,98199,47.6514,-122.385,1570,6000,-301,4430,394.01103230890465,0.05573770491803279,Very Cheap
20141020T000000,250000.0,4,1.75,1510,5500,1.5,0,0,3,7,1510,0,1920,0,98106,47.535,-122.359,1320,6431,3990,5111,45.45454545454545,0.022950819672131147,Very Cheap
20140922T000000,470000.0,4,2.5,2470,8536,2.0,0,0,3,8,2470,0,2002,0,98155,47.7699,-122.292,1690,8840,6066,7150,55.06091846298032,0.05180327868852459,Very Cheap
20141001T000000,440000.0,2,1.0,1190,3400,1.0,0,0,4,7,990,200,1917,0,98118,47.5539,-122.268,1180,4000,2210,2820,129.41176470588235,0.04786885245901639,Very Cheap
20150105T000000,299999.0,4,2.5,1981,4828,2.0,0,0,3,8,1981,0,2013,0,98092,47.3252,-122.167,1981,3783,2847,1802,62.13732394366197,0.029508065573770493,Very Cheap
20150327T000000,255000.0,3,1.75,1590,7810,1.0,0,0,4,7,1590,0,1959,0,98002,47.2932,-122.22,1470,7810,6220,6340,32.65044814340589,0.02360655737704918,Very Cheap
20140813T000000,415950.0,3,1.75,1150,7700,1.0,0,0,3,7,1150,0,1957,0,98008,47.6048,-122.121,1650,8000,6550,6350,54.01948051948052,0.044714754098360655,Very Cheap
20140805T000000,402000.0,5,2.75,2160,7200,1.5,0,0,3,7,1220,940,1955,0,98118,47.5576,-122.273,1900,7200,5040,5300,55.833333333333336,0.04288524590163934,Very Cheap
20150424T000000,729000.0,3,1.5,1770,30689,1.0,0,4,3,9,1770,0,1953,0,98177,47.7648,-122.37,2650,30280,28919,27630,23.75443970152172,0.08577049180327868,Very Cheap
20140917T000000,635000.0,2,2.5,2470,8840,2.0,0,0,4,8,1780,690,2001,0,98108,47.5693,-122.301,1940,8840,6370,6900,71.83257918552036,0.07344262295081967,Very Cheap
20141008T000000,479000.0,3,2.5,1710,8998,2.0,0,0,3,8,1710,0,1982,0,98052,47.7236,-122.11,1710,9859,7288,8149,53.23405201155813,0.05298360655737705,Very Cheap
20141222T000000,462370.0,2,2.25,1860,2670,2.0,0,0,4,8,1860,0,1986,0,98006,47.5436,-122.187,1860,2531,810,671,173.17228464419475,0.05080262295081967,Very Cheap
20150501T000000,171500.0,3,1.0,1150,6480,1.5,0,0,4,5,1150,0,1946,0,98001,47.2642,-122.258,1100,7300,5330,6200,26.46604938271605,0.012655737704918032,Very Cheap
20140715T000000,925000.0,5,3.0,3850,9457,2.0,0,0,4,9,2910,940,1963,0,98177,47.727,-122.362,2830,9608,5607,6778,97.81114518346199,0.11147540983606558,Cheap
20140513T000000,675000.0,5,3.0,3410,9600,1.0,0,0,4,8,1870,1540,1968,0,98052,47.6358,-122.103,2390,9679,6190,7289,70.3125,0.07868852459016394,Very Cheap
20140623T000000,320000.0,4,1.5,1890,43560,1.0,0,0,4,8,1890,0,1974,0,98092,47.3267,-122.166,2376,5820,41670,3444,7.3461891643709825,0.032131147540983604,Very Cheap
20140520T000000,499950.0,5,3.5,3200,43560,2.0,0,0,3,7,3200,0,1989,0,98059,47.475,-122.093,2730,43560,40360,40830,11.477272727272727,0.05573114754098361,Very Cheap
20141117T000000,435000.0,5,1.0,2170,65340,1.5,0,0,4,7,1670,500,1930,0,98011,47.7555,-122.204,3170,12884,63170,9714,6.657483930211203,0.04721311475409836,Very Cheap
20140605T000000,359800.0,4,2.5,2390,6426,2.0,0,0,3,9,2390,0,1999,0,98092,47.2586,-122.221,2520,6700,4036,4180,55.99128540305011,0.03735081967213115,Very Cheap
20140507T000000,239900.0,3,2.0,1410,7566,1.0,0,0,3,7,1410,0,1985,0,98030,47.3674,-122.182,1570,7210,6156,5640,31.707639439598204,0.02162622950819672,Very Cheap
20140710T000000,295000.0,2,1.0,740,4459,1.0,0,2,3,5,740,0,1915,0,98116,47.5704,-122.409,1490,4700,3719,3210,66.15833146445391,0.028852459016393443,Very Cheap
20150304T000000,380000.0,3,2.5,2150,25705,1.5,0,0,3,6,2150,0,1980,2009,98058,47.4514,-122.089,1850,20160,23555,18310,14.783116125267458,0.04,Very Cheap
20150421T000000,435000.0,4,2.5,2180,6500,2.0,0,0,3,7,1410,770,1945,0,98126,47.5365,-122.37,920,6500,4320,5580,66.92307692307692,0.04721311475409836,Very Cheap
20140820T000000,508000.0,2,1.0,820,5040,1.0,0,0,3,7,820,0,1953,0,98199,47.6498,-122.388,1730,5760,4220,4030,100.7936507936508,0.05678688524590164,Very Cheap
20140620T000000,2400000.0,6,4.5,5480,10800,2.0,0,3,4,9,4430,1050,1999,0,98119,47.6307,-122.367,2970,7200,5320,4230,222.22222222222223,0.30491803278688523,Medium
20140916T000000,234500.0,4,2.5,1960,7875,1.0,0,0,3,7,1220,740,1978,0,98001,47.3427,-122.274,2030,7650,5915,5620,29.77777777777778,0.020918032786885248,Very Cheap
20140528T000000,355000.0,2,1.0,1270,3200,1.0,0,0,4,7,960,310,1920,0,98103,47.6565,-122.348,1410,1320,1930,-90,110.9375,0.036721311475409836,Very Cheap
20140801T000000,230000.0,3,2.0,1710,5200,1.0,0,0,5,7,1030,680,1977,0,98042,47.3651,-122.094,1390,5200,3490,3810,44.23076923076923,0.020327868852459016,Very Cheap
20150211T000000,345000.0,3,1.75,1930,9000,1.0,0,1,4,7,1150,780,1951,0,98166,47.4539,-122.348,1590,9000,7070,7410,38.333333333333336,0.03540983606557377,Very Cheap
20140520T000000,430000.0,3,1.75,1200,4500,1.0,0,0,5,7,1200,0,1906,0,98108,47.5553,-122.316,1340,4500,3300,3160,95.55555555555556,0.04655737704918033,Very Cheap
20141215T000000,500000.0,3,1.5,1680,17409,1.0,0,0,3,7,1680,0,1962,0,98033,47.6766,-122.176,1680,9101,15729,7421,28.72077660979953,0.05573770491803279,Very Cheap
20150505T000000,378000.0,4,1.0,1300,6075,1.0,0,0,5,7,1300,0,1954,0,98133,47.773,-122.349,1450,7320,4775,5870,62.22222222222222,0.03973770491803279,Very Cheap
20140808T000000,345000.0,3,2.5,1540,3237,2.0,0,0,3,7,1540,0,1999,0,98065,47.5299,-121.878,1780,3411,1697,1631,106.58016682113067,0.03540983606557377,Very Cheap
20150329T000000,410000.0,2,1.75,870,4000,1.0,0,0,3,6,870,0,1941,0,98126,47.5657,-122.376,1420,4000,3130,2580,102.5,0.043934426229508196,Very Cheap
20140822T000000,750000.0,2,2.25,1890,5400,2.0,0,0,5,8,1610,280,1905,0,98105,47.6688,-122.31,2820,4860,3510,2040,138.88888888888889,0.08852459016393442,Very Cheap
20150122T000000,485000.0,4,1.75,2050,8913,1.0,0,0,3,7,1330,720,1968,0,98052,47.6735,-122.151,1290,8550,6863,7260,54.414899584876025,0.05377049180327869,Very Cheap
20150317T000000,105000.0,3,1.0,880,18109,1.0,0,0,4,6,880,0,1970,0,98042,47.3634,-122.101,940,11193,17229,10253,5.798221878623889,0.003934426229508197,Very Cheap
20150423T000000,1025000.0,3,2.75,2780,4000,2.0,0,2,5,8,1960,820,1904,0,98103,47.6565,-122.355,1490,4800,1220,3310,256.25,0.12459016393442623,Cheap
20141014T000000,360000.0,3,1.0,1160,10988,1.0,0,0,3,7,1160,0,1965,0,98033,47.6818,-122.165,1670,51376,9828,49706,32.763014197306155,0.037377049180327866,Very Cheap
20141030T000000,294000.0,5,2.75,2300,7600,1.0,0,0,4,7,1400,900,1969,0,98023,47.3084,-122.372,1750,8500,5300,6750,38.68421052631579,0.028721311475409836,Very Cheap
20141009T000000,400000.0,4,2.5,3140,12792,2.0,0,0,4,9,3140,0,1977,0,98042,47.3863,-122.156,2510,12792,9652,10282,31.269543464665414,0.04262295081967213,Very Cheap
20150102T000000,325000.0,3,1.75,2300,6200,1.0,0,0,4,7,1150,1150,1970,0,98198,47.4176,-122.323,1740,6600,3900,4860,52.41935483870968,0.03278688524590164,Very Cheap
20140904T000000,770000.0,3,2.5,2900,23550,1.0,0,0,3,10,1490,1410,1987,0,98006,47.5708,-122.153,2900,19604,20650,16704,32.696390658174096,0.09114754098360656,Very Cheap
20140709T000000,443000.0,3,2.25,1920,8223,2.0,0,0,4,7,1920,0,1989,0,98011,47.735,-122.201,1940,7274,6303,5334,53.87328225708379,0.048262295081967214,Very Cheap
20140917T000000,325000.0,3,1.0,1150,7486,1.0,0,0,3,7,1150,0,1970,0,98034,47.7261,-122.219,1510,7486,6336,5976,43.41437349719477,0.03278688524590164,Very Cheap
20150123T000000,760000.0,4,2.5,3120,8792,2.0,0,0,4,9,3120,0,1992,0,98029,47.5699,-121.993,2150,7688,5672,5538,86.44222020018198,0.0898360655737705,Very Cheap
20140515T000000,640000.0,4,2.0,2560,7798,1.0,0,0,4,7,1890,670,1947,0,98115,47.6914,-122.296,1330,7798,5238,6468,82.0723262374968,0.0740983606557377,Very Cheap
20150406T000000,415000.0,3,2.0,1410,4303,1.5,0,0,4,7,1410,0,1900,0,98108,47.5541,-122.317,1660,4326,2893,2666,96.44434115733209,0.04459016393442623,Very Cheap
20140512T000000,156000.0,3,1.0,970,8580,1.0,0,0,3,7,970,0,1959,0,98003,47.3363,-122.311,1430,11907,7610,10477,18.181818181818183,0.010622950819672131,Very Cheap
20140922T000000,996000.0,3,3.25,3620,8131,2.0,0,0,4,10,2730,890,1988,0,98040,47.5776,-122.214,2040,3776,4511,1736,122.49415816012791,0.12078688524590164,Cheap
20150327T000000,415000.0,2,1.0,880,5100,1.0,0,0,4,7,880,0,1941,0,98103,47.694,-122.346,980,5100,4220,4120,81.37254901960785,0.04459016393442623,Very Cheap
20140926T000000,615000.0,3,1.75,1900,3783,1.5,0,0,5,7,1110,790,1927,0,98144,47.5742,-122.315,1530,5098,1883,3568,162.56938937351308,0.07081967213114754,Very Cheap
20141007T000000,717000.0,4,2.5,2540,4241,2.0,0,0,3,8,2540,0,2009,0,98052,47.7073,-122.112,3010,4929,1701,1919,169.06390002357935,0.0841967213114754,Very Cheap
20150331T000000,548000.0,4,1.75,1690,7794,1.0,0,0,3,7,1090,600,1968,0,98033,47.6888,-122.203,1380,7325,6104,5945,70.31049525275853,0.062032786885245904,Very Cheap
20150401T000000,425000.0,3,1.5,1120,6653,1.0,0,0,4,7,1120,0,1937,0,98133,47.7321,-122.334,1580,7355,5533,5775,63.88095595971742,0.04590163934426229,Very Cheap
20141027T000000,325250.0,4,2.75,2130,9339,1.0,0,0,3,7,1330,800,1991,0,98198,47.3788,-122.316,2090,7628,7209,5538,34.8270692793661,0.03281967213114754,Very Cheap
20140801T000000,1225000.0,3,2.5,3420,79279,2.0,0,0,3,11,3420,0,1990,0,98052,47.7225,-122.126,4240,40500,75859,36260,15.451758977787309,0.15081967213114755,Cheap
20140625T000000,557500.0,3,1.75,1900,11165,1.0,0,0,4,7,1900,0,1959,0,98008,47.5789,-122.118,2030,11165,9265,9135,49.93282579489476,0.06327868852459016,Very Cheap
20140714T000000,1260500.0,4,2.5,3730,16950,2.0,0,0,3,10,3730,0,1990,0,98040,47.5678,-122.228,3200,16950,13220,13750,74.36578171091445,0.1554754098360656,Cheap
20140910T000000,249950.0,3,3.0,1790,2003,2.0,0,0,3,7,1480,310,2006,0,98108,47.5421,-122.321,1220,4000,213,2780,124.78781827259111,0.022944262295081966,Very Cheap
20140916T000000,260000.0,4,2.75,2250,7345,1.0,0,0,4,8,1320,930,1984,0,98023,47.2895,-122.37,1800,6950,5095,5150,35.39823008849557,0.024262295081967214,Very Cheap
20140611T000000,1989000.0,3,2.5,2880,13500,1.0,0,4,5,8,1520,1360,1950,0,98004,47.6281,-122.216,3710,20486,10620,16776,147.33333333333334,0.25101639344262294,Cheap
20140621T000000,442900.0,4,1.75,1780,2788,1.0,0,0,4,6,890,890,1943,0,98199,47.6511,-122.4,1760,5664,1008,3904,158.8593974175036,0.04824918032786885,Very Cheap
20140613T000000,475000.0,3,2.25,1580,12177,1.0,0,0,3,7,1200,380,1981,0,98074,47.6254,-122.045,1660,11374,10597,9714,39.00796583723413,0.05245901639344262,Very Cheap
20140813T000000,365000.0,5,2.75,3260,9253,2.0,0,0,3,8,3260,0,2004,0,98042,47.3674,-122.07,2770,8067,5993,5297,39.446665946179614,0.0380327868852459,Very Cheap
20150426T000000,780000.0,4,2.5,3180,9603,2.0,0,2,3,9,3180,0,2002,0,98155,47.7717,-122.277,2440,15261,6423,12821,81.22461730709153,0.09245901639344262,Very Cheap
20150227T000000,930000.0,3,1.75,2460,4240,1.0,0,0,4,7,1230,1230,1925,0,98103,47.6593,-122.337,1700,4240,1780,2540,219.33962264150944,0.1121311475409836,Cheap
20140611T000000,2888000.0,5,6.25,8670,64033,2.0,0,4,3,13,6120,2550,1965,2003,98177,47.7295,-122.372,4140,81021,55363,76881,45.101744413037025,0.36891803278688523,Medium
20140818T000000,350000.0,3,1.0,1020,4980,1.0,0,0,4,7,850,170,1941,0,98133,47.7039,-122.34,970,4980,3960,4010,70.28112449799197,0.036065573770491806,Very Cheap
20141218T000000,357500.0,3,1.75,1630,9403,1.0,0,0,3,7,1630,0,1983,0,98155,47.757,-122.316,1430,8461,7773,7031,38.01978092098266,0.03704918032786885,Very Cheap
20140521T000000,520000.0,4,2.5,3290,11446,2.0,0,0,3,8,3290,0,1992,0,98028,47.7399,-122.234,2050,11933,8156,9883,45.43071815481391,0.058360655737704915,Very Cheap
20140509T000000,330000.0,4,2.5,1940,3784,2.0,0,0,3,8,1940,0,2003,0,98058,47.4513,-122.119,1940,4499,1844,2559,87.20930232558139,0.03344262295081967,Very Cheap
20140604T000000,310000.0,3,2.0,1350,11150,1.0,0,0,3,7,1110,240,1995,0,98045,47.446,-121.776,1290,10043,9800,8753,27.80269058295964,0.03081967213114754,Very Cheap
20150213T000000,279000.0,3,1.0,1110,6060,1.0,0,0,3,6,1110,0,1949,0,98166,47.4705,-122.352,1480,8100,4950,6620,46.039603960396036,0.02675409836065574,Very Cheap
20140725T000000,540000.0,4,1.5,2993,19400,2.0,0,0,4,7,2233,760,1921,0,98166,47.4692,-122.365,2060,15100,16407,13040,27.835051546391753,0.06098360655737705,Very Cheap
20140530T000000,322000.0,4,2.5,2280,7200,2.0,0,0,3,8,2280,0,1994,0,98030,47.3829,-122.207,2250,7200,4920,4950,44.72222222222222,0.03239344262295082,Very Cheap
20150312T000000,380000.0,5,3.25,3800,15500,1.0,0,0,3,7,2490,1310,1965,0,98032,47.3862,-122.28,2000,13980,11700,11980,24.516129032258064,0.04,Very Cheap
20150428T000000,320000.0,2,1.0,850,8400,1.0,0,0,4,6,850,0,1941,0,98166,47.4696,-122.359,1280,8400,7550,7120,38.095238095238095,0.032131147540983604,Very Cheap
20140922T000000,400000.0,3,1.75,1560,8456,1.0,0,0,5,7,1560,0,1970,0,98028,47.7769,-122.25,2230,13109,6896,10879,47.30368968779565,0.04262295081967213,Very Cheap
20140822T000000,412000.0,3,1.0,1000,3844,1.0,0,0,5,7,900,100,1928,0,98133,47.7031,-122.349,1000,3920,2844,2920,107.18002081165453,0.04419672131147541,Very Cheap
20150407T000000,887200.0,3,1.0,1400,5100,1.5,0,0,3,7,1400,0,1900,0,98103,47.6677,-122.333,1740,3060,3700,1320,173.9607843137255,0.10651803278688525,Cheap
20140624T000000,395000.0,4,1.75,1540,5120,1.0,0,0,5,6,770,770,1943,0,98126,47.5359,-122.372,1080,5120,3580,4040,77.1484375,0.0419672131147541,Very Cheap
20150429T000000,895000.0,4,3.0,3570,10273,1.5,0,3,3,9,2630,940,1935,2007,98074,47.6394,-122.077,3640,15324,6703,11684,87.12158084298648,0.10754098360655738,Cheap
20141119T000000,195000.0,2,1.0,800,5280,1.0,0,0,5,6,800,0,1918,0,98022,47.205,-121.995,1240,7670,4480,6430,36.93181818181818,0.015737704918032787,Very Cheap
20140620T000000,390000.0,3,1.0,1160,3750,1.5,0,0,3,7,1160,0,1910,0,98106,47.5652,-122.359,1530,3750,2590,2220,104.0,0.04131147540983607,Very Cheap
20141111T000000,165000.0,3,1.0,1010,7690,1.0,0,0,4,6,1010,0,1958,0,98058,47.4501,-122.176,1010,7619,6680,6609,21.456436931079324,0.01180327868852459,Very Cheap
20150508T000000,255000.0,3,1.0,1010,7690,1.0,0,0,4,6,1010,0,1958,0,98058,47.4501,-122.176,1010,7619,6680,6609,33.159947984395316,0.02360655737704918,Very Cheap
20150316T000000,589000.0,4,2.25,2390,57599,2.0,0,0,3,8,2390,0,1981,0,98053,47.6651,-122.067,2390,38186,55209,35796,10.225871976944044,0.06740983606557377,Very Cheap
20140619T000000,505000.0,3,2.5,1610,4611,2.0,0,0,3,8,1610,0,1996,0,98029,47.5678,-122.004,1730,4461,3001,2731,109.52071134244198,0.05639344262295082,Very Cheap
20150223T000000,335750.0,3,3.0,2400,7260,1.0,0,0,3,7,1440,960,1955,0,98178,47.5045,-122.251,1060,7200,4860,6140,46.2465564738292,0.03419672131147541,Very Cheap
20150115T000000,719000.0,3,1.75,1800,5816,1.0,0,0,5,7,900,900,1947,0,98199,47.6529,-122.407,1650,5816,4016,4166,123.62448418156809,0.08445901639344262,Very Cheap
20140909T000000,796000.0,4,3.25,2110,3000,2.0,0,0,3,8,2110,0,2001,0,98115,47.6769,-122.328,1780,4000,890,2220,265.3333333333333,0.09455737704918032,Very Cheap
20150408T000000,95000.0,2,1.0,960,7000,1.0,0,0,3,4,960,0,1918,0,98198,47.3864,-122.307,1850,8120,6040,6270,13.571428571428571,0.002622950819672131,Very Cheap
20140529T000000,525000.0,3,3.0,2600,5238,1.5,0,3,3,9,1890,710,1989,0,98198,47.3448,-122.327,2220,4853,2638,2633,100.2290950744559,0.05901639344262295,Very Cheap
20140515T000000,417000.0,3,1.5,1340,10224,1.0,0,0,4,7,1340,0,1956,0,98006,47.5752,-122.157,1340,10440,8884,9100,40.786384976525824,0.04485245901639344,Very Cheap
20150420T000000,410000.0,3,1.0,1410,5000,1.0,0,0,3,6,980,430,1925,0,98116,47.5769,-122.397,1410,5000,3590,3590,82.0,0.043934426229508196,Very Cheap
20150112T000000,984000.0,4,2.25,2390,12292,1.0,0,0,5,9,2390,0,1962,0,98040,47.5528,-122.221,2870,12337,9902,9467,80.05206638464041,0.11921311475409836,Cheap
20150403T000000,325000.0,2,1.5,1180,834,3.0,0,0,3,8,1180,0,2009,0,98133,47.7074,-122.356,1180,1207,-346,27,389.6882494004796,0.03278688524590164,Very Cheap
20140507T000000,314950.0,3,1.0,1040,16986,1.0,0,0,4,7,1040,0,1968,0,98059,47.4812,-122.097,1660,16986,15946,15326,18.541740256681972,0.03146885245901639,Very Cheap
20140923T000000,350000.0,3,2.25,1840,9929,1.0,0,0,3,7,1200,640,1987,0,98028,47.7408,-122.236,1710,9929,8089,8219,35.25027696646188,0.036065573770491806,Very Cheap
20141027T000000,1045000.0,4,2.25,2630,4000,2.0,0,0,5,9,1810,820,1909,0,98102,47.6393,-122.317,2370,4700,1370,2330,261.25,0.12721311475409836,Cheap
20140710T000000,657000.0,4,2.5,2640,25038,2.0,0,0,4,8,2640,0,1995,0,98056,47.5277,-122.174,2630,16668,22398,14038,26.240115025161753,0.07632786885245901,Very Cheap
20150408T000000,234950.0,2,2.5,1720,3132,2.0,0,0,3,8,1720,0,1999,0,98042,47.3728,-122.157,1740,4220,1412,2480,75.01596424010216,0.02097704918032787,Very Cheap
20150320T000000,410000.0,4,1.75,2320,7500,1.0,0,0,3,7,1220,1100,1955,0,98133,47.7574,-122.343,2230,7500,5180,5270,54.666666666666664,0.043934426229508196,Very Cheap
20150417T000000,625000.0,3,1.75,1840,5664,2.0,0,0,3,7,1270,570,1948,0,98115,47.6899,-122.283,1480,5664,3824,4184,110.34604519774011,0.07213114754098361,Very Cheap
20150423T000000,706000.0,5,2.5,2890,15891,2.0,0,0,3,9,2890,0,1990,0,98059,47.5286,-122.16,2590,10556,13001,7966,44.42766345730288,0.08275409836065574,Very Cheap
20140519T000000,485000.0,3,1.75,2200,7706,2.0,0,2,3,7,2200,0,1908,1988,98198,47.3878,-122.326,1170,70973,5506,69803,62.93797041266546,0.05377049180327869,Very Cheap
20141002T000000,685000.0,4,2.75,1660,5150,1.5,0,0,5,7,1280,380,1928,0,98117,47.6835,-122.362,1490,4017,3490,2527,133.0097087378641,0.08,Very Cheap
20141016T000000,242050.0,3,2.5,2170,9900,1.0,0,0,3,7,1690,480,1980,0,98038,47.3634,-122.031,1420,10614,7730,9194,24.449494949494948,0.021908196721311477,Very Cheap
20140922T000000,770000.0,3,3.25,3310,5000,2.0,0,0,3,9,3310,0,2006,0,98029,47.5558,-122.001,2670,4907,1690,2237,154.0,0.09114754098360656,Very Cheap
20150428T000000,557000.0,2,1.5,1450,3840,1.0,0,0,3,7,950,500,1947,0,98117,47.684,-122.381,1450,3840,2390,2390,145.05208333333334,0.06321311475409835,Very Cheap
20140711T000000,246000.0,3,1.75,1440,11325,1.0,0,0,4,8,1440,0,1966,0,98001,47.3503,-122.279,1440,20000,9885,18560,21.721854304635762,0.02242622950819672,Very Cheap
20150310T000000,194000.0,4,2.0,1760,7700,1.0,0,0,4,7,1760,0,1962,0,98003,47.3299,-122.318,1870,7316,5940,5446,25.194805194805195,0.01560655737704918,Very Cheap
20141124T000000,720000.0,3,2.5,3170,7187,2.0,0,0,3,9,3170,0,2005,0,98033,47.6934,-122.166,2790,7336,4017,4546,100.18088214832336,0.08459016393442623,Very Cheap
20150325T000000,449000.0,2,1.0,1250,4576,1.0,0,0,3,6,1040,210,1925,0,98118,47.5387,-122.266,1550,5000,3326,3450,98.12062937062937,0.049049180327868855,Very Cheap
20140619T000000,925000.0,4,2.5,3280,209088,2.0,0,0,3,10,3280,0,1994,0,98053,47.6553,-122.023,2460,39498,205808,37038,4.42397459442914,0.11147540983606558,Cheap
20150326T000000,570000.0,4,3.0,2460,10401,1.0,0,0,5,7,1700,760,1947,0,98125,47.7106,-122.285,1470,7727,7941,6257,54.80242284395731,0.06491803278688525,Very Cheap
20141112T000000,395000.0,3,2.0,1470,10125,1.0,0,0,4,7,1470,0,1962,0,98011,47.7751,-122.222,1440,10125,8655,8685,39.01234567901235,0.0419672131147541,Very Cheap
20140729T000000,1000000.0,4,2.0,1780,15648,1.5,0,0,5,8,1780,0,1918,0,98004,47.5849,-122.198,2320,14963,13868,12643,63.90593047034765,0.12131147540983607,Cheap
20140701T000000,406000.0,4,1.0,1580,8475,1.5,0,2,4,7,1580,0,1928,0,98178,47.5104,-122.254,1700,5650,6895,3950,47.905604719764014,0.04340983606557377,Very Cheap
20141023T000000,574800.0,3,1.5,1630,2946,1.5,0,0,4,8,1630,0,1932,0,98115,47.6865,-122.31,1550,3800,1316,2250,195.11201629327903,0.06554754098360656,Very Cheap
20150420T000000,309000.0,4,2.0,2240,9240,1.0,0,0,3,7,1120,1120,1968,0,98032,47.3666,-122.288,2040,8250,7000,6210,33.44155844155844,0.030688524590163933,Very Cheap
20140603T000000,770000.0,3,2.5,2430,54059,2.0,0,0,3,10,2430,0,1987,0,98027,47.4664,-121.992,2910,49658,51629,46748,14.243696701751789,0.09114754098360656,Very Cheap
20150317T000000,525000.0,3,1.5,1940,5625,1.0,0,0,4,7,1440,500,1941,0,98117,47.6818,-122.388,1460,5500,3685,4040,93.33333333333333,0.05901639344262295,Very Cheap
20140718T000000,419000.0,3,2.5,1970,4058,2.0,0,0,3,7,1970,0,2004,0,98065,47.5308,-121.853,2340,4067,2088,1727,103.25283390832922,0.04511475409836065,Very Cheap
20150411T000000,479000.0,4,2.5,2050,6705,1.0,0,0,4,7,1230,820,1973,0,98034,47.7242,-122.217,1610,7292,4655,5682,71.43922445935868,0.05298360655737705,Very Cheap
20150113T000000,160000.0,3,1.0,1340,18552,1.5,0,0,4,5,1340,0,1935,0,98014,47.7129,-121.325,960,15141,17212,14181,8.624407072013799,0.011147540983606558,Very Cheap
20140916T000000,333000.0,4,1.75,1880,9880,1.0,0,0,4,8,1880,0,1967,0,98058,47.4551,-122.151,1880,9600,8000,7720,33.70445344129555,0.033836065573770495,Very Cheap
20140930T000000,310000.0,2,1.0,860,12160,1.0,0,0,4,6,860,0,1921,0,98106,47.5267,-122.361,1010,7611,11300,6601,25.49342105263158,0.03081967213114754,Very Cheap
20150205T000000,666000.0,3,2.5,2140,2868,2.0,0,0,3,8,1770,370,2007,0,98052,47.6668,-122.132,2140,2527,728,387,232.21757322175733,0.07750819672131147,Very Cheap
20140725T000000,2230000.0,3,3.0,3620,28064,2.0,1,4,5,10,2370,1250,1977,0,98136,47.5516,-122.398,2550,34713,24444,32163,79.46123147092361,0.28262295081967215,Cheap
20140917T000000,310000.0,4,2.75,2370,7320,2.0,0,0,3,7,2370,0,1989,0,98023,47.3071,-122.36,1960,7320,4950,5360,42.349726775956285,0.03081967213114754,Very Cheap
20141227T000000,350000.0,3,2.5,1860,21876,2.0,0,0,3,8,1860,0,1992,0,98014,47.6455,-121.901,2450,21876,20016,19426,15.999268604863778,0.036065573770491806,Very Cheap
20140512T000000,610000.0,4,3.0,2110,5000,1.5,0,2,4,7,1640,470,1930,0,98136,47.5195,-122.391,1380,5000,2890,3620,122.0,0.07016393442622951,Very Cheap
20141008T000000,564800.0,3,2.25,1990,8501,2.0,0,0,3,8,1990,0,1991,0,98029,47.5707,-121.996,2090,6459,6511,4369,66.43924244206563,0.0642360655737705,Very Cheap
20150421T000000,438000.0,3,2.25,1820,9150,1.0,0,0,3,7,1320,500,1961,0,98133,47.737,-122.334,1780,8055,7330,6275,47.868852459016395,0.04760655737704918,Very Cheap
20140813T000000,855000.0,3,2.0,3120,9400,1.0,0,0,5,9,1820,1300,1978,0,98006,47.5612,-122.15,2770,9500,6280,6730,90.95744680851064,0.10229508196721311,Cheap
20140508T000000,229000.0,3,2.5,1190,3000,2.0,0,0,3,7,1190,0,2002,0,98178,47.4933,-122.275,1190,3000,1810,1810,76.33333333333333,0.02019672131147541,Very Cheap
20140725T000000,260000.0,3,2.0,1170,5450,1.0,0,0,5,6,1170,0,1902,0,98118,47.5276,-122.273,1340,6384,4280,5044,47.706422018348626,0.024262295081967214,Very Cheap
20140918T000000,609000.0,3,2.5,2630,10131,2.0,0,0,3,9,2630,0,1989,0,98028,47.7695,-122.259,2800,10123,7501,7323,60.11252591057151,0.0700327868852459,Very Cheap
20140528T000000,277000.0,4,1.0,1450,6250,1.0,0,0,3,6,990,460,1964,0,98146,47.5131,-122.357,1440,4000,4800,2560,44.32,0.026491803278688525,Very Cheap
20141209T000000,283000.0,4,2.0,2100,8160,1.0,0,0,3,7,1200,900,1959,0,98106,47.5145,-122.365,1140,8160,6060,7020,34.681372549019606,0.027278688524590165,Very Cheap
20150318T000000,334000.0,2,1.75,1680,8367,1.0,0,0,3,6,840,840,1914,0,98115,47.6976,-122.288,1830,6720,6687,4890,39.918728337516434,0.0339672131147541,Very Cheap
20150226T000000,267000.0,4,1.75,2000,7350,1.0,0,0,3,7,1100,900,1963,0,98003,47.3428,-122.303,1720,7350,5350,5630,36.326530612244895,0.025180327868852458,Very Cheap
20140714T000000,385000.0,3,1.0,1030,3000,1.0,0,0,3,7,830,200,1924,0,98115,47.6813,-122.317,1830,3000,1970,1170,128.33333333333334,0.04065573770491803,Very Cheap
20141024T000000,640000.0,5,1.75,2020,6565,1.0,0,0,3,8,1120,900,1956,0,98115,47.6821,-122.283,2020,6552,4545,4532,97.48667174409749,0.0740983606557377,Very Cheap
20150506T000000,532500.0,4,2.0,2220,23750,1.0,0,0,3,7,2220,0,1963,0,98011,47.7759,-122.214,2650,21167,21530,18517,22.42105263157895,0.06,Very Cheap
20140523T000000,335000.0,4,2.5,1750,8476,1.0,0,0,4,7,1240,510,1983,0,98058,47.4447,-122.137,1660,7875,6726,6215,39.52336007550731,0.03409836065573771,Very Cheap
20141030T000000,415000.0,3,2.5,1710,4920,2.0,0,0,3,7,1710,0,1990,0,98126,47.5347,-122.376,1500,4920,3210,3420,84.34959349593495,0.04459016393442623,Very Cheap
20140917T000000,1098000.0,6,3.25,3560,107362,1.5,0,0,4,8,2760,800,1963,0,98005,47.6356,-122.15,3210,35001,103802,31791,10.227082207857528,0.1341639344262295,Cheap
20140828T000000,1442500.0,2,2.5,2720,16637,1.0,0,3,3,10,2160,560,1953,0,98118,47.5499,-122.264,2880,7320,13917,4440,86.70433371401094,0.17934426229508196,Cheap
20140807T000000,180000.0,3,1.0,1010,10215,1.0,0,0,3,6,1010,0,1955,0,98146,47.4872,-122.345,1320,10245,9205,8925,17.621145374449338,0.01377049180327869,Very Cheap
20140714T000000,335000.0,4,2.5,1830,4500,2.0,0,0,3,7,1830,0,2004,0,98038,47.3504,-122.005,2080,5100,2670,3020,74.44444444444444,0.03409836065573771,Very Cheap
20140723T000000,835000.0,4,3.0,4480,42717,2.0,0,0,3,9,4480,0,1987,0,98077,47.7711,-122.088,3140,41632,38237,38492,19.547252850153335,0.09967213114754099,Very Cheap
20141003T000000,592500.0,4,1.5,2080,4400,1.5,0,0,3,7,2080,0,1925,0,98122,47.606,-122.299,1680,4400,2320,2720,134.6590909090909,0.06786885245901639,Very Cheap
20140808T000000,418900.0,3,1.5,1470,11112,1.0,0,0,3,7,1470,0,1954,0,98155,47.7462,-122.294,1460,11407,9642,9947,37.6979841612671,0.0451016393442623,Very Cheap
20140709T000000,340000.0,3,1.0,1600,7324,1.0,0,0,4,7,1600,0,1958,0,98056,47.5054,-122.19,1430,7249,5724,5819,46.422719825232114,0.03475409836065574,Very Cheap
20140702T000000,545000.0,3,2.0,1340,7200,1.5,0,0,4,7,1340,0,1923,0,98118,47.5601,-122.265,1630,5760,5860,4130,75.69444444444444,0.06163934426229508,Very Cheap
20150403T000000,1378000.0,5,3.5,3680,8680,2.0,0,0,3,9,3680,0,2003,0,98033,47.6575,-122.197,2020,8847,5000,6827,158.7557603686636,0.17088524590163934,Cheap
20150326T000000,183750.0,3,2.5,1770,3451,2.0,0,0,3,7,1770,0,2004,0,98055,47.4325,-122.197,1490,2138,1681,648,53.24543610547667,0.014262295081967214,Very Cheap
20140522T000000,295000.0,4,2.0,980,10640,1.0,0,0,5,7,980,0,1978,0,98045,47.4462,-121.773,1230,9750,9660,8520,27.725563909774436,0.028852459016393443,Very Cheap
20140711T000000,625000.0,4,3.0,2530,5625,1.0,0,0,3,8,1470,1060,1976,0,98034,47.7094,-122.233,1840,7070,3095,5230,111.11111111111111,0.07213114754098361,Very Cheap
20140609T000000,290000.0,4,3.0,2390,4500,2.0,0,0,3,7,2390,0,1974,0,98055,47.4872,-122.204,1320,4500,2110,3180,64.44444444444444,0.02819672131147541,Very Cheap
20150123T000000,760000.0,4,2.5,3600,155509,2.0,0,0,3,9,3600,0,2004,0,98010,47.3538,-121.986,3410,34412,151909,31002,4.887176947957996,0.0898360655737705,Very Cheap
20150219T000000,560000.0,4,2.5,3270,24750,1.0,0,0,4,8,1690,1580,1979,0,98056,47.5221,-122.178,1520,13480,21480,11960,22.626262626262626,0.06360655737704918,Very Cheap
20140923T000000,475000.0,5,2.5,2300,28480,2.0,0,0,3,6,2300,0,1994,0,98053,47.6403,-121.964,1880,26720,26180,24840,16.678370786516854,0.05245901639344262,Very Cheap
20140513T000000,620000.0,3,1.0,1710,4050,1.5,0,0,3,7,1710,0,1909,0,98103,47.6732,-122.331,1790,4896,2340,3106,153.08641975308643,0.07147540983606557,Very Cheap
20150508T000000,330000.0,4,2.0,1170,4000,1.0,0,0,3,7,1170,0,1955,0,98144,47.5797,-122.305,1720,4000,2830,2280,82.5,0.03344262295081967,Very Cheap
20150408T000000,620000.0,3,2.25,1990,6256,1.0,0,0,3,7,1390,600,1960,0,98033,47.6903,-122.206,2080,9300,4266,7220,99.10485933503837,0.07147540983606557,Very Cheap
20150107T000000,320000.0,4,1.75,1710,10480,1.5,0,0,4,6,1710,0,1969,0,98059,47.4743,-122.143,1750,10480,8770,8730,30.53435114503817,0.032131147540983604,Very Cheap
20140915T000000,525000.0,3,2.5,1740,2350,2.0,0,0,3,8,1120,620,1996,0,98112,47.6206,-122.297,1750,3802,610,2052,223.40425531914894,0.05901639344262295,Very Cheap
20140721T000000,802500.0,4,3.75,3320,8030,2.0,0,0,3,10,3320,0,2005,0,98075,47.5818,-121.972,3740,8030,4710,4290,99.93773349937733,0.09540983606557377,Very Cheap
20140926T000000,569500.0,4,1.0,1960,3194,2.0,0,0,3,7,1960,0,1907,0,98144,47.6005,-122.296,1870,4200,1234,2330,178.30306825297433,0.06485245901639344,Very Cheap
20141216T000000,850000.0,6,3.5,2820,5400,1.0,0,0,3,8,1620,1200,1958,0,98117,47.6791,-122.374,1560,2276,2580,716,157.40740740740742,0.10163934426229508,Cheap
20150405T000000,630000.0,3,1.0,1590,4080,1.5,0,0,3,7,1590,0,1922,0,98105,47.662,-122.326,1570,4080,2490,2510,154.41176470588235,0.07278688524590164,Very Cheap
20140805T000000,454800.0,4,2.25,2490,10720,1.0,0,1,4,7,1400,1090,1979,0,98074,47.6137,-122.06,3080,10720,8230,7640,42.42537313432836,0.04980983606557377,Very Cheap
20150303T000000,177000.0,3,1.0,870,5200,1.0,0,0,5,6,870,0,1969,0,98042,47.3695,-122.081,870,5200,4330,4330,34.03846153846154,0.01337704918032787,Very Cheap
20140619T000000,275000.0,3,1.75,1860,15681,1.0,0,0,4,7,1860,0,1971,0,98023,47.3191,-122.339,1860,22979,13821,21119,17.53714686563357,0.02622950819672131,Very Cheap
20150416T000000,460000.0,3,2.0,2930,29136,2.0,0,0,3,8,2240,690,1990,0,98010,47.3102,-122.042,2110,29362,26206,27252,15.788028555738606,0.050491803278688525,Very Cheap
20140617T000000,729000.0,3,1.0,1580,3840,2.0,0,0,3,8,1580,0,1908,0,98102,47.6192,-122.319,1680,2624,2260,944,189.84375,0.08577049180327868,Very Cheap
20141021T000000,935000.0,4,3.25,4110,15488,2.0,0,2,3,11,4110,0,1995,0,98006,47.5493,-122.117,4190,14973,11378,10783,60.36931818181818,0.11278688524590164,Cheap
20140509T000000,481450.0,3,2.0,1410,4800,1.0,0,0,3,7,1410,0,1940,0,98117,47.6852,-122.378,1190,3840,3390,2650,100.30208333333333,0.053304918032786884,Very Cheap
20150317T000000,860000.0,3,2.0,2090,4190,1.5,0,0,4,8,1490,600,1930,0,98122,47.6178,-122.284,2090,6270,2100,4180,205.25059665871123,0.10295081967213114,Cheap
20141106T000000,274000.0,3,1.75,1400,8364,1.0,0,0,4,7,1400,0,1958,0,98056,47.4918,-122.178,1210,8160,6964,6950,32.75944524151124,0.026098360655737705,Very Cheap
20140605T000000,499000.0,3,3.5,1690,1432,2.0,0,0,3,7,1360,330,2008,0,98199,47.6513,-122.4,1650,2788,-258,1138,348.463687150838,0.05560655737704918,Very Cheap
20140917T000000,696500.0,5,2.25,3210,61419,1.5,0,0,3,8,3210,0,1979,0,98077,47.7632,-122.09,2820,48351,58209,45531,11.340139044920953,0.08150819672131147,Very Cheap
20150413T000000,390000.0,3,1.0,1190,85226,1.5,0,0,5,5,1190,0,1935,0,98070,47.365,-122.462,1360,46960,84036,45600,4.576068335953817,0.04131147540983607,Very Cheap
20141216T000000,265000.0,3,1.0,960,9748,1.0,0,0,3,5,960,0,1922,0,98065,47.5259,-121.815,1600,9958,8788,8358,27.185063602790315,0.024918032786885248,Very Cheap
20140709T000000,470000.0,4,2.25,2380,17199,2.0,0,0,3,8,1530,850,1979,0,98028,47.7668,-122.27,2280,11529,14819,9249,27.32717018431304,0.05180327868852459,Very Cheap
20150129T000000,168500.0,2,1.0,1020,7742,1.0,0,0,4,6,1020,0,1935,1978,98168,47.499,-122.301,1510,7742,6722,6232,21.764401963316974,0.012262295081967214,Very Cheap
20141111T000000,220000.0,3,1.75,1290,8250,1.0,0,0,3,7,1290,0,1983,0,98001,47.3353,-122.27,1410,7823,6960,6413,26.666666666666668,0.01901639344262295,Very Cheap
20141020T000000,295000.0,3,2.0,1830,17321,1.0,0,0,4,7,1100,730,1948,0,98178,47.5072,-122.272,1450,10706,15491,9256,17.03134922925928,0.028852459016393443,Very Cheap
20150114T000000,1475000.0,5,4.0,4770,31570,2.0,0,0,3,12,4770,0,1990,0,98006,47.5468,-122.123,4520,32070,26800,27550,46.72157111181502,0.18360655737704917,Cheap
20140821T000000,1295000.0,2,2.5,2910,19449,2.0,1,4,5,9,1940,970,1985,0,98177,47.7729,-122.393,2540,23598,16539,21058,66.58440022623272,0.16,Cheap
20150408T000000,285000.0,3,1.0,950,10723,1.0,0,0,4,6,950,0,1959,0,98059,47.4899,-122.133,1520,10723,9773,9203,26.578382915228946,0.02754098360655738,Very Cheap
20141022T000000,294950.0,3,1.0,1160,8950,1.0,0,0,3,7,1160,0,1968,0,98133,47.7499,-122.338,1210,8193,7790,6983,32.95530726256983,0.028845901639344262,Very Cheap
20150102T000000,1465000.0,4,4.0,4930,22093,2.0,0,3,3,12,4930,0,2004,0,98075,47.5874,-121.965,4630,18889,17163,14259,66.31059611641696,0.1822950819672131,Cheap
20150403T000000,565500.0,3,1.75,1780,5850,1.0,0,0,5,7,980,800,1944,0,98116,47.5589,-122.392,1550,5850,4070,4300,96.66666666666667,0.06432786885245902,Very Cheap
20141013T000000,230000.0,3,2.0,1410,10625,1.0,0,0,3,7,1410,0,1980,0,98042,47.3649,-122.117,1410,9744,9215,8334,21.647058823529413,0.020327868852459016,Very Cheap
20150323T000000,569950.0,4,3.5,2700,443440,1.5,0,0,3,8,2700,0,1948,1997,98042,47.333,-122.098,3210,298182,440740,294972,1.2852922605087498,0.06491147540983606,Very Cheap
20140924T000000,721000.0,2,1.5,1790,4250,1.0,0,0,3,7,920,870,1915,2014,98112,47.6367,-122.301,1910,4250,2460,2340,169.64705882352942,0.08472131147540983,Very Cheap
20141218T000000,565000.0,3,2.5,4040,8653,2.0,0,0,3,9,2900,1140,2006,0,98019,47.7378,-121.975,3360,8653,4613,5293,65.29527331561309,0.06426229508196721,Very Cheap
20140917T000000,438000.0,3,1.75,1990,9885,1.0,0,0,4,7,1030,960,1978,0,98052,47.6722,-122.162,1560,10000,7895,8440,44.30955993930197,0.04760655737704918,Very Cheap
20150402T000000,369900.0,3,1.75,2150,19127,1.0,0,0,3,7,1650,500,1978,0,98168,47.5061,-122.324,1550,15000,16977,13450,19.33915407539081,0.03867540983606557,Very Cheap
20140905T000000,405000.0,4,2.5,1850,9136,2.0,0,0,3,8,1850,0,1997,0,98059,47.4943,-122.157,1930,7873,7286,5943,44.330122591943955,0.043278688524590166,Very Cheap
20140527T000000,282000.0,3,2.5,1680,15711,1.0,0,0,3,7,1240,440,1994,0,98031,47.423,-122.171,1420,8588,14031,7168,17.94920756158106,0.02714754098360656,Very Cheap
20141104T000000,380950.0,2,1.0,1430,7819,1.0,0,0,3,7,1110,320,1944,0,98125,47.7307,-122.302,1380,7473,6389,6093,48.721064074689856,0.04012459016393442,Very Cheap
20140630T000000,349810.0,3,1.0,960,8855,1.0,0,0,4,7,960,0,1958,0,98155,47.7689,-122.328,1250,8855,7895,7605,39.50423489553924,0.036040655737704916,Very Cheap
20140526T000000,690000.0,4,2.5,2700,8810,2.0,0,0,3,9,2700,0,2004,0,98052,47.7041,-122.116,2730,5100,6110,2370,78.32009080590238,0.08065573770491803,Very Cheap
20150505T000000,653000.0,2,1.5,1290,5141,1.0,0,0,4,7,1050,240,1947,0,98115,47.6878,-122.29,1290,5406,3851,4116,127.01808986578487,0.07580327868852459,Very Cheap
20141028T000000,526500.0,3,2.5,1860,43170,2.0,0,0,3,8,1860,0,1986,0,98072,47.7712,-122.136,2270,40835,41310,38565,12.195969423210563,0.05921311475409836,Very Cheap
20141017T000000,1040000.0,4,3.5,4320,8490,2.0,0,0,3,10,3280,1040,2005,0,98029,47.5568,-122.029,4030,11008,4170,6978,122.49705535924618,0.12655737704918033,Cheap
20140923T000000,335000.0,3,1.0,2130,3825,1.5,0,0,3,7,2130,0,1917,0,98118,47.5506,-122.281,1780,5150,1695,3370,87.58169934640523,0.03409836065573771,Very Cheap
20140915T000000,570000.0,2,1.75,2870,102366,2.0,0,2,4,8,1770,1100,1994,0,98027,47.4847,-122.0,2960,108900,99496,105940,5.568255084696091,0.06491803278688525,Very Cheap
20150310T000000,1080000.0,5,3.5,3740,11340,2.0,0,0,3,10,3740,0,2013,0,98052,47.6628,-122.143,2040,8715,7600,6675,95.23809523809524,0.1318032786885246,Cheap
20140922T000000,475000.0,3,2.5,2130,8022,2.0,0,0,3,8,2130,0,1985,0,98052,47.7252,-122.106,2130,7605,5892,5475,59.21216654200948,0.05245901639344262,Very Cheap
20150212T000000,315000.0,4,2.0,1210,4250,1.0,0,0,4,7,1210,0,1941,0,98108,47.5275,-122.321,1210,6000,3040,4790,74.11764705882354,0.031475409836065574,Very Cheap
20141209T000000,405000.0,6,2.0,2800,29985,1.0,0,0,5,7,1400,1400,1954,0,98058,47.4398,-122.08,1980,29985,27185,28005,13.506753376688344,0.043278688524590166,Very Cheap
20140506T000000,562000.0,5,2.25,3040,8111,2.0,0,0,3,8,3040,0,1984,0,98052,47.7157,-122.103,2020,8304,5071,6284,69.28862039206017,0.0638688524590164,Very Cheap
20150424T000000,295000.0,3,2.5,1570,6932,2.0,0,0,3,7,1570,0,1993,0,98038,47.3902,-122.049,1570,6271,5362,4701,42.55626081938834,0.028852459016393443,Very Cheap
20140708T000000,383000.0,3,2.25,2090,15000,1.0,0,0,3,7,2090,0,1961,0,98045,47.4885,-121.783,1690,14400,12910,12710,25.533333333333335,0.04039344262295082,Very Cheap
20150413T000000,242000.0,3,2.25,1690,7292,1.0,0,0,3,7,1250,440,1985,0,98003,47.2639,-122.303,1670,7747,5602,6077,33.18705430608887,0.021901639344262296,Very Cheap
20150403T000000,352500.0,3,1.5,1470,17577,1.0,0,0,5,7,1470,0,1967,0,98059,47.4695,-122.116,2300,13832,16107,11532,20.054616828810378,0.03639344262295082,Very Cheap
20140723T000000,239950.0,4,1.0,1460,6000,1.0,0,0,4,7,730,730,1941,0,98178,47.4952,-122.224,1190,6000,4540,4810,39.99166666666667,0.021632786885245902,Very Cheap
20140903T000000,998000.0,4,2.5,3030,6820,2.0,0,0,3,9,2530,500,1947,2000,98105,47.6695,-122.266,2070,6820,3790,4750,146.3343108504399,0.12104918032786885,Cheap
20150417T000000,515000.0,3,1.75,1190,4500,1.0,0,0,3,6,1190,0,1922,2012,98116,47.5576,-122.388,1820,4500,3310,2680,114.44444444444444,0.057704918032786885,Very Cheap
20150406T000000,590000.0,5,1.0,1840,6710,1.5,0,0,3,7,1840,0,1920,0,98126,47.5686,-122.378,1410,4880,4870,3470,87.9284649776453,0.06754098360655737,Very Cheap
20150402T000000,1160000.0,4,3.75,3560,13959,2.0,0,0,4,9,3560,0,1972,0,98040,47.5575,-122.211,3320,11834,10399,8514,83.10050863242353,0.1422950819672131,Cheap
20141104T000000,289000.0,3,1.75,1580,9750,1.0,0,0,5,7,1580,0,1954,0,98148,47.427,-122.331,1460,9750,8170,8290,29.641025641025642,0.028065573770491802,Very Cheap
20150323T000000,424000.0,3,1.5,1230,7200,1.0,0,0,3,7,1230,0,1953,0,98125,47.7281,-122.311,1400,6240,5970,4840,58.888888888888886,0.04577049180327869,Very Cheap
20141016T000000,199000.0,4,2.0,1440,9477,1.0,0,0,3,5,1440,0,1943,0,98056,47.5093,-122.182,1440,9546,8037,8106,20.998206183391368,0.016262295081967214,Very Cheap
20141006T000000,730000.0,4,3.5,4420,7902,2.0,0,0,3,10,3350,1070,2004,0,98065,47.5327,-121.86,3440,7851,3482,4411,92.3816755251835,0.0859016393442623,Very Cheap
20140527T000000,244000.0,3,1.0,910,5250,1.0,0,0,4,6,910,0,1971,0,98166,47.4729,-122.352,1650,10442,4340,8792,46.476190476190474,0.02216393442622951,Very Cheap
20140618T000000,240000.0,2,1.0,670,10920,1.0,0,0,3,6,670,0,1942,0,98146,47.5128,-122.372,900,7425,10250,6525,21.978021978021978,0.021639344262295083,Very Cheap
20150422T000000,797000.0,4,2.75,2650,8610,2.0,0,0,3,8,2650,0,1959,2007,98008,47.6155,-122.121,1680,8316,5960,6636,92.56678281068525,0.09468852459016393,Very Cheap
20140520T000000,350000.0,4,2.25,2220,6953,2.0,0,0,4,8,2220,0,1999,0,98038,47.3509,-122.041,2240,6716,4733,4476,50.33798360419963,0.036065573770491806,Very Cheap
20141119T000000,415000.0,3,1.75,1640,6435,1.0,0,0,3,7,1190,450,1972,0,98034,47.7197,-122.217,1770,6930,4795,5160,64.49106449106449,0.04459016393442623,Very Cheap
20150414T000000,378510.0,2,1.0,770,5185,1.0,0,0,3,7,770,0,1947,0,98126,47.5459,-122.379,1260,6550,4415,5290,73.0009643201543,0.03980459016393443,Very Cheap
20140708T000000,1195000.0,4,3.5,3960,6654,2.0,0,0,3,10,2850,1110,2006,0,98199,47.6461,-122.389,2840,6400,2694,3560,179.5912233243162,0.14688524590163934,Cheap
20141006T000000,379900.0,2,1.5,1140,7620,1.0,0,0,4,6,1140,0,1925,0,98106,47.5277,-122.351,1300,7620,6480,6320,49.85564304461942,0.03998688524590164,Very Cheap
20140520T000000,620000.0,3,2.5,2480,9041,2.0,0,0,3,7,2480,0,2004,0,98053,47.6797,-122.035,2480,6500,6561,4020,68.5764849021126,0.07147540983606557,Very Cheap
20140829T000000,524500.0,3,1.5,1580,3172,1.0,0,0,4,8,900,680,1946,0,98117,47.6796,-122.393,1580,5000,1592,3420,165.3530895334174,0.05895081967213115,Very Cheap
20140609T000000,270000.0,4,2.75,1990,7252,1.0,0,0,3,7,1270,720,1999,0,98002,47.2839,-122.202,2100,7535,5262,5435,37.23110865968009,0.025573770491803278,Very Cheap
20140528T000000,236000.0,4,2.25,1830,9485,1.0,0,0,4,7,1200,630,1989,0,98023,47.2995,-122.387,1730,10109,7655,8379,24.881391671059568,0.021114754098360656,Very Cheap
20141105T000000,308500.0,2,2.0,840,14564,1.5,0,0,5,6,840,0,1942,0,98106,47.5499,-122.36,1430,7920,13724,6490,21.18236748146114,0.03062295081967213,Very Cheap
20141208T000000,989900.0,5,2.25,3320,11350,1.0,0,0,5,8,1660,1660,1963,0,98040,47.5749,-122.213,3320,11085,8030,7765,87.21585903083701,0.11998688524590163,Cheap
20141002T000000,299000.0,4,2.25,2050,26000,2.0,0,0,4,8,2050,0,1977,0,98042,47.3423,-122.063,2330,31100,23950,28770,11.5,0.02937704918032787,Very Cheap
20140913T000000,295000.0,2,1.75,1560,43748,2.0,0,0,3,8,1560,0,1967,2000,98065,47.5729,-121.676,1000,24602,42188,23602,6.743165401846942,0.028852459016393443,Very Cheap
20140611T000000,110000.0,2,1.0,800,15000,1.0,0,0,3,6,800,0,1927,0,98168,47.4932,-122.316,1170,15000,14200,13830,7.333333333333333,0.0045901639344262295,Very Cheap
20140703T000000,295950.0,2,1.0,1190,6200,1.0,0,0,3,7,1190,0,1948,0,98133,47.7634,-122.34,1470,7800,5010,6330,47.733870967741936,0.02897704918032787,Very Cheap
20140528T000000,270000.0,3,1.75,1300,4127,1.0,0,0,4,6,650,650,1918,1953,98106,47.5353,-122.352,1420,4000,2827,2580,65.42282529682578,0.025573770491803278,Very Cheap
20140521T000000,712000.0,4,2.5,3400,247421,2.0,0,0,3,9,3400,0,2001,0,98010,47.3623,-121.971,3180,222156,244021,218976,2.8776862109521826,0.08354098360655737,Very Cheap
20150506T000000,475000.0,2,1.5,1170,1250,3.0,0,0,3,8,1170,0,2000,0,98107,47.6719,-122.38,1310,1308,80,-2,380.0,0.05245901639344262,Very Cheap
20150317T000000,410000.0,4,2.5,2510,5258,2.0,0,0,3,7,2510,0,2001,0,98056,47.4818,-122.188,2570,5119,2748,2549,77.97641688855077,0.043934426229508196,Very Cheap
20150313T000000,588000.0,4,2.25,2510,19550,1.0,0,0,4,9,1810,700,1977,0,98034,47.7041,-122.241,2450,19250,17040,16800,30.076726342710998,0.06727868852459017,Very Cheap
20141212T000000,420000.0,3,2.5,2390,3903,2.0,0,0,3,8,1970,420,2006,0,98072,47.7515,-122.174,2390,3431,1513,1041,107.60953112990008,0.04524590163934426,Very Cheap
20150119T000000,355000.0,4,2.25,2200,3404,2.0,0,0,3,8,2200,0,2005,0,98038,47.3895,-122.034,2200,3449,1204,1249,104.28907168037603,0.036721311475409836,Very Cheap
20140623T000000,446000.0,2,1.0,2550,21675,1.0,0,1,4,7,1610,940,1958,0,98198,47.4013,-122.319,2030,10591,19125,8561,20.57670126874279,0.04865573770491803,Very Cheap
20140520T000000,765000.0,4,2.25,2560,12100,1.0,0,0,4,8,1760,800,1976,0,98052,47.631,-122.108,2240,12100,9540,9860,63.22314049586777,0.09049180327868853,Very Cheap
20140527T000000,967500.0,3,3.75,3250,5797,2.0,0,2,4,8,2370,880,1951,0,98199,47.6481,-122.405,1840,5797,2547,3957,166.8966706917371,0.11704918032786885,Cheap
20140905T000000,381000.0,2,2.0,1340,4447,1.0,0,0,3,8,1340,0,2004,0,98053,47.7175,-122.033,1350,4458,3107,3108,85.67573645154036,0.040131147540983604,Very Cheap
20150501T000000,490000.0,3,2.25,2840,107157,2.0,0,0,4,9,2840,0,1983,0,98092,47.2848,-122.118,2600,215622,104317,213022,4.572729733008576,0.05442622950819672,Very Cheap
20140827T000000,716000.0,4,2.25,2480,9780,1.0,0,0,4,8,1900,580,1975,0,98052,47.6388,-122.099,2640,9780,7300,7140,73.21063394683027,0.0840655737704918,Very Cheap
20150414T000000,605000.0,5,3.5,3060,8862,2.0,0,0,3,8,3060,0,1989,0,98056,47.5322,-122.185,2680,8398,5802,5718,68.2690137666441,0.06950819672131148,Very Cheap
20140919T000000,312200.0,4,2.5,2910,8596,2.0,0,0,3,8,2910,0,2004,0,98003,47.2596,-122.304,2770,8602,5686,5832,36.31921824104234,0.031108196721311477,Very Cheap
20140718T000000,327000.0,4,1.0,1900,9000,1.0,0,0,4,7,1290,610,1948,0,98166,47.4629,-122.361,1950,10800,7100,8850,36.333333333333336,0.033049180327868855,Very Cheap
20140609T000000,229950.0,4,1.75,1300,21000,1.0,0,0,4,7,1300,0,1969,0,98001,47.3067,-122.285,2120,9920,19700,7800,10.95,0.020321311475409835,Very Cheap
20140711T000000,160000.0,3,1.5,1480,7000,1.0,0,0,3,7,1000,480,1980,0,98023,47.2866,-122.368,1470,7022,5520,5552,22.857142857142858,0.011147540983606558,Very Cheap
20140812T000000,255000.0,3,1.0,1250,9472,1.0,0,0,4,6,1250,0,1972,0,98059,47.495,-122.154,1590,9600,8222,8010,26.9214527027027,0.02360655737704918,Very Cheap
20141125T000000,530000.0,4,2.5,2000,4700,1.5,0,0,4,7,1220,780,1944,0,98117,47.6902,-122.368,1560,4700,2700,3140,112.76595744680851,0.05967213114754098,Very Cheap
20141024T000000,239000.0,3,1.5,1330,6540,1.0,0,0,3,7,900,430,1971,0,98188,47.4239,-122.292,1400,11500,5210,10100,36.54434250764526,0.021508196721311476,Very Cheap
20150228T000000,285000.0,3,2.25,1840,6214,1.0,0,0,4,7,1270,570,1983,0,98031,47.4043,-122.185,1840,6214,4374,4374,45.86417766334084,0.02754098360655738,Very Cheap
20140827T000000,537000.0,4,2.0,1560,7104,1.5,0,0,3,7,1140,420,1945,0,98105,47.6714,-122.28,1850,7105,5544,5255,75.59121621621621,0.060590163934426226,Very Cheap
20140814T000000,530000.0,3,2.5,3150,21893,2.0,0,0,3,9,3150,0,2006,0,98014,47.6455,-121.901,2280,21886,18743,19606,24.208651167039694,0.05967213114754098,Very Cheap
20140725T000000,213675.0,3,2.25,1560,6013,2.0,0,0,3,7,1560,0,1990,0,98023,47.2862,-122.352,1640,6290,4453,4650,35.53550640279395,0.01818688524590164,Very Cheap
20140506T000000,530000.0,5,2.5,2910,9636,1.0,0,0,4,7,1690,1220,1964,0,98008,47.5803,-122.119,2830,10385,6726,7555,55.002075550020756,0.05967213114754098,Very Cheap
20150305T000000,780000.0,3,2.5,2940,15875,2.0,0,0,3,10,2940,0,1994,0,98075,47.5947,-122.016,2980,15875,12935,12895,49.13385826771653,0.09245901639344262,Very Cheap
20141113T000000,390000.0,3,1.0,950,3621,1.0,0,0,4,6,950,0,1947,0,98144,47.575,-122.289,1540,4080,2671,2540,107.70505385252693,0.04131147540983607,Very Cheap
20140521T000000,450000.0,2,1.0,1200,4000,1.0,0,0,3,7,1070,130,1940,0,98126,47.5766,-122.378,1770,4000,2800,2230,112.5,0.04918032786885246,Very Cheap
20150311T000000,420000.0,2,1.0,1000,5375,1.0,0,0,3,7,1000,0,1953,0,98118,47.5404,-122.268,1380,5000,4375,3620,78.13953488372093,0.04524590163934426,Very Cheap
20150127T000000,550000.0,3,2.0,1490,3880,1.0,0,0,3,7,1490,0,1959,0,98107,47.662,-122.363,1490,3880,2390,2390,141.75257731958763,0.06229508196721312,Very Cheap
20150219T000000,110000.0,2,1.0,600,6120,1.0,0,0,3,5,600,0,1943,0,98168,47.4997,-122.317,1060,6120,5520,5060,17.973856209150327,0.0045901639344262295,Very Cheap
20140528T000000,700000.0,2,1.75,2320,5500,1.5,0,2,3,8,1720,600,1925,2000,98144,47.586,-122.292,2380,5000,3180,2620,127.27272727272727,0.08196721311475409,Very Cheap
20150424T000000,807500.0,4,2.5,3190,24170,2.0,0,0,3,10,3190,0,2002,0,98074,47.6209,-122.052,2110,26321,20980,24211,33.409184940008274,0.0960655737704918,Very Cheap
20141002T000000,179000.0,2,1.0,990,8760,1.0,0,0,3,7,990,0,1977,0,98003,47.3302,-122.305,1560,11880,7770,10320,20.4337899543379,0.013639344262295083,Very Cheap
20140710T000000,1612500.0,4,2.75,5470,18200,2.0,1,4,3,11,3730,1740,1992,0,98118,47.5316,-122.263,3620,15100,12730,11480,88.5989010989011,0.20163934426229507,Cheap
20150409T000000,655000.0,4,2.75,2890,46609,2.0,0,0,4,9,2890,0,1981,0,98077,47.7454,-122.061,2880,68824,43719,65944,14.053079877276922,0.0760655737704918,Very Cheap
20150316T000000,472500.0,3,2.0,1790,6800,1.0,0,0,4,7,1240,550,1964,0,98133,47.728,-122.339,1470,6800,5010,5330,69.48529411764706,0.05213114754098361,Very Cheap
20141027T000000,299000.0,4,2.5,2350,6958,2.0,0,0,3,9,2350,0,1998,0,98092,47.3321,-122.172,2480,6395,4608,3915,42.972118424834726,0.02937704918032787,Very Cheap
20140514T000000,740000.0,4,2.5,3430,10157,2.0,0,0,3,10,3430,0,2000,0,98034,47.723,-122.158,3480,10157,6727,6677,72.85615831446293,0.08721311475409836,Very Cheap
20141010T000000,860000.0,3,1.75,2600,15064,1.0,0,0,4,8,1700,900,1967,0,98004,47.64,-122.204,2940,14984,12464,12044,57.08975039830059,0.10295081967213114,Cheap
20140701T000000,620000.0,4,3.0,2130,6325,1.0,0,0,5,7,1440,690,1948,0,98116,47.5683,-122.396,1240,6325,4195,5085,98.02371541501977,0.07147540983606557,Very Cheap
20141010T000000,410000.0,3,1.75,1660,5987,1.0,0,0,3,7,960,700,1982,0,98146,47.5107,-122.381,1510,6000,4327,4490,68.4817103724737,0.043934426229508196,Very Cheap
20150304T000000,343000.0,5,3.5,2473,9282,2.0,0,1,5,7,2473,0,1963,0,98198,47.3966,-122.308,2040,10920,6809,8880,36.95324283559577,0.035147540983606555,Very Cheap
20140617T000000,465000.0,2,2.75,1430,1425,2.0,0,0,3,7,995,435,2006,0,98112,47.621,-122.298,1500,1749,-5,249,326.3157894736842,0.051147540983606556,Very Cheap
20150304T000000,273950.0,3,2.25,1570,3109,2.0,0,0,3,8,1570,0,2002,0,98092,47.3258,-122.186,1680,3590,1539,1910,88.11514956577678,0.026091803278688524,Very Cheap
20141017T000000,825000.0,2,1.0,1240,42247,1.0,0,1,4,7,1240,0,1915,0,98056,47.5169,-122.201,1550,12459,41007,10909,19.528013823466754,0.09836065573770492,Very Cheap
20150330T000000,255000.0,3,2.5,1720,6200,2.0,0,0,3,7,1720,0,2014,0,98022,47.2137,-121.989,1710,9520,4480,7810,41.12903225806452,0.02360655737704918,Very Cheap
20140908T000000,250000.0,3,2.0,1140,11161,1.0,0,0,4,7,1140,0,1998,0,98022,47.209,-122.012,1720,8587,10021,6867,22.399426574679687,0.022950819672131147,Very Cheap
20140822T000000,635000.0,4,3.25,2690,7200,2.0,0,3,3,9,1720,970,1978,0,98155,47.7341,-122.288,2400,8845,4510,6445,88.19444444444444,0.07344262295081967,Very Cheap
20140826T000000,240000.0,3,1.75,1520,9600,1.0,0,0,3,8,1520,0,1966,0,98023,47.3263,-122.365,2060,9600,8080,7540,25.0,0.021639344262295083,Very Cheap
20150507T000000,670000.0,4,2.25,2040,7031,2.0,0,0,3,8,2040,0,2012,0,98033,47.7016,-122.17,1670,7031,4991,5361,95.29227705873987,0.0780327868852459,Very Cheap
20141024T000000,713414.0,3,2.5,2830,6000,1.0,0,3,3,9,1730,1100,1954,0,98126,47.5751,-122.378,2040,5300,3170,3260,118.90233333333333,0.0837264262295082,Very Cheap
20150513T000000,245000.0,3,1.5,1340,7391,1.0,0,0,4,7,1340,0,1966,0,98198,47.3837,-122.317,1300,7391,6051,6091,33.148423758625356,0.022295081967213116,Very Cheap
20141209T000000,600000.0,4,2.5,2520,10850,1.0,0,0,4,8,1680,840,1968,0,98155,47.7751,-122.284,2590,10800,8330,8210,55.29953917050691,0.06885245901639345,Very Cheap
20141015T000000,270000.0,3,2.5,1660,5550,2.0,0,0,3,7,1660,0,2002,0,98198,47.375,-122.304,1810,5550,3890,3740,48.648648648648646,0.025573770491803278,Very Cheap
20141120T000000,190000.0,2,1.0,880,6900,1.0,0,0,3,6,880,0,1943,0,98056,47.4903,-122.191,1060,8000,6020,6940,27.536231884057973,0.015081967213114755,Very Cheap
20140606T000000,435000.0,3,2.0,980,5000,1.0,0,0,3,6,980,0,1940,0,98144,47.595,-122.308,1970,3025,4020,1055,87.0,0.04721311475409836,Very Cheap
20141023T000000,560000.0,4,1.0,1360,5814,1.5,0,0,2,6,1360,0,1900,0,98122,47.6038,-122.314,1010,5814,4454,4804,96.31922944616443,0.06360655737704918,Very Cheap
20140905T000000,998000.0,3,3.75,3710,34412,2.0,0,0,3,10,2910,800,1978,0,98075,47.5888,-122.04,2390,34412,30702,32022,29.0015111007788,0.12104918032786885,Cheap
20141202T000000,725000.0,3,1.0,940,8377,1.0,0,0,4,7,940,0,1952,0,98004,47.5974,-122.2,1710,6900,7437,5190,86.54649635907843,0.08524590163934426,Very Cheap
20141124T000000,210000.0,2,1.0,970,8874,1.0,0,0,3,7,970,0,1968,0,98056,47.4943,-122.178,1340,8175,7904,6835,23.664638269100745,0.017704918032786884,Very Cheap
20140825T000000,513000.0,3,2.25,1500,1312,3.0,0,0,3,8,1500,0,2007,0,98103,47.6534,-122.346,1500,1282,-188,-218,391.0060975609756,0.05744262295081967,Very Cheap
20141105T000000,290000.0,5,2.5,2780,9652,1.0,0,0,4,8,1390,1390,1967,0,98001,47.3444,-122.271,1790,9652,6872,7862,30.045586406962286,0.02819672131147541,Very Cheap
20140925T000000,1260000.0,3,2.5,3110,9930,1.0,0,1,3,8,1640,1470,1954,0,98039,47.6112,-122.226,3650,14399,6820,10749,126.8882175226586,0.15540983606557376,Cheap
20140620T000000,330000.0,3,2.25,1860,11227,2.0,0,0,3,7,1860,0,1995,0,98038,47.3879,-122.031,1820,8800,9367,6980,29.393426560969093,0.03344262295081967,Very Cheap
20140605T000000,189000.0,3,1.0,1010,7560,1.0,0,0,3,6,1010,0,1958,0,98058,47.4497,-122.176,1170,7560,6550,6390,25.0,0.014950819672131148,Very Cheap
20150504T000000,907500.0,3,2.25,2850,6281,2.0,0,2,4,7,1900,950,1947,0,98115,47.6911,-122.326,1680,7006,3431,5326,144.48336252189142,0.10918032786885246,Cheap
20141104T000000,410000.0,3,2.25,2280,200811,1.0,0,0,3,7,2280,0,1978,0,98014,47.6522,-121.941,2280,206038,198531,203758,2.0417208220665204,0.043934426229508196,Very Cheap
20150220T000000,1050000.0,4,3.0,3080,10757,2.0,0,3,5,8,3080,0,1961,0,98006,47.5671,-122.159,2810,10757,7677,7947,97.61085804592358,0.12786885245901639,Cheap
20141204T000000,622100.0,4,2.5,2280,14290,1.5,0,0,4,7,1510,770,1942,0,98125,47.7054,-122.297,2140,9890,12010,7750,43.533939818054584,0.07175081967213115,Very Cheap
20140723T000000,250000.0,3,1.5,2030,14400,1.0,0,0,4,7,1310,720,1969,0,98001,47.2639,-122.285,1330,14400,12370,13070,17.36111111111111,0.022950819672131147,Very Cheap
20140818T000000,1180000.0,4,3.0,2570,4000,2.0,0,0,3,8,1750,820,1909,2014,98115,47.6743,-122.313,1970,4000,1430,2030,295.0,0.14491803278688525,Cheap
20150209T000000,925000.0,3,2.75,3640,10300,1.0,0,0,4,9,2060,1580,1979,0,98006,47.5612,-122.146,3110,10625,6660,7515,89.80582524271844,0.11147540983606558,Cheap
20150218T000000,554000.0,3,2.0,1760,4046,1.0,0,0,3,7,960,800,1931,0,98117,47.6876,-122.381,1500,4046,2286,2546,136.92535837864557,0.06281967213114754,Very Cheap
20140709T000000,545000.0,3,2.5,2760,17377,2.0,0,0,3,9,2760,0,2002,0,98056,47.4929,-122.188,1940,8504,14617,6564,31.363296311215976,0.06163934426229508,Very Cheap
20140909T000000,660000.0,3,2.5,2650,11250,2.0,0,0,3,9,2650,0,2005,0,98155,47.7644,-122.29,2200,10013,8600,7813,58.666666666666664,0.07672131147540984,Very Cheap
20150505T000000,1900000.0,5,4.5,5160,44315,2.0,0,0,3,12,5160,0,1996,0,98005,47.6568,-122.154,4760,44315,39155,39555,42.87487306780999,0.23934426229508196,Cheap
20140502T000000,260000.0,4,2.0,1480,8625,1.0,0,0,4,7,1480,0,1974,0,98055,47.462,-122.193,2130,8502,7145,6372,30.144927536231883,0.024262295081967214,Very Cheap
20141030T000000,219900.0,3,1.0,860,6664,1.0,0,0,3,6,860,0,1944,0,98178,47.4931,-122.247,1150,6857,5804,5707,32.99819927971188,0.01900327868852459,Very Cheap
20150325T000000,373500.0,4,2.5,2610,4978,2.0,0,0,3,8,2610,0,2004,0,98038,47.3438,-122.04,2470,5024,2368,2554,75.03013258336681,0.03914754098360656,Very Cheap
20140711T000000,380000.0,2,1.0,1470,81021,1.0,0,0,4,6,1470,0,1949,0,98027,47.4771,-122.03,2600,69696,79551,67096,4.69014206193456,0.04,Very Cheap
20140701T000000,1060000.0,4,2.5,4570,16015,2.0,0,2,3,11,4570,0,1990,0,98074,47.6246,-122.067,4490,17668,11445,13178,66.18794879800187,0.12918032786885245,Cheap
20150330T000000,2600000.0,3,3.0,3410,16015,2.0,1,4,4,10,2220,1190,1973,0,98040,47.5721,-122.239,3760,16572,12605,12812,162.34779893849517,0.33114754098360655,Medium
20140723T000000,450000.0,3,2.25,1760,10013,2.0,0,0,4,8,1760,0,1983,0,98056,47.5336,-122.189,1810,9768,8253,7958,44.94157595126336,0.04918032786885246,Very Cheap
20140716T000000,379950.0,3,1.75,2040,12065,1.0,0,0,3,8,2040,0,1987,0,98038,47.3756,-122.044,2010,11717,10025,9707,31.49191877331123,0.03999344262295082,Very Cheap
20140820T000000,834800.0,3,3.5,3470,4171,3.0,0,0,3,9,3470,0,2008,0,98034,47.711,-122.229,3430,4268,701,838,200.1438503955886,0.09964590163934427,Very Cheap
20140916T000000,365000.0,2,1.0,680,4800,1.0,0,0,3,6,680,0,1917,0,98122,47.6084,-122.304,1610,4800,4120,3190,76.04166666666667,0.0380327868852459,Very Cheap
20140617T000000,465000.0,2,2.0,1494,19271,2.0,1,4,3,7,1494,0,1943,1997,98070,47.4728,-122.497,1494,43583,17777,42089,24.129521041980176,0.051147540983606556,Very Cheap
20140730T000000,452000.0,3,1.5,1250,4000,1.0,0,0,3,7,1250,0,1955,0,98117,47.6916,-122.379,1030,4000,2750,2970,113.0,0.04944262295081967,Very Cheap
20150304T000000,840000.0,3,3.0,3570,6250,2.0,0,2,3,10,2710,860,1985,0,98116,47.5624,-122.399,2550,7596,2680,5046,134.4,0.10032786885245902,Cheap
20141103T000000,465000.0,4,2.0,2000,6250,1.5,0,0,3,7,1480,520,1930,0,98136,47.5532,-122.389,1110,6250,4250,5140,74.4,0.051147540983606556,Very Cheap
20150507T000000,295000.0,3,2.5,2030,4867,2.0,0,0,3,7,2030,0,2003,0,98042,47.3747,-122.128,2030,5000,2837,2970,60.6122868296692,0.028852459016393443,Very Cheap
20150224T000000,396000.0,3,1.0,1390,6160,1.0,0,0,4,7,1390,0,1949,0,98133,47.7289,-122.338,1230,6160,4770,4930,64.28571428571429,0.0420983606557377,Very Cheap
20150224T000000,397000.0,2,1.0,1030,12350,1.5,0,0,3,7,1030,0,1942,0,98115,47.6984,-122.324,1790,6900,11320,5110,32.14574898785425,0.04222950819672131,Very Cheap
20140819T000000,240000.0,3,1.0,1280,9000,1.5,0,0,4,6,1280,0,1954,0,98146,47.4915,-122.338,1430,4500,7720,3070,26.666666666666668,0.021639344262295083,Very Cheap
20150105T000000,300523.0,3,2.5,2370,6840,2.0,0,0,3,9,2370,0,1987,0,98119,47.6503,-122.366,1590,4400,4470,2810,43.93611111111111,0.0295767868852459,Very Cheap
20141106T000000,215500.0,3,2.0,1380,9000,2.0,0,0,2,7,1380,0,1946,1982,98001,47.2613,-122.248,1460,9732,7620,8272,23.944444444444443,0.01842622950819672,Very Cheap
20140805T000000,552500.0,5,3.0,2320,7229,1.0,0,0,4,8,1370,950,1986,0,98052,47.697,-122.097,2090,7554,4909,5464,76.4282750034583,0.06262295081967213,Very Cheap
20140828T000000,375000.0,5,1.5,2050,9360,1.0,0,0,3,7,1520,530,1968,0,98055,47.436,-122.195,1840,9383,7310,7543,40.06410256410256,0.03934426229508197,Very Cheap
20140606T000000,160000.0,3,1.0,1210,103237,1.0,0,0,2,6,1210,0,1918,1960,98070,47.4208,-122.445,1880,40510,102027,38630,1.5498319400989955,0.011147540983606558,Very Cheap
20140612T000000,1070000.0,4,2.5,3270,35445,2.0,0,0,3,11,3270,0,1989,0,98006,47.548,-122.121,4180,32130,32175,27950,30.187614614191,0.13049180327868853,Cheap
20141104T000000,952000.0,3,2.5,2450,4400,2.0,0,0,4,9,1800,650,1922,0,98102,47.6439,-122.319,2220,5500,1950,3280,216.36363636363637,0.11501639344262295,Cheap
20140627T000000,523460.0,5,1.75,1890,5000,1.5,0,0,3,7,1090,800,1906,0,98107,47.6711,-122.372,1610,5000,3110,3390,104.692,0.0588144262295082,Very Cheap
20140812T000000,305950.0,4,2.5,2007,4968,2.0,0,0,3,9,2007,0,2009,0,98092,47.3301,-122.191,2189,5852,2961,3663,61.5841384863124,0.030288524590163936,Very Cheap
20150209T000000,220000.0,3,2.5,1430,9044,2.0,0,0,3,7,1430,0,1991,0,98022,47.1956,-121.986,1580,8624,7614,7044,24.325519681556834,0.01901639344262295,Very Cheap
20150409T000000,289000.0,2,1.75,2056,52333,1.0,0,0,4,7,1048,1008,1980,0,98001,47.2592,-122.291,2220,6458,50277,4238,5.522328167695336,0.028065573770491802,Very Cheap
20150209T000000,648000.0,5,2.5,2210,10772,1.0,0,2,3,9,1430,780,1964,0,98155,47.7383,-122.288,2720,9858,8562,7138,60.15595989602674,0.07514754098360656,Very Cheap
20150410T000000,825000.0,5,1.75,2330,6000,1.5,0,0,3,8,2080,250,1937,0,98199,47.6461,-122.392,2150,6000,3670,3850,137.5,0.09836065573770492,Very Cheap
20141204T000000,400000.0,4,2.0,2070,10800,2.0,0,0,3,7,2070,0,1982,0,98011,47.7264,-122.237,1880,10800,8730,8920,37.03703703703704,0.04262295081967213,Very Cheap
20140512T000000,420000.0,2,2.5,1480,1369,3.0,0,0,3,7,1480,0,2009,0,98052,47.676,-122.121,1390,1337,-111,-53,306.79327976625274,0.04524590163934426,Very Cheap
20150120T000000,389000.0,2,1.75,1160,4848,2.0,0,1,4,7,1160,0,1949,0,98118,47.542,-122.265,1990,7440,3688,5450,80.23927392739274,0.04118032786885246,Very Cheap
20140908T000000,865000.0,4,2.5,2520,4950,2.0,0,0,3,8,2520,0,1906,2002,98117,47.6814,-122.359,1810,3500,2430,1690,174.74747474747474,0.10360655737704919,Cheap
20141203T000000,345000.0,2,1.0,1770,16660,1.0,0,3,3,8,1220,550,1957,0,98023,47.3346,-122.354,2790,20504,14890,17714,20.70828331332533,0.03540983606557377,Very Cheap
20150326T000000,700000.0,3,2.5,3110,123710,2.0,0,0,3,8,2430,680,1995,0,98038,47.3879,-122.002,2420,92782,120600,90362,5.65839463260852,0.08196721311475409,Very Cheap
20150416T000000,550000.0,3,2.5,1680,10455,2.0,0,0,3,8,1680,0,1982,0,98052,47.7229,-122.11,1860,10063,8775,8203,52.60640841702535,0.06229508196721312,Very Cheap
20140708T000000,201500.0,3,1.0,1320,5000,1.5,0,0,3,7,1320,0,1912,0,98116,47.5711,-122.386,1320,4179,3680,2859,40.3,0.01659016393442623,Very Cheap
20150323T000000,459000.0,3,1.0,1320,5000,1.5,0,0,3,7,1320,0,1912,0,98116,47.5711,-122.386,1320,4179,3680,2859,91.8,0.050360655737704915,Very Cheap
20141218T000000,327000.0,3,2.5,1810,7350,1.0,0,0,3,8,1310,500,1984,0,98058,47.4434,-122.125,2240,7350,5540,5110,44.48979591836735,0.033049180327868855,Very Cheap
20140516T000000,540000.0,1,1.0,1140,6700,1.5,0,0,3,7,1140,0,1920,0,98103,47.6958,-122.357,1350,6700,5560,5350,80.59701492537313,0.06098360655737705,Very Cheap
20140606T000000,805000.0,5,2.5,4600,19831,1.0,0,3,3,9,2300,2300,1956,2015,98177,47.7608,-122.378,2890,19831,15231,16941,40.59301094246382,0.09573770491803278,Very Cheap
20141023T000000,521000.0,3,2.0,1840,6000,1.0,0,0,4,6,1840,0,1908,1944,98136,47.5508,-122.392,2010,6000,4160,3990,86.83333333333333,0.058491803278688526,Very Cheap
20140527T000000,375000.0,3,1.5,2000,7294,1.0,0,0,3,7,1520,480,1965,0,98118,47.5297,-122.267,2000,6000,5294,4000,51.412119550315325,0.03934426229508197,Very Cheap
20150117T000000,235000.0,3,1.75,1480,6592,1.0,0,0,4,7,1080,400,1978,0,98023,47.2982,-122.378,1660,7150,5112,5490,35.64927184466019,0.02098360655737705,Very Cheap
20140929T000000,240000.0,4,2.5,2040,11841,2.0,0,0,3,7,2040,0,1994,0,98042,47.3691,-122.074,1730,8808,9801,7078,20.268558398783888,0.021639344262295083,Very Cheap
20140915T000000,575000.0,4,2.25,2060,12155,1.0,0,0,4,8,2060,0,1968,0,98008,47.6378,-122.117,2360,8625,10095,6265,47.30563554092966,0.06557377049180328,Very Cheap
20141201T000000,1520000.0,6,3.5,3720,11690,2.0,0,0,3,10,3720,0,2003,0,98040,47.5699,-122.226,3030,11686,7970,8656,130.0256629597947,0.18950819672131147,Cheap
20140702T000000,394500.0,4,2.5,3002,6042,2.0,0,0,3,8,3002,0,2004,0,98055,47.4231,-122.186,2566,6390,3040,3824,65.29294935451837,0.0419016393442623,Very Cheap
20140515T000000,174950.0,3,1.0,1060,5200,1.0,0,0,5,6,1060,0,1970,0,98042,47.3636,-122.093,1380,5200,4140,3820,33.64423076923077,0.013108196721311475,Very Cheap
20141117T000000,383000.0,4,2.0,1830,21183,1.0,0,0,4,7,1060,770,1966,0,98059,47.4826,-122.128,1950,6120,19353,4170,18.080536279091724,0.04039344262295082,Very Cheap
20140505T000000,249950.0,3,2.0,1550,15040,1.0,0,0,4,6,1550,0,1958,0,98059,47.4873,-122.099,1510,41416,13490,39906,16.61901595744681,0.022944262295081966,Very Cheap
20150318T000000,431000.0,3,2.5,1690,2752,2.0,0,0,3,8,1690,0,1979,0,98052,47.6332,-122.108,1690,2855,1062,1165,156.61337209302326,0.046688524590163934,Very Cheap
20140530T000000,459900.0,3,1.75,2580,11000,1.0,0,0,4,7,1290,1290,1951,0,98006,47.5646,-122.181,2280,17643,8420,15363,41.80909090909091,0.050478688524590164,Very Cheap
20140707T000000,475000.0,5,2.5,2510,8050,1.0,0,0,4,7,1490,1020,1977,0,98034,47.7212,-122.172,1840,8471,5540,6631,59.006211180124225,0.05245901639344262,Very Cheap
20140516T000000,605000.0,3,2.25,1290,2500,2.0,0,0,4,8,1290,0,1987,0,98112,47.6229,-122.298,1700,3750,1210,2050,242.0,0.06950819672131148,Very Cheap
20150218T000000,234950.0,4,2.0,1450,7560,1.0,0,0,3,7,1450,0,1967,0,98001,47.3375,-122.276,1430,7560,6110,6130,31.07804232804233,0.02097704918032787,Very Cheap
20140613T000000,419000.0,4,2.5,2690,7947,2.0,0,0,3,8,2690,0,1993,0,98058,47.4248,-122.153,2160,8328,5257,6168,52.72429847741286,0.04511475409836065,Very Cheap
20140522T000000,910000.0,4,3.25,3340,10890,1.5,0,0,3,9,2240,1100,1963,2000,98052,47.6677,-122.136,2880,9794,7550,6914,83.56290174471992,0.10950819672131147,Cheap
20141203T000000,392000.0,4,2.5,2600,8921,2.0,0,0,3,8,2600,0,1991,0,98058,47.4423,-122.178,2550,8683,6321,6133,43.941262190337405,0.04157377049180328,Very Cheap
20140825T000000,915000.0,3,2.5,3140,9808,2.0,0,0,3,9,2500,640,2001,0,98052,47.6383,-122.097,2370,10014,6668,7644,93.29119086460032,0.11016393442622952,Cheap
20141114T000000,630000.0,3,3.25,3800,13995,2.0,0,3,3,9,3800,0,1983,0,98011,47.7741,-122.203,2480,8434,10195,5954,45.01607717041801,0.07278688524590164,Very Cheap
20140710T000000,416100.0,4,1.75,2320,5490,1.0,0,3,3,8,1160,1160,1956,0,98178,47.5091,-122.241,2240,7200,3170,4960,75.79234972677595,0.0447344262295082,Very Cheap
20140821T000000,285000.0,4,2.5,2360,7350,1.0,0,0,4,7,1440,920,1965,0,98001,47.3417,-122.277,1450,7305,4990,5855,38.775510204081634,0.02754098360655738,Very Cheap
20150506T000000,353000.0,4,1.5,1100,9600,1.0,0,0,4,6,1100,0,1960,0,98033,47.7,-122.175,1100,9630,8500,8530,36.770833333333336,0.03645901639344262,Very Cheap
20140826T000000,297950.0,3,2.0,1390,5127,1.0,0,0,3,8,1390,0,1990,0,98055,47.4504,-122.206,1960,5019,3737,3059,58.1139067680905,0.029239344262295082,Very Cheap
20141007T000000,750000.0,2,2.0,2180,21392,2.0,0,0,3,8,2180,0,1934,1979,98034,47.7162,-122.246,2890,22000,19212,19110,35.05983545250561,0.08852459016393442,Very Cheap
20150402T000000,525000.0,3,3.0,1730,1074,3.5,0,0,3,8,1730,0,2006,0,98107,47.6692,-122.392,1370,1185,-656,-185,488.8268156424581,0.05901639344262295,Very Cheap
20140715T000000,495000.0,5,1.75,2760,18112,1.0,0,0,3,8,1510,1250,1968,0,98155,47.7363,-122.298,1720,8482,15352,6762,27.329946996466433,0.05508196721311476,Very Cheap
20140825T000000,710000.0,3,1.75,2430,11448,1.0,0,1,5,7,1620,810,1949,0,98117,47.6971,-122.391,2140,8144,9018,6004,62.019566736547866,0.08327868852459017,Very Cheap
20140730T000000,310000.0,3,2.0,2010,12950,1.0,0,0,3,8,2010,0,1953,0,98034,47.7222,-122.229,1490,10181,10940,8691,23.93822393822394,0.03081967213114754,Very Cheap
20140516T000000,205000.0,5,1.75,1730,5200,1.0,0,0,4,7,1050,680,1978,0,98042,47.3628,-122.089,1350,5200,3470,3850,39.42307692307692,0.017049180327868854,Very Cheap
20150508T000000,530000.0,3,3.0,2450,211266,1.5,0,3,3,8,2450,0,2004,0,98022,47.2215,-122.067,2300,263492,208816,261192,2.508685732678235,0.05967213114754098,Very Cheap
20140724T000000,725000.0,4,2.5,3300,28433,2.0,0,0,3,9,3300,0,1998,0,98059,47.5072,-122.112,3550,26386,25133,22836,25.498540428375478,0.08524590163934426,Very Cheap
20141125T000000,195000.0,2,1.0,720,9520,1.0,0,0,4,6,720,0,1947,0,98155,47.7678,-122.316,1450,8612,8800,7162,20.483193277310924,0.015737704918032787,Very Cheap
20140701T000000,401000.0,3,2.0,1240,11172,1.0,0,0,3,7,1000,240,1984,0,98074,47.6364,-122.037,1330,14102,9932,12772,35.89330469029717,0.04275409836065574,Very Cheap
20140922T000000,1030000.0,5,2.5,3050,8200,1.0,0,4,4,8,1650,1400,1962,0,98006,47.5647,-122.155,2970,8792,5150,5822,125.60975609756098,0.12524590163934426,Cheap
20150403T000000,251000.0,3,1.5,1590,21600,1.5,0,0,4,7,1590,0,1971,0,98022,47.2159,-121.966,1780,21600,20010,19820,11.62037037037037,0.023081967213114753,Very Cheap
20141027T000000,667500.0,3,2.0,2040,4841,1.0,0,0,4,7,1020,1020,1949,0,98115,47.6778,-122.302,1600,4841,2801,3241,137.88473455897542,0.07770491803278688,Very Cheap
20140623T000000,300000.0,4,2.5,1840,5550,2.0,0,0,3,8,1840,0,2004,0,98031,47.3937,-122.183,2030,5500,3710,3470,54.054054054054056,0.029508196721311476,Very Cheap
20140814T000000,610000.0,4,2.25,1960,9021,2.0,0,0,4,8,1960,0,1973,0,98052,47.6349,-122.096,1960,9975,7061,8015,67.61999778295089,0.07016393442622951,Very Cheap
20140703T000000,1042030.0,4,5.0,4110,43560,2.0,0,0,4,11,4110,0,1978,0,98005,47.6353,-122.18,3650,43995,39450,40345,23.921717171717173,0.12682360655737704,Cheap
20141203T000000,430000.0,3,2.25,1830,19965,1.0,0,0,3,8,1400,430,1976,0,98072,47.7412,-122.088,1830,17250,18135,15420,21.537690959178562,0.04655737704918033,Very Cheap
20150402T000000,455000.0,2,1.0,1330,92782,1.0,0,0,2,6,1330,0,1950,0,98014,47.6624,-121.868,1280,168141,91452,166861,4.903968442154729,0.049836065573770495,Very Cheap
20140702T000000,600000.0,5,2.0,2190,9072,1.0,0,0,5,7,1110,1080,1965,0,98052,47.6696,-122.149,1660,8327,6882,6667,66.13756613756614,0.06885245901639345,Very Cheap
20150219T000000,638000.0,3,3.25,1720,1587,2.5,0,2,3,9,1410,310,2004,0,98122,47.6187,-122.299,1490,1620,-133,130,402.0163831127914,0.0738360655737705,Very Cheap
20141014T000000,561000.0,3,1.75,1710,5000,1.0,0,0,4,7,1360,350,1918,0,98136,47.5492,-122.389,1490,6250,3290,4760,112.2,0.06373770491803278,Very Cheap
20141216T000000,625000.0,3,2.5,2180,5000,1.0,0,0,4,8,1240,940,1977,0,98116,47.5828,-122.396,2000,5000,2820,3000,125.0,0.07213114754098361,Very Cheap
20150324T000000,263950.0,3,1.75,1700,11613,1.0,0,0,5,7,1180,520,1977,0,98092,47.2874,-122.187,1500,12377,9913,10877,22.728838370791355,0.02478032786885246,Very Cheap
20141028T000000,740000.0,3,2.5,2960,9350,2.0,0,2,4,9,2960,0,1978,0,98008,47.6218,-122.094,2960,11745,6390,8785,79.14438502673796,0.08721311475409836,Very Cheap
20140609T000000,234999.0,3,1.0,1330,8912,1.0,0,0,3,6,1330,0,1948,0,98188,47.4493,-122.274,1200,8913,7582,7713,26.36882854578097,0.020983475409836066,Very Cheap
20150414T000000,380000.0,4,2.5,1940,3200,2.0,0,0,3,8,1940,0,2004,0,98058,47.4583,-122.118,1900,3200,1260,1300,118.75,0.04,Very Cheap
20140812T000000,329500.0,3,2.25,1500,9656,1.0,0,0,3,7,1170,330,1989,0,98019,47.7327,-121.982,1690,9656,8156,7966,34.123860811930406,0.03337704918032787,Very Cheap
20140711T000000,464950.0,4,2.5,2230,64438,1.0,0,0,4,7,1230,1000,1978,0,98027,47.4754,-122.007,2230,71002,62208,68772,7.215462925602905,0.051140983606557375,Very Cheap
20150402T000000,500000.0,3,2.25,1700,9008,1.0,0,0,3,8,1340,360,1985,0,98125,47.7161,-122.317,2340,8003,7308,5663,55.50621669626998,0.05573770491803279,Very Cheap
20140709T000000,415000.0,4,1.5,1840,11367,1.5,0,0,4,7,1840,0,1950,0,98177,47.7656,-122.358,1690,9800,9527,8110,36.509193278789475,0.04459016393442623,Very Cheap
20140905T000000,437500.0,3,2.25,2100,205603,2.0,0,0,3,8,2100,0,1983,0,98070,47.3668,-122.505,2396,187308,203503,184912,2.1278872389994308,0.047540983606557376,Very Cheap
20140709T000000,599000.0,7,2.5,2580,5750,1.0,0,0,4,7,1880,700,1901,0,98122,47.6025,-122.294,2280,5750,3170,3470,104.17391304347827,0.06872131147540983,Very Cheap
20141014T000000,367000.0,4,2.5,2350,8182,2.0,0,0,3,8,2350,0,1997,0,98042,47.3697,-122.106,2330,7000,5832,4670,44.8545587875825,0.03829508196721312,Very Cheap
20150425T000000,530000.0,2,1.0,760,3000,1.0,0,0,3,6,760,0,1922,0,98107,47.6633,-122.357,1630,3600,2240,1970,176.66666666666666,0.05967213114754098,Very Cheap
20140604T000000,989000.0,5,3.5,3280,4000,2.0,0,0,3,9,2440,840,2003,0,98117,47.689,-122.396,1980,4000,720,2020,247.25,0.11986885245901639,Cheap
20140822T000000,462600.0,3,2.0,1320,4000,1.0,0,0,4,6,1020,300,1940,0,98118,47.5515,-122.262,2410,6212,2680,3802,115.65,0.0508327868852459,Very Cheap
20150424T000000,875000.0,3,2.5,1690,10592,1.0,0,0,3,8,1690,0,1973,2009,98040,47.58,-122.231,2260,9945,8902,7685,82.6095166163142,0.10491803278688525,Cheap
20140722T000000,335000.0,3,2.25,2060,47318,1.0,0,2,4,8,1600,460,1976,0,98001,47.2758,-122.265,1870,19663,45258,17793,7.0797582315397944,0.03409836065573771,Very Cheap
20140731T000000,393000.0,4,2.0,1450,5456,1.0,0,0,5,7,1450,0,1951,0,98108,47.5442,-122.297,980,6100,4006,5120,72.0307917888563,0.041704918032786885,Very Cheap
20140721T000000,1340000.0,4,3.0,2760,4905,2.0,0,1,4,9,1840,920,1938,0,98105,47.6591,-122.27,3200,5424,2145,2224,273.19062181447504,0.1659016393442623,Cheap
20150323T000000,590000.0,3,2.5,2830,5788,2.0,0,0,3,9,2830,0,2001,0,98028,47.7604,-122.235,2500,5802,2958,3302,101.9350380096752,0.06754098360655737,Very Cheap
20150421T000000,671000.0,4,2.75,1890,1475,2.0,0,0,3,9,1200,690,2015,0,98199,47.6472,-122.383,1650,1682,-415,32,454.91525423728814,0.07816393442622951,Very Cheap
20140728T000000,925000.0,3,3.25,2610,4500,1.5,0,0,4,9,1660,950,1909,0,98103,47.6701,-122.339,2110,4500,1890,2390,205.55555555555554,0.11147540983606558,Cheap
20141006T000000,245000.0,3,2.25,1900,7250,1.0,0,0,3,7,1250,650,1967,0,98146,47.4869,-122.344,1560,9420,5350,7860,33.793103448275865,0.022295081967213116,Very Cheap
20150402T000000,392500.0,3,1.0,930,6572,1.0,0,0,3,7,930,0,1952,0,98115,47.6889,-122.301,960,5840,5642,4880,59.72306755934267,0.04163934426229508,Very Cheap
20140828T000000,505000.0,4,2.0,2730,12000,1.0,0,0,4,8,1410,1320,1998,0,98155,47.7733,-122.271,2730,9039,9270,6309,42.083333333333336,0.05639344262295082,Very Cheap
20140819T000000,702000.0,4,2.5,2650,6240,2.0,0,0,3,8,2650,0,2013,0,98053,47.6885,-122.021,2640,6524,3590,3884,112.5,0.08222950819672131,Very Cheap
20140718T000000,337000.0,2,1.0,1010,4000,1.0,0,0,3,7,1010,0,1947,0,98136,47.5311,-122.382,1480,4366,2990,2886,84.25,0.034360655737704915,Very Cheap
20141229T000000,920000.0,4,2.5,3550,10233,2.0,0,0,3,9,3550,0,1996,0,98027,47.5499,-122.1,3310,9157,6683,5847,89.90520863871788,0.11081967213114755,Cheap
20140827T000000,495500.0,3,1.75,2130,6360,1.0,0,0,3,7,1720,410,1959,0,98125,47.7059,-122.301,1540,6361,4230,4821,77.90880503144655,0.05514754098360656,Very Cheap
20140924T000000,245000.0,2,1.75,1840,7230,1.0,0,0,3,7,1570,270,1938,0,98030,47.3815,-122.228,1282,6769,5390,5487,33.8865836791148,0.022295081967213116,Very Cheap
20140529T000000,395000.0,2,1.0,1320,1824,1.5,0,0,4,6,1320,0,1909,0,98144,47.585,-122.294,1320,4000,504,2680,216.55701754385964,0.0419672131147541,Very Cheap
20150217T000000,335000.0,3,1.0,990,6315,1.0,0,0,3,7,990,0,1970,0,98034,47.7116,-122.214,1450,6702,5325,5252,53.048297703879655,0.03409836065573771,Very Cheap
20141110T000000,187000.0,2,1.75,1020,10346,1.0,0,0,4,6,1020,0,1983,0,98022,47.1958,-122.002,1160,8610,9326,7450,18.074618209936208,0.014688524590163935,Very Cheap
20141121T000000,450000.0,4,2.0,1570,7320,1.0,0,0,4,7,1570,0,1960,0,98007,47.5967,-122.14,1530,8800,5750,7270,61.47540983606557,0.04918032786885246,Very Cheap
20140617T000000,280000.0,4,2.25,1930,7207,1.0,0,0,4,7,1360,570,1988,0,98030,47.3783,-122.182,1760,7207,5277,5447,38.851116969612875,0.026885245901639345,Very Cheap
20140715T000000,1375000.0,5,4.0,3760,22763,1.0,0,3,4,11,1910,1850,1969,0,98040,47.5333,-122.22,3730,11201,19003,7471,60.40504327197645,0.17049180327868851,Cheap
20140609T000000,265000.0,2,1.0,1000,31505,1.0,0,0,3,6,1000,0,1960,0,98019,47.7659,-121.899,1560,22597,30505,21037,8.411363275670528,0.024918032786885248,Very Cheap
20150423T000000,795000.0,3,1.75,1930,9600,1.0,0,0,3,8,1930,0,1958,0,98040,47.5747,-122.237,2350,9840,7670,7490,82.8125,0.09442622950819672,Very Cheap
20140529T000000,510000.0,3,1.5,2240,3800,2.0,0,0,3,8,1370,870,1929,0,98115,47.6887,-122.307,1690,4275,1560,2585,134.21052631578948,0.057049180327868855,Very Cheap
20140628T000000,699900.0,4,2.5,2190,11500,1.0,0,0,4,8,1430,760,1972,0,98006,47.5668,-122.147,2580,9700,9310,7120,60.86086956521739,0.08195409836065574,Very Cheap
20140812T000000,839000.0,4,2.75,2400,12469,1.0,0,2,4,8,1760,640,1958,0,98008,47.5861,-122.112,2400,10400,10069,8000,67.28687144117411,0.1001967213114754,Cheap
20140715T000000,396000.0,4,1.75,1970,12409,1.0,0,0,4,7,1220,750,1968,0,98028,47.7489,-122.236,1690,10720,10439,9030,31.91232170199049,0.0420983606557377,Very Cheap
20150507T000000,365000.0,3,2.25,2860,8458,2.0,0,0,3,7,2860,0,1983,0,98058,47.4269,-122.148,1760,8458,5598,6698,43.15441002601088,0.0380327868852459,Very Cheap
20140711T000000,440000.0,3,2.25,1900,7225,1.0,0,0,3,8,1220,680,1970,0,98008,47.6394,-122.113,1900,7399,5325,5499,60.89965397923876,0.04786885245901639,Very Cheap
20141104T000000,405000.0,4,2.5,2090,6667,2.0,0,0,3,8,2090,0,1997,0,98058,47.4648,-122.15,2250,6165,4577,3915,60.746962651867406,0.043278688524590166,Very Cheap
20140515T000000,295000.0,3,1.5,850,2500,1.0,0,0,3,7,850,0,1986,0,98106,47.5677,-122.36,850,5000,1650,4150,118.0,0.028852459016393443,Very Cheap
20140515T000000,275000.0,4,2.5,1840,1562,2.0,0,0,3,7,1400,440,2004,0,98106,47.5345,-122.364,1840,1766,-278,-74,176.05633802816902,0.02622950819672131,Very Cheap
20141003T000000,295000.0,2,1.0,820,288367,1.0,0,0,3,6,820,0,1930,1986,98042,47.4196,-122.165,1580,8154,287547,6574,1.0230019385019784,0.028852459016393443,Very Cheap
20140815T000000,1500000.0,5,3.5,4370,12240,2.0,0,0,3,11,3270,1100,1990,0,98004,47.582,-122.199,2980,12800,7870,9820,122.54901960784314,0.18688524590163935,Cheap
20140902T000000,795000.0,3,3.5,3190,10223,2.0,0,0,3,10,2560,630,1994,0,98052,47.6968,-122.102,3120,9735,7033,6615,77.76582216570479,0.09442622950819672,Very Cheap
20140506T000000,650000.0,5,3.5,3480,36615,2.0,0,0,4,8,2490,990,1983,0,98075,47.5741,-122.05,2540,35910,33135,33370,17.75228731394237,0.07540983606557378,Very Cheap
20140910T000000,260000.0,3,1.0,1690,13184,1.0,0,0,4,7,1690,0,1959,0,98166,47.476,-122.343,1130,13451,11494,12321,19.72087378640777,0.024262295081967214,Very Cheap
20140806T000000,382000.0,2,2.5,1650,2710,2.0,0,2,3,8,1650,0,2008,0,98065,47.5173,-121.878,1760,2992,1060,1232,140.95940959409594,0.040262295081967214,Very Cheap
20150421T000000,790100.0,4,2.5,2590,9341,2.0,0,0,3,8,2590,0,1985,0,98052,47.6496,-122.114,2280,9510,6751,7230,84.58409163901081,0.09378360655737705,Very Cheap
20140521T000000,220000.0,4,2.5,2160,8005,2.0,0,0,3,7,2160,0,1993,0,98001,47.2668,-122.231,1790,8016,5845,6226,27.482823235477827,0.01901639344262295,Very Cheap
20140605T000000,799000.0,4,3.5,3500,8547,2.0,0,0,3,9,2500,1000,1994,0,98006,47.5613,-122.126,2350,10270,5047,7920,93.48309348309348,0.09495081967213115,Very Cheap
20140723T000000,1480000.0,4,2.25,3920,7200,2.0,0,0,3,10,3120,800,1928,0,98144,47.5731,-122.284,3400,7200,3280,3800,205.55555555555554,0.1842622950819672,Cheap
20140609T000000,367300.0,4,2.75,2190,14937,2.0,0,0,3,8,2190,0,1993,0,98001,47.3535,-122.273,1920,11360,12747,9440,24.58994443328647,0.038334426229508195,Very Cheap
20150409T000000,805000.0,4,2.0,1890,4500,1.5,0,0,3,7,1490,400,1907,1993,98103,47.6684,-122.356,1640,4010,2610,2370,178.88888888888889,0.09573770491803278,Very Cheap
20141215T000000,730000.0,2,1.0,1860,3400,1.0,0,0,3,7,1010,850,1920,0,98105,47.6714,-122.329,1540,3997,1540,2457,214.7058823529412,0.0859016393442623,Very Cheap
20141123T000000,402000.0,3,2.0,1720,7704,1.0,0,0,4,7,1160,560,1969,0,98011,47.7368,-122.195,1620,7600,5984,5980,52.18068535825545,0.04288524590163934,Very Cheap
20140530T000000,750000.0,4,2.75,2600,4674,1.0,0,0,3,8,1560,1040,1976,0,98115,47.6782,-122.286,2600,6099,2074,3499,160.46213093709883,0.08852459016393442,Very Cheap
20140730T000000,458000.0,3,1.5,1570,12196,1.0,0,0,4,7,1570,0,1972,0,98045,47.4866,-121.786,1740,12196,10626,10456,37.55329616267629,0.05022950819672131,Very Cheap
20140828T000000,898000.0,3,2.5,3530,9753,2.0,0,0,3,10,3530,0,1997,0,98006,47.5539,-122.103,3220,9234,6223,6014,92.07423356915821,0.10793442622950819,Cheap
20150323T000000,308000.0,4,2.5,1960,5642,2.0,0,0,3,7,1960,0,1998,0,98092,47.3167,-122.187,1870,5250,3682,3380,54.59057071960298,0.030557377049180327,Very Cheap
20150506T000000,385000.0,3,2.5,2230,8296,2.0,0,0,3,7,2230,0,2004,0,98058,47.4386,-122.116,2480,5940,6066,3460,46.407907425265186,0.04065573770491803,Very Cheap
20141006T000000,1020000.0,4,3.0,2720,4800,1.5,0,0,5,8,1790,930,1928,0,98105,47.6595,-122.283,2260,4800,2080,2540,212.5,0.12393442622950819,Cheap
20141229T000000,1425000.0,5,3.0,2840,6240,2.0,0,0,5,9,2440,400,1905,0,98112,47.6285,-122.309,2940,6000,3400,3060,228.3653846153846,0.17704918032786884,Cheap
20140723T000000,240000.0,3,1.75,1260,7362,1.0,0,0,3,7,1260,0,1984,0,98038,47.3602,-122.052,1530,7232,6102,5702,32.59983700081499,0.021639344262295083,Very Cheap
20141001T000000,217000.0,3,1.5,1860,8505,1.0,0,0,4,7,1860,0,1967,0,98023,47.3106,-122.365,1810,8262,6645,6452,25.51440329218107,0.01862295081967213,Very Cheap
20140630T000000,972000.0,4,1.75,2010,6300,1.0,0,2,5,8,1610,400,1937,0,98199,47.6457,-122.412,3290,6300,4290,3010,154.28571428571428,0.11763934426229508,Cheap
20140507T000000,361280.0,2,1.0,820,6400,1.0,0,0,4,7,820,0,1944,0,98126,47.55,-122.379,1490,6400,5580,4910,56.45,0.03754491803278689,Very Cheap
20140804T000000,385000.0,3,1.75,1220,1450,1.0,0,0,3,6,620,600,1905,0,98119,47.6361,-122.368,1660,2960,230,1300,265.51724137931035,0.04065573770491803,Very Cheap
20141105T000000,475000.0,3,2.5,2220,60984,2.0,0,0,4,8,2220,0,1987,0,98027,47.4802,-122.052,1930,55333,58764,53403,7.788928243473698,0.05245901639344262,Very Cheap
20150402T000000,724950.0,4,2.5,2860,3638,1.5,0,2,5,7,1720,1140,1924,0,98107,47.6631,-122.361,1760,3880,778,2120,199.2715777899945,0.08523934426229508,Very Cheap
20141027T000000,935000.0,5,4.5,4230,9701,2.0,0,0,3,10,4230,0,1999,0,98006,47.5444,-122.131,4130,12253,5471,8123,96.38181630759715,0.11278688524590164,Cheap
20140908T000000,169950.0,3,1.0,840,8470,1.0,0,0,4,6,840,0,1961,0,98023,47.3275,-122.338,840,8450,7630,7610,20.064935064935064,0.012452459016393443,Very Cheap
20141208T000000,585000.0,3,2.5,2290,5089,2.0,0,0,3,9,2290,0,2001,0,98006,47.5443,-122.172,2290,7984,2799,5694,114.95382196895264,0.06688524590163934,Very Cheap
20150423T000000,585000.0,3,2.5,2290,5089,2.0,0,0,3,9,2290,0,2001,0,98006,47.5443,-122.172,2290,7984,2799,5694,114.95382196895264,0.06688524590163934,Very Cheap
20150327T000000,480000.0,5,3.5,3480,12821,2.0,0,2,3,10,2890,590,2004,0,98092,47.2641,-122.215,3400,9870,9341,6470,37.43857733406131,0.05311475409836065,Very Cheap
20141105T000000,635000.0,4,2.5,4260,36360,1.5,0,0,4,8,4100,160,1935,0,98155,47.764,-122.302,2430,17888,32100,15458,17.464246424642464,0.07344262295081967,Very Cheap
20150204T000000,368750.0,3,2.5,2230,5717,2.0,0,0,3,7,2230,0,2004,0,98058,47.4388,-122.117,2230,5194,3487,2964,64.50061220920063,0.038524590163934426,Very Cheap
20141202T000000,432500.0,6,2.0,3080,5500,2.0,0,0,1,7,3080,0,1900,0,98122,47.6031,-122.296,1830,5000,2420,3170,78.63636363636364,0.046885245901639346,Very Cheap
20140903T000000,589000.0,3,2.5,2250,4337,2.0,0,0,3,8,2250,0,2004,0,98075,47.5908,-122.017,2250,4721,2087,2471,135.80816232418724,0.06740983606557377,Very Cheap
20150414T000000,840000.0,4,3.25,3160,6327,2.0,0,0,3,9,2280,880,2004,0,98027,47.536,-122.066,3160,5946,3167,2786,132.76434329065907,0.10032786885245902,Cheap
20150305T000000,316500.0,3,2.5,1770,3873,2.0,0,0,3,7,1770,0,2005,0,98058,47.4648,-122.144,2280,4330,2103,2050,81.71959721146398,0.031672131147540986,Very Cheap
20150213T000000,536000.0,4,2.5,2880,8833,2.0,0,0,3,7,2880,0,2006,0,98065,47.5388,-121.89,2570,5234,5953,2664,60.681535152269895,0.06045901639344262,Very Cheap
20150420T000000,563750.0,4,2.75,2690,25000,1.0,0,0,3,8,1750,940,1978,0,98029,47.5537,-122.026,2640,28250,22310,25610,22.55,0.06409836065573771,Very Cheap
20141226T000000,152500.0,4,1.0,1730,7350,1.5,0,0,4,6,1730,0,1970,0,98003,47.3467,-122.307,1440,7752,5620,6312,20.74829931972789,0.010163934426229508,Very Cheap
20150420T000000,267950.0,4,1.0,1730,7350,1.5,0,0,4,6,1730,0,1970,0,98003,47.3467,-122.307,1440,7752,5620,6312,36.45578231292517,0.025304918032786887,Very Cheap
20150413T000000,1640000.0,5,4.0,4780,118047,2.0,0,0,3,11,4780,0,1994,0,98077,47.7243,-122.052,4040,31760,113267,27720,13.892771523206859,0.20524590163934425,Cheap
20140623T000000,269950.0,4,2.5,2540,8400,2.0,0,0,5,7,2540,0,1977,0,98032,47.3754,-122.277,1600,8050,5860,6450,32.13690476190476,0.025567213114754097,Very Cheap
20140721T000000,731688.0,4,3.0,2630,5772,2.0,0,0,3,9,2630,0,2006,0,98052,47.6952,-122.133,3460,6158,3142,2698,126.76507276507276,0.08612301639344262,Very Cheap
20141203T000000,240000.0,3,1.5,1890,9000,1.0,0,0,3,7,1190,700,1959,0,98188,47.4425,-122.272,2060,9000,7110,6940,26.666666666666668,0.021639344262295083,Very Cheap
20140903T000000,555950.0,2,1.0,1220,5040,1.0,0,0,3,7,1220,0,1961,0,98117,47.6957,-122.364,1420,5040,3820,3620,110.30753968253968,0.06307540983606558,Very Cheap
20150427T000000,289000.0,2,1.0,710,6300,1.0,0,0,3,6,710,0,1942,0,98126,47.5155,-122.374,740,6300,5590,5560,45.87301587301587,0.028065573770491802,Very Cheap
20140506T000000,525000.0,3,2.5,2970,11985,1.0,0,0,3,9,1770,1200,1995,0,98074,47.6359,-122.052,2990,12049,9015,9059,43.804755944931166,0.05901639344262295,Very Cheap
20141204T000000,745000.0,3,2.5,2970,11985,1.0,0,0,3,9,1770,1200,1995,0,98074,47.6359,-122.052,2990,12049,9015,9059,62.161034626616605,0.08786885245901639,Very Cheap
20141117T000000,397000.0,2,1.0,1000,7664,1.0,0,2,3,7,1000,0,1939,0,98115,47.7001,-122.311,1570,6350,6664,4780,51.80062630480167,0.04222950819672131,Very Cheap
20150422T000000,233000.0,3,1.0,1980,8505,1.0,0,0,3,7,1030,950,1965,0,98106,47.538,-122.353,1830,8505,6525,6675,27.39564961787184,0.020721311475409836,Very Cheap
20141016T000000,625000.0,4,2.25,1920,8259,2.0,0,0,4,8,1920,0,1979,0,98027,47.5616,-122.088,2030,8910,6339,6880,75.67502118900593,0.07213114754098361,Very Cheap
20140729T000000,535000.0,3,2.0,2740,23505,2.0,0,4,3,10,2740,0,1988,0,98001,47.319,-122.26,2800,16400,20765,13600,22.761114656456073,0.06032786885245902,Very Cheap
20150504T000000,270000.0,3,2.25,1740,7345,1.0,0,0,3,7,1380,360,1973,0,98032,47.3663,-122.285,1770,8250,5605,6480,36.75970047651464,0.025573770491803278,Very Cheap
20140722T000000,360000.0,3,1.75,1300,7770,1.0,0,0,3,7,1300,0,1967,0,98034,47.7347,-122.192,1520,7600,6470,6080,46.33204633204633,0.037377049180327866,Very Cheap
20140513T000000,1105000.0,4,1.5,2740,4000,2.0,0,0,5,9,1930,810,1905,0,98109,47.6343,-122.352,1680,4000,1260,2320,276.25,0.13508196721311475,Cheap
20141111T000000,970000.0,4,1.75,4060,4000,2.0,0,3,3,10,2890,1170,1953,1995,98199,47.6375,-122.389,1860,4000,-60,2140,242.5,0.11737704918032787,Cheap
20141010T000000,915000.0,5,2.5,3490,18850,1.0,0,4,4,9,1840,1650,1958,0,98005,47.5955,-122.176,2690,11625,15360,8935,48.54111405835544,0.11016393442622952,Cheap
20140711T000000,412000.0,4,1.75,1430,10500,1.0,0,0,4,7,1130,300,1960,0,98007,47.6083,-122.132,2070,8640,9070,6570,39.23809523809524,0.04419672131147541,Very Cheap
20150212T000000,265000.0,4,1.75,1860,9112,1.0,0,0,4,7,1110,750,1963,0,98032,47.3792,-122.282,1570,9112,7252,7542,29.08252853380158,0.024918032786885248,Very Cheap
20140916T000000,426000.0,4,2.25,2120,7700,1.0,0,0,4,7,1490,630,1976,0,98034,47.7207,-122.165,1890,8203,5580,6313,55.324675324675326,0.046032786885245904,Very Cheap
20141210T000000,266000.0,4,2.25,1860,12693,1.0,0,0,3,8,1140,720,1978,0,98023,47.3114,-122.395,1950,8740,10833,6790,20.956432679429607,0.02504918032786885,Very Cheap
20141215T000000,325000.0,3,2.0,2330,4950,1.5,0,0,3,6,1430,900,1900,0,98118,47.5585,-122.29,1160,5115,2620,3955,65.65656565656566,0.03278688524590164,Very Cheap
20150120T000000,615000.0,3,1.75,1670,5100,1.0,0,2,5,7,990,680,1954,0,98144,47.5898,-122.291,2140,4452,3430,2312,120.58823529411765,0.07081967213114754,Very Cheap
20150423T000000,310000.0,3,1.75,2130,7140,1.0,0,0,3,8,1580,550,1979,0,98023,47.3074,-122.341,2180,7906,5010,5726,43.417366946778714,0.03081967213114754,Very Cheap
20140914T000000,340000.0,4,1.75,1900,7313,1.0,0,0,3,7,1900,0,1973,0,98034,47.7311,-122.232,1420,7384,5413,5964,46.49254751811842,0.03475409836065574,Very Cheap
20150501T000000,562500.0,2,1.0,1170,2800,1.5,0,0,4,5,1170,0,1905,0,98103,47.6574,-122.345,1660,4996,1630,3336,200.89285714285714,0.06393442622950819,Very Cheap
20140721T000000,447000.0,2,1.0,980,1600,2.0,0,0,3,8,980,0,2010,0,98119,47.638,-122.375,1180,1600,620,420,279.375,0.04878688524590164,Very Cheap
20140930T000000,2450000.0,7,4.25,4670,23115,2.0,0,2,3,11,4670,0,1992,0,98039,47.6183,-122.227,3240,13912,18445,10672,105.99178022928834,0.3114754098360656,Medium
20140520T000000,250000.0,4,1.5,2500,6300,1.0,0,0,4,7,1500,1000,1961,0,98032,47.3781,-122.284,1720,8925,3800,7205,39.682539682539684,0.022950819672131147,Very Cheap
20150102T000000,633000.0,4,2.5,2020,8044,2.0,0,0,3,8,2020,0,1990,0,98074,47.6247,-122.043,2320,7328,6024,5008,78.6921929388364,0.07318032786885247,Very Cheap
20150423T000000,310000.0,3,2.0,1290,886,3.0,0,0,3,7,1290,0,2004,0,98125,47.7161,-122.295,1270,1152,-404,-118,349.88713318284425,0.03081967213114754,Very Cheap
20141110T000000,439000.0,2,1.75,1620,113862,1.5,0,0,3,7,1620,0,1995,0,98045,47.4821,-121.719,1560,54806,112242,53246,3.8555444309778504,0.04773770491803279,Very Cheap
20140820T000000,470000.0,3,3.25,1710,2381,2.0,0,0,3,8,1360,350,2003,0,98029,47.5477,-122.004,1420,1163,671,-257,197.39605207895843,0.05180327868852459,Very Cheap
20150414T000000,270000.0,3,2.5,1720,8550,1.0,0,0,4,7,1720,0,1968,0,98002,47.2837,-122.207,1460,8550,6830,7090,31.57894736842105,0.025573770491803278,Very Cheap
20141219T000000,299500.0,3,1.75,1820,8813,2.0,0,0,3,7,1820,0,1994,0,98003,47.2622,-122.303,1780,7349,6993,5569,33.98388743901055,0.02944262295081967,Very Cheap
20140918T000000,227000.0,3,1.0,1130,10018,1.0,0,0,4,6,1130,0,1954,0,98032,47.3733,-122.275,1770,7700,8888,5930,22.659213415851468,0.019934426229508195,Very Cheap
20140820T000000,735000.0,4,2.75,3040,2415,2.0,1,4,3,8,3040,0,1966,0,98118,47.5188,-122.256,2620,2433,-625,-187,304.3478260869565,0.08655737704918033,Very Cheap
20140626T000000,537000.0,3,3.0,2410,7479,2.0,0,2,3,7,2410,0,1942,1988,98155,47.7394,-122.288,2610,7479,5069,4869,71.8010429201765,0.060590163934426226,Very Cheap
20141209T000000,699000.0,4,2.5,2440,14470,1.0,0,0,4,9,1660,780,1970,0,98005,47.6401,-122.168,2810,15564,12030,12754,48.30684174153421,0.08183606557377049,Very Cheap
20140902T000000,330000.0,2,1.0,800,4533,1.0,0,0,3,6,600,200,1929,0,98115,47.6979,-122.325,1720,6800,3733,5080,72.7994705493051,0.03344262295081967,Very Cheap
20140829T000000,229000.0,3,1.0,1030,7800,1.0,0,0,3,7,1030,0,1954,0,98168,47.473,-122.324,1630,12664,6770,11034,29.358974358974358,0.02019672131147541,Very Cheap
20141121T000000,200000.0,3,1.0,1480,5600,1.0,0,0,4,6,940,540,1947,0,98178,47.5045,-122.27,1350,11100,4120,9750,35.714285714285715,0.01639344262295082,Very Cheap
20140812T000000,522500.0,3,1.75,1710,9707,1.0,0,0,4,8,1710,0,1966,0,98008,47.623,-122.105,1820,8700,7997,6880,53.827135057175234,0.05868852459016394,Very Cheap
20150324T000000,1295000.0,3,2.75,3450,5350,1.5,0,3,4,9,2590,860,1925,0,98199,47.6389,-122.407,2910,5350,1900,2440,242.05607476635515,0.16,Cheap
20141110T000000,2000000.0,3,3.25,2610,16387,2.0,1,4,3,9,2610,0,2006,0,98125,47.7175,-122.278,2590,12958,13777,10368,122.04796485018612,0.25245901639344265,Cheap
20141022T000000,200000.0,2,0.75,780,55764,1.0,0,0,4,4,780,0,1945,0,98058,47.442,-122.105,1620,30847,54984,29227,3.5865432895775053,0.01639344262295082,Very Cheap
20150408T000000,352000.0,3,1.75,1260,7200,1.0,0,0,3,7,1260,0,1971,0,98034,47.7189,-122.178,1460,7200,5940,5740,48.888888888888886,0.03632786885245902,Very Cheap
20150325T000000,855000.0,4,3.0,2590,6250,2.0,0,2,3,9,2240,350,1964,0,98115,47.6774,-122.267,2260,6780,3660,4520,136.8,0.10229508196721311,Cheap
20140820T000000,267000.0,3,2.5,1580,12250,2.0,0,0,3,8,1580,0,1993,0,98198,47.3771,-122.315,1560,9900,10670,8340,21.79591836734694,0.025180327868852458,Very Cheap
20140506T000000,484000.0,2,1.75,1660,6000,1.0,0,0,3,7,1160,500,1942,0,98105,47.6624,-122.291,1660,4000,4340,2340,80.66666666666667,0.05363934426229508,Very Cheap
20140629T000000,402000.0,4,2.75,2950,15540,1.0,0,0,4,8,2120,830,1974,0,98042,47.3845,-122.152,2840,17136,12590,14296,25.868725868725868,0.04288524590163934,Very Cheap
20150420T000000,905000.0,4,2.25,2240,5000,2.0,0,0,3,8,1770,470,1900,2014,98122,47.6027,-122.295,2120,5000,2760,2880,181.0,0.10885245901639344,Cheap
20140808T000000,274000.0,4,1.75,1940,7500,1.0,0,0,4,7,1720,220,1966,0,98030,47.3736,-122.215,2000,9000,5560,7000,36.53333333333333,0.026098360655737705,Very Cheap
20150409T000000,475000.0,3,1.75,1850,26445,1.0,0,0,4,7,1850,0,1962,1977,98010,47.3412,-122.051,2110,23280,24595,21170,17.961807525051995,0.05245901639344262,Very Cheap
20141114T000000,1535000.0,4,4.5,5770,10050,1.0,0,3,5,9,3160,2610,1949,0,98115,47.677,-122.275,2950,6700,4280,3750,152.7363184079602,0.19147540983606556,Cheap
20140504T000000,628000.0,4,2.0,2280,6010,1.0,0,0,3,7,1140,1140,1900,0,98122,47.6034,-122.289,2240,6200,3730,3960,104.49251247920134,0.07252459016393442,Very Cheap
20140617T000000,675000.0,6,1.75,2740,6360,1.0,0,3,3,8,1370,1370,1953,0,98146,47.5062,-122.385,2150,6600,3620,4450,106.13207547169812,0.07868852459016394,Very Cheap
20141104T000000,429900.0,4,3.25,3760,4675,2.0,0,0,3,8,2740,1020,2007,0,98038,47.3862,-122.048,3280,4033,915,753,91.9572192513369,0.04654426229508197,Very Cheap
20140625T000000,260000.0,3,1.5,1580,8184,1.0,0,0,3,7,1140,440,1954,0,98148,47.4294,-122.331,1540,9476,6604,7936,31.76930596285435,0.024262295081967214,Very Cheap
20140903T000000,690000.0,3,1.75,1600,4400,1.0,0,0,3,7,1030,570,1941,0,98112,47.6348,-122.281,2150,4000,2800,1850,156.8181818181818,0.08065573770491803,Very Cheap
20150323T000000,1081000.0,4,2.25,2100,12172,1.0,0,0,5,9,2100,0,1961,0,98040,47.5458,-122.227,2400,10713,10072,8313,88.81038448899113,0.13193442622950818,Cheap
20150409T000000,360000.0,4,2.5,2610,7333,2.0,0,0,3,8,2610,0,1988,0,98003,47.2721,-122.293,2280,9033,4723,6753,49.09314059729988,0.037377049180327866,Very Cheap
20140619T000000,499000.0,3,1.75,1840,5000,1.0,0,0,4,7,920,920,1910,0,98117,47.6808,-122.376,1220,5000,3160,3780,99.8,0.05560655737704918,Very Cheap
20140818T000000,159000.0,3,1.0,1320,6534,1.0,0,0,3,7,1320,0,1952,0,98055,47.4806,-122.223,2140,7405,5214,5265,24.33425160697888,0.011016393442622952,Very Cheap
20150327T000000,430000.0,3,1.75,1540,8100,1.0,0,0,4,7,940,600,1947,0,98133,47.749,-122.351,1840,8100,6560,6260,53.08641975308642,0.04655737704918033,Very Cheap
20150413T000000,1050000.0,5,2.75,2520,18625,1.0,0,0,3,8,1660,860,1959,0,98004,47.6409,-122.207,3000,16624,16105,13624,56.375838926174495,0.12786885245901639,Cheap
20141113T000000,725000.0,5,2.5,3780,20000,1.0,0,1,4,9,1890,1890,1978,0,98155,47.7603,-122.273,2840,19908,16220,17068,36.25,0.08524590163934426,Very Cheap
20140710T000000,150000.0,3,1.0,1200,9527,1.0,0,0,3,7,1200,0,1959,0,98168,47.5112,-122.316,1510,9457,8327,7947,15.74472551695182,0.009836065573770493,Very Cheap
20140721T000000,840000.0,4,2.25,2720,8712,2.0,0,0,4,9,2720,0,1976,0,98006,47.5616,-122.153,2470,8714,5992,6244,96.41873278236915,0.10032786885245902,Cheap
20150415T000000,499000.0,4,2.5,3100,5700,2.0,0,0,3,9,3100,0,2011,0,98038,47.3696,-122.058,3060,6000,2600,2940,87.54385964912281,0.05560655737704918,Very Cheap
20141014T000000,285000.0,3,1.75,1630,4000,1.0,0,0,3,7,1100,530,1968,0,98106,47.5351,-122.353,1300,4000,2370,2700,71.25,0.02754098360655738,Very Cheap
20150308T000000,340000.0,4,2.5,1910,7201,1.0,0,0,3,7,1210,700,1987,0,98198,47.3908,-122.316,1690,7554,5291,5864,47.21566449104291,0.03475409836065574,Very Cheap
20150505T000000,405100.0,4,2.0,1580,7300,1.0,0,0,4,7,1580,0,1955,0,98155,47.7598,-122.328,1180,9450,5720,8270,55.49315068493151,0.04329180327868853,Very Cheap
20140807T000000,464000.0,3,2.5,1690,4898,2.0,0,0,3,7,1690,0,2003,0,98053,47.6834,-122.038,2220,4933,3208,2713,94.73254389546754,0.05101639344262295,Very Cheap
20140529T000000,723000.0,4,2.25,1960,8680,1.0,0,0,4,8,1290,670,1959,0,98004,47.6076,-122.192,2160,8680,6720,6520,83.29493087557604,0.08498360655737705,Very Cheap
20141211T000000,430000.0,8,3.25,4300,10441,2.0,0,0,4,8,2800,1500,1979,0,98059,47.4786,-122.131,1780,10457,6141,8677,41.18379465568432,0.04655737704918033,Very Cheap
20150430T000000,645000.0,3,1.75,1840,4255,1.0,0,0,3,7,940,900,1907,2005,98116,47.58,-122.392,1600,4255,2415,2655,151.58636897767332,0.07475409836065573,Very Cheap
20150508T000000,1580000.0,4,2.75,3480,19991,2.0,0,2,4,10,2630,850,1979,0,98004,47.6354,-122.214,3770,20271,16511,16501,79.03556600470212,0.19737704918032786,Cheap
20140811T000000,925000.0,5,3.0,2710,4200,2.0,0,0,3,7,1890,820,1919,2014,98115,47.6754,-122.307,2150,4200,1490,2050,220.23809523809524,0.11147540983606558,Cheap
20140709T000000,759000.0,4,1.75,2100,4750,1.0,0,0,3,7,1340,760,1975,0,98103,47.6695,-122.333,1700,4125,2650,2425,159.78947368421052,0.08970491803278688,Very Cheap
20140805T000000,690000.0,4,2.0,1760,7800,1.0,0,0,3,8,1760,0,1954,0,98117,47.6945,-122.38,1950,7800,6040,5850,88.46153846153847,0.08065573770491803,Very Cheap
20150326T000000,358800.0,4,2.5,2155,8140,2.0,0,0,3,8,2155,0,1996,0,98031,47.4204,-122.201,2155,7245,5985,5090,44.07862407862408,0.03721967213114754,Very Cheap
20150413T000000,683000.0,5,1.5,1720,4000,1.5,0,0,3,7,1520,200,1925,0,98112,47.6197,-122.287,2280,4000,2280,1720,170.75,0.07973770491803278,Very Cheap
20141208T000000,650000.0,3,1.0,1430,4240,1.5,0,0,3,7,1430,0,1924,0,98103,47.6595,-122.337,1660,4240,2810,2580,153.30188679245282,0.07540983606557378,Very Cheap
20141209T000000,288000.0,5,2.75,2790,4807,1.5,0,0,4,7,2140,650,1949,0,98002,47.3098,-122.223,1056,4807,2017,3751,59.912627418348244,0.027934426229508195,Very Cheap
20140707T000000,209950.0,3,1.5,1180,7300,1.0,0,0,4,7,1180,0,1968,0,98002,47.2857,-122.197,2030,8424,6120,6394,28.76027397260274,0.017698360655737704,Very Cheap
20141008T000000,939000.0,3,3.5,2450,9248,2.0,0,4,3,8,1960,490,1933,1993,98136,47.5476,-122.397,2620,10207,6798,7587,101.53546712802768,0.11331147540983606,Cheap
20140816T000000,320000.0,3,1.0,1330,5850,1.0,0,0,3,7,930,400,1954,0,98108,47.5498,-122.298,1440,5850,4520,4410,54.7008547008547,0.032131147540983604,Very Cheap
20140822T000000,283748.0,3,2.25,1940,9560,2.0,0,0,3,7,1940,0,1989,0,98023,47.2998,-122.387,1800,9560,7620,7760,29.680753138075314,0.0273767868852459,Very Cheap
20140731T000000,370000.0,3,2.25,1600,7620,1.0,0,0,3,7,1280,320,1987,0,98011,47.774,-122.208,1600,8215,6020,6615,48.55643044619423,0.038688524590163934,Very Cheap
20150327T000000,399950.0,4,2.75,3210,41689,1.0,0,0,4,8,1610,1600,1989,0,98042,47.3493,-122.062,2100,41384,38479,39284,9.59365779941951,0.04261639344262295,Very Cheap
20141212T000000,360000.0,5,2.5,2880,6902,1.0,0,0,3,8,1680,1200,1976,2007,98058,47.4332,-122.144,2080,5586,4022,3506,52.15879455230368,0.037377049180327866,Very Cheap
20141112T000000,365000.0,2,1.5,1160,8060,1.0,0,0,4,7,1160,0,1950,0,98136,47.5146,-122.386,1500,8060,6900,6560,45.28535980148883,0.0380327868852459,Very Cheap
20141219T000000,396900.0,3,2.0,1360,3120,2.0,0,0,3,7,1360,0,1989,0,98115,47.6943,-122.307,1360,3120,1760,1760,127.21153846153847,0.04221639344262295,Very Cheap
20150422T000000,321000.0,3,2.5,2014,4500,2.0,0,0,3,7,2014,0,2005,0,98001,47.3371,-122.256,2014,4500,2486,2486,71.33333333333333,0.032262295081967214,Very Cheap
20150106T000000,245000.0,3,2.0,1440,7008,1.0,0,0,3,7,1440,0,1985,0,98030,47.3702,-122.182,1680,7200,5568,5520,34.960045662100455,0.022295081967213116,Very Cheap
20141007T000000,502000.0,2,1.0,1570,4704,1.5,0,1,3,8,1570,0,1931,0,98136,47.5256,-122.392,1820,4704,3134,2884,106.71768707482993,0.056,Very Cheap
20140605T000000,257000.0,4,2.75,2330,7642,1.0,0,0,3,8,1800,530,1990,0,98023,47.2946,-122.37,2320,7933,5312,5613,33.62993980633342,0.023868852459016394,Very Cheap
20140515T000000,423000.0,4,1.75,1880,7303,1.0,0,0,3,7,1010,870,1976,0,98034,47.7129,-122.203,1710,7200,5423,5490,57.921402163494456,0.04563934426229508,Very Cheap
20150327T000000,485000.0,4,2.25,1850,9911,1.0,0,0,4,7,1850,0,1957,0,98008,47.6019,-122.116,1650,8670,8061,7020,48.935526183028955,0.05377049180327869,Very Cheap
20141217T000000,500000.0,4,2.5,2230,8560,2.0,0,0,3,8,2230,0,2002,0,98059,47.4877,-122.143,2400,7756,6330,5356,58.41121495327103,0.05573770491803279,Very Cheap
20141021T000000,442000.0,2,1.0,990,4313,1.5,0,2,4,6,990,0,1917,0,98126,47.5677,-122.38,1480,5750,3323,4270,102.48087178298168,0.048131147540983604,Very Cheap
20150512T000000,475000.0,3,1.75,1720,3825,1.5,0,0,3,7,1720,0,1925,0,98105,47.666,-122.327,2000,3825,2105,1825,124.18300653594771,0.05245901639344262,Very Cheap
20150406T000000,625000.0,4,2.25,3230,9935,2.0,0,0,3,8,3230,0,1986,0,98028,47.7685,-122.257,2820,9722,6705,6902,62.90890790135883,0.07213114754098361,Very Cheap
20141015T000000,194000.0,3,1.0,1180,6050,1.0,0,0,3,6,820,360,1944,0,98178,47.4945,-122.249,1070,6050,4870,4980,32.06611570247934,0.01560655737704918,Very Cheap
20140707T000000,410000.0,3,2.25,1450,19206,2.0,0,0,3,7,1450,0,1989,0,98074,47.62,-122.052,1710,21485,17756,19775,21.3474955742997,0.043934426229508196,Very Cheap
20140612T000000,1034500.0,4,2.5,2370,10858,2.0,0,0,3,9,2370,0,2003,0,98004,47.6336,-122.192,2510,21673,8488,19163,95.27537299686867,0.1258360655737705,Cheap
20150324T000000,490000.0,4,2.5,2570,6157,2.0,0,0,3,7,2570,0,2006,0,98065,47.5389,-121.89,2060,5292,3587,3232,79.58421309079097,0.05442622950819672,Very Cheap
20141209T000000,348500.0,4,1.75,1870,7575,1.0,0,0,3,7,1480,390,1972,0,98034,47.7205,-122.218,1670,7575,5705,5905,46.006600660066006,0.035868852459016394,Very Cheap
20150427T000000,380000.0,3,1.0,1220,3000,1.5,0,0,3,6,1220,0,1901,0,98103,47.6506,-122.346,1350,3000,1780,1650,126.66666666666667,0.04,Very Cheap
20141211T000000,660000.0,3,2.0,1770,2150,3.0,0,0,3,8,1770,0,1999,0,98122,47.6102,-122.314,2010,3200,380,1190,306.9767441860465,0.07672131147540984,Very Cheap
20150401T000000,525000.0,3,1.0,1500,6800,1.0,0,0,3,7,1500,0,1943,0,98105,47.6706,-122.268,1500,6800,5300,5300,77.20588235294117,0.05901639344262295,Very Cheap
20140717T000000,235000.0,3,2.0,1110,8724,1.0,0,0,4,7,1110,0,1990,0,98002,47.3056,-122.206,1390,7750,7614,6360,26.937184777624942,0.02098360655737705,Very Cheap
20150422T000000,1210000.0,4,3.75,4980,18069,2.0,0,3,3,11,4980,0,2006,0,98065,47.5348,-121.856,4080,14577,13089,10497,66.96552105816592,0.14885245901639343,Cheap
20150324T000000,397950.0,4,1.75,2360,8116,1.0,0,0,4,7,1180,1180,1916,1970,98133,47.7635,-122.335,1670,8160,5756,6490,49.03277476589453,0.04235409836065574,Very Cheap
20141118T000000,268000.0,3,1.75,1600,7711,1.0,0,0,3,7,1600,0,1999,0,98002,47.284,-122.202,2100,7711,6111,5611,34.75554402801193,0.025311475409836064,Very Cheap
20140521T000000,525000.0,3,1.0,1450,4000,1.0,0,1,4,8,950,500,1948,0,98118,47.5554,-122.266,1880,4000,2550,2120,131.25,0.05901639344262295,Very Cheap
20141006T000000,549950.0,3,2.5,2680,5860,2.0,0,0,3,8,2680,0,2001,0,98011,47.7557,-122.223,2680,5860,3180,3180,93.8481228668942,0.062288524590163936,Very Cheap
20140827T000000,370000.0,3,1.75,1150,6600,1.5,0,0,4,6,1150,0,1970,0,98033,47.6709,-122.185,1530,6600,5450,5070,56.06060606060606,0.038688524590163934,Very Cheap
20140926T000000,299000.0,4,2.25,1870,6693,2.0,0,0,3,7,1870,0,1996,0,98003,47.2774,-122.299,1650,6518,4823,4868,44.67353951890034,0.02937704918032787,Very Cheap
20150115T000000,715000.0,6,2.75,3400,5000,2.0,0,2,3,8,2860,540,1977,0,98107,47.6728,-122.362,1800,5000,1600,3200,143.0,0.0839344262295082,Very Cheap
20150424T000000,430000.0,4,1.5,1810,7200,1.0,0,0,3,7,1810,0,1966,0,98034,47.7207,-122.186,2060,7200,5390,5140,59.72222222222222,0.04655737704918033,Very Cheap
20150210T000000,345000.0,3,1.75,1860,7191,1.0,0,0,4,7,1260,600,1975,0,98058,47.4338,-122.168,1850,7490,5331,5640,47.97663746349604,0.03540983606557377,Very Cheap
20140527T000000,1600000.0,3,3.25,3790,19000,2.0,0,4,3,10,3790,0,1985,0,98177,47.724,-122.373,2740,18628,15210,15888,84.21052631578948,0.2,Cheap
20140518T000000,534640.0,3,2.5,2130,3500,1.0,0,0,4,8,1210,920,1994,0,98072,47.736,-122.159,2030,3710,1370,1680,152.75428571428571,0.06028065573770492,Very Cheap
20141007T000000,1225000.0,3,2.5,2860,4500,2.0,0,2,3,8,1980,880,1915,0,98119,47.6463,-122.371,2310,4500,1640,2190,272.22222222222223,0.15081967213114755,Cheap
20150413T000000,351000.0,4,2.5,2370,7274,2.0,0,0,3,7,2370,0,1997,0,98031,47.3982,-122.171,2090,7656,4904,5566,48.254055540280454,0.03619672131147541,Very Cheap
20140715T000000,745000.0,4,2.25,2290,10409,2.0,0,0,3,8,2290,0,1972,0,98005,47.6351,-122.168,2040,10409,8119,8369,71.57267749063311,0.08786885245901639,Very Cheap
20141105T000000,320000.0,2,1.0,1120,5329,1.0,0,1,3,6,750,370,1929,0,98126,47.5421,-122.378,1530,5330,4209,3800,60.04878964158379,0.032131147540983604,Very Cheap
20140731T000000,555700.0,3,2.0,1810,12420,1.0,0,0,4,7,1810,0,1957,0,98008,47.5888,-122.127,2230,12330,10610,10100,44.74235104669887,0.06304262295081967,Very Cheap
20140708T000000,690000.0,4,2.5,3220,35400,2.0,0,0,3,9,3220,0,1991,0,98072,47.7547,-122.114,3050,35252,32180,32202,19.491525423728813,0.08065573770491803,Very Cheap
20141231T000000,449000.0,3,1.75,1660,9697,1.0,0,0,4,7,1660,0,1952,0,98155,47.7564,-122.286,2060,20624,8037,18564,46.30298030318655,0.049049180327868855,Very Cheap
20140502T000000,308500.0,2,1.0,850,6174,1.0,0,0,4,7,850,0,1950,0,98155,47.7352,-122.328,1100,6174,5324,5074,49.96760609005507,0.03062295081967213,Very Cheap
20150305T000000,340000.0,4,2.5,2665,5868,2.0,0,0,3,9,2665,0,2006,0,98030,47.3831,-122.185,2665,6092,3203,3427,57.94137695978187,0.03475409836065574,Very Cheap
20150327T000000,937750.0,4,2.75,2580,3560,1.5,0,0,5,7,1710,870,1917,0,98115,47.6753,-122.304,1980,3800,980,1820,263.4129213483146,0.11314754098360656,Cheap
20140506T000000,725126.0,4,2.5,3200,12369,2.0,0,0,3,10,3200,0,1998,0,98059,47.5273,-122.143,3770,12960,9169,9190,58.62446438677338,0.08526242622950819,Very Cheap
20150105T000000,135000.0,3,1.0,840,3000,1.0,0,0,3,5,840,0,1943,0,98178,47.494,-122.275,1010,6000,2160,4990,45.0,0.007868852459016393,Very Cheap
20150403T000000,635000.0,4,2.5,2970,7961,1.0,0,0,3,8,2020,950,1969,0,98125,47.7118,-122.29,1410,7959,4991,6549,79.76384876271825,0.07344262295081967,Very Cheap
20140806T000000,245500.0,2,1.0,790,7500,1.0,0,0,3,6,790,0,1950,0,98011,47.7644,-122.198,1970,8970,6710,7000,32.733333333333334,0.022360655737704918,Very Cheap
20141202T000000,230000.0,6,1.5,2140,36509,1.5,0,0,4,8,2140,0,1903,1979,98001,47.2668,-122.252,1710,12000,34369,10290,6.299816483606782,0.020327868852459016,Very Cheap
20150304T000000,1770000.0,3,2.5,2580,14603,1.0,0,2,4,9,2580,0,1951,0,98004,47.6199,-122.212,2410,14347,12023,11937,121.20797096487023,0.22229508196721312,Cheap
20141110T000000,425000.0,5,2.5,2180,7875,1.0,0,0,4,7,1200,980,1955,0,98133,47.7543,-122.341,1840,5105,5695,3265,53.96825396825397,0.04590163934426229,Very Cheap
20150420T000000,220000.0,2,1.0,1060,10423,1.5,0,0,3,7,1060,0,1965,0,98125,47.705,-122.313,2240,10200,9363,7960,21.107166842559725,0.01901639344262295,Very Cheap
20140829T000000,370000.0,3,2.0,1860,9100,1.5,0,0,3,8,1860,0,1939,2006,98155,47.7522,-122.304,1620,9519,7240,7899,40.65934065934066,0.038688524590163934,Very Cheap
20140917T000000,390000.0,3,2.0,1840,16815,1.0,0,0,5,7,960,880,1972,0,98059,47.4837,-122.11,1810,16732,14975,14922,23.193577163247102,0.04131147540983607,Very Cheap
20140603T000000,239000.0,3,1.75,1340,16480,1.0,0,0,4,7,1340,0,1968,0,98042,47.364,-122.162,1520,10451,15140,8931,14.50242718446602,0.021508196721311476,Very Cheap
20150102T000000,345000.0,4,2.25,2320,7350,2.0,0,0,3,8,2320,0,1973,0,98058,47.4512,-122.131,2170,7350,5030,5180,46.93877551020408,0.03540983606557377,Very Cheap
20140826T000000,289000.0,3,2.5,2110,8304,1.0,0,0,4,7,2110,0,1985,0,98030,47.3558,-122.173,1680,7508,6194,5828,34.80250481695568,0.028065573770491802,Very Cheap
20150508T000000,285000.0,5,1.5,1840,8050,1.5,0,0,4,7,1840,0,1962,0,98198,47.3668,-122.312,1690,8151,6210,6461,35.40372670807454,0.02754098360655738,Very Cheap
20140915T000000,147400.0,3,2.0,1080,9225,1.0,0,0,2,7,1080,0,1955,0,98146,47.4842,-122.346,1410,9840,8145,8430,15.978319783197833,0.009495081967213114,Very Cheap
20150127T000000,600000.0,2,1.0,1290,4636,1.0,0,0,3,7,1290,0,1924,0,98112,47.6393,-122.301,1940,4635,3346,2695,129.42191544434857,0.06885245901639345,Very Cheap
20140806T000000,245000.0,3,2.25,2210,10794,1.0,0,0,3,7,1540,670,1967,0,98178,47.4911,-122.224,2230,10753,8584,8523,22.69779507133593,0.022295081967213116,Very Cheap
20150304T000000,520000.0,3,2.25,2210,10794,1.0,0,0,3,7,1540,670,1967,0,98178,47.4911,-122.224,2230,10753,8584,8523,48.17491198814156,0.058360655737704915,Very Cheap
20140518T000000,352500.0,3,2.25,1410,14110,1.0,0,2,3,7,1170,240,1987,0,98065,47.5336,-121.76,1560,18336,12700,16776,24.98228206945429,0.03639344262295082,Very Cheap
20150505T000000,448000.0,5,3.5,3740,24684,2.0,0,0,3,9,2760,980,1998,0,98038,47.3832,-122.057,2880,26023,20944,23143,18.149408523740075,0.048918032786885245,Very Cheap
20140929T000000,270000.0,4,2.75,2440,7150,1.0,0,0,3,7,1200,1240,1963,1985,98032,47.3662,-122.282,1790,7150,4710,5360,37.76223776223776,0.025573770491803278,Very Cheap
20140826T000000,872500.0,3,2.5,2040,6000,1.0,0,0,3,8,1840,200,1951,0,98109,47.6334,-122.35,1820,4920,3960,3100,145.41666666666666,0.10459016393442623,Cheap
20150318T000000,2152500.0,4,3.25,3840,6214,1.5,0,3,4,10,2590,1250,1939,0,98199,47.6388,-122.406,3280,5915,2374,2635,346.3952365626006,0.2724590163934426,Cheap
20140812T000000,225000.0,3,1.5,1660,7221,1.0,0,0,3,7,980,680,1962,0,98168,47.4962,-122.32,1770,8083,5561,6313,31.15911923556294,0.019672131147540985,Very Cheap
20141121T000000,735000.0,4,2.0,1640,6000,1.5,0,0,4,9,1640,0,1911,0,98119,47.6505,-122.375,1900,6000,4360,4100,122.5,0.08655737704918033,Very Cheap
20150401T000000,375000.0,3,1.0,1310,8400,1.0,0,0,3,7,1310,0,1972,1989,98034,47.7253,-122.197,1680,8000,7090,6320,44.642857142857146,0.03934426229508197,Very Cheap
20141023T000000,169000.0,3,1.75,1720,9775,1.0,0,0,3,8,1720,0,1978,0,98032,47.3731,-122.286,1970,8400,8055,6430,17.28900255754476,0.012327868852459017,Very Cheap
20150304T000000,279950.0,3,1.75,1720,9775,1.0,0,0,3,8,1720,0,1978,0,98032,47.3731,-122.286,1970,8400,8055,6430,28.63938618925831,0.026878688524590164,Very Cheap
20150116T000000,1950000.0,4,2.75,4020,18745,2.0,0,4,4,10,2830,1190,1989,0,98004,47.6042,-122.21,3150,20897,14725,17747,104.02774073086157,0.2459016393442623,Cheap
20140805T000000,310000.0,3,2.25,1960,2345,2.0,0,0,3,7,1750,210,2003,0,98118,47.5419,-122.288,1760,1958,385,198,132.1961620469083,0.03081967213114754,Very Cheap
20140730T000000,975000.0,4,2.5,3240,35083,2.0,0,0,4,9,3240,0,1978,0,98005,47.6337,-122.154,3340,24501,31843,21161,27.791237921500443,0.1180327868852459,Cheap
20141029T000000,650000.0,10,2.0,3610,11914,2.0,0,0,4,7,3010,600,1958,0,98006,47.5705,-122.175,2040,11914,8304,9874,54.557663253315425,0.07540983606557378,Very Cheap
20141216T000000,930000.0,2,1.5,1800,4500,1.0,0,2,3,7,1000,800,1942,0,98109,47.6305,-122.347,2270,3840,2700,1570,206.66666666666666,0.1121311475409836,Cheap
20150402T000000,412000.0,4,1.5,1960,5000,1.0,0,0,3,7,980,980,1912,0,98106,47.5688,-122.363,1300,5000,3040,3700,82.4,0.04419672131147541,Very Cheap
20150417T000000,225000.0,3,1.0,1250,10200,1.0,0,0,3,6,1250,0,1965,0,98178,47.4902,-122.256,1800,8283,8950,6483,22.058823529411764,0.019672131147540985,Very Cheap
20140619T000000,507000.0,3,2.5,2120,7201,2.0,0,0,3,8,2120,0,2003,0,98133,47.7174,-122.337,1930,7206,5081,5276,70.40688793223164,0.05665573770491803,Very Cheap
20150128T000000,1755000.0,4,4.0,3860,67953,2.0,0,2,4,12,3860,0,1927,0,98177,47.7469,-122.378,4410,128066,64093,123656,25.826674319014614,0.22032786885245903,Cheap
20141117T000000,230000.0,3,2.5,1340,3011,2.0,0,0,3,7,1340,0,1995,0,98038,47.3839,-122.038,1060,3232,1671,2172,76.38658253072069,0.020327868852459016,Very Cheap
20150223T000000,316000.0,1,2.0,1780,188465,2.0,0,0,3,10,1780,0,2001,0,98045,47.4506,-121.768,1780,21094,186685,19314,1.676703897275356,0.03160655737704918,Very Cheap
20140910T000000,616200.0,5,3.25,3920,4832,2.0,0,0,3,9,3030,890,2014,0,98065,47.5202,-121.885,2660,4832,912,2172,127.5248344370861,0.07097704918032786,Very Cheap
20140829T000000,509900.0,3,1.75,1690,53578,1.0,0,0,3,8,1690,0,1984,0,98053,47.6546,-122.049,2290,52707,51888,50417,9.516965918847289,0.05703606557377049,Very Cheap
20150316T000000,370000.0,4,2.5,2570,7753,2.0,0,0,3,8,2570,0,1987,0,98058,47.4237,-122.162,2140,7615,5183,5475,47.723461885721655,0.038688524590163934,Very Cheap
20150306T000000,619100.0,3,1.75,1870,7030,1.0,0,0,3,7,1870,0,1977,0,98033,47.6999,-122.17,1820,7500,5160,5680,88.06543385490754,0.07135737704918033,Very Cheap
20140821T000000,805000.0,3,2.25,2860,11250,1.0,0,1,5,8,2290,570,1956,0,98166,47.4534,-122.372,2030,11250,8390,9220,71.55555555555556,0.09573770491803278,Very Cheap
20150202T000000,612125.0,2,1.5,1670,6000,1.0,0,0,3,7,1090,580,1950,0,98119,47.6517,-122.374,1670,6000,4330,4330,102.02083333333333,0.07044262295081967,Very Cheap
20140912T000000,350000.0,2,1.5,1070,937,3.0,0,0,3,8,1070,0,2003,0,98115,47.6761,-122.3,1100,3200,-133,2100,373.5325506937033,0.036065573770491806,Very Cheap
20141104T000000,225000.0,2,1.0,940,15000,1.0,0,0,3,7,940,0,1960,0,98055,47.4312,-122.195,1450,15000,14060,13550,15.0,0.019672131147540985,Very Cheap
20141022T000000,335000.0,3,2.5,2588,5701,2.0,0,0,3,8,2588,0,2008,0,98042,47.3449,-122.151,2389,5702,3113,3313,58.761620768286264,0.03409836065573771,Very Cheap
20150331T000000,972800.0,5,3.25,3500,10457,2.0,0,0,3,11,3500,0,2001,0,98059,47.5198,-122.157,3500,11734,6957,8234,93.02859328679354,0.11774426229508196,Cheap
20150202T000000,500000.0,3,1.75,1690,48096,1.0,0,0,3,7,1690,0,1973,0,98053,47.6745,-122.061,2070,35160,46406,33090,10.395874916833,0.05573770491803279,Very Cheap
20141223T000000,2200000.0,4,3.75,3790,7200,2.0,0,0,3,10,2530,1260,1931,0,98112,47.6264,-122.289,3250,7200,3410,3950,305.55555555555554,0.2786885245901639,Cheap
20141119T000000,415000.0,3,1.5,1090,8400,1.0,0,0,4,7,1090,0,1966,0,98008,47.6219,-122.115,1320,8400,7310,7080,49.404761904761905,0.04459016393442623,Very Cheap
20140826T000000,399000.0,3,3.0,2240,10479,2.0,0,0,4,7,1710,530,1950,0,98106,47.5529,-122.356,1530,5244,8239,3714,38.07615230460922,0.042491803278688525,Very Cheap
20140520T000000,376000.0,2,1.0,1150,4000,1.0,0,0,3,7,1150,0,1947,0,98199,47.6575,-122.394,1150,4288,2850,3138,94.0,0.039475409836065574,Very Cheap
20141217T000000,340000.0,3,2.0,1870,3378,1.0,0,0,3,7,1120,750,1913,0,98136,47.5371,-122.393,1870,1872,1508,2,100.65127294256956,0.03475409836065574,Very Cheap
20141114T000000,490000.0,5,2.75,2990,7200,2.0,0,0,3,8,2990,0,1997,0,98059,47.4955,-122.16,2710,7620,4210,4910,68.05555555555556,0.05442622950819672,Very Cheap
20140622T000000,374000.0,4,2.5,2580,6260,2.0,0,0,3,7,2580,0,2004,0,98056,47.4858,-122.185,2160,3600,3680,1440,59.7444089456869,0.03921311475409836,Very Cheap
20150326T000000,852000.0,4,1.0,2220,3588,1.5,0,0,4,7,1470,750,1927,0,98115,47.6854,-122.308,1740,3588,1368,1848,237.4581939799331,0.1019016393442623,Cheap
20141125T000000,473000.0,3,2.25,1620,12309,2.0,0,0,3,7,1620,0,1987,0,98074,47.6188,-122.029,2030,13963,10689,11933,38.42716711349419,0.05219672131147541,Very Cheap
20150504T000000,540000.0,3,1.75,2590,25992,1.0,0,0,3,8,1970,620,1968,0,98029,47.5521,-122.03,2590,29250,23402,26660,20.775623268698062,0.06098360655737705,Very Cheap
20140826T000000,431000.0,2,2.0,1390,12530,1.0,0,0,3,8,970,420,1959,0,98155,47.7499,-122.29,1940,12530,11140,10590,34.397446129289705,0.046688524590163934,Very Cheap
20150506T000000,435000.0,4,3.0,2270,7245,1.0,0,0,3,7,1410,860,1979,0,98155,47.7722,-122.315,1740,7571,4975,5831,60.041407867494826,0.04721311475409836,Very Cheap
20140508T000000,1051000.0,4,3.0,2920,33976,1.0,0,3,5,8,1460,1460,1964,0,98008,47.6164,-122.104,2970,15210,31056,12240,30.93360018836826,0.128,Cheap
20140513T000000,450000.0,3,2.75,1250,892,2.0,0,0,3,8,1040,210,2010,0,98116,47.5826,-122.387,1250,1296,-358,46,504.4843049327354,0.04918032786885246,Very Cheap
20150319T000000,157500.0,3,1.0,1100,27008,1.0,0,0,3,6,960,140,1935,0,98178,47.4963,-122.249,1280,8890,25908,7610,5.8316054502369665,0.010819672131147541,Very Cheap
20141217T000000,244000.0,3,1.75,1500,7475,1.0,0,0,4,8,1500,0,1976,0,98023,47.3155,-122.365,1940,7475,5975,5535,32.642140468227424,0.02216393442622951,Very Cheap
20150211T000000,550000.0,3,2.5,2800,10603,2.0,0,0,3,9,2800,0,2001,0,98011,47.7528,-122.195,2580,10603,7803,8023,51.872111666509475,0.06229508196721312,Very Cheap
20140905T000000,975000.0,4,2.5,3420,183387,2.0,0,0,3,10,3420,0,2000,0,98053,47.633,-121.972,2260,34613,179967,32353,5.316625496899999,0.1180327868852459,Cheap
20150205T000000,426500.0,4,2.75,2100,88426,1.0,0,0,3,6,2100,0,1990,0,98038,47.399,-122.011,2150,63162,86326,61012,4.823242032886255,0.046098360655737705,Very Cheap
20140716T000000,350000.0,3,1.0,1790,3876,1.5,0,0,5,7,1090,700,1904,0,98144,47.575,-122.288,1360,4080,2086,2720,90.29927760577915,0.036065573770491806,Very Cheap
20150210T000000,615000.0,3,1.0,1790,3876,1.5,0,0,5,7,1090,700,1904,0,98144,47.575,-122.288,1360,4080,2086,2720,158.6687306501548,0.07081967213114754,Very Cheap
20150223T000000,542000.0,3,2.25,2220,12056,2.0,0,0,3,8,2220,0,1985,0,98052,47.7148,-122.101,2320,12025,9836,9705,44.95686794956868,0.06124590163934426,Very Cheap
20141119T000000,710000.0,4,1.75,2000,6000,1.0,0,3,5,7,1000,1000,1956,0,98109,47.6428,-122.348,2610,4377,4000,1767,118.33333333333333,0.08327868852459017,Very Cheap
20150501T000000,289950.0,3,2.5,1770,9450,1.0,0,0,3,8,1770,0,1988,0,98001,47.3196,-122.272,2200,8582,7680,6382,30.682539682539684,0.028190163934426228,Very Cheap
20141016T000000,1900000.0,4,2.75,4280,12668,2.0,0,0,3,9,3900,380,1947,2008,98004,47.6185,-122.219,3590,12670,8388,9080,149.98421218819072,0.23934426229508196,Cheap
20141119T000000,528000.0,2,1.0,1260,5100,1.5,0,0,4,7,1120,140,1925,0,98117,47.6805,-122.384,1260,5100,3840,3840,103.52941176470588,0.05940983606557377,Very Cheap
20150325T000000,471000.0,2,1.0,840,5100,1.0,0,0,4,7,840,0,1949,0,98117,47.6779,-122.384,1550,5100,4260,3550,92.3529411764706,0.051934426229508196,Very Cheap
20141203T000000,250000.0,4,2.75,1830,6643,2.0,0,0,3,8,1830,0,2001,0,98001,47.2601,-122.286,2400,6472,4813,4072,37.6335992774349,0.022950819672131147,Very Cheap
20141027T000000,155000.0,3,1.5,970,8400,1.0,0,0,3,7,970,0,1966,0,98003,47.3284,-122.331,1230,8400,7430,7170,18.452380952380953,0.010491803278688525,Very Cheap
20140818T000000,515000.0,4,1.5,1740,8160,1.5,0,0,4,7,1400,340,1946,0,98177,47.7243,-122.363,1600,8160,6420,6560,63.11274509803921,0.057704918032786885,Very Cheap
20150305T000000,336600.0,3,2.25,1654,8464,2.0,0,0,3,7,1654,0,1995,0,98038,47.3618,-122.033,1975,8515,6810,6540,39.768431001890356,0.034308196721311475,Very Cheap
20150310T000000,915000.0,3,2.25,2390,2750,2.0,0,0,5,8,1580,810,1925,0,98109,47.6339,-122.354,2200,5160,360,2960,332.72727272727275,0.11016393442622952,Cheap
20140715T000000,350000.0,2,1.75,1080,7242,2.0,0,0,4,7,1080,0,1984,0,98034,47.7065,-122.235,1800,7321,6162,5521,48.32919083126208,0.036065573770491806,Very Cheap
20140702T000000,1300000.0,4,1.75,2610,21600,1.0,0,0,4,8,2610,0,1966,0,98004,47.6245,-122.227,2920,20330,18990,17410,60.18518518518518,0.16065573770491803,Cheap
20150305T000000,175000.0,3,1.0,1070,6164,1.0,0,0,3,7,1070,0,1967,0,98001,47.3377,-122.291,1320,7920,5094,6600,28.390655418559376,0.013114754098360656,Very Cheap
20150330T000000,545000.0,2,2.0,1430,3880,1.0,0,0,4,7,1430,0,1949,0,98117,47.6844,-122.392,1430,3880,2450,2450,140.46391752577318,0.06163934426229508,Very Cheap
20141227T000000,475000.0,4,3.0,2400,5400,2.0,0,2,4,7,1600,800,1965,0,98178,47.5099,-122.26,2400,5400,3000,3000,87.96296296296296,0.05245901639344262,Very Cheap
20150430T000000,390000.0,2,1.0,670,11505,1.0,0,0,3,5,670,0,2003,0,98059,47.499,-122.157,2180,11505,10835,9325,33.898305084745765,0.04131147540983607,Very Cheap
20140717T000000,645000.0,4,2.5,2860,14000,2.0,0,0,3,8,2860,0,1995,0,98019,47.7306,-121.973,2650,14564,11140,11914,46.07142857142857,0.07475409836065573,Very Cheap
20141202T000000,410000.0,3,1.5,2270,8187,1.0,0,0,4,8,1420,850,1954,0,98155,47.7573,-122.278,2020,14092,5917,12072,50.07939416147551,0.043934426229508196,Very Cheap
20150331T000000,480000.0,4,2.5,2180,9861,2.0,0,2,3,8,2180,0,1997,0,98045,47.4817,-121.802,2390,9761,7681,7371,48.67660480681472,0.05311475409836065,Very Cheap
20140701T000000,725000.0,3,1.75,1860,6000,2.0,0,2,4,8,1860,0,1959,0,98144,47.5981,-122.288,3030,7119,4140,4089,120.83333333333333,0.08524590163934426,Very Cheap
20140522T000000,1150000.0,6,4.5,6040,219542,2.0,0,0,3,11,4100,1940,1996,0,98029,47.5622,-122.003,2010,32362,213502,30352,5.238177660766505,0.14098360655737704,Cheap
20140702T000000,300000.0,2,1.0,1010,11919,1.0,0,0,3,6,1010,0,1947,0,98155,47.7461,-122.322,1220,11240,10909,10020,25.169896803423107,0.029508196721311476,Very Cheap
20150309T000000,752000.0,4,2.5,2570,8178,1.0,0,2,3,8,1710,860,1961,0,98118,47.5483,-122.261,2050,7500,5608,5450,91.95402298850574,0.08878688524590164,Very Cheap
20140923T000000,585000.0,4,2.5,1950,3720,2.0,0,0,3,8,1950,0,2004,0,98029,47.5503,-121.997,1720,3720,1770,2000,157.25806451612902,0.06688524590163934,Very Cheap
20150213T000000,678700.0,3,1.75,1970,10548,1.0,0,0,4,8,1300,670,1973,0,98033,47.6669,-122.179,2500,8548,8578,6048,64.34395145999241,0.07917377049180328,Very Cheap
20150417T000000,603000.0,4,2.25,2110,11155,2.0,0,0,3,9,2110,0,1975,0,98074,47.6386,-122.058,2660,11900,9045,9240,54.05647691618108,0.06924590163934426,Very Cheap
20150320T000000,715000.0,3,1.75,1650,7276,1.5,0,4,4,7,1150,500,1928,0,98117,47.6989,-122.399,2300,8088,5626,5788,98.26827927432656,0.0839344262295082,Very Cheap
20141028T000000,1395000.0,4,3.0,3520,128502,2.0,0,2,4,10,3520,0,1981,0,98072,47.7448,-122.117,3260,79714,124982,76454,10.855862165569407,0.17311475409836066,Cheap
20150429T000000,1085000.0,3,2.5,2840,7500,2.0,0,3,3,11,2840,0,1997,0,98034,47.7049,-122.224,2580,5918,4660,3338,144.66666666666666,0.13245901639344262,Cheap
20150222T000000,467500.0,2,1.75,1490,4800,1.0,0,0,4,7,750,740,1918,0,98136,47.5496,-122.391,1400,6000,3310,4600,97.39583333333333,0.05147540983606557,Very Cheap
20141013T000000,359000.0,3,2.25,1650,7218,1.0,0,0,3,7,1230,420,1985,0,98133,47.7237,-122.335,1690,7459,5568,5769,49.73676918814076,0.03724590163934426,Very Cheap
20140826T000000,745000.0,4,2.0,1960,4520,1.0,0,0,3,8,960,1000,1922,2001,98116,47.58,-122.405,1680,4520,2560,2840,164.8230088495575,0.08786885245901639,Very Cheap
20140513T000000,450000.0,3,2.25,2450,42180,1.0,0,0,4,7,2450,0,1978,2000,98042,47.3549,-122.111,1440,42180,39730,40740,10.668563300142248,0.04918032786885246,Very Cheap
20150408T000000,935000.0,3,2.0,1720,2000,1.5,0,0,3,8,1060,660,1910,2000,98109,47.6384,-122.35,1590,4000,280,2410,467.5,0.11278688524590164,Cheap
20140903T000000,615000.0,3,2.5,1980,3128,2.0,0,0,3,8,1890,90,2009,0,98027,47.5456,-122.016,2160,2240,1148,80,196.61125319693096,0.07081967213114754,Very Cheap
20140929T000000,1031000.0,3,2.5,4110,35741,2.0,0,0,3,7,4110,0,1976,0,98033,47.6642,-122.171,2710,8865,31631,6155,28.846422875688983,0.12537704918032788,Cheap
20150106T000000,283500.0,4,2.5,1990,5577,2.0,0,0,3,7,1990,0,1999,0,98092,47.3191,-122.191,2020,6400,3587,4380,50.83378160301237,0.027344262295081967,Very Cheap
20141202T000000,340000.0,2,1.0,860,7102,1.0,0,0,3,6,860,0,1947,0,98177,47.7042,-122.369,1450,7102,6242,5652,47.87383835539285,0.03475409836065574,Very Cheap
20150225T000000,370000.0,4,2.5,2320,9264,2.0,0,0,3,8,2320,0,1994,0,98188,47.4449,-122.274,2320,9129,6944,6809,39.939550949913645,0.038688524590163934,Very Cheap
20140820T000000,1150000.0,3,2.5,4190,9624,2.0,0,0,3,10,4190,0,1999,0,98006,47.5642,-122.127,3650,8321,5434,4671,119.49293433083957,0.14098360655737704,Cheap
20140510T000000,265000.0,4,1.0,1940,9533,1.0,0,0,3,7,1080,860,1962,0,98031,47.4139,-122.208,1940,8839,7593,6899,27.79817476135529,0.024918032786885248,Very Cheap
20140826T000000,480000.0,4,2.25,2520,2370,2.0,0,0,3,8,1690,830,1908,0,98122,47.6109,-122.303,1530,2370,-150,840,202.53164556962025,0.05311475409836065,Very Cheap
20140617T000000,667500.0,3,2.0,1880,3800,1.0,0,0,5,7,1030,850,1927,0,98115,47.6841,-122.309,1700,3800,1920,2100,175.6578947368421,0.07770491803278688,Very Cheap
20150227T000000,1398000.0,3,2.5,2910,10044,2.0,0,0,4,10,2910,0,1989,0,98004,47.5845,-122.199,2420,12287,7134,9867,139.18757467144565,0.1735081967213115,Cheap
20140808T000000,2300000.0,7,4.75,5310,8816,2.0,0,0,3,10,3650,1660,2013,0,98004,47.6221,-122.208,2920,10610,3506,7690,260.88929219600726,0.29180327868852457,Cheap
20140616T000000,465000.0,3,2.25,2670,7500,1.0,0,0,4,7,1640,1030,1966,0,98166,47.4608,-122.354,1970,9598,4830,7628,62.0,0.051147540983606556,Very Cheap
20141020T000000,192500.0,1,1.0,470,63737,1.0,0,2,5,5,470,0,1924,0,98022,47.2163,-121.984,1350,46762,63267,45412,3.0202237318982696,0.01540983606557377,Very Cheap
20150323T000000,345000.0,3,1.0,1060,5600,1.0,0,0,4,6,760,300,1943,0,98146,47.5116,-122.379,1310,5600,4540,4290,61.607142857142854,0.03540983606557377,Very Cheap
20140602T000000,439800.0,3,1.5,1120,6900,1.0,0,0,5,7,1120,0,1956,0,98007,47.6023,-122.132,1300,7000,5780,5700,63.73913043478261,0.047842622950819674,Very Cheap
20140725T000000,468000.0,4,1.75,2250,8580,1.0,0,0,4,7,1330,920,1958,0,98011,47.7633,-122.199,2250,10032,6330,7782,54.54545454545455,0.05154098360655738,Very Cheap
20140724T000000,775000.0,4,2.5,2070,8473,1.0,0,0,4,8,1250,820,1976,0,98033,47.6608,-122.19,2070,9499,6403,7429,91.46701286439277,0.09180327868852459,Very Cheap
20140608T000000,684680.0,4,2.25,2370,9360,2.0,0,0,4,8,2370,0,1979,0,98052,47.6518,-122.123,2370,9720,6990,7350,73.14957264957265,0.07995803278688525,Very Cheap
20150116T000000,910000.0,4,3.5,3570,27699,2.0,0,0,3,11,3570,0,1990,0,98052,47.7173,-122.098,3800,35880,24129,32080,32.853171594642404,0.10950819672131147,Cheap
20140911T000000,3640900.0,4,3.25,4830,22257,2.0,1,4,4,11,4830,0,1990,0,98039,47.6409,-122.241,3820,25582,17427,21762,163.5844902727232,0.46765901639344265,High
20140617T000000,375000.0,3,1.75,1160,22470,1.0,0,0,4,7,1160,0,1976,0,98028,47.7595,-122.23,1940,15999,21310,14059,16.688918558077436,0.03934426229508197,Very Cheap
20140911T000000,250000.0,3,2.5,1610,6600,2.0,0,0,3,7,1610,0,1994,0,98003,47.2827,-122.302,1660,7689,4990,6029,37.878787878787875,0.022950819672131147,Very Cheap
20150212T000000,3065000.0,5,3.0,4150,7500,2.5,0,4,5,11,3510,640,1909,0,98119,47.6303,-122.362,2250,4050,3350,1800,408.6666666666667,0.3921311475409836,Medium
20141125T000000,442500.0,4,2.25,1840,7575,1.0,0,0,4,7,1390,450,1973,0,98034,47.7328,-122.198,1820,7500,5735,5680,58.415841584158414,0.04819672131147541,Very Cheap
20140523T000000,900000.0,3,3.5,4080,217697,1.5,0,3,3,10,4080,0,2000,0,98092,47.2604,-122.139,2710,217790,213617,215080,4.13418650693395,0.10819672131147541,Cheap
20140919T000000,699000.0,3,2.0,1820,4080,2.0,0,2,3,8,1820,0,1937,1987,98107,47.6735,-122.401,2160,5400,2260,3240,171.3235294117647,0.08183606557377049,Very Cheap
20140506T000000,360000.0,4,2.0,2680,18768,1.0,0,0,5,8,2680,0,1965,0,98001,47.3182,-122.279,1230,15750,16088,14520,19.18158567774936,0.037377049180327866,Very Cheap
20140909T000000,1675000.0,4,4.75,4790,25412,2.0,0,0,3,12,4790,0,1999,0,98074,47.603,-122.012,3830,16314,20622,12484,65.91374153943019,0.2098360655737705,Cheap
20150129T000000,675000.0,5,2.0,2420,21000,1.5,0,0,3,8,2420,0,1966,0,98033,47.677,-122.165,1940,8085,18580,6145,32.142857142857146,0.07868852459016394,Very Cheap
20140918T000000,345000.0,2,1.0,1130,8081,1.0,0,0,4,7,1130,0,1921,0,98133,47.7064,-122.355,1220,7800,6951,6580,42.69273604751887,0.03540983606557377,Very Cheap
20150408T000000,229000.0,4,1.0,1320,5000,1.5,0,0,3,7,1320,0,1928,0,98106,47.5457,-122.363,1640,5164,3680,3524,45.8,0.02019672131147541,Very Cheap
20150326T000000,300000.0,3,1.0,1290,12415,1.5,0,0,3,6,1290,0,1908,0,98070,47.3719,-122.461,1620,12415,11125,10795,24.164317358034637,0.029508196721311476,Very Cheap
20140820T000000,392500.0,3,3.25,1600,1289,3.0,0,0,3,8,1600,0,1998,0,98117,47.6957,-122.375,1600,1376,-311,-224,304.49961210240497,0.04163934426229508,Very Cheap
20140616T000000,552000.0,3,1.0,1120,2300,1.0,0,0,4,7,820,300,1912,0,98117,47.6797,-122.384,1430,5100,1180,3670,240.0,0.06255737704918032,Very Cheap
20141120T000000,457000.0,2,1.75,2060,7192,1.0,0,0,3,7,1420,640,1940,0,98125,47.7038,-122.317,1860,7140,5132,5280,63.54282536151279,0.0500983606557377,Very Cheap
20141007T000000,518000.0,4,2.5,2830,13760,2.0,0,0,3,8,2830,0,1993,0,98019,47.7334,-121.97,2350,14029,10930,11679,37.645348837209305,0.0580983606557377,Very Cheap
20140812T000000,237000.0,3,2.0,1210,6634,1.0,0,0,4,7,1210,0,1985,0,98031,47.4097,-122.193,1560,7200,5424,5640,35.72505275851673,0.021245901639344263,Very Cheap
20150314T000000,399950.0,3,2.25,1560,11997,1.0,0,0,3,7,1260,300,1988,0,98065,47.5378,-121.742,1820,36590,10437,34770,33.33750104192715,0.04261639344262295,Very Cheap
20150506T000000,605000.0,3,2.25,2260,17114,2.0,0,0,3,7,2260,0,1990,0,98155,47.7537,-122.296,2360,14893,14854,12533,35.351174477036345,0.06950819672131148,Very Cheap
20140722T000000,295000.0,4,2.5,1850,8198,2.0,0,0,3,7,1850,0,1993,0,98031,47.4079,-122.186,1850,7924,6348,6074,35.984386435716026,0.028852459016393443,Very Cheap
20150428T000000,513000.0,4,2.5,1930,8040,1.0,0,0,3,7,1380,550,1978,0,98034,47.7283,-122.218,2080,7200,6110,5120,63.80597014925373,0.05744262295081967,Very Cheap
20141001T000000,772500.0,4,2.5,3230,4290,2.0,0,0,3,9,3230,0,2004,0,98033,47.6874,-122.161,3220,5083,1060,1863,180.06993006993008,0.09147540983606557,Very Cheap
20141219T000000,765000.0,4,2.5,3230,4290,2.0,0,0,3,9,3230,0,2004,0,98033,47.6874,-122.161,3220,5083,1060,1863,178.32167832167832,0.09049180327868853,Very Cheap
20141010T000000,696950.0,4,2.75,2450,5376,1.5,0,0,4,7,1550,900,1920,0,98117,47.6865,-122.396,1920,5264,2926,3344,129.64099702380952,0.0815672131147541,Very Cheap
20150213T000000,329000.0,3,1.0,1200,5650,1.5,0,0,3,7,1200,0,1928,0,98178,47.5065,-122.249,1610,5650,4450,4040,58.230088495575224,0.03331147540983607,Very Cheap
20141218T000000,339999.0,3,2.5,2360,8093,2.0,0,0,3,8,2360,0,1995,0,98092,47.3257,-122.17,1860,6762,5733,4902,42.011491412331644,0.03475396721311475,Very Cheap
20140714T000000,364500.0,3,1.0,1060,9506,1.0,0,0,3,7,1060,0,1959,0,98125,47.7317,-122.31,1520,8469,8446,6949,38.34420366084578,0.0379672131147541,Very Cheap
20140514T000000,607500.0,5,1.75,2220,6000,1.5,0,0,3,7,1420,800,1923,0,98199,47.648,-122.384,1550,1715,3780,165,101.25,0.06983606557377049,Very Cheap
20150408T000000,550000.0,3,1.0,880,6664,1.0,0,0,3,6,880,0,1961,0,98033,47.6855,-122.199,1690,6564,5784,4874,82.53301320528212,0.06229508196721312,Very Cheap
20150421T000000,479900.0,4,2.0,2510,9750,1.0,0,0,3,8,1630,880,1960,0,98028,47.7438,-122.229,1980,9750,7240,7770,49.22051282051282,0.0531016393442623,Very Cheap
20150212T000000,1120280.0,4,4.0,2530,1774,3.0,0,2,3,9,2100,430,2013,0,98119,47.6362,-122.369,2160,2400,-756,240,631.499436302142,0.13708590163934425,Cheap
20140512T000000,192000.0,2,1.0,700,10540,1.0,0,0,3,6,700,0,1953,0,98166,47.438,-122.336,890,10540,9840,9650,18.216318785578746,0.015344262295081967,Very Cheap
20150413T000000,250000.0,3,2.0,1500,5200,1.0,0,0,3,7,1060,440,1977,0,98042,47.3653,-122.09,1640,5200,3700,3560,48.07692307692308,0.022950819672131147,Very Cheap
20140715T000000,340000.0,3,2.0,1130,9879,2.0,0,0,3,6,1130,0,1996,0,98053,47.635,-121.964,1900,14907,8749,13007,34.416438910820936,0.03475409836065574,Very Cheap
20141028T000000,340000.0,3,2.0,1420,6060,1.0,0,0,5,7,830,590,1942,0,98146,47.5102,-122.372,1420,6360,4640,4940,56.1056105610561,0.03475409836065574,Very Cheap
20141013T000000,635250.0,3,2.25,2210,22040,1.0,0,0,5,8,1510,700,1976,0,98004,47.5904,-122.194,2470,14258,19830,11788,28.822595281306715,0.07347540983606557,Very Cheap
20150407T000000,324800.0,2,1.0,1170,5043,1.0,0,0,3,6,880,290,1949,0,98108,47.5492,-122.302,1430,5692,3873,4262,64.40610747570891,0.03276065573770492,Very Cheap
20140506T000000,78000.0,2,1.0,780,16344,1.0,0,0,1,5,780,0,1942,0,98168,47.4739,-122.28,1700,10387,15564,8687,4.772393538913363,0.00039344262295081965,Very Cheap
20150409T000000,400000.0,4,1.75,1770,12875,1.0,0,0,3,8,1770,0,1988,0,98028,47.7438,-122.247,2150,12875,11105,10725,31.067961165048544,0.04262295081967213,Very Cheap
20150506T000000,640500.0,3,1.0,1070,4505,1.0,0,2,4,7,1070,0,1919,0,98136,47.5305,-122.384,1380,4505,3435,3125,142.17536071032185,0.07416393442622951,Very Cheap
20150430T000000,570000.0,3,2.0,1930,10929,1.0,0,0,3,8,1260,670,1964,0,98155,47.7657,-122.272,2030,8750,8999,6720,52.15481745813889,0.06491803278688525,Very Cheap
20140625T000000,1330000.0,3,1.5,1940,2885,1.5,0,2,3,8,1940,0,1900,0,98119,47.6308,-122.369,2550,3600,945,1050,461.0051993067591,0.16459016393442624,Cheap
20150403T000000,330490.0,3,2.75,1440,7350,1.0,0,0,4,7,1040,400,1980,0,98058,47.4431,-122.138,1510,7350,5910,5840,44.964625850340134,0.03350688524590164,Very Cheap
20140819T000000,325000.0,3,2.5,1740,5267,2.0,0,0,3,7,1740,0,1999,0,98038,47.3777,-122.023,2180,5000,3527,2820,61.70495538257072,0.03278688524590164,Very Cheap
20150421T000000,335000.0,3,2.5,1740,5267,2.0,0,0,3,7,1740,0,1999,0,98038,47.3777,-122.023,2180,5000,3527,2820,63.60356939434213,0.03409836065573771,Very Cheap
20141113T000000,314000.0,5,2.75,2210,13500,1.0,0,0,5,7,1460,750,1963,0,98188,47.4468,-122.282,1590,10850,11290,9260,23.25925925925926,0.03134426229508197,Very Cheap
20140923T000000,625000.0,4,2.0,2190,3622,1.5,0,0,5,8,1990,200,1925,0,98115,47.6887,-122.312,1450,3082,1432,1632,172.5565985643291,0.07213114754098361,Very Cheap
20140617T000000,809000.0,3,2.5,2590,7720,2.0,0,0,3,9,2590,0,1988,0,98007,47.659,-122.146,2600,9490,5130,6890,104.79274611398964,0.09626229508196721,Very Cheap
20140818T000000,535000.0,3,2.5,2790,19485,2.0,0,0,3,9,2790,0,1990,0,98059,47.4688,-122.124,2580,17859,16695,15279,27.45701821914293,0.06032786885245902,Very Cheap
20140821T000000,275000.0,5,1.75,2180,9178,1.0,0,0,3,7,1140,1040,1963,0,98188,47.4364,-122.28,2140,9261,6998,7121,29.96295489213336,0.02622950819672131,Very Cheap
20150417T000000,358000.0,4,2.75,2580,11900,1.0,0,0,4,7,1620,960,1967,0,98058,47.4475,-122.159,1570,9375,9320,7805,30.084033613445378,0.03711475409836065,Very Cheap
20150313T000000,297975.0,3,2.25,2820,8100,1.0,0,0,4,7,1720,1100,1947,0,98168,47.4944,-122.304,1040,8100,5280,7060,36.78703703703704,0.029242622950819672,Very Cheap
20150504T000000,492000.0,2,1.75,1300,22239,1.0,0,0,4,7,1300,0,1945,1986,98059,47.4801,-122.092,1300,14810,20939,13510,22.123296910832323,0.054688524590163934,Very Cheap
20140626T000000,210000.0,2,1.0,720,8040,1.0,0,0,3,6,720,0,1943,0,98166,47.4662,-122.359,2300,9500,7320,7200,26.119402985074625,0.017704918032786884,Very Cheap
20140827T000000,622500.0,3,2.5,2260,4550,1.5,0,0,4,7,1380,880,1928,0,98126,47.5714,-122.376,1870,4582,2290,2712,136.8131868131868,0.0718032786885246,Very Cheap
20141022T000000,550000.0,3,2.5,1550,1092,3.0,0,0,3,8,1390,160,2004,0,98102,47.6355,-122.324,1550,1079,-458,-471,503.6630036630037,0.06229508196721312,Very Cheap
20150226T000000,190000.0,3,1.75,1390,7700,1.0,0,0,5,7,1390,0,1965,0,98058,47.4559,-122.183,1260,7700,6310,6440,24.675324675324674,0.015081967213114755,Very Cheap
20140728T000000,340000.0,4,2.5,2380,9362,2.0,0,0,3,8,2380,0,2000,0,98023,47.3148,-122.349,2190,9840,6982,7650,36.31702627643666,0.03475409836065574,Very Cheap
20140725T000000,678000.0,3,2.5,2640,5964,2.0,0,0,3,9,2640,0,2003,0,98052,47.7043,-122.128,2680,5211,3324,2531,113.68209255533199,0.07908196721311475,Very Cheap
20150428T000000,275000.0,5,2.0,2260,11970,1.0,0,0,4,7,1250,1010,1962,0,98031,47.3896,-122.218,1950,11970,9710,10020,22.974101921470343,0.02622950819672131,Very Cheap
20140915T000000,493000.0,3,2.75,1720,6720,1.0,0,0,4,7,1270,450,1947,0,98122,47.6138,-122.298,1690,3248,5000,1558,73.36309523809524,0.054819672131147544,Very Cheap
20141216T000000,147000.0,3,1.0,1070,14000,1.0,0,0,3,7,1070,0,1960,0,98178,47.4971,-122.279,920,12500,12930,11580,10.5,0.009442622950819672,Very Cheap
20150204T000000,334000.0,3,2.25,2000,7225,2.0,0,0,4,7,2000,0,1985,0,98030,47.349,-122.167,1950,7464,5225,5514,46.22837370242215,0.0339672131147541,Very Cheap
20140703T000000,605000.0,4,2.5,2800,10786,1.0,0,0,3,8,1420,1380,1970,0,98008,47.5959,-122.116,2140,10788,7986,8648,56.09122937140738,0.06950819672131148,Very Cheap
20150427T000000,365000.0,3,1.75,1450,61419,1.0,0,0,4,8,1450,0,1976,0,98092,47.3343,-122.16,2256,82328,59969,80072,5.942786434165323,0.0380327868852459,Very Cheap
20141125T000000,345000.0,3,1.0,1620,10610,1.0,0,0,4,6,1620,0,1958,0,98059,47.474,-122.125,1680,10795,8990,9115,32.51649387370405,0.03540983606557377,Very Cheap
20141030T000000,999000.0,3,2.5,2710,23292,1.0,0,4,3,9,2080,630,1956,0,98177,47.7608,-122.374,2430,20000,20582,17570,42.8902627511592,0.12118032786885245,Cheap
20150402T000000,470000.0,2,1.75,1520,4220,1.0,0,0,4,7,840,680,1910,0,98117,47.6876,-122.366,1120,5700,2700,4580,111.37440758293839,0.05180327868852459,Very Cheap
20140624T000000,599000.0,5,2.75,2730,22572,1.0,0,0,3,7,2080,650,1968,1992,98075,47.5951,-122.037,2260,15458,19842,13198,26.537302853092328,0.06872131147540983,Very Cheap
20140917T000000,255000.0,3,2.25,1740,10378,1.0,0,0,5,7,1740,0,1977,0,98042,47.3815,-122.09,1420,10167,8638,8747,24.571208325303527,0.02360655737704918,Very Cheap
20150206T000000,295000.0,4,1.75,1800,28650,1.0,0,0,4,7,1800,0,1975,0,98031,47.3926,-122.166,1800,5234,26850,3434,10.296684118673648,0.028852459016393443,Very Cheap
20140627T000000,550000.0,4,3.5,4150,16197,2.0,0,0,3,10,4150,0,2006,0,98003,47.3423,-122.183,3618,15210,12047,11592,33.95690559980243,0.06229508196721312,Very Cheap
20140731T000000,1305000.0,5,3.5,3270,4080,2.0,0,0,3,9,2180,1090,2011,0,98115,47.6754,-122.327,1410,4080,810,2670,319.8529411764706,0.16131147540983606,Cheap
20150505T000000,225000.0,2,1.0,1070,6000,1.0,0,0,4,5,1070,0,1922,0,98178,47.495,-122.227,1910,6000,4930,4090,37.5,0.019672131147540985,Very Cheap
20141223T000000,520000.0,4,0.75,1960,8277,1.0,1,4,4,7,1320,640,1923,1986,98198,47.3648,-122.325,1940,8402,6317,6462,62.82469493777939,0.058360655737704915,Very Cheap
20140826T000000,345000.0,3,3.25,1600,1882,2.0,0,0,3,8,1360,240,2000,0,98133,47.7151,-122.355,1390,1379,282,-11,183.31562167906483,0.03540983606557377,Very Cheap
20140520T000000,475000.0,4,1.75,1650,7775,1.0,0,0,4,7,1150,500,1950,0,98133,47.715,-122.354,1390,7200,6125,5810,61.09324758842444,0.05245901639344262,Very Cheap
20141008T000000,497500.0,5,1.5,2170,8610,1.0,0,0,4,7,1230,940,1959,0,98008,47.6111,-122.126,1670,8610,6440,6940,57.78164924506388,0.05540983606557377,Very Cheap
20141120T000000,649500.0,3,3.0,3730,383328,1.5,0,0,4,9,2230,1500,1990,0,98038,47.4257,-122.03,1940,217800,379598,215860,1.6943713999499124,0.07534426229508197,Very Cheap
20140825T000000,734500.0,4,2.75,3280,6845,2.0,0,0,3,10,3280,0,2003,0,98052,47.7042,-122.107,3280,7467,3565,4187,107.3046018991965,0.08649180327868852,Very Cheap
20141218T000000,276000.0,3,1.0,870,8040,1.0,0,0,3,7,870,0,1953,0,98177,47.7048,-122.368,1440,8040,7170,6600,34.32835820895522,0.026360655737704918,Very Cheap
20140630T000000,235000.0,2,1.0,900,28800,1.0,0,0,1,6,900,0,1928,0,98065,47.5245,-121.822,1360,7200,27900,5840,8.159722222222221,0.02098360655737705,Very Cheap
20140812T000000,325000.0,2,1.0,1400,10800,1.0,0,0,4,7,1400,0,1974,0,98011,47.7726,-122.21,1560,11280,9400,9720,30.09259259259259,0.03278688524590164,Very Cheap
20140528T000000,425000.0,4,2.75,1680,9545,1.0,0,0,4,7,1080,600,1979,0,98028,47.739,-122.243,1890,9545,7865,7655,44.525929806181246,0.04590163934426229,Very Cheap
20150430T000000,307000.0,4,2.0,2390,23972,2.0,0,0,3,7,1720,670,1949,0,98023,47.3197,-122.343,1950,22750,21582,20800,12.806607708993827,0.03042622950819672,Very Cheap
20140528T000000,635000.0,3,2.5,2300,5500,1.5,0,0,4,8,2000,300,1921,0,98144,47.5785,-122.293,2100,5000,3200,2900,115.45454545454545,0.07344262295081967,Very Cheap
20140514T000000,223000.0,3,1.75,1340,7473,1.0,0,0,4,7,1340,0,1973,0,98002,47.3087,-122.206,1510,8240,6133,6730,29.840760069583837,0.019409836065573772,Very Cheap
20150413T000000,425000.0,3,2.75,2600,10874,2.0,0,0,3,9,2600,0,1994,0,98042,47.3815,-122.146,2800,11504,8274,8704,39.084053706087914,0.04590163934426229,Very Cheap
20150506T000000,190000.0,3,2.25,1640,7730,1.0,0,0,4,7,1220,420,1989,0,98038,47.3576,-122.039,1560,7566,6090,6006,24.579560155239328,0.015081967213114755,Very Cheap
20140918T000000,275000.0,4,1.75,1960,6177,1.0,0,0,4,8,1960,0,1967,0,98023,47.3131,-122.383,2010,8162,4217,6152,44.51999352436458,0.02622950819672131,Very Cheap
20140606T000000,450000.0,3,2.5,1480,1961,2.0,0,0,3,8,1480,0,2005,0,98029,47.5478,-122.0,1400,1138,481,-262,229.47475777664457,0.04918032786885246,Very Cheap
20140519T000000,1468000.0,4,3.25,5010,34460,2.0,0,0,3,12,5010,0,1988,0,98006,47.5469,-122.127,4760,34460,29450,29700,42.60011607661056,0.18268852459016394,Cheap
20141222T000000,550000.0,4,2.0,1540,5000,1.5,0,0,4,7,1540,0,1913,0,98105,47.6713,-122.3,1790,4000,3460,2210,110.0,0.06229508196721312,Very Cheap
20141204T000000,835000.0,4,2.75,4030,10240,2.0,0,2,3,8,3310,720,1943,1994,98177,47.7168,-122.365,2490,7680,6210,5190,81.54296875,0.09967213114754099,Very Cheap
20140618T000000,900000.0,6,3.0,3020,13783,2.0,0,0,3,8,3020,0,1952,2002,98040,47.5722,-122.226,1720,13500,10763,11780,65.29783066095915,0.10819672131147541,Cheap
20141124T000000,290000.0,2,2.0,1590,9375,1.0,0,0,3,7,910,680,1983,0,98055,47.4585,-122.205,1560,8524,7785,6964,30.933333333333334,0.02819672131147541,Very Cheap
20140808T000000,1035000.0,4,2.5,2910,9131,2.0,0,0,3,10,2910,0,2014,0,98033,47.6826,-122.186,1880,11212,6221,9332,113.35012594458438,0.1259016393442623,Cheap
20150105T000000,780000.0,4,2.5,3020,15164,1.0,0,0,4,8,1730,1290,1976,0,98004,47.5882,-122.192,2600,11556,12144,8956,51.43761540490636,0.09245901639344262,Very Cheap
20141218T000000,572500.0,3,2.0,2290,11200,2.0,0,0,3,9,2290,0,1979,0,98052,47.6517,-122.124,2250,10000,8910,7750,51.11607142857143,0.06524590163934427,Very Cheap
20150324T000000,389000.0,3,1.75,2180,9220,1.0,0,0,4,7,1090,1090,1938,0,98001,47.3547,-122.285,2050,22400,7040,20350,42.19088937093275,0.04118032786885246,Very Cheap
20140821T000000,350000.0,4,1.75,2740,10086,1.0,0,0,3,7,1440,1300,1972,0,98168,47.5112,-122.329,1710,9840,7346,8130,34.7015665278604,0.036065573770491806,Very Cheap
20140728T000000,476000.0,4,2.5,2740,33158,2.0,0,0,3,9,2740,0,1993,0,98042,47.3333,-122.074,2740,36074,30418,33334,14.355509982507993,0.052590163934426226,Very Cheap
20140904T000000,1046250.0,2,3.0,2330,3600,2.0,0,0,5,10,1870,460,1927,1979,98112,47.6316,-122.282,2950,7200,1270,4250,290.625,0.12737704918032786,Cheap
20141217T000000,287000.0,3,2.25,2300,7200,1.0,0,0,4,8,1550,750,1978,0,98003,47.324,-122.328,2000,7350,4900,5350,39.861111111111114,0.02780327868852459,Very Cheap
20141107T000000,707500.0,4,4.0,1550,6596,1.5,0,0,5,7,1550,0,1907,0,98107,47.6711,-122.398,1830,4850,5046,3020,107.26197695573074,0.08295081967213115,Very Cheap
20140801T000000,464500.0,4,2.5,1750,11381,1.0,0,0,4,7,1610,140,1947,0,98155,47.7425,-122.321,1080,11375,9631,10295,40.813636763026096,0.051081967213114754,Very Cheap
20141203T000000,720000.0,3,1.5,2180,5000,1.0,0,3,4,8,1090,1090,1941,0,98116,47.5787,-122.402,2070,5000,2820,2930,144.0,0.08459016393442623,Very Cheap
20141224T000000,319000.0,3,2.5,1610,8544,2.0,0,0,5,7,1610,0,1994,0,98038,47.3714,-122.054,1840,8190,6934,6350,37.33614232209738,0.032,Very Cheap
20140916T000000,330000.0,3,1.0,1570,9136,1.0,0,0,3,7,1570,0,1953,0,98133,47.7688,-122.337,1380,9127,7566,7747,36.120840630472856,0.03344262295081967,Very Cheap
20140520T000000,120750.0,3,1.75,1140,9628,1.0,0,0,4,7,1140,0,1969,0,98023,47.2933,-122.372,1510,9633,8488,8123,12.541545492314084,0.006,Very Cheap
20141021T000000,195000.0,3,1.75,1140,9628,1.0,0,0,4,7,1140,0,1969,0,98023,47.2933,-122.372,1510,9633,8488,8123,20.253427503115912,0.015737704918032787,Very Cheap
20150126T000000,650000.0,4,1.5,2480,6383,1.0,0,0,3,7,1380,1100,1946,0,98119,47.6445,-122.374,1440,6000,3903,4560,101.83299389002036,0.07540983606557378,Very Cheap
20140513T000000,530000.0,3,1.75,1690,8190,1.0,0,0,4,8,1690,0,1958,0,98005,47.5857,-122.172,1840,8705,6500,6865,64.71306471306471,0.05967213114754098,Very Cheap
20150407T000000,825000.0,4,3.0,2910,8027,1.0,0,0,5,8,1800,1110,1970,0,98117,47.6939,-122.391,2390,7660,5117,5270,102.77812383206677,0.09836065573770492,Very Cheap
20140822T000000,436000.0,4,2.0,1600,15044,1.0,0,0,3,7,1600,0,1972,0,98034,47.72,-122.216,1660,8102,13444,6442,28.98165381547461,0.047344262295081964,Very Cheap
20150114T000000,658000.0,2,1.0,1010,14244,1.0,1,4,1,5,1010,0,1926,0,98136,47.5476,-122.399,1820,15792,13234,13972,46.19488907610222,0.07645901639344262,Very Cheap
20140813T000000,547500.0,3,2.0,1850,9570,1.0,0,0,4,7,950,900,1940,0,98115,47.697,-122.322,1430,6380,7720,4950,57.210031347962385,0.061967213114754095,Very Cheap
20141203T000000,762000.0,3,1.75,2150,2527,2.0,0,0,4,8,1400,750,1906,0,98103,47.6629,-122.329,1610,3663,377,2053,301.5433320142461,0.0900983606557377,Very Cheap
20150126T000000,340000.0,3,1.75,2650,7378,1.0,0,0,3,7,1460,1190,1952,0,98155,47.7525,-122.315,1600,7616,4728,6016,46.08294930875576,0.03475409836065574,Very Cheap
20141121T000000,880000.0,4,1.75,2510,5800,1.0,0,2,4,9,1830,680,1953,0,98199,47.648,-122.41,2190,5800,3290,3610,151.72413793103448,0.10557377049180328,Cheap
20140521T000000,1220000.0,4,2.5,3240,3600,2.0,0,0,3,9,2060,1180,2008,0,98109,47.6405,-122.356,1820,3600,360,1780,338.8888888888889,0.1501639344262295,Cheap
20150408T000000,1950000.0,4,2.5,3440,14554,2.0,1,4,3,8,2170,1270,2012,0,98155,47.7364,-122.286,3170,11810,11114,8640,133.98378452659063,0.2459016393442623,Cheap
20140923T000000,382500.0,3,2.0,1150,6249,1.0,0,0,3,7,1150,0,1952,2006,98155,47.7489,-122.284,2470,7751,5099,5281,61.20979356697072,0.040327868852459016,Very Cheap
20150105T000000,344500.0,3,1.75,1890,9535,1.0,0,0,3,7,1210,680,1976,0,98055,47.4872,-122.223,2040,11108,7645,9068,36.13004719454641,0.03534426229508197,Very Cheap
20150412T000000,375000.0,4,2.75,1430,7403,1.0,0,0,3,7,1030,400,1982,0,98106,47.5346,-122.344,1480,7663,5973,6183,50.65513980818587,0.03934426229508197,Very Cheap
20140701T000000,276000.0,1,0.75,370,1801,1.0,0,0,5,5,370,0,1923,0,98117,47.6778,-122.389,1340,5000,1431,3660,153.2481954469739,0.026360655737704918,Very Cheap
20140701T000000,500000.0,5,3.25,3130,12087,2.0,0,0,3,8,2180,950,1975,0,98027,47.5336,-122.052,2410,10350,8957,7940,41.36675767353355,0.05573770491803279,Very Cheap
20140702T000000,330000.0,4,2.5,2105,6093,2.0,0,0,3,8,2105,0,2003,0,98042,47.3531,-122.147,1930,8022,3988,6092,54.16051206302314,0.03344262295081967,Very Cheap
20140822T000000,328000.0,3,1.0,890,5965,1.0,0,0,3,7,890,0,1950,0,98155,47.7518,-122.279,1930,7500,5075,5570,54.98742665549036,0.03318032786885246,Very Cheap
20150225T000000,450000.0,3,1.5,1340,7200,1.0,0,0,3,7,1340,0,1972,0,98034,47.718,-122.193,1730,8820,5860,7090,62.5,0.04918032786885246,Very Cheap
20140715T000000,840500.0,4,2.25,2290,12174,1.0,1,4,3,7,1490,800,1948,0,98178,47.5114,-122.245,2290,9379,9884,7089,69.0405782815837,0.10039344262295082,Cheap
20140814T000000,679000.0,3,2.5,2770,9350,2.0,0,3,3,8,2770,0,1957,2000,98056,47.5253,-122.201,2660,9695,6580,7035,72.62032085561498,0.07921311475409835,Very Cheap
20140605T000000,270000.0,3,1.5,1890,9450,1.0,0,0,3,7,1090,800,1957,0,98146,47.4829,-122.341,1470,8100,7560,6630,28.571428571428573,0.025573770491803278,Very Cheap
20150114T000000,757500.0,5,2.25,3160,8065,2.0,0,0,3,8,3160,0,1977,0,98027,47.5678,-122.089,2540,7917,4905,5377,93.92436453812772,0.08950819672131148,Very Cheap
20141112T000000,524950.0,2,2.5,1830,2856,2.0,0,0,3,7,1830,0,2005,0,98029,47.5524,-121.996,1850,2667,1026,817,183.8060224089636,0.05900983606557377,Very Cheap
20140723T000000,424900.0,4,2.75,2950,49658,1.0,0,0,4,8,2950,0,1960,1998,98010,47.3596,-121.922,1720,54672,46708,52952,8.556526642232873,0.04588852459016393,Very Cheap
20150107T000000,551100.0,3,1.0,1430,8640,1.0,0,0,5,7,1430,0,1954,0,98006,47.572,-122.147,1430,9840,7210,8410,63.78472222222222,0.06243934426229508,Very Cheap
20141107T000000,421000.0,3,2.0,1420,12655,1.0,0,0,5,7,1420,0,1968,0,98056,47.5309,-122.186,2020,9655,11235,7635,33.267483208218096,0.045377049180327866,Very Cheap
20140801T000000,635000.0,4,1.75,2460,7560,2.0,0,0,4,8,2460,0,1952,0,98177,47.7256,-122.367,2760,8918,5100,6158,83.994708994709,0.07344262295081967,Very Cheap
20141209T000000,255000.0,3,1.0,1340,6120,1.5,0,0,4,7,1340,0,1920,0,98108,47.5272,-122.322,1260,6000,4780,4740,41.666666666666664,0.02360655737704918,Very Cheap
20150310T000000,419950.0,4,1.0,1530,7920,1.0,0,0,3,7,1030,500,1955,0,98166,47.4544,-122.36,1690,7920,6390,6230,53.023989898989896,0.04523934426229508,Very Cheap
20141210T000000,325000.0,6,3.0,2650,12870,1.0,0,0,4,7,2650,0,1977,0,98022,47.2069,-121.989,1450,8668,10220,7218,25.252525252525253,0.03278688524590164,Very Cheap
20150421T000000,281000.0,4,2.25,1677,3600,2.0,0,0,3,7,1677,0,2012,0,98092,47.32,-122.178,1677,3600,1923,1923,78.05555555555556,0.027016393442622952,Very Cheap
20140610T000000,655275.0,3,1.75,2050,11856,1.0,0,0,3,7,1460,590,1962,0,98006,47.5735,-122.162,2670,11856,9806,9186,55.26948380566802,0.0761016393442623,Very Cheap
20140825T000000,861000.0,3,2.0,2520,3959,1.0,0,0,5,8,1270,1250,1931,0,98105,47.6693,-122.289,1660,3959,1439,2299,217.47916140439506,0.10308196721311476,Cheap
20141016T000000,850000.0,3,3.5,2620,11148,2.0,0,4,4,9,2060,560,1977,0,98008,47.5845,-122.115,2590,10796,8528,8206,76.24686042339432,0.10163934426229508,Cheap
20141119T000000,246000.0,3,2.5,1650,6675,1.0,0,0,3,8,1290,360,1990,0,98023,47.2899,-122.372,1880,6675,5025,4795,36.853932584269664,0.02242622950819672,Very Cheap
20141216T000000,380000.0,2,1.0,700,4836,1.0,0,0,4,6,700,0,1926,0,98125,47.7139,-122.288,1190,7050,4136,5860,78.57733664185277,0.04,Very Cheap
20141020T000000,813000.0,4,2.5,3430,7508,2.0,0,0,3,10,3430,0,1998,0,98052,47.6866,-122.11,3110,8741,4078,5631,108.28449653702717,0.09678688524590164,Very Cheap
20141120T000000,990000.0,4,2.5,3140,11049,2.0,0,0,3,10,3140,0,1988,0,98004,47.5817,-122.192,2750,11049,7909,8299,89.60086885691013,0.12,Cheap
20141105T000000,650000.0,3,2.5,2350,3750,2.0,0,0,3,7,1740,610,2003,0,98117,47.6767,-122.365,1590,4700,1400,3110,173.33333333333334,0.07540983606557378,Very Cheap
20140522T000000,273000.0,4,3.0,1990,6180,2.0,0,0,3,7,1990,0,1990,0,98023,47.3083,-122.36,1910,6180,4190,4270,44.1747572815534,0.025967213114754098,Very Cheap
20140724T000000,398000.0,4,2.5,2050,14724,2.0,0,0,3,7,2050,0,1989,0,98019,47.73,-121.969,1920,12841,12674,10921,27.030698179842435,0.042360655737704915,Very Cheap
20140822T000000,200000.0,2,1.0,930,8665,1.0,0,0,4,6,930,0,1938,0,98168,47.4822,-122.318,1630,12375,7735,10745,23.08136180034622,0.01639344262295082,Very Cheap
20140515T000000,839000.0,3,1.0,1230,12305,1.0,0,0,3,7,1230,0,1955,1990,98004,47.6095,-122.195,2100,7960,11075,5860,68.18366517675742,0.1001967213114754,Cheap
20141104T000000,502000.0,3,2.5,1870,9135,1.0,0,0,3,7,1250,620,1984,0,98074,47.6269,-122.06,1550,9100,7265,7550,54.953475643130815,0.056,Very Cheap
20140617T000000,305000.0,3,2.25,2110,7665,1.0,0,0,4,7,1360,750,1973,0,98023,47.3082,-122.372,1660,8436,5555,6776,39.79125896934116,0.03016393442622951,Very Cheap
20140618T000000,574950.0,5,3.25,3160,10000,2.0,0,0,4,8,3160,0,1980,0,98027,47.52,-122.047,2130,10000,6840,7870,57.495,0.0655672131147541,Very Cheap
20140818T000000,311000.0,3,1.0,1120,8631,1.0,0,0,3,7,1120,0,1942,0,98125,47.7077,-122.314,1350,7714,7511,6364,36.032904646043335,0.030950819672131147,Very Cheap
20141122T000000,1650000.0,3,2.25,2750,6203,1.0,1,4,5,7,1620,1130,1959,0,98074,47.6163,-122.068,2570,7009,3453,4439,266.0003224246332,0.20655737704918034,Cheap
20140506T000000,387000.0,3,1.0,1230,9568,1.0,0,0,5,7,1230,0,1962,0,98056,47.539,-122.179,1270,9575,8338,8305,40.447324414715716,0.040918032786885244,Very Cheap
20140805T000000,375000.0,3,1.5,1190,20672,1.5,0,3,3,7,1190,0,1948,0,98166,47.4459,-122.359,2150,16239,19482,14089,18.140479876160992,0.03934426229508197,Very Cheap
20140925T000000,175000.0,2,1.0,740,3434,1.0,0,0,5,6,740,0,1920,0,98022,47.2088,-121.992,1160,6000,2694,4840,50.96097845078626,0.013114754098360656,Very Cheap
20140612T000000,248000.0,4,2.5,1770,5855,2.0,0,0,3,7,1770,0,2003,0,98038,47.3483,-122.053,1790,5679,4085,3889,42.356959863364644,0.022688524590163933,Very Cheap
20150403T000000,336750.0,4,2.25,1720,7803,1.0,0,0,3,8,1350,370,1955,0,98146,47.5119,-122.337,1720,7803,6083,6083,43.15647827758554,0.03432786885245902,Very Cheap
20140604T000000,685000.0,4,2.5,2770,45514,2.0,0,0,4,9,2770,0,1989,0,98077,47.7751,-122.088,2940,49495,42744,46555,15.050314189040735,0.08,Very Cheap
20140715T000000,645000.0,4,2.75,2330,3917,2.0,0,0,3,9,2330,0,2004,0,98029,47.5527,-121.99,2620,4400,1587,1780,164.66683686494767,0.07475409836065573,Very Cheap
20141218T000000,279000.0,3,2.5,1660,7388,2.0,0,0,3,7,1660,0,2003,0,98038,47.3865,-122.027,2240,6228,5728,3988,37.76394152680022,0.02675409836065574,Very Cheap
20150416T000000,479000.0,2,2.5,1730,1037,3.5,0,0,3,8,1730,0,2008,0,98118,47.5594,-122.285,1280,1026,-693,-254,461.90935390549663,0.05298360655737705,Very Cheap
20150128T000000,466000.0,3,2.25,1880,7279,1.0,0,0,3,7,1280,600,1962,0,98155,47.7574,-122.322,2020,8274,5399,6254,64.01978293721665,0.051278688524590166,Very Cheap
20150420T000000,361500.0,4,2.75,2190,6740,2.0,0,0,3,7,2190,0,1995,0,98038,47.3804,-122.027,1950,7150,4550,5200,53.63501483679525,0.03757377049180328,Very Cheap
20141202T000000,404000.0,3,1.75,1720,7202,1.0,0,0,3,7,1720,0,1995,0,98056,47.5044,-122.19,1720,7625,5482,5905,56.09552901971674,0.043147540983606555,Very Cheap
20150316T000000,319000.0,4,3.25,2360,8344,2.0,0,0,3,8,2360,0,1990,0,98058,47.4403,-122.126,1860,8410,5984,6550,38.23106423777565,0.032,Very Cheap
20150316T000000,320000.0,3,1.5,1490,10132,1.0,0,0,4,6,1490,0,1969,0,98059,47.4779,-122.145,1720,9915,8642,8195,31.583103039873667,0.032131147540983604,Very Cheap
20141117T000000,1311000.0,4,3.75,3490,5625,2.0,0,0,3,9,2610,880,2014,0,98103,47.6685,-122.332,1940,5000,2135,3060,233.06666666666666,0.1620983606557377,Cheap
20140923T000000,1000000.0,3,2.75,2370,8900,1.0,0,4,4,9,1670,700,1971,0,98006,47.5648,-122.156,2840,8956,6530,6116,112.35955056179775,0.12131147540983607,Cheap
20141107T000000,660000.0,4,2.5,2290,9120,2.0,0,0,4,8,2290,0,1977,0,98006,47.5613,-122.128,2290,9120,6830,6830,72.36842105263158,0.07672131147540984,Very Cheap
20150421T000000,546000.0,4,3.0,1790,3600,1.5,0,0,3,8,1790,0,1901,0,98122,47.6117,-122.313,1770,3119,1810,1349,151.66666666666666,0.06177049180327869,Very Cheap
20140709T000000,300000.0,4,1.75,1820,5015,1.0,0,0,4,6,1190,630,1926,0,98108,47.5569,-122.31,1530,9130,3195,7600,59.82053838484546,0.029508196721311476,Very Cheap
20141016T000000,500000.0,2,1.5,1760,12000,1.0,0,0,4,7,1760,0,1964,0,98052,47.6288,-122.109,2200,12088,10240,9888,41.666666666666664,0.05573770491803279,Very Cheap
20140910T000000,381500.0,4,2.5,2430,5556,2.0,0,0,4,8,2430,0,2003,0,98042,47.3762,-122.126,2430,5556,3126,3126,68.66450683945284,0.04019672131147541,Very Cheap
20150427T000000,990000.0,3,2.25,2630,12899,2.0,0,0,4,9,2630,0,1966,0,98040,47.5479,-122.233,3140,15320,10269,12180,76.75013566943174,0.12,Cheap
20150116T000000,278226.0,4,2.5,2390,4639,2.0,0,0,3,8,2390,0,2006,0,98038,47.3527,-121.999,2390,4521,2249,2131,59.97542573830567,0.026652590163934425,Very Cheap
20150127T000000,340000.0,2,1.75,1500,4158,1.0,0,0,4,7,1220,280,1947,0,98103,47.7006,-122.35,1270,4081,2658,2811,81.77008177008177,0.03475409836065574,Very Cheap
20140813T000000,305000.0,4,2.5,2510,12000,1.0,0,0,3,8,1520,990,1977,0,98023,47.3086,-122.384,2210,8320,9490,6110,25.416666666666668,0.03016393442622951,Very Cheap
20140613T000000,760000.0,4,2.5,2420,10285,1.0,0,4,3,8,1700,720,1958,0,98146,47.4871,-122.36,2540,9900,7865,7360,73.8940204180846,0.0898360655737705,Very Cheap
20141029T000000,195000.0,4,1.5,2170,9948,2.0,0,0,3,7,2170,0,1952,0,98148,47.4263,-122.331,1500,9750,7778,8250,19.60193003618818,0.015737704918032787,Very Cheap
20150415T000000,564000.0,4,1.75,1960,6138,1.0,0,0,4,7,1260,700,1960,0,98115,47.6968,-122.299,2000,7057,4178,5057,91.88660801564028,0.0641311475409836,Very Cheap
20141224T000000,539500.0,4,2.25,2280,8550,1.0,0,0,3,8,1660,620,1977,0,98034,47.701,-122.231,2590,9500,6270,6910,63.099415204678365,0.06091803278688525,Very Cheap
20140918T000000,299980.0,4,1.5,1580,10230,1.0,0,0,3,6,790,790,1945,2008,98178,47.5002,-122.246,1130,6955,8650,5825,29.32355816226784,0.029505573770491803,Very Cheap
20141013T000000,290000.0,4,2.5,1850,5674,2.0,0,0,3,7,1850,0,1993,0,98042,47.3536,-122.142,1750,6875,3824,5125,51.11032781106803,0.02819672131147541,Very Cheap
20150203T000000,257000.0,2,1.0,770,11084,1.0,0,0,4,6,770,0,1947,0,98155,47.7482,-122.321,1010,11084,10314,10074,23.18657524359437,0.023868852459016394,Very Cheap
20140821T000000,518500.0,4,3.0,2120,5520,1.5,0,0,3,8,1420,700,1985,0,98125,47.7085,-122.286,2020,8700,3400,6680,93.93115942028986,0.05816393442622951,Very Cheap
20140908T000000,657000.0,4,2.75,3060,35380,1.0,0,0,3,9,1810,1250,1982,0,98074,47.6198,-122.038,1980,10425,32320,8445,18.569813453928774,0.07632786885245901,Very Cheap
20140815T000000,590000.0,3,2.25,2680,41250,2.0,0,0,3,7,2680,0,1984,0,98045,47.4817,-121.749,1940,47044,38570,45104,14.303030303030303,0.06754098360655737,Very Cheap
20140718T000000,526000.0,4,1.75,2220,6350,1.0,0,0,3,7,1110,1110,1959,0,98125,47.7136,-122.29,1950,8100,4130,6150,82.83464566929133,0.059147540983606556,Very Cheap
20150323T000000,254500.0,2,1.0,1150,11250,1.0,0,0,3,6,1150,0,1920,0,98178,47.486,-122.264,1100,11400,10100,10300,22.622222222222224,0.02354098360655738,Very Cheap
20150414T000000,575000.0,2,1.0,980,3663,1.0,0,0,5,7,980,0,1909,0,98105,47.6645,-122.288,1620,3706,2683,2086,156.97515697515698,0.06557377049180328,Very Cheap
20150121T000000,464550.0,3,1.5,1690,10500,1.0,0,0,4,7,1690,0,1967,0,98033,47.7018,-122.165,1570,10500,8810,8930,44.24285714285714,0.051088524590163935,Very Cheap
20140715T000000,409950.0,3,1.75,1320,6030,1.0,0,0,4,7,1320,0,1969,0,98052,47.6993,-122.13,1840,6565,4710,4725,67.98507462686567,0.043927868852459015,Very Cheap
20140507T000000,100000.0,2,1.0,910,22000,1.0,0,0,3,6,910,0,1956,0,98001,47.2777,-122.252,1326,9891,21090,8565,4.545454545454546,0.003278688524590164,Very Cheap
20150302T000000,365000.0,2,1.5,820,1270,2.0,0,0,3,7,820,0,2009,0,98144,47.5925,-122.295,1130,1201,450,71,287.40157480314963,0.0380327868852459,Very Cheap
20150209T000000,208000.0,3,1.0,1300,7420,1.0,0,0,4,6,1300,0,1960,0,98002,47.2899,-122.219,1250,7420,6120,6170,28.032345013477087,0.01744262295081967,Very Cheap
20141110T000000,497950.0,4,2.5,1950,3000,2.0,0,0,3,7,1550,400,1998,0,98118,47.565,-122.281,1540,4300,1050,2760,165.98333333333332,0.05546885245901639,Very Cheap
20140910T000000,405000.0,5,3.5,3672,9742,2.0,0,0,3,9,3006,666,2006,0,98092,47.3255,-122.192,2140,9118,6070,6978,41.572572367070414,0.043278688524590166,Very Cheap
20150311T000000,568000.0,3,2.5,2740,22499,2.0,0,0,3,9,2740,0,1994,0,98058,47.4597,-122.153,2710,22499,19759,19789,25.245566469620872,0.06465573770491803,Very Cheap
20150511T000000,334000.0,2,1.0,890,6000,1.0,0,0,3,6,890,0,1941,0,98118,47.5437,-122.281,1090,5900,5110,4810,55.666666666666664,0.0339672131147541,Very Cheap
20150115T000000,235000.0,3,2.0,1090,8400,1.0,0,0,4,6,1090,0,1961,0,98168,47.4942,-122.322,1100,10850,7310,9750,27.976190476190474,0.02098360655737705,Very Cheap
20140603T000000,295000.0,2,1.0,1170,10621,1.0,0,0,3,7,1170,0,1963,0,98045,47.497,-121.78,1340,9832,9451,8492,27.7751624140853,0.028852459016393443,Very Cheap
20150122T000000,610000.0,4,3.0,2600,29539,1.0,0,0,3,8,2600,0,1994,0,98028,47.746,-122.231,1810,11600,26939,9790,20.650665222248552,0.07016393442622951,Very Cheap
20140605T000000,453500.0,4,1.75,2000,6032,1.0,0,2,3,7,1300,700,1959,0,98146,47.5132,-122.389,1930,6032,4032,4102,75.18236074270557,0.04963934426229508,Very Cheap
20140623T000000,1220000.0,4,3.75,3520,3944,1.5,0,0,5,8,2200,1320,1913,0,98109,47.6424,-122.348,2310,4725,424,2415,309.3306288032454,0.1501639344262295,Cheap
20150128T000000,175000.0,2,1.0,1410,7000,1.0,0,0,3,7,1410,0,1968,0,98055,47.4908,-122.223,1540,6000,5590,4460,25.0,0.013114754098360656,Very Cheap
20150428T000000,335000.0,2,1.0,1410,7000,1.0,0,0,3,7,1410,0,1968,0,98055,47.4908,-122.223,1540,6000,5590,4460,47.857142857142854,0.03409836065573771,Very Cheap
20140904T000000,275000.0,3,1.5,1950,7620,1.0,0,0,4,7,1010,940,1956,0,98166,47.4594,-122.346,1850,7620,5670,5770,36.08923884514436,0.02622950819672131,Very Cheap
20140514T000000,400000.0,2,1.0,980,2130,1.0,0,0,4,6,860,120,1918,0,98117,47.6769,-122.366,980,2800,1150,1820,187.79342723004694,0.04262295081967213,Very Cheap
20140718T000000,915000.0,3,2.75,3390,7000,1.0,0,3,4,8,1740,1650,1979,0,98116,47.5701,-122.408,1770,6500,3610,4730,130.71428571428572,0.11016393442622952,Cheap
20140619T000000,619850.0,4,2.5,2270,9247,1.0,0,0,5,8,1500,770,1972,0,98006,47.5602,-122.176,2270,9163,6977,6893,67.0325510976533,0.07145573770491803,Very Cheap
20150202T000000,225900.0,3,1.0,1510,8800,1.0,0,0,4,7,1010,500,1963,0,98003,47.329,-122.33,1290,8470,7290,7180,25.670454545454547,0.01979016393442623,Very Cheap
20140918T000000,525000.0,2,1.5,960,7200,1.0,0,0,3,7,960,0,1910,1987,98199,47.649,-122.403,1550,6000,6240,4450,72.91666666666667,0.05901639344262295,Very Cheap
20141226T000000,215000.0,4,2.25,1900,9600,1.0,0,0,4,7,1900,0,1967,0,98031,47.4208,-122.2,2040,9600,7700,7560,22.395833333333332,0.018360655737704918,Very Cheap
20140514T000000,802000.0,3,2.5,2580,13096,2.0,0,0,3,9,2580,0,1986,0,98052,47.6616,-122.144,2580,7988,10516,5408,61.2400733048259,0.09534426229508197,Very Cheap
20140630T000000,330000.0,4,2.5,2340,11784,2.0,0,0,3,9,2340,0,1997,0,98042,47.384,-122.149,2250,10760,9444,8510,28.0040733197556,0.03344262295081967,Very Cheap
20140801T000000,549800.0,3,2.25,1580,11680,1.0,0,0,4,7,1580,0,1958,0,98005,47.5872,-122.17,2270,10948,10100,8678,47.071917808219176,0.062268852459016394,Very Cheap
20141024T000000,195500.0,4,1.0,1230,8636,1.5,0,0,4,6,1230,0,1954,0,98002,47.3231,-122.219,1168,8316,7406,7148,22.637795275590552,0.01580327868852459,Very Cheap
20140818T000000,338000.0,3,2.5,1590,7819,2.0,0,0,3,7,1590,0,1992,0,98055,47.4367,-122.199,1790,7733,6229,5943,43.2280342754828,0.034491803278688525,Very Cheap
20140812T000000,3200000.0,4,3.25,7000,28206,1.0,1,4,4,12,3500,3500,1991,0,98075,47.5928,-122.086,4913,14663,21206,9750,113.45103878607388,0.4098360655737705,High
20140820T000000,480000.0,4,2.25,1770,7000,1.0,0,0,5,7,1770,0,1972,0,98034,47.7193,-122.218,1780,6500,5230,4720,68.57142857142857,0.05311475409836065,Very Cheap
20150406T000000,383000.0,4,2.5,1850,8310,1.0,0,0,3,7,1200,650,1962,0,98155,47.7717,-122.29,1840,10080,6460,8240,46.08904933814681,0.04039344262295082,Very Cheap
20150331T000000,257000.0,3,1.75,1430,7210,1.0,0,0,3,7,1430,0,1975,0,98031,47.4189,-122.168,1220,7777,5780,6557,35.64493758668516,0.023868852459016394,Very Cheap
20150223T000000,335000.0,4,2.75,2190,9209,2.0,0,0,4,8,2190,0,1996,0,98092,47.3341,-122.188,2430,6687,7019,4257,36.3774568357042,0.03409836065573771,Very Cheap
20150508T000000,422000.0,4,2.5,2310,6650,2.0,0,2,3,8,2310,0,2012,0,98166,47.4513,-122.267,1800,9819,4340,8019,63.45864661654135,0.04550819672131148,Very Cheap
20140603T000000,560000.0,3,1.75,2000,10182,1.0,0,0,5,7,1400,600,1963,0,98033,47.6616,-122.175,2050,10182,8182,8132,54.99901787468081,0.06360655737704918,Very Cheap
20150424T000000,680000.0,4,2.75,3620,35429,2.0,0,0,3,10,3620,0,2006,0,98058,47.4238,-122.098,3310,54193,31809,50883,19.193316209884557,0.07934426229508197,Very Cheap
20141028T000000,320000.0,2,1.0,1210,7040,1.0,0,0,3,7,1210,0,1952,0,98155,47.745,-122.297,1210,7205,5830,5995,45.45454545454545,0.032131147540983604,Very Cheap
20140903T000000,665000.0,3,2.5,2330,15536,1.0,0,2,3,10,2330,0,1996,0,98074,47.655,-122.087,3320,17461,13206,14141,42.8038105046344,0.07737704918032787,Very Cheap
20150326T000000,751000.0,3,2.5,2840,6854,2.0,0,0,3,9,2840,0,2002,0,98075,47.6006,-121.978,2840,7398,4014,4558,109.57105339947476,0.08865573770491804,Very Cheap
20141113T000000,320000.0,6,2.75,2410,10763,1.0,0,0,5,7,1310,1100,1957,0,98188,47.4429,-122.282,1310,10746,8353,9436,29.731487503484157,0.032131147540983604,Very Cheap
20150121T000000,290000.0,4,1.75,1820,22043,2.5,0,0,4,7,1820,0,1918,0,98155,47.7606,-122.28,1880,19961,20223,18081,13.156103978587307,0.02819672131147541,Very Cheap
20141030T000000,250000.0,4,2.0,1470,7412,1.0,0,0,3,7,1470,0,1967,0,98198,47.3702,-122.318,1390,7825,5942,6435,33.72908796546142,0.022950819672131147,Very Cheap
20150415T000000,423000.0,3,1.75,1100,10005,1.0,0,0,5,7,1100,0,1964,0,98056,47.5374,-122.173,1340,9709,8905,8369,42.27886056971514,0.04563934426229508,Very Cheap
20150506T000000,601002.0,4,2.5,2050,8094,1.0,0,0,3,8,1050,1000,1976,0,98052,47.6614,-122.138,1990,9020,6044,7030,74.25277983691623,0.06898386885245901,Very Cheap
20150205T000000,352900.0,2,1.5,1240,1892,2.0,0,0,3,7,1240,0,2002,0,98144,47.5915,-122.295,1220,1740,652,520,186.52219873150105,0.03644590163934426,Very Cheap
20140819T000000,509950.0,3,2.5,2210,70567,2.0,0,3,3,9,2210,0,1995,0,98014,47.6087,-121.895,2000,73616,68357,71616,7.22646562840988,0.057042622950819674,Very Cheap
20150205T000000,360000.0,2,1.75,1340,1050,3.0,0,0,3,8,1340,0,2009,0,98133,47.7053,-122.343,1340,1090,-290,-250,342.85714285714283,0.037377049180327866,Very Cheap
20141110T000000,1075000.0,4,2.75,2580,8100,2.0,0,1,4,8,1780,800,1964,0,98040,47.5387,-122.215,2840,10006,5520,7166,132.71604938271605,0.13114754098360656,Cheap
20140731T000000,349950.0,3,2.5,2390,6441,2.0,0,0,3,7,2390,0,2002,0,98038,47.3659,-122.029,2180,7346,4051,5166,54.33162552398696,0.036059016393442625,Very Cheap
20141126T000000,395000.0,4,2.5,2250,6840,2.0,0,0,3,9,2250,0,1987,0,98058,47.4398,-122.151,2480,7386,4590,4906,57.748538011695906,0.0419672131147541,Very Cheap
20150107T000000,273500.0,3,1.5,2000,15265,1.0,0,0,3,8,1540,460,1967,0,98032,47.387,-122.281,1920,15265,13265,13345,17.916803144448085,0.026032786885245903,Very Cheap
20150414T000000,700000.0,4,1.75,1870,6000,1.0,0,0,5,8,1670,200,1949,0,98199,47.6435,-122.399,1710,6000,4130,4290,116.66666666666667,0.08196721311475409,Very Cheap
20150417T000000,699000.0,3,2.5,2370,10968,2.0,0,0,4,9,2370,0,1985,0,98033,47.6679,-122.172,2380,8144,8598,5764,63.7308533916849,0.08183606557377049,Very Cheap
20150416T000000,537000.0,4,2.25,2640,8800,1.0,0,0,3,8,1620,1020,1980,0,98072,47.7552,-122.148,2500,11700,6160,9200,61.02272727272727,0.060590163934426226,Very Cheap
20150429T000000,405000.0,3,1.5,1240,9975,1.0,0,0,3,6,1240,0,1977,0,98024,47.5667,-121.905,1390,10735,8735,9345,40.6015037593985,0.043278688524590166,Very Cheap
20140804T000000,269500.0,2,1.0,800,1200,2.0,0,0,3,7,800,0,1999,0,98103,47.6969,-122.347,806,1200,400,394,224.58333333333334,0.025508196721311476,Very Cheap
20140925T000000,260000.0,4,2.5,2050,12500,1.0,0,0,3,7,1300,750,1965,0,98198,47.42,-122.319,1790,7900,10450,6110,20.8,0.024262295081967214,Very Cheap
20140904T000000,266750.0,3,2.25,1650,10000,2.0,0,0,3,7,1650,0,1988,0,98198,47.3862,-122.315,1420,10000,8350,8580,26.675,0.025147540983606557,Very Cheap
20141209T000000,1800000.0,5,3.75,4320,39094,2.0,1,4,3,8,4320,0,1938,0,98155,47.7519,-122.276,1920,7750,34774,5830,46.042871028802374,0.2262295081967213,Cheap
20140821T000000,779000.0,2,2.25,2130,5920,1.0,0,0,3,8,1830,300,1950,0,98115,47.6792,-122.275,2130,7192,3790,5062,131.58783783783784,0.09232786885245901,Very Cheap
20140619T000000,500000.0,3,2.5,2840,48716,1.0,0,3,3,9,1870,970,1994,0,98014,47.6832,-121.915,2710,43676,45876,40966,10.26356843747434,0.05573770491803279,Very Cheap
20150403T000000,365000.0,4,1.75,3080,32997,1.5,0,0,4,7,3080,0,1950,1982,98168,47.498,-122.321,1980,5711,29917,3731,11.061611661666213,0.0380327868852459,Very Cheap
20140906T000000,724000.0,2,1.0,1560,5000,1.5,0,1,4,7,1560,0,1942,0,98117,47.7006,-122.386,2620,5400,3440,2780,144.8,0.08511475409836065,Very Cheap
20140811T000000,890000.0,4,2.75,3220,15467,2.0,0,0,3,11,3220,0,1994,0,98077,47.7128,-122.083,3670,16641,12247,12971,57.541863321911165,0.10688524590163935,Cheap
20140724T000000,431000.0,4,2.5,1450,3600,1.5,0,0,3,7,1250,200,1902,0,98144,47.5985,-122.298,1680,3600,2150,1920,119.72222222222223,0.046688524590163934,Very Cheap
20140710T000000,242000.0,2,1.0,960,21850,1.0,0,0,3,6,960,0,1947,0,98032,47.4122,-122.267,1020,21850,20890,20830,11.075514874141877,0.021901639344262296,Very Cheap
20150416T000000,415000.0,4,2.5,2670,8279,2.0,0,0,3,7,2670,0,1999,0,98148,47.4292,-122.328,2290,7504,5609,5214,50.126826911462736,0.04459016393442623,Very Cheap
20140814T000000,727160.0,7,3.75,2310,5000,2.0,0,0,3,8,2310,0,1984,0,98117,47.6781,-122.376,1360,1552,2690,192,145.432,0.08552918032786885,Very Cheap
20141211T000000,1110000.0,4,3.25,3520,19354,1.0,0,2,4,9,2010,1510,1978,0,98006,47.5572,-122.147,2630,19354,15834,16724,57.35248527436189,0.13573770491803278,Cheap
20150114T000000,265000.0,2,1.75,1090,3272,1.0,0,0,5,8,1090,0,1970,0,98198,47.3794,-122.32,1160,5475,2182,4315,80.99022004889976,0.024918032786885248,Very Cheap
20150202T000000,519000.0,3,1.75,2000,5680,1.0,0,0,4,7,1080,920,1903,0,98117,47.6805,-122.366,1230,4535,3680,3305,91.37323943661971,0.05822950819672131,Very Cheap
20150112T000000,262000.0,4,1.5,1840,9009,2.0,0,0,3,7,1840,0,1965,0,98198,47.406,-122.318,1390,8025,7169,6635,29.08202908202908,0.024524590163934427,Very Cheap
20140623T000000,1190000.0,4,2.5,3160,13194,2.0,0,0,5,10,3160,0,1965,0,98040,47.5472,-122.233,3490,13194,10034,9704,90.19251174776413,0.14622950819672131,Cheap
20150507T000000,295000.0,3,1.75,1520,6559,1.0,0,0,4,7,1170,350,1992,0,98038,47.35,-122.037,1520,6095,5039,4575,44.97636834883367,0.028852459016393443,Very Cheap
20150123T000000,615000.0,3,1.75,2110,56192,1.0,0,0,3,7,1480,630,1978,0,98072,47.7701,-122.138,2570,46609,54082,44039,10.944618451025057,0.07081967213114754,Very Cheap
20140905T000000,1100000.0,4,2.75,3410,7750,1.0,0,4,5,8,1710,1700,1958,0,98116,47.5718,-122.406,3080,8525,4340,5445,141.93548387096774,0.13442622950819672,Cheap
20140926T000000,575000.0,4,2.5,2630,6247,2.0,0,0,3,8,2630,0,1992,0,98029,47.5662,-122.0,2130,4668,3617,2538,92.04418120697935,0.06557377049180328,Very Cheap
20150407T000000,388000.0,3,1.75,1350,2325,3.0,0,0,3,7,1350,0,1999,0,98103,47.6965,-122.35,1520,1652,975,132,166.88172043010752,0.041049180327868855,Very Cheap
20141103T000000,750500.0,4,2.5,2860,9159,1.0,0,0,4,8,1530,1330,1989,0,98033,47.6923,-122.2,2070,8680,6299,6610,81.94125996287805,0.08859016393442623,Very Cheap
20140527T000000,527500.0,3,1.75,2310,78844,1.0,0,0,3,8,1760,550,1977,0,98027,47.5406,-122.066,2830,6230,76534,3400,6.690426665313784,0.05934426229508197,Very Cheap
20140529T000000,503000.0,3,2.0,2590,108900,2.0,0,0,3,8,1980,610,1988,0,98038,47.4088,-122.055,3170,108900,106310,105730,4.618916437098255,0.056131147540983604,Very Cheap
20141104T000000,1047000.0,4,3.5,3500,4000,2.0,0,0,3,10,2560,940,2000,0,98112,47.628,-122.299,1910,4000,500,2090,261.75,0.12747540983606556,Cheap
20140708T000000,325000.0,2,1.0,800,7260,1.0,0,0,3,7,800,0,1953,0,98126,47.5359,-122.367,1010,7440,6460,6430,44.76584022038568,0.03278688524590164,Very Cheap
20140825T000000,402000.0,3,1.75,1580,6127,1.5,0,0,5,7,1580,0,1947,0,98125,47.7192,-122.32,1500,6128,4547,4628,65.6112289864534,0.04288524590163934,Very Cheap
20140924T000000,370000.0,3,1.5,1560,6774,1.0,0,0,4,6,1060,500,1927,0,98133,47.7024,-122.35,1320,3844,5214,2524,54.62060820785356,0.038688524590163934,Very Cheap
20140626T000000,329950.0,3,1.0,1750,7800,1.0,0,0,4,7,1150,600,1956,0,98166,47.4596,-122.343,1750,7560,6050,5810,42.30128205128205,0.03343606557377049,Very Cheap
20150512T000000,135000.0,2,1.0,600,6120,1.0,0,0,3,5,600,0,1943,1989,98168,47.5,-122.317,1090,6120,5520,5030,22.058823529411764,0.007868852459016393,Very Cheap
20140620T000000,482500.0,4,3.0,1630,7626,1.0,0,0,5,7,1110,520,1990,0,98125,47.7168,-122.308,1630,8082,5996,6452,63.270390768423816,0.053442622950819675,Very Cheap
20140923T000000,259000.0,4,1.5,1260,7248,1.5,0,0,5,7,1260,0,1955,0,98188,47.433,-122.292,1300,7732,5988,6432,35.73399558498896,0.024131147540983607,Very Cheap
20141027T000000,210000.0,3,2.25,2140,9775,1.0,0,0,4,7,1470,670,1978,0,98023,47.306,-122.379,2050,8625,7635,6575,21.483375959079282,0.017704918032786884,Very Cheap
20141009T000000,459000.0,4,2.75,2790,6600,2.0,0,0,3,9,2790,0,2000,0,98058,47.4362,-122.109,2900,6752,3810,3852,69.54545454545455,0.050360655737704915,Very Cheap
20140701T000000,375000.0,3,1.75,2530,35150,1.0,0,0,4,7,1800,730,1977,0,98042,47.3913,-122.121,2460,36386,32620,33926,10.668563300142248,0.03934426229508197,Very Cheap
20141022T000000,295000.0,3,2.25,1330,7200,1.0,0,0,3,7,900,430,1974,0,98146,47.5102,-122.364,1380,9570,5870,8190,40.97222222222222,0.028852459016393443,Very Cheap
20140512T000000,910000.0,3,2.0,2700,6120,1.0,0,0,4,8,1350,1350,1962,0,98115,47.6731,-122.327,1700,4590,3420,2890,148.69281045751634,0.10950819672131147,Cheap
20141010T000000,470000.0,4,1.0,1740,37238,1.5,0,0,4,7,1740,0,1932,0,98024,47.5651,-121.902,1810,18352,35498,16542,12.62151565605027,0.05180327868852459,Very Cheap
20150220T000000,565000.0,4,2.0,2070,7980,1.5,0,0,4,7,2070,0,1940,0,98146,47.5092,-122.386,1600,7980,5910,6380,70.80200501253132,0.06426229508196721,Very Cheap
20141107T000000,339950.0,4,2.25,2670,9040,1.0,0,0,3,8,2170,500,1955,0,98148,47.4666,-122.326,1880,2648,6370,768,37.605088495575224,0.03474754098360656,Very Cheap
20150115T000000,547000.0,5,3.0,2200,103237,1.0,0,0,3,7,1160,1040,1971,0,98072,47.7726,-122.111,2300,103237,101037,100937,5.298487945213441,0.061901639344262294,Very Cheap
20140924T000000,125000.0,2,1.0,810,8382,1.0,0,0,4,5,810,0,1942,0,98146,47.5033,-122.358,1040,8382,7572,7342,14.912908613696015,0.006557377049180328,Very Cheap
20140701T000000,2300000.0,4,4.75,3970,9778,2.0,0,2,4,11,3390,580,1928,0,98119,47.6312,-122.366,3970,8460,5808,4490,235.22192677439148,0.29180327868852457,Cheap
20150430T000000,348000.0,3,2.5,2370,7500,1.0,0,3,3,8,1620,750,1979,0,98198,47.4091,-122.331,1960,8062,5130,6102,46.4,0.03580327868852459,Very Cheap
20150414T000000,175000.0,3,1.0,1460,11880,1.0,0,0,2,7,1460,0,1961,0,98030,47.3762,-122.219,1310,9315,10420,8005,14.73063973063973,0.013114754098360656,Very Cheap
20140502T000000,439950.0,3,2.5,1770,2875,2.0,0,0,3,8,1770,0,1990,0,98116,47.5631,-122.397,1770,3833,1105,2063,153.02608695652174,0.04786229508196721,Very Cheap
20150311T000000,230000.0,3,1.0,1120,32250,1.0,0,0,4,6,1120,0,1934,0,98070,47.447,-122.482,1010,335289,31130,334279,7.131782945736434,0.020327868852459016,Very Cheap
20140902T000000,207000.0,3,2.5,1520,2550,2.0,0,0,3,7,1520,0,2005,0,98108,47.5245,-122.33,1460,2550,1030,1090,81.17647058823529,0.017311475409836064,Very Cheap
20140602T000000,320000.0,5,2.5,3020,21441,1.0,0,0,4,8,1510,1510,1978,0,98042,47.3392,-122.131,1610,16445,18421,14835,14.924677020661349,0.032131147540983604,Very Cheap
20150406T000000,1089000.0,5,3.25,5600,107157,2.0,0,0,3,10,3440,2160,1988,0,98072,47.7341,-122.102,3470,75794,101557,72324,10.162658529074163,0.13298360655737704,Cheap
20140606T000000,510000.0,4,1.5,1320,14250,1.0,0,0,4,7,1320,0,1954,0,98033,47.7016,-122.199,1720,14250,12930,12530,35.78947368421053,0.057049180327868855,Very Cheap
20141031T000000,730000.0,4,1.0,1870,4992,1.5,0,0,4,7,1670,200,1940,0,98199,47.6437,-122.396,2160,5239,3122,3079,146.23397435897436,0.0859016393442623,Very Cheap
20140813T000000,750000.0,3,3.75,2460,7630,1.0,0,0,5,8,1940,520,1976,0,98177,47.7147,-122.373,2000,7326,5170,5326,98.2961992136304,0.08852459016393442,Very Cheap
20150410T000000,237000.0,3,1.5,960,7400,1.0,0,0,3,7,960,0,1962,0,98198,47.3798,-122.306,1640,8060,6440,6420,32.027027027027025,0.021245901639344263,Very Cheap
20140926T000000,560000.0,3,2.5,3440,103672,2.0,0,0,3,9,3440,0,1990,0,98038,47.3895,-121.986,2710,112820,100232,110110,5.401651361987808,0.06360655737704918,Very Cheap
20140714T000000,745000.0,3,2.75,3010,12432,1.0,0,0,4,8,1890,1120,1970,0,98052,47.6392,-122.108,2500,12432,9422,9932,59.92599742599742,0.08786885245901639,Very Cheap
20140815T000000,1825000.0,3,3.75,6030,39317,2.0,0,0,3,11,4440,1590,1991,0,98004,47.6055,-122.21,4040,12333,33287,8293,46.41758018160083,0.22950819672131148,Cheap
20140618T000000,180000.0,3,2.25,1990,6350,2.0,0,0,3,7,1990,0,1967,0,98198,47.3822,-122.316,1220,6250,4360,5030,28.346456692913385,0.01377049180327869,Very Cheap
20141113T000000,309950.0,3,2.25,1990,6350,2.0,0,0,3,7,1990,0,1967,0,98198,47.3822,-122.316,1220,6250,4360,5030,48.811023622047244,0.03081311475409836,Very Cheap
20150506T000000,715000.0,4,1.0,1710,6050,1.5,0,0,3,7,1410,300,1913,0,98118,47.5569,-122.288,1560,4950,4340,3390,118.18181818181819,0.0839344262295082,Very Cheap
20150427T000000,620000.0,4,2.25,1890,4300,1.5,0,0,3,7,1350,540,1918,0,98103,47.6649,-122.337,1830,3800,2410,1970,144.1860465116279,0.07147540983606557,Very Cheap
20141231T000000,330000.0,3,2.5,1990,9995,2.0,0,0,3,7,1990,0,1996,0,98198,47.383,-122.305,1680,7511,8005,5831,33.01650825412706,0.03344262295081967,Very Cheap
20150401T000000,525000.0,4,1.75,1600,7400,1.0,0,0,3,7,1210,390,1973,0,98125,47.7111,-122.309,1640,7500,5800,5860,70.94594594594595,0.05901639344262295,Very Cheap
20140607T000000,611000.0,6,2.5,3820,53173,1.0,0,0,4,9,2040,1780,1974,0,98027,47.5209,-122.052,2510,15314,49353,12804,11.490794200063942,0.07029508196721311,Very Cheap
20140612T000000,294000.0,4,2.5,2210,8465,1.0,0,0,3,8,1490,720,1990,0,98092,47.2647,-122.221,2210,7917,6255,5707,34.73124630832841,0.028721311475409836,Very Cheap
20150421T000000,463000.0,3,1.75,2020,11095,1.0,0,0,4,7,1480,540,1975,0,98034,47.7351,-122.183,2030,10710,9075,8680,41.730509238395676,0.05088524590163934,Very Cheap
20140714T000000,320900.0,3,2.0,1770,7251,1.0,0,0,4,8,1770,0,1990,0,98031,47.4087,-122.17,2560,7210,5481,4650,44.25596469452489,0.03224918032786885,Very Cheap
20141028T000000,369950.0,4,2.5,2050,4502,2.0,0,0,3,7,2050,0,2005,0,98059,47.5002,-122.15,2480,4504,2452,2024,82.17458907152377,0.03868196721311475,Very Cheap
20140616T000000,565000.0,4,2.75,3130,139392,2.0,0,0,4,9,3130,0,1981,0,98030,47.3535,-122.19,2720,104544,136262,101824,4.053317263544536,0.06426229508196721,Very Cheap
20150311T000000,589500.0,4,1.5,3520,4933,1.5,0,0,4,8,2270,1250,1929,0,98108,47.5655,-122.315,1710,5400,1413,3690,119.50131765659842,0.06747540983606558,Very Cheap
20140812T000000,400000.0,4,1.75,1810,9750,2.0,0,0,4,7,1810,0,1977,0,98155,47.7681,-122.311,1570,10000,7940,8430,41.02564102564103,0.04262295081967213,Very Cheap
20141022T000000,458000.0,3,2.25,2150,9900,1.0,0,0,3,8,1450,700,1977,0,98052,47.6647,-122.149,2170,9500,7750,7330,46.26262626262626,0.05022950819672131,Very Cheap
20141202T000000,436000.0,4,2.5,2495,5751,2.0,0,0,3,7,2495,0,2002,0,98019,47.7243,-121.957,2490,6300,3256,3810,75.81290210398191,0.047344262295081964,Very Cheap
20141002T000000,310000.0,3,2.0,1290,6150,1.0,0,1,5,6,1290,0,1950,0,98118,47.5181,-122.257,1960,6150,4860,4190,50.40650406504065,0.03081967213114754,Very Cheap
20141023T000000,398000.0,5,2.5,3004,5700,2.0,0,0,3,9,3004,0,2006,0,98030,47.3801,-122.185,2665,5700,2696,3035,69.82456140350877,0.042360655737704915,Very Cheap
20140815T000000,625000.0,4,2.25,2070,7200,1.0,0,0,5,8,1390,680,1977,0,98033,47.697,-122.169,2110,8400,5130,6290,86.80555555555556,0.07213114754098361,Very Cheap
20141216T000000,1005000.0,5,3.25,4050,35600,2.0,0,0,3,12,4050,0,1990,0,98006,47.5465,-122.122,4770,33880,31550,29110,28.230337078651687,0.1219672131147541,Cheap
20150413T000000,435000.0,2,1.0,960,6250,1.0,0,0,4,6,740,220,1940,0,98126,47.5378,-122.375,1090,6000,5290,4910,69.6,0.04721311475409836,Very Cheap
20150313T000000,250000.0,3,2.25,1900,9990,1.0,0,0,3,7,1300,600,1961,0,98003,47.3478,-122.298,1900,9990,8090,8090,25.025025025025027,0.022950819672131147,Very Cheap
20150317T000000,430000.0,3,1.5,1450,7316,1.0,0,0,3,7,1450,0,1961,0,98133,47.7725,-122.349,1440,7316,5866,5876,58.77528704209951,0.04655737704918033,Very Cheap
20140812T000000,790000.0,4,3.5,2720,3000,2.0,0,0,3,9,2250,470,2014,0,98136,47.5371,-122.388,1600,4600,280,3000,263.3333333333333,0.09377049180327869,Very Cheap
20140709T000000,1681000.0,5,5.25,4830,18707,2.0,0,1,5,9,3930,900,1952,1998,98040,47.5858,-122.247,2880,10520,13877,7640,89.85941091570001,0.21062295081967214,Cheap
20150407T000000,250000.0,4,2.75,1920,7102,1.0,0,0,3,7,1130,790,1992,0,98106,47.539,-122.356,1830,6440,5182,4610,35.201351731906506,0.022950819672131147,Very Cheap
20140613T000000,1120000.0,5,1.5,2540,6660,2.0,0,3,4,8,2340,200,1954,0,98136,47.5144,-122.393,2460,9000,4120,6540,168.16816816816817,0.13704918032786886,Cheap
20150427T000000,383900.0,3,1.5,1600,8040,1.0,0,0,4,7,1050,550,1965,0,98133,47.7471,-122.337,1810,7819,6440,6009,47.74875621890547,0.040511475409836066,Very Cheap
20150326T000000,330000.0,4,2.5,2210,5929,2.0,0,0,3,8,2210,0,2004,0,98042,47.35,-122.139,2200,5901,3719,3701,55.65862708719852,0.03344262295081967,Very Cheap
20140915T000000,624000.0,3,2.5,2510,47044,1.0,0,0,4,7,1910,600,1975,0,98072,47.7531,-122.14,2510,42803,44534,40293,13.264178216138083,0.072,Very Cheap
20150211T000000,383000.0,5,2.0,2280,5750,1.0,0,0,4,8,1140,1140,1951,0,98116,47.5672,-122.39,1780,5750,3470,3970,66.6086956521739,0.04039344262295082,Very Cheap
20140602T000000,687000.0,4,3.25,4400,186846,2.0,0,0,4,9,4400,0,1993,0,98022,47.1593,-121.957,2280,186846,182446,184566,3.676824764779551,0.08026229508196721,Very Cheap
20150309T000000,558000.0,4,3.25,3160,8876,2.0,0,0,3,9,2460,700,1997,0,98056,47.5153,-122.178,2900,10000,5716,7100,62.86615592609284,0.06334426229508197,Very Cheap
20140905T000000,275000.0,3,2.0,1380,3500,2.0,0,0,3,7,1380,0,1971,0,98118,47.5558,-122.27,1620,3900,2120,2280,78.57142857142857,0.02622950819672131,Very Cheap
20140728T000000,687500.0,5,2.75,3320,10500,1.0,0,0,4,7,2020,1300,1963,0,98033,47.692,-122.166,1840,10425,7180,8585,65.47619047619048,0.08032786885245902,Very Cheap
20140728T000000,275000.0,3,2.5,1870,6821,2.0,0,0,3,7,1870,0,1989,0,98023,47.3065,-122.358,1970,6821,4951,4851,40.31666911010116,0.02622950819672131,Very Cheap
20141211T000000,700000.0,3,3.5,3030,11550,2.0,0,2,3,8,3030,0,1971,2011,98146,47.5051,-122.381,2340,10560,8520,8220,60.60606060606061,0.08196721311475409,Very Cheap
20140624T000000,342500.0,2,1.75,1210,7507,1.0,0,0,3,7,1210,0,1982,0,98034,47.7078,-122.234,1840,7500,6297,5660,45.62408418809112,0.035081967213114754,Very Cheap
20140506T000000,483500.0,4,2.5,2740,45732,2.0,0,0,3,8,2740,0,1995,0,98077,47.74,-122.048,2080,43560,42992,41480,10.572465669553049,0.05357377049180328,Very Cheap
20140801T000000,190000.0,3,1.75,1350,7370,1.0,0,0,4,6,1350,0,1912,0,98118,47.5336,-122.278,1440,6000,6020,4560,25.780189959294436,0.015081967213114755,Very Cheap
20150318T000000,300000.0,3,1.75,1350,7370,1.0,0,0,4,6,1350,0,1912,0,98118,47.5336,-122.278,1440,6000,6020,4560,40.70556309362279,0.029508196721311476,Very Cheap
20140521T000000,540000.0,3,2.0,1470,1691,2.0,0,0,3,8,1000,470,2007,0,98115,47.6743,-122.316,1660,4000,221,2340,319.337670017741,0.06098360655737705,Very Cheap
20150211T000000,140000.0,3,1.75,1270,8991,2.0,0,0,3,7,1270,0,1981,0,98042,47.3563,-122.149,1270,8993,7721,7723,15.571126682237793,0.008524590163934427,Very Cheap
20150413T000000,275000.0,4,1.75,1680,19405,1.0,0,0,4,7,1560,120,1959,0,98055,47.4552,-122.202,2000,12900,17725,10900,14.171605256377223,0.02622950819672131,Very Cheap
20140825T000000,370000.0,3,2.75,2120,7650,1.0,0,0,4,7,2120,0,1958,0,98056,47.4923,-122.178,1180,7650,5530,6470,48.36601307189542,0.038688524590163934,Very Cheap
20150325T000000,227000.0,2,1.0,1040,9100,1.0,0,0,4,7,1040,0,1937,0,98133,47.7407,-122.347,1950,13228,8060,11278,24.945054945054945,0.019934426229508195,Very Cheap
20150128T000000,312000.0,4,1.0,1730,8706,1.0,0,0,4,7,1010,720,1962,0,98058,47.4586,-122.175,1369,8418,6976,7049,35.83735354927636,0.031081967213114754,Very Cheap
20141003T000000,260000.0,2,1.0,1410,5650,1.5,0,0,3,6,1410,0,1918,0,98118,47.5159,-122.258,1430,5650,4240,4220,46.017699115044245,0.024262295081967214,Very Cheap
20140710T000000,797000.0,3,2.5,1370,1911,2.0,0,0,3,9,1370,0,1907,2011,98109,47.6375,-122.354,1630,2090,541,460,417.05913134484564,0.09468852459016393,Very Cheap
20141017T000000,640000.0,6,2.0,2840,228690,1.5,0,0,3,6,2720,120,1948,0,98019,47.7158,-121.966,2330,228690,225850,226360,2.7985482530937076,0.0740983606557377,Very Cheap
20150213T000000,605000.0,4,1.75,3280,35160,1.0,0,0,3,7,2080,1200,1976,0,98053,47.6728,-122.061,2510,31331,31880,28821,17.207053469852106,0.06950819672131148,Very Cheap
20150302T000000,329950.0,3,2.25,2070,7995,1.0,0,0,3,7,1350,720,1987,0,98031,47.403,-122.175,1620,6799,5925,5179,41.26954346466542,0.03343606557377049,Very Cheap
20141212T000000,180000.0,2,1.0,960,87991,1.5,0,0,3,5,960,0,1946,0,98014,47.63,-121.9,1940,392040,87031,390100,2.0456637610664727,0.01377049180327869,Very Cheap
20140813T000000,220000.0,3,2.25,1470,7518,1.0,0,0,3,7,1160,310,1985,0,98003,47.2725,-122.3,1720,8300,6048,6580,29.263101888800215,0.01901639344262295,Very Cheap
20140702T000000,723000.0,4,2.25,2430,4748,1.5,0,0,3,8,1630,800,1928,0,98116,47.5904,-122.389,2430,4748,2318,2318,152.27464195450716,0.08498360655737705,Very Cheap
20150116T000000,375000.0,3,1.75,1430,8412,1.0,0,0,4,7,1070,360,1928,0,98125,47.7218,-122.299,1490,8410,6982,6920,44.57917261055635,0.03934426229508197,Very Cheap
20150126T000000,388000.0,3,1.75,1760,9277,1.0,0,0,4,7,1760,0,1962,0,98146,47.4977,-122.358,1760,7650,7517,5890,41.82386547375229,0.041049180327868855,Very Cheap
20141031T000000,249950.0,5,2.0,1730,7375,1.0,0,0,4,6,1730,0,1944,0,98178,47.4953,-122.238,1550,7125,5645,5575,33.891525423728815,0.022944262295081966,Very Cheap
20141106T000000,390000.0,5,1.75,2290,7900,1.0,0,0,4,7,1190,1100,1965,0,98133,47.7577,-122.358,1870,8250,5610,6380,49.36708860759494,0.04131147540983607,Very Cheap
20140917T000000,705000.0,4,1.75,1690,11739,1.0,0,0,4,8,1690,0,1959,0,98040,47.552,-122.219,2300,11600,10049,9300,60.05622284692052,0.08262295081967214,Very Cheap
20140623T000000,590000.0,4,2.5,3220,7875,1.5,0,0,4,8,3220,0,1966,0,98008,47.626,-122.12,1600,7875,4655,6275,74.92063492063492,0.06754098360655737,Very Cheap
20141010T000000,292000.0,4,1.75,2130,11097,1.0,0,0,3,7,1370,760,1952,0,98166,47.4629,-122.356,1850,11097,8967,9247,26.31341804091196,0.028459016393442622,Very Cheap
20140805T000000,506000.0,3,2.5,2100,213008,1.0,0,0,3,8,2100,0,1990,0,98092,47.2984,-122.144,1330,214315,210908,212985,2.3754976338916847,0.05652459016393443,Very Cheap
20140604T000000,907500.0,4,2.5,2770,8642,2.0,0,0,4,9,2770,0,1987,0,98007,47.6599,-122.146,2670,9000,5872,6330,105.01041425595926,0.10918032786885246,Cheap
20140702T000000,2271150.0,4,3.25,4040,18916,1.0,0,0,4,9,4040,0,1954,0,98039,47.6155,-122.238,3000,18831,14876,15831,120.06502431803764,0.28801967213114754,Cheap
20141014T000000,319500.0,4,2.75,2500,5100,1.5,0,0,4,7,1420,1080,1907,0,98108,47.523,-122.332,1430,5100,2600,3670,62.64705882352941,0.0320655737704918,Very Cheap
20150223T000000,265000.0,5,1.75,1580,5292,1.0,0,0,3,6,980,600,1913,0,98118,47.5677,-122.29,1600,2976,3712,1376,50.0755857898715,0.024918032786885248,Very Cheap
20140605T000000,237000.0,3,1.0,1130,10650,1.0,0,0,3,7,1130,0,1954,0,98188,47.4363,-122.286,1320,10650,9520,9330,22.253521126760564,0.021245901639344263,Very Cheap
20140910T000000,235000.0,5,1.0,1500,9282,1.5,0,0,5,6,1500,0,1966,0,98168,47.4702,-122.281,1520,9639,7782,8119,25.317819435466493,0.02098360655737705,Very Cheap
20150330T000000,740000.0,4,2.25,2230,6000,1.5,0,2,3,8,1810,420,1928,0,98199,47.6464,-122.391,2840,6000,3770,3160,123.33333333333333,0.08721311475409836,Very Cheap
20140709T000000,359000.0,3,1.5,1550,4980,1.0,0,0,3,7,1080,470,1978,0,98133,47.7035,-122.34,940,4980,3430,4040,72.08835341365462,0.03724590163934426,Very Cheap
20150213T000000,334950.0,4,2.5,2230,5500,2.0,0,0,3,7,2230,0,1999,0,98038,47.3533,-122.023,1910,5500,3270,3590,60.9,0.03409180327868853,Very Cheap
20140929T000000,259950.0,2,1.0,790,8100,1.0,0,0,3,6,790,0,1947,0,98125,47.7159,-122.305,1420,8100,7310,6680,32.092592592592595,0.024255737704918033,Very Cheap
20140514T000000,253000.0,4,2.5,2230,4541,2.0,0,0,3,7,2230,0,2006,0,98042,47.3848,-122.1,2800,4860,2311,2060,55.71460030830214,0.023344262295081967,Very Cheap
20140612T000000,561000.0,3,2.25,1710,4140,2.0,0,0,3,8,1710,0,2004,0,98029,47.5498,-121.997,1730,3680,2430,1950,135.5072463768116,0.06373770491803278,Very Cheap
20150325T000000,455000.0,2,1.5,1260,5100,1.0,0,0,3,7,1260,0,1941,0,98115,47.6914,-122.288,1640,5100,3840,3460,89.2156862745098,0.049836065573770495,Very Cheap
20150406T000000,675000.0,4,2.5,2420,18470,1.0,0,0,3,8,920,1500,1968,0,98005,47.6001,-122.176,2690,13800,16050,11110,36.54574986464537,0.07868852459016394,Very Cheap
20140626T000000,267000.0,3,1.5,1090,8160,1.0,0,0,3,7,1090,0,1967,2014,98058,47.4551,-122.175,1260,7560,7070,6300,32.720588235294116,0.025180327868852458,Very Cheap
20141106T000000,368000.0,4,2.5,2689,5724,2.0,0,0,3,9,2689,0,2006,0,98030,47.3799,-122.184,2665,5700,3035,3035,64.29070580013976,0.03842622950819672,Very Cheap
20141123T000000,599995.0,3,1.0,1620,3000,1.5,0,0,5,7,1620,0,1928,0,98103,47.6888,-122.347,1420,3060,1380,1640,199.99833333333333,0.06885180327868852,Very Cheap
20140917T000000,342500.0,3,1.0,940,10500,1.0,0,0,4,7,940,0,1966,0,98034,47.7268,-122.229,1660,10500,9560,8840,32.61904761904762,0.035081967213114754,Very Cheap
20141118T000000,252000.0,4,1.75,1940,13370,1.0,0,0,4,8,1940,0,1974,0,98023,47.3215,-122.369,2405,11769,11430,9364,18.848167539267017,0.02321311475409836,Very Cheap
20140716T000000,247200.0,3,1.0,1590,11200,1.0,0,0,4,7,1590,0,1961,0,98092,47.2894,-122.188,1560,9750,9610,8190,22.071428571428573,0.02258360655737705,Very Cheap
20140506T000000,910000.0,3,3.5,3020,4082,2.0,0,0,3,9,2080,940,1954,2004,98199,47.651,-122.409,2060,5102,1062,3042,222.9299363057325,0.10950819672131147,Cheap
20150105T000000,419950.0,4,1.75,1870,16549,1.0,0,0,3,8,1870,0,1969,0,98072,47.7482,-122.083,1870,10804,14679,8934,25.376155658952204,0.04523934426229508,Very Cheap
20150226T000000,160000.0,3,1.0,880,8976,1.0,0,0,4,6,880,0,1966,0,98023,47.3056,-122.368,990,8760,8096,7770,17.825311942959,0.011147540983606558,Very Cheap
20140922T000000,799950.0,4,3.5,3030,5494,3.0,0,0,3,9,3030,0,2014,0,98052,47.7103,-122.109,2910,5314,2464,2404,145.60429559519477,0.09507540983606558,Very Cheap
20140617T000000,400000.0,3,2.25,2140,11266,2.0,0,0,3,7,2140,0,1986,0,98019,47.7267,-121.966,2000,14174,9126,12174,35.505059470974615,0.04262295081967213,Very Cheap
20140505T000000,210000.0,5,2.0,2050,10200,1.0,0,0,3,6,1430,620,1956,0,98198,47.4136,-122.333,1940,8625,8150,6685,20.58823529411765,0.017704918032786884,Very Cheap
20150313T000000,475000.0,5,2.0,2050,10200,1.0,0,0,3,6,1430,620,1956,0,98198,47.4136,-122.333,1940,8625,8150,6685,46.568627450980394,0.05245901639344262,Very Cheap
20150504T000000,355900.0,3,2.5,2090,3821,2.0,0,0,3,7,2090,0,2008,0,98038,47.3655,-122.017,2040,4200,1731,2160,93.14315624182152,0.036839344262295085,Very Cheap
20150120T000000,420000.0,3,2.25,2520,26943,1.0,0,0,3,7,1760,760,1977,0,98028,47.7728,-122.25,2300,10004,24423,7704,15.58846453624318,0.04524590163934426,Very Cheap
20140825T000000,710000.0,4,2.5,2630,8580,1.0,0,0,4,9,1700,930,1977,0,98005,47.5916,-122.166,2430,10240,5950,7810,82.75058275058275,0.08327868852459017,Very Cheap
20150407T000000,518000.0,4,1.75,2560,15000,1.0,0,0,3,7,1880,680,1974,0,98075,47.5952,-122.053,2210,15150,12440,12940,34.53333333333333,0.0580983606557377,Very Cheap
20141016T000000,375000.0,3,1.0,1200,5404,1.0,0,0,3,6,1200,0,1937,0,98117,47.6969,-122.368,1200,5987,4204,4787,69.39304219096965,0.03934426229508197,Very Cheap
20141107T000000,185000.0,3,1.5,1010,7755,1.0,0,0,3,6,1010,0,1953,0,98148,47.4238,-122.332,1270,8350,6745,7080,23.855577047066408,0.014426229508196721,Very Cheap
20140829T000000,402000.0,3,2.5,1520,3425,2.0,0,0,3,7,1520,0,1986,0,98052,47.6801,-122.161,1640,3425,1905,1785,117.37226277372262,0.04288524590163934,Very Cheap
20140829T000000,585000.0,3,1.75,2170,153767,1.0,0,0,3,7,2170,0,1976,0,98042,47.3694,-122.065,2840,49500,151597,46660,3.804457393328868,0.06688524590163934,Very Cheap
20150122T000000,500000.0,4,2.0,1980,4500,2.0,0,0,4,7,1980,0,1910,0,98107,47.6728,-122.379,1550,2541,2520,991,111.11111111111111,0.05573770491803279,Very Cheap
20141223T000000,1715000.0,4,2.5,3070,7207,2.0,0,0,4,10,2670,400,1927,0,98112,47.6325,-122.29,3190,7523,4137,4333,237.96309143887888,0.21508196721311476,Cheap
20141001T000000,1680000.0,5,3.5,5170,7197,3.0,1,4,3,11,3520,1650,1998,0,98155,47.7561,-122.271,3020,12880,2027,9860,233.4305960817007,0.21049180327868852,Cheap
20150212T000000,570000.0,2,2.0,1140,690,2.0,0,0,3,8,760,380,2014,0,98112,47.6205,-122.3,1480,1171,-450,-309,826.0869565217391,0.06491803278688525,Very Cheap
20140814T000000,680000.0,8,2.75,2530,4800,2.0,0,0,4,7,1390,1140,1901,0,98112,47.6241,-122.305,1540,4800,2270,3260,141.66666666666666,0.07934426229508197,Very Cheap
20141209T000000,345000.0,3,2.25,1690,14615,2.0,0,0,4,7,1690,0,1979,0,98045,47.4492,-121.78,1390,11360,12925,9970,23.605884365378035,0.03540983606557377,Very Cheap
20150422T000000,355000.0,4,2.5,2150,3600,2.0,0,0,3,7,2150,0,2010,0,98038,47.3658,-122.019,2220,3915,1450,1695,98.61111111111111,0.036721311475409836,Very Cheap
20140922T000000,390000.0,3,1.5,1180,7700,1.0,0,0,4,7,1180,0,1959,0,98007,47.6133,-122.133,1510,8800,6520,7290,50.64935064935065,0.04131147540983607,Very Cheap
20150428T000000,128000.0,3,1.0,1400,9690,1.0,0,0,3,7,1400,0,1969,0,98023,47.3201,-122.398,1280,9600,8290,8320,13.209494324045407,0.006950819672131147,Very Cheap
20140826T000000,448500.0,3,1.75,1300,4800,2.0,0,1,4,7,1300,0,1912,0,98136,47.5457,-122.383,1300,4800,3500,3500,93.4375,0.048983606557377046,Very Cheap
20141109T000000,346000.0,3,1.75,1590,9636,1.5,0,0,4,6,1590,0,1953,0,98155,47.754,-122.321,1800,9975,8046,8175,35.90701535907015,0.03554098360655738,Very Cheap
20140903T000000,779000.0,3,1.75,1990,5600,1.0,0,1,3,8,1330,660,1941,0,98199,47.65,-122.415,2630,6780,3610,4150,139.10714285714286,0.09232786885245901,Very Cheap
20150203T000000,335000.0,3,1.75,1510,9720,1.0,0,0,3,7,1510,0,1948,1976,98028,47.7728,-122.258,1520,10037,8210,8517,34.465020576131685,0.03409836065573771,Very Cheap
20140911T000000,1850000.0,4,3.25,2910,1880,2.0,0,3,5,9,1830,1080,1914,0,98122,47.616,-122.282,3100,8200,-1030,5100,984.0425531914893,0.23278688524590163,Cheap
20150218T000000,799990.0,3,2.5,2850,21780,2.0,0,0,3,10,2850,0,1994,0,98053,47.6455,-122.04,3020,21798,18930,18778,36.73048668503214,0.09508065573770492,Very Cheap
20141010T000000,1075000.0,3,2.5,2830,56628,2.0,0,0,3,11,2830,0,2001,0,98011,47.7409,-122.198,2830,16430,53798,13600,18.98354171081444,0.13114754098360656,Cheap
20140822T000000,371000.0,2,1.5,1110,1189,3.0,0,0,3,8,1110,0,2000,0,98107,47.6711,-122.377,1420,1311,79,-109,312.026913372582,0.038819672131147544,Very Cheap
20141027T000000,620000.0,4,2.5,1900,9775,1.0,0,0,5,7,1900,0,1967,0,98033,47.6856,-122.168,1990,10500,7875,8510,63.42710997442455,0.07147540983606557,Very Cheap
20140515T000000,343000.0,4,1.75,2290,10290,1.0,0,0,3,7,1340,950,1960,0,98146,47.5045,-122.369,1800,7605,8000,5805,33.333333333333336,0.035147540983606555,Very Cheap
20141014T000000,265000.0,3,1.0,1010,14948,1.0,0,0,5,6,1010,0,1969,0,98059,47.4772,-122.144,1510,9600,13938,8090,17.728124163767728,0.024918032786885248,Very Cheap
20140804T000000,1000000.0,5,2.5,4670,15857,2.0,0,0,3,11,4670,0,1998,0,98074,47.63,-122.011,3810,14824,11187,11014,63.06363120388472,0.12131147540983607,Cheap
20141006T000000,825000.0,3,2.5,3400,38400,1.0,0,4,3,8,1870,1530,1955,2015,98177,47.7611,-122.372,3400,24338,35000,20938,21.484375,0.09836065573770492,Very Cheap
20150414T000000,889000.0,4,3.5,4070,10976,2.0,0,0,3,10,4070,0,2004,0,98075,47.5805,-121.97,4080,10106,6906,6026,80.99489795918367,0.10675409836065573,Cheap
20150415T000000,305000.0,3,2.25,1630,10962,1.0,0,0,4,8,1100,530,1977,0,98030,47.3801,-122.166,1830,8470,9332,6640,27.823389892355408,0.03016393442622951,Very Cheap
20141030T000000,407000.0,2,2.5,1700,6635,2.0,0,0,4,8,1700,0,1976,0,98052,47.6655,-122.13,1700,6635,4935,4935,61.3413715146948,0.04354098360655738,Very Cheap
20140603T000000,613000.0,5,2.5,2070,12000,1.0,0,0,4,7,1340,730,1967,0,98008,47.626,-122.104,2090,12000,9930,9910,51.083333333333336,0.07055737704918033,Very Cheap
20141201T000000,1637500.0,3,3.5,4660,21164,2.0,1,4,3,12,4660,0,1975,1990,98166,47.4418,-122.354,3140,24274,16504,21134,77.37195237195237,0.20491803278688525,Cheap
20150210T000000,645000.0,3,3.75,2050,6000,2.0,0,0,5,7,1550,500,1910,0,98103,47.6873,-122.332,1780,4000,3950,2220,107.5,0.07475409836065573,Very Cheap
20140618T000000,1160000.0,4,3.5,4680,9700,2.0,0,0,3,10,3360,1320,2005,0,98006,47.5703,-122.165,2800,12343,5020,9543,119.58762886597938,0.1422950819672131,Cheap
20140929T000000,610000.0,3,2.25,2320,38186,2.0,0,0,3,8,2320,0,1980,0,98053,47.6645,-122.068,2875,37523,35866,34648,15.97444089456869,0.07016393442622951,Very Cheap
20150318T000000,450000.0,3,2.5,3800,13071,2.0,0,0,3,10,2730,1070,1994,0,98023,47.3076,-122.397,2980,11110,9271,8130,34.42735827404177,0.04918032786885246,Very Cheap
20140728T000000,300000.0,3,2.0,720,7598,1.0,0,0,5,6,720,0,1947,0,98106,47.5483,-122.36,1080,7209,6878,6129,39.48407475651487,0.029508196721311476,Very Cheap
20140606T000000,1120000.0,5,2.75,4400,18500,1.0,0,3,5,9,2250,2150,1963,0,98028,47.7424,-122.263,3290,19257,14100,15967,60.54054054054054,0.13704918032786886,Cheap
20150224T000000,418200.0,3,2.5,2260,74297,2.0,0,0,3,9,2260,0,1992,0,98022,47.2704,-122.013,3110,98000,72037,94890,5.628760246039544,0.04500983606557377,Very Cheap
20140828T000000,250000.0,3,2.5,1650,2802,2.0,0,0,3,7,1650,0,2004,0,98055,47.4328,-122.196,1490,2084,1152,594,89.22198429693077,0.022950819672131147,Very Cheap
20140825T000000,619000.0,3,2.5,2560,43608,2.0,0,0,3,9,2560,0,2002,0,98077,47.7614,-122.026,3000,54088,41048,51088,14.194643184736746,0.07134426229508196,Very Cheap
20140630T000000,500000.0,4,3.0,3720,15048,3.0,0,0,3,7,3720,0,1979,2014,98059,47.5116,-122.144,2020,15180,11328,13160,33.22700691121744,0.05573770491803279,Very Cheap
20141107T000000,465000.0,4,2.5,2590,16437,2.0,0,0,3,8,2590,0,1986,0,98038,47.3714,-122.059,2320,15625,13847,13305,28.28983391129768,0.051147540983606556,Very Cheap
20141212T000000,322000.0,4,1.0,1750,68841,1.0,0,0,3,7,1750,0,1942,0,98058,47.4442,-122.081,1550,32799,67091,31249,4.677445127177118,0.03239344262295082,Very Cheap
20150128T000000,276900.0,3,2.5,1620,7320,2.0,0,0,3,7,1620,0,1989,0,98038,47.3617,-122.054,1550,7686,5700,6136,37.82786885245902,0.026478688524590163,Very Cheap
20150318T000000,660000.0,3,2.25,1700,12615,1.0,0,0,4,7,1300,400,1990,0,98033,47.6965,-122.197,1950,13163,10915,11213,52.318668252080855,0.07672131147540984,Very Cheap
20141029T000000,480000.0,3,2.5,2450,28185,2.0,0,0,3,9,2450,0,1990,0,98058,47.4665,-122.122,2440,33541,25735,31101,17.03033528472592,0.05311475409836065,Very Cheap
20150408T000000,925000.0,3,1.75,1610,10796,1.0,0,0,3,7,1070,540,1951,0,98004,47.6272,-122.208,1940,10796,9186,8856,85.67988143756946,0.11147540983606558,Cheap
20140724T000000,825000.0,3,3.0,3730,35900,1.0,0,0,3,9,2960,770,1979,0,98008,47.5814,-122.122,2280,16026,32170,13746,22.98050139275766,0.09836065573770492,Very Cheap
20150318T000000,326000.0,2,1.0,1210,7440,1.0,0,0,3,6,780,430,1940,0,98155,47.7376,-122.322,1070,7440,6230,6370,43.81720430107527,0.032918032786885244,Very Cheap
20150421T000000,205000.0,3,1.0,1300,9880,1.0,0,0,4,7,1300,0,1959,0,98003,47.3352,-122.297,2140,9600,8580,7460,20.748987854251013,0.017049180327868854,Very Cheap
20140724T000000,150000.0,2,1.0,850,54000,1.5,0,0,1,4,850,0,1950,0,98023,47.2959,-122.377,1550,14440,53150,12890,2.7777777777777777,0.009836065573770493,Very Cheap
20150429T000000,593567.0,3,2.5,1770,3205,2.0,0,0,3,9,1770,0,2005,0,98052,47.6658,-122.084,2120,4134,1435,2014,185.2003120124805,0.0680087868852459,Very Cheap
20140814T000000,440000.0,3,2.5,2060,11231,2.0,0,0,3,8,2060,0,1987,0,98072,47.7571,-122.141,2140,10224,9171,8084,39.17727717923604,0.04786885245901639,Very Cheap
20140716T000000,751000.0,3,2.5,3090,13316,2.0,0,0,3,10,3090,0,1992,0,98075,47.588,-122.079,2980,14437,10226,11457,56.39831781315711,0.08865573770491804,Very Cheap
20140909T000000,295000.0,2,1.75,1050,6500,1.5,0,2,4,6,1050,0,1925,0,98055,47.4727,-122.2,1320,10075,5450,8755,45.38461538461539,0.028852459016393443,Very Cheap
20140904T000000,422500.0,3,2.0,1300,2250,2.0,0,0,3,7,1300,0,1988,0,98103,47.6923,-122.332,1300,4500,950,3200,187.77777777777777,0.04557377049180328,Very Cheap
20141201T000000,480000.0,3,1.0,1160,8800,1.0,0,0,4,7,1160,0,1959,0,98008,47.6112,-122.128,1750,8400,7640,6650,54.54545454545455,0.05311475409836065,Very Cheap
20140725T000000,890900.0,4,2.5,3420,6233,2.0,0,0,3,9,3420,0,2006,0,98027,47.5416,-121.998,3350,5000,2813,1650,142.9327771538585,0.10700327868852459,Cheap
20140529T000000,672500.0,4,2.75,2620,6707,2.0,0,0,3,9,2620,0,2000,0,98075,47.5965,-122.038,2590,6530,4087,3940,100.26837632324437,0.07836065573770491,Very Cheap
20141010T000000,605000.0,4,1.5,1880,3500,1.0,0,0,4,7,1080,800,1926,0,98103,47.6835,-122.347,1690,3500,1620,1810,172.85714285714286,0.06950819672131148,Very Cheap
20150317T000000,1675000.0,5,3.25,4560,19080,1.0,0,0,5,9,2490,2070,1963,0,98004,47.6291,-122.226,3390,20140,14520,16750,87.78825995807128,0.2098360655737705,Cheap
20140926T000000,565000.0,4,2.5,2330,7936,2.0,0,0,3,9,2330,0,1987,0,98074,47.6269,-122.03,2460,8137,5606,5677,71.1945564516129,0.06426229508196721,Very Cheap
20150506T000000,725000.0,4,1.75,2350,7574,1.0,0,0,3,8,1720,630,1979,0,98027,47.5634,-122.087,2220,8496,5224,6276,95.7222075521521,0.08524590163934426,Very Cheap
20140731T000000,640000.0,3,3.0,1560,1466,3.0,0,0,3,8,1560,0,2006,0,98103,47.6604,-122.352,1530,2975,-94,1445,436.56207366984995,0.0740983606557377,Very Cheap
20150226T000000,253750.0,4,1.0,1380,7110,1.5,0,0,3,6,1380,0,1939,0,98030,47.3846,-122.226,1430,7110,5730,5680,35.68917018284107,0.023442622950819673,Very Cheap
20140714T000000,799950.0,6,2.75,3040,36721,1.0,0,3,4,9,1760,1280,1958,0,98166,47.4488,-122.356,2420,21075,33681,18655,21.784537458130224,0.09507540983606558,Very Cheap
20140716T000000,595000.0,4,1.5,1350,8113,1.0,0,0,4,7,1350,0,1959,0,98004,47.5807,-122.196,1930,8113,6763,6183,73.3390854184642,0.06819672131147542,Very Cheap
20140929T000000,850000.0,4,2.5,3180,11652,2.0,0,1,3,9,3180,0,1977,0,98040,47.567,-122.212,3110,15183,8472,12073,72.94884998283557,0.10163934426229508,Cheap
20141002T000000,366000.0,3,2.5,1790,4065,2.0,0,0,3,8,1790,0,2009,0,98019,47.7344,-121.965,2480,4252,2275,1772,90.03690036900369,0.03816393442622951,Very Cheap
20140922T000000,715000.0,4,3.0,1986,6000,2.0,0,2,4,8,1746,240,1922,0,98136,47.5374,-122.39,1930,6200,4014,4270,119.16666666666667,0.0839344262295082,Very Cheap
20141211T000000,300000.0,4,2.5,2400,7215,2.0,0,0,3,8,2400,0,1992,0,98023,47.2944,-122.371,2220,7760,4815,5540,41.58004158004158,0.029508196721311476,Very Cheap
20140603T000000,960000.0,4,3.0,4590,9150,2.0,0,0,3,10,3490,1100,1981,0,98177,47.7234,-122.372,2910,12348,4560,9438,104.91803278688525,0.1160655737704918,Cheap
20150401T000000,812000.0,3,2.0,1970,3420,2.0,0,3,5,8,1970,0,1913,0,98103,47.6762,-122.354,1770,3420,1450,1650,237.42690058479533,0.09665573770491803,Very Cheap
20140509T000000,234950.0,3,1.0,1360,9948,1.0,0,0,3,6,1360,0,1977,0,98010,47.3422,-122.053,1670,8475,8588,6805,23.617812625653396,0.02097704918032787,Very Cheap
20140612T000000,656500.0,4,2.0,2710,4750,1.0,0,0,4,7,1460,1250,1919,0,98115,47.6756,-122.305,1700,3800,2040,2100,138.21052631578948,0.07626229508196722,Very Cheap
20140703T000000,255000.0,2,1.5,920,1598,2.0,0,0,3,7,920,0,1995,0,98133,47.7081,-122.342,1110,1598,678,488,159.5744680851064,0.02360655737704918,Very Cheap
20141204T000000,538000.0,3,2.75,2000,7204,1.0,0,0,5,7,1250,750,1960,0,98006,47.565,-122.116,2480,17633,5204,15153,74.68073292615213,0.06072131147540984,Very Cheap
20140701T000000,260000.0,3,2.25,1920,9680,1.0,0,0,4,7,1300,620,1961,0,98031,47.412,-122.195,1500,9516,7760,8016,26.859504132231404,0.024262295081967214,Very Cheap
20141027T000000,546200.0,3,2.5,2678,6607,2.0,0,0,3,9,2678,0,1998,0,98028,47.738,-122.235,2780,6607,3929,3827,82.66989556530952,0.06179672131147541,Very Cheap
20150419T000000,280500.0,3,1.0,1220,4541,1.0,0,0,3,7,890,330,1952,0,98108,47.5387,-122.294,1670,3429,3321,1759,61.77053512442193,0.026950819672131147,Very Cheap
20140811T000000,295000.0,3,1.75,1440,4000,1.0,0,0,4,7,1050,390,1979,0,98106,47.5329,-122.354,1560,4000,2560,2440,73.75,0.028852459016393443,Very Cheap
20141022T000000,700000.0,4,1.75,2420,520,1.5,0,0,3,7,2420,0,1900,0,98112,47.6209,-122.302,1200,1170,-1900,-30,1346.1538461538462,0.08196721311475409,Very Cheap
20141120T000000,560000.0,3,2.0,2090,15790,1.0,0,0,3,9,2090,0,1992,0,98034,47.7296,-122.199,1820,8770,13700,6950,35.46548448385054,0.06360655737704918,Very Cheap
20150401T000000,912000.0,4,2.75,4030,10888,2.0,0,0,3,10,4030,0,1997,0,98075,47.5651,-122.034,3720,10756,6858,7036,83.76193975018369,0.10977049180327869,Cheap
20140508T000000,437000.0,3,1.75,1310,9282,1.0,0,0,4,7,1310,0,1976,0,98052,47.6844,-122.111,1310,8748,7972,7438,47.08037060978238,0.047475409836065574,Very Cheap
20150316T000000,447000.0,3,2.5,1800,3074,2.0,0,0,3,7,1800,0,2003,0,98072,47.7631,-122.149,1610,2929,1274,1319,145.4131424853611,0.04878688524590164,Very Cheap
20141020T000000,500000.0,4,1.0,1160,20100,1.0,0,0,4,6,820,340,1913,0,98056,47.5175,-122.201,1670,10200,18940,8530,24.875621890547265,0.05573770491803279,Very Cheap
20150319T000000,508300.0,3,1.0,1160,5969,1.0,0,0,3,7,880,280,1930,0,98115,47.6844,-122.306,1550,5120,4809,3570,85.15664265371083,0.05682622950819672,Very Cheap
20140731T000000,485000.0,3,1.5,1870,7853,1.0,0,0,3,7,1300,570,1962,0,98125,47.7045,-122.281,1870,8300,5983,6430,61.75983700496626,0.05377049180327869,Very Cheap
20140507T000000,540000.0,7,5.75,3700,7647,2.0,0,1,3,8,3700,0,1948,1984,98155,47.7393,-122.289,2510,7479,3947,4969,70.61592781482935,0.06098360655737705,Very Cheap
20140916T000000,356000.0,3,2.25,2280,8765,2.0,0,0,3,8,2280,0,1977,0,98058,47.4419,-122.133,1920,8265,6485,6345,40.616086708499715,0.03685245901639344,Very Cheap
20140825T000000,525000.0,4,2.0,1720,6099,1.0,0,0,4,7,860,860,1949,0,98115,47.6765,-122.287,1100,5671,4379,4571,86.07968519429414,0.05901639344262295,Very Cheap
20150324T000000,962800.0,4,2.75,3630,11775,2.0,0,0,3,10,3630,0,1999,0,98074,47.6378,-122.066,3800,12451,8145,8651,81.76645435244161,0.1164327868852459,Cheap
20141001T000000,315000.0,4,2.5,2040,6300,2.0,0,0,3,8,2040,0,2003,0,98031,47.3918,-122.185,2260,5877,4260,3617,50.0,0.031475409836065574,Very Cheap
20140620T000000,525000.0,3,2.25,1750,1879,3.0,0,0,3,8,1750,0,2001,0,98107,47.6722,-122.391,1750,3155,129,1405,279.4039382650346,0.05901639344262295,Very Cheap
20150430T000000,325000.0,2,2.25,1550,2285,2.0,0,0,3,8,1550,0,2007,0,98106,47.5398,-122.369,1550,2135,735,585,142.2319474835886,0.03278688524590164,Very Cheap
20150423T000000,965800.0,4,1.75,2500,8725,1.0,0,0,4,8,1500,1000,1966,0,98004,47.6304,-122.205,1900,8998,6225,7098,110.69340974212034,0.11682622950819672,Cheap
20140709T000000,550000.0,4,1.0,1440,3600,1.5,0,0,4,7,1440,0,1924,0,98116,47.5694,-122.385,1010,5175,2160,4165,152.77777777777777,0.06229508196721312,Very Cheap
20141021T000000,182200.0,4,1.0,1130,13927,1.5,0,0,3,6,1130,0,1929,0,98168,47.4939,-122.3,1800,8274,12797,6474,13.082501615566885,0.014059016393442623,Very Cheap
20140911T000000,315000.0,3,1.0,1210,8505,1.5,0,0,3,7,1210,0,1958,0,98106,47.5389,-122.353,1430,8505,7295,7075,37.03703703703704,0.031475409836065574,Very Cheap
20140825T000000,500000.0,2,1.0,960,5000,1.0,0,0,4,7,960,0,1900,0,98107,47.6755,-122.367,1330,5000,4040,3670,100.0,0.05573770491803279,Very Cheap
20140702T000000,480000.0,5,2.5,2160,7737,2.0,0,0,3,7,2160,0,1998,0,98065,47.5381,-121.872,2460,7737,5577,5277,62.03955021326095,0.05311475409836065,Very Cheap
20140520T000000,1690000.0,3,1.75,3400,8965,1.0,0,2,5,9,1820,1580,1957,0,98105,47.6569,-122.273,3200,8500,5565,5300,188.51087562744004,0.21180327868852458,Cheap
20141118T000000,525000.0,5,3.25,3960,321908,2.0,0,0,4,9,2690,1270,1989,0,98038,47.3984,-122.055,2360,96703,317948,94343,1.6309007542527678,0.05901639344262295,Very Cheap
20150412T000000,407500.0,4,2.5,1900,9075,2.0,0,0,3,7,1900,0,1988,0,98133,47.7776,-122.352,1800,8460,7175,6660,44.90358126721763,0.04360655737704918,Very Cheap
20150309T000000,443000.0,4,3.0,2620,35124,2.0,0,0,3,9,2620,0,1987,0,98092,47.3067,-122.116,2920,35807,32504,32887,12.612458717685913,0.048262295081967214,Very Cheap
20140530T000000,1256500.0,4,2.5,3150,13700,2.0,0,0,4,9,3150,0,1966,0,98040,47.5309,-122.224,3200,11900,10550,8700,91.71532846715328,0.15495081967213115,Cheap
20140830T000000,642000.0,3,1.0,1040,4480,1.0,0,0,3,7,870,170,1924,0,98109,47.6461,-122.356,1730,4200,3440,2470,143.30357142857142,0.07436065573770492,Very Cheap
20150109T000000,520000.0,3,1.75,1540,7558,1.0,0,0,3,8,1540,0,1964,0,98052,47.6707,-122.156,1540,7863,6018,6323,68.80127017729558,0.058360655737704915,Very Cheap
20140623T000000,750000.0,3,2.0,1820,5000,1.5,0,0,4,8,1720,100,1941,0,98116,47.5845,-122.395,2220,7200,3180,4980,150.0,0.08852459016393442,Very Cheap
20150407T000000,855000.0,5,1.5,1930,4500,1.5,0,0,3,8,1930,0,1929,0,98112,47.6401,-122.303,2083,4500,2570,2417,190.0,0.10229508196721311,Cheap
20141002T000000,275000.0,4,1.0,1430,27153,1.5,0,0,4,5,1430,0,1934,0,98065,47.5372,-121.744,1880,27153,25723,25273,10.12779435053217,0.02622950819672131,Very Cheap
20140910T000000,265000.0,5,2.75,2920,5250,1.5,0,0,5,7,1800,1120,1911,0,98002,47.3072,-122.221,1220,5250,2330,4030,50.476190476190474,0.024918032786885248,Very Cheap
20150410T000000,894400.0,3,2.5,3100,45738,2.0,0,0,3,10,3100,0,1991,0,98053,47.6854,-122.048,3340,45738,42638,42398,19.554855918492283,0.10746229508196721,Cheap
20150211T000000,546000.0,2,1.0,1200,12856,1.0,0,0,4,6,1200,0,1948,0,98027,47.5321,-122.034,1740,6098,11656,4358,42.47044181705041,0.06177049180327869,Very Cheap
20141126T000000,699950.0,2,2.5,2390,7489,1.0,0,0,3,8,2390,0,2007,0,98053,47.7243,-122.032,2170,7489,5099,5319,93.46374682868206,0.08196065573770492,Very Cheap
20150414T000000,435000.0,3,2.0,1270,10713,1.0,0,0,4,7,1270,0,1969,0,98034,47.7247,-122.181,1620,8250,9443,6630,40.604872584710165,0.04721311475409836,Very Cheap
20150506T000000,259500.0,4,1.5,1300,7200,1.0,0,0,4,7,1300,0,1970,0,98031,47.4179,-122.181,1420,7200,5900,5780,36.041666666666664,0.02419672131147541,Very Cheap
20141029T000000,359950.0,4,3.25,2290,4785,2.0,0,0,3,9,2290,0,2007,0,98038,47.3833,-122.037,2290,4785,2495,2495,75.22466039707419,0.037370491803278685,Very Cheap
20141215T000000,517000.0,3,1.75,1740,10000,1.0,0,0,3,7,1740,0,1976,2009,98074,47.617,-122.058,1350,7500,8260,6150,51.7,0.0579672131147541,Very Cheap
20140804T000000,579000.0,3,1.0,1590,5400,1.0,0,1,3,8,1280,310,1948,0,98118,47.5509,-122.261,2140,7161,3810,5021,107.22222222222223,0.06609836065573771,Very Cheap
20140905T000000,525000.0,4,2.0,2420,10735,1.5,0,0,3,7,2420,0,1967,0,98052,47.6899,-122.122,1570,9540,8315,7970,48.905449464368886,0.05901639344262295,Very Cheap
20150414T000000,320000.0,4,2.5,2130,9653,1.0,0,0,3,7,1500,630,1978,0,98031,47.4068,-122.175,2000,7988,7523,5988,33.15031596394903,0.032131147540983604,Very Cheap
20140513T000000,635000.0,4,1.75,1950,13320,1.0,0,0,4,8,1370,580,1969,0,98007,47.6196,-122.139,2120,12051,11370,9931,47.672672672672675,0.07344262295081967,Very Cheap
20140916T000000,400000.0,4,2.5,2150,5397,2.0,0,0,3,8,2150,0,1998,0,98058,47.4644,-122.151,2260,5080,3247,2820,74.11524921252548,0.04262295081967213,Very Cheap
20141010T000000,455000.0,3,1.75,1270,7700,1.0,0,0,4,7,1270,0,1968,0,98052,47.6711,-122.148,1510,7700,6430,6190,59.09090909090909,0.049836065573770495,Very Cheap
20150225T000000,572000.0,3,1.75,1850,22767,1.5,0,4,5,6,1850,0,1908,0,98074,47.6144,-122.067,2700,17906,20917,15206,25.124083102736417,0.06518032786885246,Very Cheap
20150413T000000,650000.0,2,1.5,1440,136778,1.0,0,0,4,8,1140,300,1956,0,98072,47.7608,-122.118,1740,21600,135338,19860,4.752226235213265,0.07540983606557378,Very Cheap
20150123T000000,162500.0,3,1.5,1390,7417,1.0,0,0,3,7,1390,0,1967,0,98001,47.3369,-122.275,1390,7665,6027,6275,21.909127679654848,0.011475409836065573,Very Cheap
20141113T000000,400000.0,2,2.5,1340,1240,2.0,0,0,3,8,1150,190,2008,0,98052,47.6858,-122.102,1280,1312,-100,32,322.5806451612903,0.04262295081967213,Very Cheap
20150318T000000,268300.0,3,1.0,1190,9000,1.0,0,0,3,7,1190,0,1968,0,98028,47.77,-122.264,1960,7200,7810,5240,29.81111111111111,0.025350819672131146,Very Cheap
20140702T000000,989000.0,6,4.5,3830,4800,3.0,0,0,3,9,3050,780,1919,2004,98119,47.6404,-122.361,1990,4800,970,2810,206.04166666666666,0.11986885245901639,Cheap
20140627T000000,342000.0,3,1.75,1780,10409,1.0,0,0,3,7,1280,500,1981,0,98058,47.4627,-122.168,1780,7415,8629,5635,32.856182150062445,0.03501639344262295,Very Cheap
20150325T000000,315000.0,4,2.5,3130,5999,2.0,0,0,3,7,3130,0,2006,0,98042,47.3837,-122.099,3020,5997,2869,2977,52.50875145857643,0.031475409836065574,Very Cheap
20150428T000000,485000.0,4,2.75,1830,8384,1.0,0,0,3,7,1320,510,1979,0,98034,47.733,-122.22,2190,7695,6554,5505,57.84828244274809,0.05377049180327869,Very Cheap
20141204T000000,277500.0,4,2.5,2550,7500,1.0,0,0,3,8,1750,800,1976,0,98023,47.3165,-122.386,2260,8800,4950,6540,37.0,0.026557377049180327,Very Cheap
20150312T000000,1295000.0,4,3.5,3790,90169,2.0,0,0,3,11,3790,0,1998,0,98053,47.6587,-122.022,3410,46951,86379,43541,14.36192039392696,0.16,Cheap
20140806T000000,385000.0,4,1.75,1800,10890,1.5,0,0,4,6,1800,0,1912,0,98027,47.5312,-122.04,1530,9818,9090,8288,35.35353535353536,0.04065573770491803,Very Cheap
20141117T000000,426000.0,2,1.0,1630,7680,1.0,0,0,3,7,830,800,1947,0,98125,47.7092,-122.291,1250,7740,6050,6490,55.46875,0.046032786885245904,Very Cheap
20140617T000000,310000.0,4,2.0,1870,6000,1.5,0,0,3,7,1870,0,1956,0,98125,47.7155,-122.315,1520,7169,4130,5649,51.666666666666664,0.03081967213114754,Very Cheap
20150126T000000,449000.0,4,2.0,1870,6000,1.5,0,0,3,7,1870,0,1956,0,98125,47.7155,-122.315,1520,7169,4130,5649,74.83333333333333,0.049049180327868855,Very Cheap
20141219T000000,375000.0,2,1.0,980,3915,1.0,0,0,4,7,980,0,1919,0,98118,47.5589,-122.29,1425,1576,2935,151,95.78544061302682,0.03934426229508197,Very Cheap
20150330T000000,1187500.0,3,2.25,2860,10625,1.0,0,4,3,10,1920,940,1976,0,98115,47.6915,-122.273,2860,8075,7765,5215,111.76470588235294,0.14590163934426228,Cheap
20150414T000000,468000.0,3,2.25,1470,5597,2.0,0,0,3,7,1470,0,1985,0,98029,47.5674,-122.019,1610,5217,4127,3607,83.6162229765946,0.05154098360655738,Very Cheap
20150403T000000,336000.0,1,1.0,1160,5000,2.0,0,0,3,7,1160,0,2000,0,98144,47.5883,-122.311,2060,5000,3840,2940,67.2,0.03422950819672131,Very Cheap
20140610T000000,392000.0,4,2.75,1940,6555,2.0,0,0,3,8,1940,0,1990,0,98038,47.3701,-122.041,1840,6912,4615,5072,59.80167810831426,0.04157377049180328,Very Cheap
20140807T000000,412500.0,4,2.25,1630,7969,1.0,0,0,3,7,1100,530,1977,0,98034,47.7336,-122.19,1580,7440,6339,5860,51.76308194252729,0.04426229508196721,Very Cheap
20150325T000000,545000.0,4,2.5,2755,11612,2.0,0,0,3,8,2755,0,2001,0,98019,47.7394,-121.965,2820,12831,8857,10011,46.934205993799516,0.06163934426229508,Very Cheap
20141220T000000,133000.0,5,2.0,1430,5600,1.5,0,0,3,6,1430,0,1947,0,98118,47.5192,-122.266,1860,5980,4170,4120,23.75,0.00760655737704918,Very Cheap
20150514T000000,440000.0,5,2.0,1430,5600,1.5,0,0,3,6,1430,0,1947,0,98118,47.5192,-122.266,1860,5980,4170,4120,78.57142857142857,0.04786885245901639,Very Cheap
20141205T000000,294450.0,4,2.25,1400,7341,1.0,0,0,3,7,1300,100,1961,0,98155,47.7565,-122.305,2090,7410,5941,5320,40.110339190845934,0.02878032786885246,Very Cheap
20140826T000000,335000.0,4,2.5,2520,7205,2.0,0,0,3,8,2520,0,1987,0,98003,47.343,-122.316,2350,7632,4685,5282,46.49548924358085,0.03409836065573771,Very Cheap
20140908T000000,362000.0,3,1.0,1290,10125,1.0,0,0,4,7,1290,0,1956,0,98028,47.7641,-122.265,1760,14460,8835,12700,35.75308641975309,0.03763934426229508,Very Cheap
20141028T000000,322000.0,3,1.75,1400,18002,1.0,0,0,3,6,1400,0,1977,0,98019,47.725,-121.967,2240,14068,16602,11828,17.886901455393843,0.03239344262295082,Very Cheap
20150317T000000,230500.0,2,1.0,740,8853,1.0,0,0,3,6,740,0,1943,0,98166,47.4793,-122.336,850,8775,8113,7925,26.036371851349823,0.02039344262295082,Very Cheap
20150305T000000,380000.0,4,2.0,1710,9996,1.0,0,0,3,7,1710,0,1950,0,98108,47.5472,-122.3,1550,6768,8286,5218,38.015206082432975,0.04,Very Cheap
20140611T000000,292000.0,4,2.75,2414,7693,2.0,0,0,3,8,2414,0,2006,0,98002,47.3046,-122.222,1500,7177,5279,5677,37.956583907448326,0.028459016393442622,Very Cheap
20140812T000000,172500.0,3,1.0,1040,7500,1.0,0,0,4,6,1040,0,1954,0,98198,47.4206,-122.316,1270,8000,6460,6730,23.0,0.012786885245901639,Very Cheap
20140724T000000,784000.0,4,2.75,3540,7091,1.5,0,1,4,8,1970,1570,1947,0,98199,47.6467,-122.394,2200,6000,3551,3800,110.56268509378084,0.09298360655737704,Very Cheap
20141002T000000,525000.0,4,2.75,2530,11549,1.0,0,0,3,7,1700,830,1942,0,98033,47.6557,-122.197,2530,10000,9019,7470,45.45848125378821,0.05901639344262295,Very Cheap
20140704T000000,600000.0,3,2.5,2320,7609,2.0,0,0,3,8,2320,0,2003,0,98027,47.5391,-122.069,2590,4000,5289,1410,78.85398869759496,0.06885245901639345,Very Cheap
20141027T000000,435000.0,3,2.5,2530,16102,2.0,0,0,3,9,2530,0,1989,0,98038,47.371,-122.055,2370,14957,13572,12587,27.015277605266427,0.04721311475409836,Very Cheap
20150205T000000,359900.0,5,2.75,2790,7600,1.5,0,0,4,7,2790,0,1965,0,98056,47.4999,-122.165,1480,7600,4810,6120,47.35526315789474,0.03736393442622951,Very Cheap
20141211T000000,700000.0,4,1.75,1950,7139,1.0,1,4,3,7,1150,800,1957,0,98178,47.5121,-122.248,1600,13122,5189,11522,98.05294859223982,0.08196721311475409,Very Cheap
20150312T000000,280000.0,3,2.0,1020,889,2.0,0,0,3,7,720,300,2009,0,98126,47.5434,-122.375,1130,972,-131,-158,314.96062992125985,0.026885245901639345,Very Cheap
20141002T000000,655000.0,4,2.5,3110,24466,2.0,0,0,3,9,3110,0,1997,0,98059,47.4898,-122.127,3080,22185,21356,19105,26.771846644322732,0.0760655737704918,Very Cheap
20150512T000000,2480000.0,4,5.0,5310,16909,1.0,0,4,3,12,3090,2220,1992,0,98006,47.5515,-122.113,5220,15701,11599,10481,146.66745520137206,0.31540983606557377,Medium
20150224T000000,499950.0,3,2.5,2580,23925,2.0,0,0,3,9,2580,0,2001,0,98023,47.2978,-122.376,1660,8460,21345,6800,20.896551724137932,0.05573114754098361,Very Cheap
20140805T000000,540000.0,3,2.5,1380,1021,2.0,0,0,3,8,1160,220,2008,0,98122,47.6148,-122.309,1440,1021,-359,-419,528.8932419196866,0.06098360655737705,Very Cheap
20150306T000000,970000.0,4,2.75,3980,9209,2.0,0,0,3,11,3980,0,2002,0,98074,47.6286,-122.064,3800,9333,5229,5533,105.33174068845695,0.11737704918032787,Cheap
20140813T000000,330000.0,4,2.5,2080,7000,1.0,0,0,4,8,1400,680,1989,0,98058,47.4252,-122.163,2090,7082,4920,4992,47.142857142857146,0.03344262295081967,Very Cheap
20140703T000000,474000.0,3,1.75,1530,8000,2.0,0,0,3,7,1530,0,1978,0,98052,47.6971,-122.13,1530,7500,6470,5970,59.25,0.05232786885245902,Very Cheap
20150317T000000,670000.0,4,1.75,1930,9310,1.0,0,0,4,9,1930,0,1968,0,98008,47.6158,-122.108,2110,10290,7380,8180,71.9656283566058,0.0780327868852459,Very Cheap
20140512T000000,1300000.0,4,3.25,2330,9687,2.0,0,3,3,9,2330,0,1918,0,98112,47.6264,-122.283,3880,9017,7357,5137,134.20047486321874,0.16065573770491803,Cheap
20140730T000000,1160000.0,4,2.5,3860,10361,2.0,0,2,4,10,2940,920,1985,0,98006,47.5517,-122.147,3720,13155,6501,9435,111.9583051828974,0.1422950819672131,Cheap
20150112T000000,440000.0,4,2.5,2880,8061,2.0,0,0,3,9,2880,0,1988,0,98058,47.439,-122.152,2650,7660,5181,5010,54.583798536161765,0.04786885245901639,Very Cheap
20140728T000000,411000.0,2,2.5,1590,2088,2.0,0,0,3,9,1590,0,1997,0,98033,47.6897,-122.175,2320,3174,498,854,196.83908045977012,0.044065573770491806,Very Cheap
20140725T000000,500000.0,3,1.5,2150,4000,1.5,0,0,3,7,1470,680,1928,0,98144,47.5733,-122.312,1750,4000,1850,2250,125.0,0.05573770491803279,Very Cheap
20141218T000000,1335000.0,4,1.75,2300,13342,1.5,1,4,3,7,2300,0,1934,1958,98125,47.7308,-122.282,2500,13342,11042,10842,100.05996102533354,0.16524590163934427,Cheap
20141215T000000,696000.0,6,3.25,2900,6400,2.0,0,0,4,8,2300,600,1977,0,98199,47.6464,-122.401,2480,6400,3500,3920,108.75,0.08144262295081967,Very Cheap
20140506T000000,465000.0,3,2.25,1970,11088,1.0,0,0,4,8,1180,790,1967,0,98155,47.7651,-122.277,1970,10470,9118,8500,41.93722943722944,0.051147540983606556,Very Cheap
20140616T000000,518000.0,4,2.5,1740,7500,1.0,0,0,4,7,1220,520,1976,0,98052,47.6927,-122.124,1790,7350,5760,5560,69.06666666666666,0.0580983606557377,Very Cheap
20140509T000000,251000.0,3,1.75,1220,7250,1.0,0,0,3,7,1220,0,1962,0,98045,47.4887,-121.784,1700,15251,6030,13551,34.62068965517241,0.023081967213114753,Very Cheap
20150430T000000,255000.0,3,2.0,1290,13282,1.0,0,0,3,7,1290,0,1978,0,98030,47.3787,-122.169,1290,12357,11992,11067,19.19891582592983,0.02360655737704918,Very Cheap
20140820T000000,319000.0,2,1.0,780,8271,1.0,0,0,4,6,780,0,1924,0,98115,47.7,-122.3,2220,8271,7491,6051,38.568492322572844,0.032,Very Cheap
20140929T000000,719000.0,4,2.75,2210,3400,1.5,0,0,5,7,1470,740,1926,0,98115,47.6826,-122.311,1500,3400,1190,1900,211.47058823529412,0.08445901639344262,Very Cheap
20140714T000000,1520000.0,5,3.5,5930,13288,2.0,0,2,3,11,3920,2010,1996,0,98027,47.5542,-122.097,3860,12062,7358,8202,114.3889223359422,0.18950819672131147,Cheap
20150109T000000,322000.0,4,2.5,1950,4553,2.0,0,0,3,7,1950,0,2000,0,98056,47.5066,-122.175,1780,4598,2603,2818,70.7226004831979,0.03239344262295082,Very Cheap
20150305T000000,205000.0,4,1.0,1340,7920,1.0,0,0,4,7,1340,0,1970,0,98001,47.2845,-122.267,1090,9600,6580,8510,25.883838383838384,0.017049180327868854,Very Cheap
20150113T000000,229000.0,3,1.0,1590,6240,1.0,0,0,3,7,1060,530,1956,0,98146,47.4936,-122.337,1410,6240,4650,4830,36.69871794871795,0.02019672131147541,Very Cheap
20141030T000000,395000.0,3,2.25,1780,9672,1.0,0,0,3,8,1350,430,1960,0,98133,47.7774,-122.35,1860,10080,7892,8220,40.83953680727874,0.0419672131147541,Very Cheap
20150326T000000,183000.0,2,1.0,760,7272,1.0,0,0,4,7,760,0,1980,0,98003,47.3205,-122.33,1370,7866,6512,6496,25.165016501650165,0.014163934426229508,Very Cheap
20140905T000000,583500.0,3,1.75,1720,7800,1.0,0,0,4,7,1170,550,1978,0,98052,47.6928,-122.125,1760,7276,6080,5516,74.8076923076923,0.06668852459016393,Very Cheap
20150213T000000,312000.0,3,2.5,2070,25710,1.0,0,0,5,6,2070,0,1917,0,98022,47.2032,-121.964,1350,17998,23640,16648,12.135355892648775,0.031081967213114754,Very Cheap
20140909T000000,539000.0,3,1.75,1790,9860,1.0,0,0,4,7,1410,380,1978,0,98052,47.6989,-122.12,1820,9555,8070,7735,54.665314401622716,0.06085245901639344,Very Cheap
20150320T000000,409000.0,4,2.75,3230,12651,2.0,0,0,4,8,3230,0,2002,0,98001,47.3157,-122.251,2550,12081,9421,9531,32.32946012172951,0.04380327868852459,Very Cheap
20140528T000000,510250.0,3,1.75,1400,4000,1.0,0,0,3,7,870,530,1951,0,98117,47.6913,-122.381,1400,4000,2600,2600,127.5625,0.05708196721311475,Very Cheap
20141202T000000,535000.0,2,2.0,1370,3827,1.0,0,0,3,7,1020,350,1952,0,98199,47.652,-122.404,1550,5102,2457,3552,139.7961850013065,0.06032786885245902,Very Cheap
20140924T000000,280000.0,3,2.5,1600,7936,2.0,0,0,3,7,1600,0,1996,0,98038,47.3673,-122.017,1830,7936,6336,6106,35.28225806451613,0.026885245901639345,Very Cheap
20150409T000000,286000.0,3,1.0,950,8400,1.0,0,0,3,7,950,0,1958,0,98056,47.5104,-122.166,1250,8400,7450,7150,34.04761904761905,0.027672131147540982,Very Cheap
20150325T000000,710000.0,3,2.75,2210,7660,1.0,0,1,4,7,1460,750,1968,0,98116,47.5619,-122.4,2110,8750,5450,6640,92.68929503916449,0.08327868852459017,Very Cheap
20140709T000000,395000.0,2,1.0,930,6380,1.0,0,0,4,7,930,0,1940,0,98115,47.6915,-122.321,1180,6380,5450,5200,61.912225705329156,0.0419672131147541,Very Cheap
20140908T000000,237500.0,2,1.0,810,8494,1.0,0,0,3,6,810,0,1949,0,98155,47.7389,-122.324,1050,7975,7684,6925,27.960913586060748,0.021311475409836064,Very Cheap
20150121T000000,464000.0,3,2.0,1630,6550,1.0,0,0,5,7,850,780,1912,0,98126,47.5452,-122.379,1440,6550,4920,5110,70.83969465648855,0.05101639344262295,Very Cheap
20141021T000000,495000.0,3,1.75,1770,10080,1.0,0,0,3,8,1770,0,1968,0,98125,47.7218,-122.306,1860,10456,8310,8596,49.107142857142854,0.05508196721311476,Very Cheap
20150217T000000,257500.0,1,1.0,710,6060,1.0,0,0,4,6,710,0,1916,0,98118,47.5621,-122.283,1440,4545,5350,3105,42.491749174917494,0.023934426229508195,Very Cheap
20150116T000000,570000.0,4,3.5,3990,23544,1.0,0,2,3,10,2300,1690,1999,0,98023,47.3245,-122.38,3410,15932,19554,12522,24.20998980632008,0.06491803278688525,Very Cheap
20141111T000000,362000.0,3,2.5,2310,7485,2.0,0,0,3,8,2310,0,1986,0,98058,47.439,-122.135,2310,8142,5175,5832,48.36339345357381,0.03763934426229508,Very Cheap
20140625T000000,640000.0,33,1.75,1620,6000,1.0,0,0,5,7,1040,580,1947,0,98103,47.6878,-122.331,1330,4700,4380,3370,106.66666666666667,0.0740983606557377,Very Cheap
20140526T000000,172500.0,3,1.0,1140,8800,1.0,0,0,3,7,1140,0,1972,0,98001,47.2629,-122.275,1270,13560,7660,12290,19.602272727272727,0.012786885245901639,Very Cheap
20150120T000000,596000.0,2,1.0,1040,4880,1.0,0,0,3,7,1040,0,1910,1975,98115,47.6809,-122.311,1500,4590,3840,3090,122.1311475409836,0.06832786885245902,Very Cheap
20150430T000000,840000.0,4,2.5,2170,9796,1.0,0,0,4,8,1650,520,1980,0,98006,47.5505,-122.152,2350,9796,7626,7446,85.74928542262148,0.10032786885245902,Cheap
20141113T000000,1600000.0,3,2.25,3370,23065,1.0,1,4,3,10,1920,1450,1980,0,98028,47.7434,-122.263,3410,19688,19695,16278,69.3691740732712,0.2,Cheap
20140912T000000,435000.0,2,1.5,901,1245,3.0,0,0,3,7,901,0,2001,0,98115,47.6774,-122.325,1138,1137,344,-1,349.3975903614458,0.04721311475409836,Very Cheap
20140910T000000,251000.0,2,1.0,840,7870,1.0,0,0,3,6,840,0,1949,0,98155,47.7389,-122.326,1442,8131,7030,6689,31.893265565438373,0.023081967213114753,Very Cheap
20141106T000000,282500.0,4,1.0,1650,9750,1.0,0,0,4,7,1650,0,1964,0,98059,47.4991,-122.164,1650,10112,8100,8462,28.974358974358974,0.02721311475409836,Very Cheap
20141017T000000,265000.0,3,2.25,1380,7226,1.0,0,0,4,7,1140,240,1987,0,98042,47.3677,-122.091,1640,7823,5846,6183,36.67312482701356,0.024918032786885248,Very Cheap
20141217T000000,330000.0,3,1.0,910,10240,1.0,0,0,4,6,910,0,1969,0,98053,47.6729,-122.064,1140,10720,9330,9580,32.2265625,0.03344262295081967,Very Cheap
20140617T000000,435000.0,2,1.0,1230,3800,1.0,0,0,3,7,1230,0,1928,0,98115,47.6797,-122.292,1610,3800,2570,2190,114.47368421052632,0.04721311475409836,Very Cheap
20141201T000000,827235.0,3,1.75,1740,8560,1.0,0,0,3,8,1500,240,1948,0,98199,47.6475,-122.409,2240,5800,6820,3560,96.63960280373831,0.09865377049180328,Very Cheap
20140530T000000,249950.0,4,1.0,1290,5000,1.5,0,0,3,7,1290,0,1957,0,98146,47.513,-122.358,1440,2500,3710,1060,49.99,0.022944262295081966,Very Cheap
20150324T000000,400000.0,3,2.5,1950,18533,2.0,0,0,3,8,1950,0,1988,0,98024,47.5647,-121.903,1810,18401,16583,16591,21.583121998597097,0.04262295081967213,Very Cheap
20141021T000000,300499.0,4,2.5,2150,7944,2.0,0,0,3,8,2150,0,1990,0,98092,47.259,-122.215,2170,8319,5794,6149,37.82716515609265,0.029573639344262295,Very Cheap
20150417T000000,449000.0,4,2.0,1560,5220,1.0,0,0,3,7,1560,0,1959,0,98115,47.6905,-122.305,1300,5220,3660,3920,86.01532567049809,0.049049180327868855,Very Cheap
20141017T000000,500000.0,2,1.0,1120,3220,1.0,0,0,4,7,1120,0,1923,0,98103,47.6588,-122.344,1440,3220,2100,1780,155.27950310559007,0.05573770491803279,Very Cheap
20140930T000000,865000.0,3,1.5,1790,7526,1.0,0,0,3,7,1790,0,1953,2014,98004,47.6387,-122.207,2080,10943,5736,8863,114.93489237310656,0.10360655737704919,Cheap
20140616T000000,899950.0,4,3.5,3290,5414,2.0,0,1,3,9,2360,930,2006,0,98034,47.7074,-122.219,1820,9609,2124,7789,166.2264499445881,0.10819016393442622,Cheap
20140828T000000,370000.0,4,1.0,1540,9541,1.5,0,0,4,7,1540,0,1961,0,98034,47.7104,-122.213,1290,9541,8001,8251,38.78000209621633,0.038688524590163934,Very Cheap
20150504T000000,442500.0,5,3.25,4240,226097,2.0,0,0,3,8,3410,830,1980,0,98053,47.6472,-122.017,2980,217800,221857,214820,1.9571245969650195,0.04819672131147541,Very Cheap
20140503T000000,310000.0,3,1.0,1010,9945,1.0,0,0,4,6,1010,0,1973,0,98065,47.5324,-121.763,1390,12710,8935,11320,31.171442936148818,0.03081967213114754,Very Cheap
20140701T000000,1565000.0,4,2.75,2970,12750,1.5,0,1,4,7,2130,840,1918,1986,98004,47.6135,-122.213,1980,15300,9780,13320,122.74509803921569,0.19540983606557377,Cheap
20140905T000000,245000.0,4,2.25,2190,9113,2.0,0,0,3,7,2190,0,1986,0,98001,47.3241,-122.275,1570,8306,6923,6736,26.884670251289368,0.022295081967213116,Very Cheap
20141117T000000,254950.0,2,1.0,700,8100,1.0,0,0,3,6,700,0,1949,0,98155,47.7492,-122.311,1230,8100,7400,6870,31.47530864197531,0.0236,Very Cheap
20140722T000000,510000.0,6,4.5,3300,7480,2.0,0,0,3,8,3300,0,1980,0,98052,47.6796,-122.104,2470,7561,4180,5091,68.18181818181819,0.057049180327868855,Very Cheap
20150427T000000,299950.0,3,2.25,1370,5000,2.0,0,0,3,7,1370,0,1990,0,98019,47.7372,-121.981,1600,7724,3630,6124,59.99,0.029501639344262295,Very Cheap
20140821T000000,379950.0,4,2.5,2680,4500,2.0,0,0,3,8,2680,0,2011,0,98038,47.3561,-122.056,2010,4500,1820,2490,84.43333333333334,0.03999344262295082,Very Cheap
20140807T000000,350000.0,3,1.0,1390,4820,1.0,0,0,4,7,910,480,1926,0,98133,47.704,-122.343,1320,4820,3430,3500,72.61410788381743,0.036065573770491806,Very Cheap
20140618T000000,300000.0,3,2.5,1700,3575,2.0,0,0,3,7,1700,0,2000,0,98108,47.5418,-122.295,1590,3380,1875,1790,83.91608391608392,0.029508196721311476,Very Cheap
20140527T000000,994000.0,3,2.25,2510,6339,1.5,0,2,5,8,1810,700,1932,0,98199,47.6496,-122.391,1820,5741,3829,3921,156.80706736078247,0.12052459016393442,Cheap
20141119T000000,315000.0,3,1.5,1700,8067,1.0,0,0,3,7,1250,450,1956,0,98155,47.7384,-122.324,1340,7869,6367,6529,39.04797322424693,0.031475409836065574,Very Cheap
20140507T000000,480500.0,4,2.5,2180,11200,1.0,0,0,4,8,2180,0,1968,0,98072,47.7476,-122.086,1790,11200,9020,9410,42.901785714285715,0.05318032786885246,Very Cheap
20140616T000000,373000.0,3,1.0,1770,5720,1.5,0,0,4,7,1140,630,1926,0,98126,47.5546,-122.377,1500,4406,3950,2906,65.20979020979021,0.03908196721311476,Very Cheap
20140902T000000,728000.0,4,2.5,3290,5951,2.0,0,0,3,9,3290,0,2003,0,98075,47.5999,-121.976,3240,6159,2661,2919,122.33238111241808,0.08563934426229508,Very Cheap
20140925T000000,415000.0,4,3.5,3040,7125,2.0,0,1,3,8,2240,800,2002,0,98178,47.492,-122.225,2220,7800,4085,5580,58.24561403508772,0.04459016393442623,Very Cheap
20140604T000000,427500.0,4,2.5,2460,5091,2.0,0,0,3,9,2460,0,2003,0,98058,47.45,-122.121,2490,4750,2631,2260,83.97171479080731,0.04622950819672131,Very Cheap
20141110T000000,339300.0,3,2.0,970,10000,1.0,0,0,5,7,970,0,1972,0,98074,47.6205,-122.063,1230,7500,9030,6270,33.93,0.034662295081967213,Very Cheap
20140527T000000,313000.0,3,1.75,1320,6205,1.0,0,0,5,7,1320,0,1948,0,98133,47.7412,-122.343,1210,6205,4885,4995,50.443190975020144,0.03121311475409836,Very Cheap
20140522T000000,431500.0,3,3.5,1900,1612,2.0,0,0,3,8,1430,470,2008,0,98136,47.544,-122.385,1780,1525,-288,-255,267.6799007444169,0.046754098360655735,Very Cheap
20150309T000000,415000.0,3,1.5,1220,835,1.5,0,0,4,6,1220,0,1950,0,98103,47.6981,-122.341,1360,1251,-385,-109,497.0059880239521,0.04459016393442623,Very Cheap
20150316T000000,490000.0,3,1.75,1470,9750,1.0,0,0,4,7,1470,0,1978,0,98052,47.6975,-122.12,1800,9600,8280,7800,50.256410256410255,0.05442622950819672,Very Cheap
20150324T000000,1425000.0,4,5.0,4630,24054,2.0,0,3,3,11,4630,0,2005,0,98075,47.587,-121.966,4630,17584,19424,12954,59.241706161137444,0.17704918032786884,Cheap
20150330T000000,275000.0,3,1.5,1400,9750,1.0,0,0,4,6,1400,0,1964,0,98030,47.3768,-122.17,1160,9750,8350,8590,28.205128205128204,0.02622950819672131,Very Cheap
20150217T000000,325000.0,2,1.0,1070,5080,1.0,0,0,5,6,1070,0,1942,0,98106,47.5224,-122.35,900,5080,4010,4180,63.976377952755904,0.03278688524590164,Very Cheap
20140610T000000,1180000.0,5,3.75,3630,6000,1.5,0,0,3,9,2470,1160,2004,0,98033,47.6816,-122.199,2560,7560,2370,5000,196.66666666666666,0.14491803278688525,Cheap
20141001T000000,690000.0,4,1.5,1970,4590,2.5,0,0,3,7,1970,0,1909,0,98103,47.666,-122.332,1900,4590,2620,2690,150.32679738562092,0.08065573770491803,Very Cheap
20150330T000000,410000.0,4,2.0,2010,9474,2.0,0,0,3,7,2010,0,1953,2003,98166,47.4234,-122.342,2140,10164,7464,8024,43.276335233270004,0.043934426229508196,Very Cheap
20140801T000000,960000.0,4,2.5,2820,5934,1.0,0,3,5,9,1770,1050,1952,0,98116,47.5706,-122.403,2230,6000,3114,3770,161.77957532861475,0.1160655737704918,Cheap
20141030T000000,299250.0,3,2.5,2530,8669,2.0,0,0,3,9,2530,0,1990,0,98023,47.3073,-122.395,2530,9469,6139,6939,34.51955242819241,0.02940983606557377,Very Cheap
20140714T000000,239000.0,2,1.0,710,14000,1.0,0,0,4,6,710,0,1953,0,98166,47.4379,-122.337,1500,10540,13290,9040,17.071428571428573,0.021508196721311476,Very Cheap
20140502T000000,235000.0,2,1.0,1210,9400,1.0,0,0,2,6,1210,0,1949,0,98106,47.5342,-122.36,1580,6026,8190,4446,25.0,0.02098360655737705,Very Cheap
20140527T000000,587000.0,3,2.25,2370,217800,2.0,0,0,3,7,2370,0,1979,0,98053,47.6364,-121.984,3100,86248,215430,83148,2.6951331496786044,0.06714754098360656,Very Cheap
20140701T000000,431000.0,4,2.5,2300,6087,2.0,0,0,3,7,2300,0,2001,0,98056,47.5125,-122.192,1770,5907,3787,4137,70.80663709544932,0.046688524590163934,Very Cheap
20140707T000000,1636000.0,3,2.5,3110,6765,2.0,0,1,4,9,2550,560,1946,0,98115,47.6886,-122.276,2630,7626,3655,4996,241.8329637841833,0.20472131147540984,Cheap
20141203T000000,285000.0,3,1.75,1990,6500,1.0,0,0,3,7,1090,900,1961,0,98055,47.488,-122.221,2150,6500,4510,4350,43.84615384615385,0.02754098360655738,Very Cheap
20141106T000000,778000.0,3,3.0,2630,10156,1.0,0,0,4,9,2630,0,1987,0,98006,47.5481,-122.156,2660,10455,7526,7795,76.60496258369437,0.09219672131147541,Very Cheap
20140731T000000,415000.0,3,1.0,1300,7975,1.0,0,0,4,7,1300,0,1958,0,98008,47.611,-122.122,1570,9075,6675,7505,52.03761755485893,0.04459016393442623,Very Cheap
20150112T000000,550285.0,2,1.75,1680,4500,1.0,0,0,3,8,1680,0,2004,0,98053,47.7132,-122.032,1670,4500,2820,2830,122.28555555555556,0.06233245901639344,Very Cheap
20140825T000000,910000.0,3,2.25,2180,9865,1.0,0,0,4,8,1660,520,1966,0,98040,47.5358,-122.235,2600,10034,7685,7434,92.2453117080588,0.10950819672131147,Cheap
20140529T000000,860000.0,3,2.5,2770,9136,2.0,0,0,3,10,2770,0,1991,0,98006,47.5605,-122.115,2890,8442,6366,5552,94.13309982486865,0.10295081967213114,Cheap
20141003T000000,765000.0,3,1.75,2120,5000,2.0,0,0,3,7,1980,140,1920,2010,98103,47.6666,-122.331,2020,5000,2880,2980,153.0,0.09049180327868853,Very Cheap
20140509T000000,782000.0,4,2.5,2830,20345,2.0,0,0,3,10,1980,850,1979,0,98004,47.6462,-122.191,2830,13732,17515,10902,38.43696239862374,0.09272131147540984,Very Cheap
20150310T000000,525000.0,3,3.5,1370,1764,2.0,0,0,3,8,1180,190,2000,0,98119,47.6511,-122.368,1400,1398,394,-2,297.6190476190476,0.05901639344262295,Very Cheap
20141222T000000,745000.0,3,2.5,2810,435600,2.0,0,0,3,9,2810,0,1995,0,98045,47.4816,-121.701,2380,92007,432790,89627,1.7102846648301193,0.08786885245901639,Very Cheap
20140725T000000,470000.0,3,3.5,3520,35512,2.0,0,2,3,8,2760,760,2005,0,98022,47.2416,-121.979,2860,39614,31992,36754,13.234962829466095,0.05180327868852459,Very Cheap
20140602T000000,345000.0,3,1.75,1990,5650,1.0,0,1,3,7,1320,670,1963,0,98178,47.5086,-122.252,2130,5650,3660,3520,61.06194690265487,0.03540983606557377,Very Cheap
20150304T000000,279000.0,3,2.25,2070,7800,1.0,0,0,3,7,1170,900,1964,0,98003,47.3431,-122.305,1570,8400,5730,6830,35.76923076923077,0.02675409836065574,Very Cheap
20140711T000000,500000.0,3,1.5,1320,8100,1.0,0,0,4,7,1320,0,1951,0,98177,47.7194,-122.371,1480,8100,6780,6620,61.72839506172839,0.05573770491803279,Very Cheap
20140620T000000,237000.0,3,1.0,1300,8160,1.0,0,0,4,7,1300,0,1960,0,98056,47.511,-122.172,1290,8970,6860,7680,29.044117647058822,0.021245901639344263,Very Cheap
20140626T000000,200500.0,3,1.75,1260,9346,1.0,0,0,4,7,1260,0,1963,0,98030,47.3713,-122.186,1800,9705,8086,7905,21.453028033383266,0.016459016393442622,Very Cheap
20150324T000000,387500.0,4,1.75,2400,9900,1.0,0,0,3,7,1250,1150,1957,0,98166,47.4631,-122.362,1960,9900,7500,7940,39.14141414141414,0.040983606557377046,Very Cheap
20140717T000000,392500.0,4,2.0,1950,8040,1.0,0,0,3,7,1950,0,1961,0,98125,47.7074,-122.29,1950,8092,6090,6142,48.818407960199,0.04163934426229508,Very Cheap
20150213T000000,305000.0,3,2.0,1430,12430,1.0,0,0,4,7,1430,0,1957,0,98056,47.4903,-122.178,1200,8250,11000,7050,24.537409493161707,0.03016393442622951,Very Cheap
20140924T000000,981000.0,4,2.5,2110,10100,1.0,0,2,3,8,2110,0,1968,2005,98006,47.567,-122.151,2230,10100,7990,7870,97.12871287128714,0.11881967213114754,Cheap
20141209T000000,680000.0,4,2.5,2980,8770,2.0,0,0,3,10,2980,0,1990,0,98075,47.5814,-122.029,2940,9238,5790,6298,77.53705815279362,0.07934426229508197,Very Cheap
20140605T000000,276000.0,4,2.5,2068,7242,2.0,0,0,4,7,2068,0,1976,0,98001,47.3318,-122.281,1560,7524,5174,5964,38.11101905550953,0.026360655737704918,Very Cheap
20140506T000000,655500.0,4,3.5,3380,8330,2.0,0,0,3,8,3380,0,2000,0,98177,47.7741,-122.379,2220,8330,4950,6110,78.69147659063626,0.0761311475409836,Very Cheap
20141229T000000,555000.0,5,2.75,2810,13144,1.0,0,0,3,8,1440,1370,1964,0,98007,47.6199,-122.141,2480,13144,10334,10664,42.22458916615946,0.06295081967213115,Very Cheap
20150413T000000,235000.0,2,1.0,930,10505,1.0,0,0,3,6,930,0,1930,0,98148,47.4337,-122.329,1520,8881,9575,7361,22.370299857210853,0.02098360655737705,Very Cheap
20150219T000000,325000.0,3,1.0,1300,8879,1.0,0,0,3,7,920,380,1950,0,98155,47.7465,-122.326,1530,6960,7579,5430,36.603221083455345,0.03278688524590164,Very Cheap
20141030T000000,268950.0,3,1.0,1320,8100,1.0,0,0,3,6,880,440,1943,0,98166,47.4697,-122.351,1000,8100,6780,7100,33.2037037037037,0.02543606557377049,Very Cheap
20141110T000000,264500.0,3,1.5,1580,14040,1.0,0,0,3,7,1050,530,1980,0,98001,47.2932,-122.267,2240,12000,12460,9760,18.83903133903134,0.024852459016393443,Very Cheap
20141110T000000,240000.0,3,2.5,1620,5250,2.0,0,0,3,8,1620,0,1987,0,98003,47.3538,-122.301,1650,5250,3630,3600,45.714285714285715,0.021639344262295083,Very Cheap
20150220T000000,819000.0,3,2.5,2750,226512,2.0,0,0,3,9,2750,0,2000,0,98070,47.4376,-122.456,1250,211266,223762,210016,3.615702479338843,0.09757377049180328,Very Cheap
20150331T000000,850000.0,2,1.5,2210,5000,1.0,0,2,3,8,1530,680,1951,0,98122,47.6122,-122.288,2700,5000,2790,2300,170.0,0.10163934426229508,Cheap
20141022T000000,294950.0,4,2.25,1740,9600,1.0,0,2,3,7,1160,580,1957,0,98188,47.432,-122.276,1630,9600,7860,7970,30.723958333333332,0.028845901639344262,Very Cheap
20141215T000000,693000.0,3,2.25,2120,13644,2.0,0,1,4,9,1420,700,1973,0,98040,47.5574,-122.214,2950,17060,11524,14110,50.79155672823219,0.08104918032786886,Very Cheap
20141015T000000,478000.0,4,2.5,2780,7290,2.0,0,0,3,8,2780,0,1989,0,98059,47.509,-122.157,2450,7738,4510,5288,65.56927297668038,0.05285245901639344,Very Cheap
20150205T000000,222000.0,2,1.0,830,6893,1.0,0,0,3,7,830,0,1950,0,98125,47.7234,-122.328,1470,7200,6063,5730,32.20658639199188,0.019278688524590165,Very Cheap
20150408T000000,635000.0,4,2.5,2070,11286,2.0,0,0,3,8,2070,0,1996,0,98056,47.5284,-122.173,2440,10826,9216,8386,56.26439836966153,0.07344262295081967,Very Cheap
20140930T000000,469000.0,3,3.25,1390,1278,2.0,0,0,3,8,1140,250,2005,0,98107,47.6735,-122.375,1390,1256,-112,-134,366.9796557120501,0.05167213114754098,Very Cheap
20140725T000000,350000.0,4,2.5,2610,5866,2.0,0,0,3,8,2610,0,2005,0,98038,47.3441,-122.04,2480,5188,3256,2708,59.665871121718375,0.036065573770491806,Very Cheap
20141203T000000,180000.0,5,1.0,1460,11726,1.5,0,0,3,6,1290,170,1936,0,98146,47.5039,-122.361,1460,10450,10266,8990,15.350503155381205,0.01377049180327869,Very Cheap
20150408T000000,490000.0,4,2.25,3390,39356,1.0,0,0,4,8,1640,1750,1964,0,98027,47.461,-121.992,2160,38061,35966,35901,12.450452281735949,0.05442622950819672,Very Cheap
20140922T000000,360000.0,3,1.5,1360,6000,1.0,0,0,3,6,860,500,1911,0,98103,47.6846,-122.345,1560,3000,4640,1440,60.0,0.037377049180327866,Very Cheap
20140618T000000,630000.0,4,2.5,2807,9430,2.0,0,0,3,8,2807,0,1996,0,98028,47.7449,-122.223,2028,11056,6623,9028,66.80805938494167,0.07278688524590164,Very Cheap
20150414T000000,615000.0,4,1.0,1340,2006,1.5,0,0,3,7,1340,0,1931,0,98119,47.6357,-122.373,2040,3625,666,1585,306.580259222333,0.07081967213114754,Very Cheap
20141027T000000,279950.0,3,2.25,1340,7202,2.0,0,0,4,7,1340,0,1989,0,98038,47.3563,-122.039,1470,7395,5862,5925,38.87114690363788,0.026878688524590164,Very Cheap
20140611T000000,317000.0,3,1.0,1160,8813,1.0,0,0,3,7,1160,0,1952,0,98125,47.7257,-122.329,1200,7615,7653,6415,35.9695903778509,0.03173770491803279,Very Cheap
20141016T000000,618000.0,4,2.25,2470,7350,1.0,0,0,3,7,1600,870,1978,0,98052,47.6936,-122.128,1970,7700,4880,5730,84.08163265306122,0.07121311475409836,Very Cheap
20150311T000000,620000.0,5,1.75,2000,8713,1.0,0,2,3,7,1000,1000,1962,0,98008,47.5882,-122.117,2040,8449,6713,6409,71.158039710777,0.07147540983606557,Very Cheap
20140506T000000,345000.0,3,1.0,1110,6250,1.0,0,0,3,7,1110,0,1956,0,98115,47.6977,-122.292,2010,6944,5140,4934,55.2,0.03540983606557377,Very Cheap
20141010T000000,608000.0,3,1.5,2240,3750,1.0,0,0,3,7,1220,1020,1952,0,98103,47.6624,-122.336,1570,3400,1510,1830,162.13333333333333,0.0699016393442623,Very Cheap
20141223T000000,325000.0,4,2.25,1920,11603,2.0,0,0,4,7,1920,0,1967,0,98058,47.4315,-122.169,1840,7350,9683,5510,28.009997414461775,0.03278688524590164,Very Cheap
20141112T000000,475000.0,3,1.75,2270,13000,1.0,0,0,5,8,2270,0,1968,0,98058,47.4474,-122.144,2440,10000,10730,7560,36.53846153846154,0.05245901639344262,Very Cheap
20141016T000000,154000.0,3,3.0,1530,9997,1.0,0,0,3,6,1020,510,1992,0,98001,47.2861,-122.252,1410,9997,8467,8587,15.404621386415926,0.010360655737704918,Very Cheap
20140619T000000,1190000.0,5,3.0,3330,19126,2.0,0,0,4,11,2610,720,1977,0,98040,47.5485,-122.214,3330,16893,15796,13563,62.21896894280037,0.14622950819672131,Cheap
20141023T000000,376950.0,4,2.5,2643,5750,2.0,0,0,3,8,2643,0,2012,0,98030,47.3519,-122.173,2406,5772,3107,3366,65.55652173913043,0.0396,Very Cheap
20140729T000000,500000.0,2,2.0,1250,3360,1.0,0,0,3,7,1250,0,1957,0,98103,47.6526,-122.349,1250,3360,2110,2110,148.8095238095238,0.05573770491803279,Very Cheap
20150423T000000,499950.0,3,2.5,3230,129578,1.0,0,0,4,8,2100,1130,1964,0,98014,47.682,-121.913,2760,62059,126348,59299,3.8582938461775917,0.05573114754098361,Very Cheap
20150127T000000,230000.0,3,1.0,880,9035,1.0,0,0,4,6,880,0,1967,0,98059,47.476,-122.151,1440,10350,8155,8910,25.45655783065855,0.020327868852459016,Very Cheap
20150106T000000,652600.0,4,2.5,2220,5900,2.0,0,0,3,8,2220,0,2014,0,98117,47.6956,-122.36,1620,5900,3680,4280,110.61016949152543,0.07575081967213115,Very Cheap
20141229T000000,185000.0,3,1.75,1130,7000,1.0,0,0,3,7,1130,0,1978,0,98023,47.307,-122.372,1830,8880,5870,7050,26.428571428571427,0.014426229508196721,Very Cheap
20140602T000000,274950.0,3,1.0,1450,8820,1.0,0,0,3,6,1050,400,1958,0,98168,47.4698,-122.264,1510,8820,7370,7310,31.1734693877551,0.02622295081967213,Very Cheap
20150210T000000,447000.0,2,1.0,760,6035,1.0,0,0,3,6,760,0,1920,0,98136,47.5443,-122.382,2110,6046,5275,3936,74.06793703396852,0.04878688524590164,Very Cheap
20140613T000000,129000.0,2,1.0,1150,30184,1.0,0,0,3,6,1150,0,1950,0,98055,47.4492,-122.2,1670,19684,29034,18014,4.273787437052743,0.007081967213114754,Very Cheap
20150325T000000,436000.0,5,3.0,2720,9856,2.0,0,0,4,8,2720,0,1969,0,98059,47.4778,-122.146,1420,9685,7136,8265,44.23701298701299,0.047344262295081964,Very Cheap
20141006T000000,825000.0,3,1.75,2080,5000,2.0,0,0,5,8,2080,0,1906,0,98103,47.6717,-122.356,1820,5000,2920,3180,165.0,0.09836065573770492,Very Cheap
20141010T000000,225000.0,3,1.0,1080,16000,1.0,0,0,3,6,1080,0,1952,0,98001,47.2873,-122.251,1610,10007,14920,8397,14.0625,0.019672131147540985,Very Cheap
20150309T000000,265000.0,3,2.5,1890,6088,2.0,0,0,3,7,1890,0,1996,0,98002,47.2886,-122.218,1700,6600,4198,4900,43.52825229960578,0.024918032786885248,Very Cheap
20150309T000000,765000.0,3,1.5,1500,5111,2.0,0,0,5,8,1500,0,1984,0,98122,47.6118,-122.284,2380,4519,3611,2139,149.6771668949325,0.09049180327868853,Very Cheap
20141104T000000,509000.0,4,2.0,1960,2166,1.5,0,0,4,7,1260,700,1926,0,98103,47.6545,-122.344,1670,4000,206,2330,234.99538319482917,0.056918032786885245,Very Cheap
20150310T000000,762450.0,4,1.75,2570,8640,1.0,0,0,4,8,2570,0,1958,0,98005,47.5956,-122.172,2520,8800,6070,6280,88.24652777777777,0.09015737704918032,Very Cheap
20141210T000000,465000.0,5,1.5,1830,9000,1.0,0,2,3,7,1030,800,1955,0,98155,47.7488,-122.292,2610,11175,7170,8565,51.666666666666664,0.051147540983606556,Very Cheap
20140605T000000,564000.0,3,1.75,1980,6250,1.0,0,1,5,7,1090,890,1910,0,98136,47.554,-122.385,1980,6250,4270,4270,90.24,0.0641311475409836,Very Cheap
20150421T000000,384500.0,2,1.0,1130,5236,1.0,0,0,4,6,1130,0,1942,0,98146,47.5103,-122.386,1010,5320,4106,4310,73.43391902215431,0.04059016393442623,Very Cheap
20141027T000000,415000.0,3,2.0,2010,33090,1.5,0,2,5,8,2010,0,1986,0,98022,47.2133,-122.007,1840,22620,31080,20780,12.541553339377456,0.04459016393442623,Very Cheap
20141201T000000,345000.0,2,1.75,1820,8409,1.0,0,0,4,6,910,910,1948,0,98155,47.7538,-122.327,1300,8409,6589,7109,41.027470567249374,0.03540983606557377,Very Cheap
20140617T000000,465950.0,4,2.5,2340,6896,2.0,0,0,3,7,2340,0,2001,0,98059,47.4896,-122.14,2950,6775,4556,3825,67.5681554524362,0.051272131147540985,Very Cheap
20140804T000000,325000.0,3,1.75,1780,11096,1.0,0,0,3,7,1210,570,1979,0,98074,47.617,-122.051,1780,10640,9316,8860,29.28983417447729,0.03278688524590164,Very Cheap
20150217T000000,500000.0,3,1.75,1780,11096,1.0,0,0,3,7,1210,570,1979,0,98074,47.617,-122.051,1780,10640,9316,8860,45.06128334534968,0.05573770491803279,Very Cheap
20141024T000000,450000.0,4,2.5,2450,20348,1.0,0,0,3,8,1410,1040,1978,0,98075,47.5887,-122.064,2450,50094,17898,47644,22.115195596618832,0.04918032786885246,Very Cheap
20141010T000000,475000.0,4,3.0,2410,8284,1.0,0,0,5,7,1210,1200,1969,0,98034,47.7202,-122.22,2050,7940,5874,5890,57.3394495412844,0.05245901639344262,Very Cheap
20140512T000000,1346400.0,5,1.75,3380,20021,1.0,0,0,4,8,1690,1690,1963,0,98004,47.6395,-122.211,3260,19809,16641,16549,67.24938814245043,0.16674098360655737,Cheap
20150316T000000,747000.0,3,1.5,1710,5120,2.0,0,0,4,7,1710,0,1920,0,98115,47.6801,-122.305,1530,5170,3410,3640,145.8984375,0.08813114754098361,Very Cheap
20140822T000000,395000.0,3,1.75,1740,6220,1.0,0,0,4,6,1740,0,1954,0,98177,47.762,-122.362,1630,8418,4480,6788,63.5048231511254,0.0419672131147541,Very Cheap
20141006T000000,505000.0,3,2.5,1995,1483,3.0,0,0,3,8,1760,235,2005,0,98102,47.6025,-122.31,1520,1173,-512,-347,340.5259608900877,0.05639344262295082,Very Cheap
20141017T000000,215000.0,3,2.0,1760,9282,1.0,0,0,5,7,1100,660,1947,0,98001,47.3413,-122.29,1730,7500,7522,5770,23.163111398405515,0.018360655737704918,Very Cheap
20150116T000000,775000.0,4,3.5,3970,210830,2.0,0,0,3,9,3970,0,2000,0,98045,47.4614,-121.713,1680,42665,206860,40985,3.67594744580942,0.09180327868852459,Very Cheap
20141027T000000,540000.0,4,2.5,3000,5471,2.0,0,0,3,8,3000,0,2013,0,98059,47.4797,-122.126,2730,5471,2471,2741,98.70224821787608,0.06098360655737705,Very Cheap
20141119T000000,392500.0,3,1.75,1540,8925,1.0,0,0,4,7,1540,0,1957,0,98133,47.7762,-122.337,1620,10397,7385,8777,43.977591036414566,0.04163934426229508,Very Cheap
20141215T000000,987000.0,3,2.0,2160,15788,1.0,0,0,3,8,2160,0,1951,0,98004,47.6227,-122.207,2260,9787,13628,7527,62.51583481124905,0.11960655737704919,Cheap
20150512T000000,1190000.0,3,2.0,2160,15788,1.0,0,0,3,8,2160,0,1951,0,98004,47.6227,-122.207,2260,9787,13628,7527,75.37370154547757,0.14622950819672131,Cheap
20141113T000000,252500.0,3,2.0,1810,10684,2.0,0,0,3,8,1810,0,1987,0,98058,47.4619,-122.153,2140,9657,8874,7517,23.633470610258332,0.023278688524590165,Very Cheap
20150423T000000,730000.0,3,3.5,2440,3502,2.0,0,0,3,7,1970,470,2000,0,98005,47.589,-122.165,2440,3417,1062,977,208.45231296402056,0.0859016393442623,Very Cheap
20140505T000000,497300.0,6,2.75,3200,9200,1.0,0,2,4,8,1600,1600,1953,0,98146,47.492,-122.364,2220,9500,6000,7280,54.05434782608695,0.05538360655737705,Very Cheap
20140924T000000,640000.0,4,2.5,2970,34981,2.0,0,0,3,9,2970,0,1998,0,98077,47.7365,-122.037,3170,30277,32011,27107,18.295646207941456,0.0740983606557377,Very Cheap
20140513T000000,580000.0,5,2.0,2290,7125,1.0,0,0,3,7,1190,1100,1964,0,98008,47.634,-122.119,1460,7920,4835,6460,81.40350877192982,0.06622950819672131,Very Cheap
20140818T000000,377000.0,3,1.75,1820,34800,1.0,0,0,4,6,1820,0,1967,0,98027,47.4616,-121.98,2570,52707,32980,50137,10.833333333333334,0.03960655737704918,Very Cheap
20140606T000000,1280000.0,4,3.5,3010,3600,2.0,0,0,3,9,2370,640,1999,0,98112,47.6341,-122.284,2650,4200,590,1550,355.55555555555554,0.1580327868852459,Cheap
20140812T000000,396500.0,3,1.5,1360,1488,2.0,0,0,3,7,1120,240,2003,0,98199,47.6526,-122.384,1360,1573,128,213,266.46505376344084,0.04216393442622951,Very Cheap
20140731T000000,300000.0,4,2.5,2080,2999,2.0,0,0,3,8,2080,0,1998,0,98059,47.4909,-122.157,1630,3148,919,1518,100.03334444814938,0.029508196721311476,Very Cheap
20150312T000000,532000.0,3,1.0,1110,4800,1.5,0,0,3,7,1110,0,1946,0,98117,47.6857,-122.378,1510,4320,3690,2810,110.83333333333333,0.059934426229508196,Very Cheap
20150113T000000,579000.0,2,1.75,1560,4500,1.0,0,0,3,8,1560,0,2004,0,98053,47.7128,-122.032,1860,4500,2940,2640,128.66666666666666,0.06609836065573771,Very Cheap
20150325T000000,1400000.0,4,2.5,3520,7815,2.0,0,3,3,10,3140,380,1929,0,98199,47.6429,-122.412,2790,6644,4295,3854,179.14267434420987,0.1737704918032787,Cheap
20141022T000000,571000.0,5,1.75,2280,43560,1.0,0,1,4,8,1380,900,1949,0,98166,47.4558,-122.362,1940,17664,41280,15724,13.108356290174472,0.06504918032786886,Very Cheap
20140718T000000,301950.0,3,1.75,1370,9288,1.0,0,0,4,7,1370,0,1988,0,98059,47.4824,-122.152,1500,9864,7918,8364,32.50968992248062,0.02976393442622951,Very Cheap
20140612T000000,660000.0,3,3.0,2340,2970,2.0,0,0,5,8,2160,180,1925,0,98103,47.6868,-122.348,1370,4000,630,2630,222.22222222222223,0.07672131147540984,Very Cheap
20140611T000000,455000.0,4,2.5,3170,10688,2.0,0,2,3,9,3170,0,2001,0,98001,47.3179,-122.257,3100,12610,7518,9510,42.571107784431135,0.049836065573770495,Very Cheap
20141216T000000,375000.0,3,1.75,1380,5060,1.0,0,0,3,7,1380,0,1986,0,98133,47.7059,-122.341,1030,5060,3680,4030,74.11067193675889,0.03934426229508197,Very Cheap
20150115T000000,470000.0,4,2.5,2700,6769,2.0,0,0,3,9,2700,0,1999,0,98042,47.3753,-122.155,2880,7968,4069,5088,69.43418525631556,0.05180327868852459,Very Cheap
20150331T000000,374990.0,3,2.5,1300,10484,2.0,0,0,3,8,1300,0,1983,0,98028,47.7768,-122.268,1380,7868,9184,6488,35.76783670354826,0.03934295081967213,Very Cheap
20150417T000000,541500.0,2,2.5,1900,3690,2.0,0,0,3,8,1900,0,2006,0,98053,47.7082,-122.019,1900,5153,1790,3253,146.7479674796748,0.06118032786885246,Very Cheap
20150424T000000,782500.0,3,2.5,3750,7821,2.0,0,0,3,9,3750,0,2001,0,98074,47.6325,-122.064,3210,8405,4071,5195,100.05114435494183,0.09278688524590165,Very Cheap
20150507T000000,264000.0,3,2.25,1552,3677,2.0,0,0,3,7,1552,0,2012,0,98092,47.3205,-122.178,1677,3677,2125,2000,71.79766113679631,0.02478688524590164,Very Cheap
20140715T000000,640000.0,4,2.5,2500,7417,2.0,0,0,3,9,2500,0,1991,0,98074,47.6251,-122.026,2770,8188,4917,5418,86.2882567075637,0.0740983606557377,Very Cheap
20150213T000000,660000.0,3,2.0,1770,8141,1.0,0,0,5,8,1770,0,1952,0,98177,47.7232,-122.371,1770,8100,6371,6330,81.0711214838472,0.07672131147540984,Very Cheap
20140611T000000,1365000.0,5,3.5,4210,17258,2.0,0,3,3,12,4210,0,1995,0,98006,47.553,-122.114,4630,17909,13048,13279,79.09375362150887,0.16918032786885245,Cheap
20150317T000000,389950.0,3,2.5,2170,8140,2.0,0,0,3,9,2170,0,1994,0,98030,47.385,-122.169,2390,8100,5970,5710,47.9054054054054,0.04130491803278689,Very Cheap
20150304T000000,226000.0,2,1.0,1510,19874,1.0,0,0,3,7,1510,0,1951,0,98146,47.4924,-122.34,1540,10000,18364,8460,11.371641340444802,0.01980327868852459,Very Cheap
20140808T000000,390000.0,3,1.75,1870,40250,1.0,0,0,5,7,1870,0,1959,0,98038,47.4038,-122.036,1870,40250,38380,38380,9.68944099378882,0.04131147540983607,Very Cheap
20150223T000000,485000.0,3,2.25,1570,8111,2.0,0,0,3,8,1570,0,1984,0,98074,47.6324,-122.028,1990,7875,6541,5885,59.79533966218715,0.05377049180327869,Very Cheap
20150413T000000,840000.0,4,2.5,2480,4602,2.0,0,0,3,9,2480,0,2000,0,98052,47.6835,-122.161,3480,5739,2122,2259,182.52933507170795,0.10032786885245902,Cheap
20140926T000000,600000.0,5,3.5,3580,21343,1.5,0,0,4,8,2140,1440,1937,0,98155,47.7646,-122.302,2430,21343,17763,18913,28.11226163144825,0.06885245901639345,Very Cheap
20140819T000000,331000.0,2,1.0,1480,6210,1.0,0,0,3,7,1080,400,1950,0,98133,47.774,-122.351,1290,7509,4730,6219,53.30112721417069,0.03357377049180328,Very Cheap
20141016T000000,780000.0,3,2.0,2610,6000,1.0,0,0,5,7,1310,1300,1941,0,98115,47.675,-122.289,2330,4800,3390,2470,130.0,0.09245901639344262,Very Cheap
20141015T000000,300000.0,3,1.75,1700,8481,2.0,0,0,3,7,1700,0,1993,0,98003,47.2623,-122.305,1830,6600,6781,4770,35.373187124159884,0.029508196721311476,Very Cheap
20140917T000000,361810.0,3,1.75,1240,7620,1.0,0,0,3,7,1240,0,1968,2014,98166,47.4576,-122.348,1150,7620,6380,6470,47.481627296587924,0.0376144262295082,Very Cheap
20140515T000000,467000.0,3,1.0,1660,6582,1.0,0,0,5,7,1000,660,1946,0,98133,47.7169,-122.353,1110,6584,4922,5474,70.95107869948345,0.05140983606557377,Very Cheap
20141226T000000,399000.0,3,1.75,1620,10000,1.5,0,0,5,6,1620,0,1918,0,98178,47.5091,-122.262,1880,10000,8380,8120,39.9,0.042491803278688525,Very Cheap
20141015T000000,315450.0,3,1.75,1130,7500,1.5,0,0,4,7,1130,0,1908,0,98108,47.5254,-122.318,1240,6000,6370,4760,42.06,0.031534426229508195,Very Cheap
20150501T000000,600000.0,3,1.0,1310,5000,1.5,0,0,3,7,1310,0,1906,0,98103,47.6624,-122.347,1530,4800,3690,3270,120.0,0.06885245901639345,Very Cheap
20150325T000000,247500.0,4,2.0,1710,5200,1.0,0,0,4,7,910,800,1977,0,98042,47.3634,-122.09,1560,5200,3490,3640,47.59615384615385,0.02262295081967213,Very Cheap
20150130T000000,330000.0,3,1.0,2140,5037,1.0,0,0,3,7,2140,0,1957,0,98118,47.5494,-122.274,1630,6054,2897,4424,65.51518761167361,0.03344262295081967,Very Cheap
20140826T000000,500000.0,4,2.25,2350,7210,1.5,0,0,4,7,2350,0,1972,0,98011,47.7407,-122.183,1930,7519,4860,5589,69.34812760055479,0.05573770491803279,Very Cheap
20140820T000000,367500.0,3,1.0,1570,10050,1.0,0,0,3,7,1570,0,1963,0,98028,47.736,-122.231,2540,9940,8480,7400,36.56716417910448,0.03836065573770492,Very Cheap
20140912T000000,560000.0,3,2.5,2780,32880,1.0,0,0,3,9,2780,0,1993,0,98045,47.4798,-121.727,2780,40091,30100,37311,17.0316301703163,0.06360655737704918,Very Cheap
20140806T000000,655000.0,4,1.75,2540,7620,1.0,0,3,3,8,1320,1220,1948,0,98116,47.5709,-122.406,2540,8613,5080,6073,85.95800524934383,0.0760655737704918,Very Cheap
20141018T000000,530000.0,5,2.75,2500,7140,1.0,0,0,4,7,1250,1250,1968,0,98008,47.6225,-122.108,2230,8400,4640,6170,74.2296918767507,0.05967213114754098,Very Cheap
20150512T000000,270000.0,3,2.25,2080,26574,1.0,0,2,3,7,1380,700,1993,0,98002,47.2846,-122.192,1770,8140,24494,6370,10.160307067058026,0.025573770491803278,Very Cheap
20141125T000000,437500.0,3,2.0,1760,2875,2.0,0,2,3,7,1290,470,1988,0,98126,47.5602,-122.378,1760,4830,1115,3070,152.17391304347825,0.047540983606557376,Very Cheap
20150203T000000,575000.0,3,1.75,1760,10349,1.0,0,0,3,8,1760,0,1957,0,98005,47.6347,-122.173,1970,10933,8589,8963,55.56092376074983,0.06557377049180328,Very Cheap
20141107T000000,278000.0,4,2.5,1940,6887,2.0,0,0,3,7,1940,0,1990,0,98023,47.2911,-122.353,1870,6144,4947,4274,40.365906780891535,0.02662295081967213,Very Cheap
20140904T000000,568500.0,4,2.5,3010,6181,2.0,0,0,3,9,3010,0,2000,0,98056,47.5212,-122.192,2960,6515,3171,3555,91.97540850994984,0.06472131147540984,Very Cheap
20150326T000000,280000.0,4,3.0,2460,9606,1.0,0,0,3,8,2460,0,2012,0,98168,47.4889,-122.317,1730,7500,7146,5770,29.148448886112845,0.026885245901639345,Very Cheap
20140819T000000,250000.0,2,1.0,750,6350,1.0,0,0,3,5,750,0,1920,0,98103,47.6938,-122.356,920,6350,5600,5430,39.37007874015748,0.022950819672131147,Very Cheap
20150318T000000,247500.0,3,0.75,1300,72309,1.0,0,0,3,6,680,620,1950,1987,98006,47.567,-122.124,3080,8395,71009,5315,3.422810438534622,0.02262295081967213,Very Cheap
20141204T000000,1250000.0,5,2.75,3710,13874,1.5,0,3,4,9,2340,1370,1977,0,98006,47.5686,-122.154,3370,13874,10164,10504,90.09658353755226,0.1540983606557377,Cheap
20141015T000000,535000.0,4,2.5,2360,15008,1.0,0,0,3,9,1920,440,1986,0,98028,47.7363,-122.254,2680,15344,12648,12664,35.64765458422175,0.06032786885245902,Very Cheap
20140711T000000,814842.0,3,2.5,3190,6899,2.0,0,0,3,9,3190,0,2014,0,98034,47.7153,-122.221,3190,6899,3709,3709,118.11016089288303,0.09702845901639344,Very Cheap
20150213T000000,340000.0,4,2.5,2181,5521,2.0,0,0,3,8,2181,0,2006,0,98001,47.3503,-122.291,2333,5143,3340,2810,61.583046549538125,0.03475409836065574,Very Cheap
20140610T000000,359950.0,3,1.75,1890,9100,2.0,0,0,4,7,1890,0,1952,0,98133,47.7676,-122.339,1640,9100,7210,7460,39.55494505494506,0.037370491803278685,Very Cheap
20140621T000000,750000.0,3,1.75,2610,5544,1.5,0,0,3,8,1680,930,1934,0,98117,47.684,-122.376,1330,5074,2934,3744,135.28138528138527,0.08852459016393442,Very Cheap
20140926T000000,1220000.0,4,2.0,3090,8125,2.5,0,0,5,8,3090,0,1918,0,98117,47.6851,-122.395,1560,6250,5035,4690,150.15384615384616,0.1501639344262295,Cheap
20140703T000000,370000.0,2,1.0,860,5040,1.0,0,0,3,7,860,0,1956,0,98117,47.6977,-122.365,1570,5040,4180,3470,73.41269841269842,0.038688524590163934,Very Cheap
20150415T000000,329950.0,3,1.0,1000,9170,1.0,0,0,3,7,1000,0,1980,0,98058,47.4405,-122.134,1610,9170,8170,7560,35.9814612868048,0.03343606557377049,Very Cheap
20150102T000000,500000.0,3,2.5,2760,35171,2.0,0,0,3,9,2760,0,1990,0,98058,47.465,-122.123,2720,35171,32411,32451,14.216257712319809,0.05573770491803279,Very Cheap
20140918T000000,734000.0,4,2.5,3490,18521,2.0,0,0,4,9,3490,0,1990,0,98077,47.7406,-122.07,2850,18521,15031,15671,39.63068948760866,0.08642622950819673,Very Cheap
20140616T000000,385000.0,4,2.5,2960,5054,2.0,0,0,3,9,2960,0,2006,0,98038,47.3601,-122.035,2960,5000,2094,2040,76.17728531855956,0.04065573770491803,Very Cheap
20150420T000000,230000.0,2,1.0,1280,4635,1.0,0,0,3,6,840,440,1917,0,98118,47.5532,-122.28,1660,6180,3355,4520,49.622437971952536,0.020327868852459016,Very Cheap
20140730T000000,1385000.0,4,3.5,3230,7200,1.0,0,1,3,10,1640,1590,2000,0,98033,47.6838,-122.212,2660,7200,3970,4540,192.36111111111111,0.1718032786885246,Cheap
20141218T000000,210000.0,3,2.0,1830,4992,1.0,0,0,3,7,1230,600,1953,0,98118,47.5145,-122.27,2050,7740,3162,5690,42.06730769230769,0.017704918032786884,Very Cheap
20140731T000000,293000.0,3,1.75,1420,13187,1.0,0,0,4,7,1420,0,1974,0,98059,47.4608,-122.065,1620,13824,11767,12204,22.21885189959809,0.02859016393442623,Very Cheap
20141030T000000,465000.0,3,1.0,1580,3774,1.5,0,0,3,6,1580,0,1900,0,98117,47.6839,-122.361,1580,3860,2194,2280,123.2114467408585,0.051147540983606556,Very Cheap
20150112T000000,449000.0,3,2.25,1960,44634,1.0,0,0,3,7,1130,830,1984,0,98028,47.7769,-122.253,1970,44634,42674,42664,10.059595823811444,0.049049180327868855,Very Cheap
20150414T000000,325000.0,2,1.75,1670,10725,1.0,0,0,3,7,1670,0,1965,0,98178,47.4893,-122.229,1600,10725,9055,9125,30.303030303030305,0.03278688524590164,Very Cheap
20140819T000000,180000.0,3,2.0,1670,7056,1.0,0,0,4,7,1670,0,1958,0,98002,47.3139,-122.212,1330,8415,5386,7085,25.510204081632654,0.01377049180327869,Very Cheap
20150413T000000,650000.0,6,3.0,2960,5000,1.0,0,0,3,8,1790,1170,1968,0,98103,47.6971,-122.341,1280,1251,2040,-29,130.0,0.07540983606557378,Very Cheap
20140924T000000,665000.0,4,2.75,2420,7102,1.0,0,0,5,7,1670,750,1946,0,98177,47.7042,-122.371,1620,7102,4682,5482,93.6355956068713,0.07737704918032787,Very Cheap
20141017T000000,324450.0,3,2.0,1420,16000,1.0,0,0,3,7,1420,0,1966,0,98166,47.478,-122.358,1900,12630,14580,10730,20.278125,0.03271475409836066,Very Cheap
20150306T000000,588000.0,4,1.75,2170,5750,1.0,0,2,3,7,1370,800,1975,0,98116,47.5668,-122.383,1450,5750,3580,4300,102.26086956521739,0.06727868852459017,Very Cheap
20140521T000000,200000.0,4,1.0,1310,5200,1.5,0,0,3,6,1160,150,1945,0,98126,47.5384,-122.37,1090,5180,3890,4090,38.46153846153846,0.01639344262295082,Very Cheap
20140905T000000,383000.0,4,1.75,1830,11090,1.0,0,0,3,7,1060,770,1962,0,98028,47.7333,-122.246,1990,10917,9260,8927,34.5356176735798,0.04039344262295082,Very Cheap
20141215T000000,499950.0,3,2.0,1360,2500,1.0,0,0,3,7,730,630,1986,0,98107,47.6753,-122.363,1630,5000,1140,3370,199.98,0.05573114754098361,Very Cheap
20150421T000000,549000.0,5,2.5,3440,12350,1.0,0,2,4,9,1760,1680,1976,0,98003,47.3427,-122.325,3440,12763,8910,9323,44.45344129554656,0.06216393442622951,Very Cheap
20150122T000000,465000.0,5,3.0,2010,7264,1.0,0,0,3,7,1290,720,1990,0,98103,47.6945,-122.33,1510,7326,5254,5816,64.01431718061674,0.051147540983606556,Very Cheap
20140814T000000,450000.0,3,2.5,2450,19744,2.0,0,0,3,10,2450,0,1990,0,98038,47.3746,-122.026,2650,19597,17294,16947,22.791734197730957,0.04918032786885246,Very Cheap
20150423T000000,799900.0,4,2.5,3030,7800,2.0,0,0,3,9,1580,1450,1991,0,98033,47.689,-122.196,2840,7435,4770,4595,102.55128205128206,0.09506885245901639,Very Cheap
20150406T000000,495000.0,4,2.5,2480,91911,1.0,0,2,4,7,1470,1010,1973,0,98027,47.4579,-121.981,2540,91911,89431,89371,5.385644808564807,0.05508196721311476,Very Cheap
20140822T000000,1200000.0,3,3.5,4310,10842,2.0,0,2,3,10,3140,1170,1988,0,98177,47.7735,-122.386,2280,11106,6532,8826,110.68068622025457,0.14754098360655737,Cheap
20150223T000000,637000.0,4,2.5,2120,15000,2.0,0,0,4,8,2120,0,1983,0,98052,47.7159,-122.1,2170,15000,12880,12830,42.46666666666667,0.07370491803278688,Very Cheap
20141216T000000,589000.0,4,1.0,2210,4366,2.0,0,0,3,8,2210,0,1901,0,98122,47.6105,-122.309,1740,1745,2156,5,134.90609253321117,0.06740983606557377,Very Cheap
20140724T000000,305000.0,3,1.75,1400,10350,1.0,0,0,4,7,1400,0,1976,0,98059,47.479,-122.132,1780,10457,8950,8677,29.468599033816425,0.03016393442622951,Very Cheap
20150331T000000,600000.0,4,2.25,2760,5200,2.0,0,0,3,7,1790,970,1910,2003,98144,47.589,-122.313,1310,2059,2440,749,115.38461538461539,0.06885245901639345,Very Cheap
20140531T000000,587000.0,4,2.5,2550,6256,2.0,0,0,3,9,2550,0,1992,0,98072,47.7742,-122.166,2460,8256,3706,5796,93.82992327365729,0.06714754098360656,Very Cheap
20140505T000000,1425000.0,2,2.5,2220,4000,2.0,0,0,3,9,2220,0,2000,0,98112,47.6364,-122.28,1870,4000,1780,2130,356.25,0.17704918032786884,Cheap
20150312T000000,250000.0,4,1.0,1320,11212,1.0,0,0,5,6,1320,0,1914,0,98002,47.3098,-122.209,1060,6766,9892,5706,22.297538351765965,0.022950819672131147,Very Cheap
20150424T000000,515000.0,3,3.0,2440,3202,2.0,0,0,4,8,1640,800,1982,0,98133,47.7152,-122.342,2440,3200,762,760,160.8369768894441,0.057704918032786885,Very Cheap
20140509T000000,833000.0,4,2.75,3780,10308,2.0,0,0,3,10,3780,0,1999,0,98075,47.589,-121.983,3500,10740,6528,7240,80.81102056655025,0.09940983606557377,Very Cheap
20140604T000000,860000.0,3,3.25,4720,32467,2.0,0,2,3,10,3190,1530,1998,0,98059,47.508,-122.113,3260,26386,27747,23126,26.48843441032433,0.10295081967213114,Cheap
20140908T000000,550000.0,4,3.0,2360,6678,1.0,0,0,3,8,1760,600,1949,0,98115,47.6919,-122.313,1640,6380,4318,4740,82.35998802036538,0.06229508196721312,Very Cheap
20150319T000000,180000.0,2,1.0,890,6000,1.0,0,0,2,6,890,0,1919,0,98178,47.4976,-122.225,1100,6000,5110,4900,30.0,0.01377049180327869,Very Cheap
20140618T000000,507000.0,4,1.75,1770,9375,1.0,0,0,4,7,1170,600,1968,0,98052,47.6935,-122.112,1540,9375,7605,7835,54.08,0.05665573770491803,Very Cheap
20140827T000000,427000.0,3,2.0,1720,128066,1.0,0,0,3,7,1720,0,1994,0,98027,47.4487,-121.981,2360,111078,126346,108718,3.334218293692315,0.04616393442622951,Very Cheap
20141120T000000,616950.0,3,3.5,2490,2722,2.0,0,0,3,8,2020,470,1999,0,98005,47.5893,-122.165,2490,2755,232,265,226.65319617927994,0.07107540983606557,Very Cheap
20140715T000000,372000.0,4,1.75,1890,10550,1.0,0,0,5,7,1010,880,1969,0,98056,47.5147,-122.193,1930,7291,8660,5361,35.26066350710901,0.03895081967213115,Very Cheap
20141006T000000,290000.0,2,1.0,1020,6380,1.0,0,0,3,7,1020,0,1930,1973,98115,47.6971,-122.317,1380,6380,5360,5000,45.45454545454545,0.02819672131147541,Very Cheap
20150309T000000,329990.0,4,2.75,2420,8438,2.0,0,0,3,8,2420,0,1997,0,98022,47.2089,-122.011,2270,8770,6018,6500,39.10760843801849,0.03344131147540984,Very Cheap
20141013T000000,393500.0,3,1.75,1600,8156,1.0,0,0,5,7,1600,0,1948,0,98155,47.7397,-122.3,1200,8156,6556,6956,48.246689553702794,0.041770491803278686,Very Cheap
20140513T000000,1550000.0,5,3.25,3370,17458,1.0,0,2,5,10,2000,1370,1982,0,98040,47.5591,-122.229,4240,15202,14088,10962,88.78451139878565,0.19344262295081968,Cheap
20140522T000000,240000.0,4,2.25,1720,8300,1.0,0,0,4,8,1720,0,1973,0,98023,47.3192,-122.385,2010,8000,6580,5990,28.91566265060241,0.021639344262295083,Very Cheap
20140513T000000,285000.0,3,1.0,1090,8640,1.0,0,0,4,6,1090,0,1973,0,98166,47.459,-122.355,1260,8400,7550,7140,32.986111111111114,0.02754098360655738,Very Cheap
20150414T000000,382500.0,3,1.5,1090,9862,1.0,0,0,3,8,1090,0,1987,0,98074,47.6256,-122.036,1710,9862,8772,8152,38.78523626039343,0.040327868852459016,Very Cheap
20150331T000000,1925000.0,4,3.75,3600,16101,1.0,0,0,3,9,3600,0,1951,0,98112,47.6308,-122.287,3650,9506,12501,5856,119.55779144152537,0.24262295081967214,Cheap
20140829T000000,800000.0,3,2.5,2760,9471,1.0,0,2,3,8,1760,1000,1956,0,98115,47.676,-122.272,3040,6765,6711,3725,84.46837715130398,0.09508196721311475,Very Cheap
20150402T000000,550000.0,4,3.5,2770,24140,2.0,0,0,3,8,2770,0,1967,0,98033,47.6585,-122.186,1720,16011,21370,14291,22.783761391880695,0.06229508196721312,Very Cheap
20141215T000000,387846.0,4,1.75,2520,15205,1.0,0,0,4,7,2040,480,1954,0,98028,47.7642,-122.264,1680,10000,12685,8320,25.507793488983886,0.04102898360655738,Very Cheap
20140821T000000,367500.0,4,2.0,1960,16015,1.0,0,0,3,7,1960,0,1980,0,98002,47.33,-122.22,1960,16015,14055,14055,22.947236965344988,0.03836065573770492,Very Cheap
20140804T000000,780500.0,5,1.0,1760,4264,2.0,0,0,3,8,1760,0,1902,0,98112,47.6246,-122.312,2130,4264,2504,2134,183.04409005628517,0.09252459016393443,Very Cheap
20150505T000000,680000.0,3,1.75,1090,6775,1.0,0,0,4,7,850,240,1950,0,98115,47.6934,-122.321,1580,5760,5685,4180,100.3690036900369,0.07934426229508197,Very Cheap
20141224T000000,434400.0,5,1.75,1960,7875,1.0,0,0,4,7,1960,0,1968,0,98034,47.7256,-122.18,1800,7764,5915,5964,55.161904761904765,0.0471344262295082,Very Cheap
20140612T000000,370000.0,2,1.0,1220,17172,1.0,0,0,4,6,1220,0,1947,0,98033,47.6934,-122.163,1510,12915,15952,11405,21.546703936641045,0.038688524590163934,Very Cheap
20150313T000000,465000.0,3,1.75,1730,8073,1.0,0,0,3,8,1350,380,1971,0,98177,47.7694,-122.367,2500,8073,6343,5573,57.599405425492385,0.051147540983606556,Very Cheap
20150327T000000,323000.0,3,2.0,1830,6925,1.0,0,0,4,8,1830,0,1979,0,98058,47.4445,-122.123,2010,7350,5095,5340,46.64259927797834,0.03252459016393443,Very Cheap
20150105T000000,270000.0,4,2.5,1600,9921,2.0,0,0,3,7,1600,0,2009,0,98042,47.3678,-122.124,2140,5806,8321,3666,27.214998488055638,0.025573770491803278,Very Cheap
20141219T000000,1320000.0,3,1.75,2040,42693,1.0,0,2,3,10,2040,0,1980,0,98052,47.6479,-122.12,2640,11957,40653,9317,30.91841753917504,0.16327868852459015,Cheap
20140627T000000,560000.0,4,2.5,2710,6583,2.0,0,0,3,9,2710,0,2003,0,98059,47.4922,-122.141,2710,6583,3873,3873,85.06759835941061,0.06360655737704918,Very Cheap
20150428T000000,450000.0,3,1.0,1140,4500,1.0,0,0,3,6,840,300,1907,0,98144,47.5897,-122.314,1150,3000,3360,1850,100.0,0.04918032786885246,Very Cheap
20140626T000000,290000.0,2,1.0,930,7740,1.0,0,0,3,6,930,0,1924,0,98125,47.7091,-122.292,1250,7740,6810,6490,37.46770025839793,0.02819672131147541,Very Cheap
20140924T000000,354000.0,3,2.0,1010,21340,1.0,0,0,3,8,1010,0,1980,0,98074,47.6223,-122.043,1700,13045,20330,11345,16.588566073102154,0.03659016393442623,Very Cheap
20150304T000000,705000.0,5,3.0,2380,5000,2.0,0,0,5,7,2380,0,1909,0,98107,47.6722,-122.389,1800,4650,2620,2850,141.0,0.08262295081967214,Very Cheap
20140808T000000,445000.0,3,2.25,1860,7200,1.0,0,0,4,7,1240,620,1977,0,98034,47.7332,-122.192,1560,7630,5340,6070,61.80555555555556,0.04852459016393443,Very Cheap
20140721T000000,229900.0,3,1.0,1440,11925,1.0,0,0,3,7,1440,0,1968,0,98003,47.2738,-122.3,1440,10425,10485,8985,19.27882599580713,0.020314754098360657,Very Cheap
20150310T000000,610000.0,4,2.5,2980,5896,2.0,0,0,3,8,2980,0,2001,0,98053,47.6872,-122.036,2900,5712,2916,2812,103.45997286295794,0.07016393442622951,Very Cheap
20141210T000000,535000.0,3,3.25,2670,5108,2.0,0,2,3,9,2670,0,2000,0,98065,47.5342,-121.866,2670,6500,2438,3830,104.73766640563821,0.06032786885245902,Very Cheap
20150204T000000,437400.0,3,1.75,2150,8925,1.0,0,0,4,7,2150,0,1960,0,98008,47.6253,-122.119,1100,7875,6775,6775,49.00840336134454,0.047527868852459014,Very Cheap
20140812T000000,540000.0,5,2.75,3160,10059,2.0,0,0,3,10,1740,1420,1978,0,98011,47.7477,-122.217,3120,11557,6899,8437,53.68326871458395,0.06098360655737705,Very Cheap
20140630T000000,570000.0,3,2.0,1890,29185,1.0,0,0,3,7,1470,420,1949,2013,98006,47.5621,-122.168,2580,11600,27295,9020,19.530580777796814,0.06491803278688525,Very Cheap
20141009T000000,533000.0,3,2.5,2810,4607,2.0,0,0,3,8,2810,0,2004,0,98011,47.7735,-122.227,2540,4871,1797,2331,115.69350987627523,0.060065573770491806,Very Cheap
20150403T000000,555000.0,3,2.5,2690,4819,2.0,0,0,3,7,2690,0,2004,0,98065,47.5302,-121.849,2360,4829,2129,2469,115.16912222452791,0.06295081967213115,Very Cheap
20140623T000000,239950.0,3,1.75,1230,9600,1.0,0,0,4,7,1230,0,1984,0,98042,47.3675,-122.095,1330,8250,8370,6920,24.994791666666668,0.021632786885245902,Very Cheap
20150108T000000,350000.0,3,1.0,950,9451,1.0,0,0,4,7,950,0,1977,0,98034,47.7308,-122.19,1480,8352,8501,6872,37.03311818855148,0.036065573770491806,Very Cheap
20140616T000000,245000.0,2,1.0,1200,4880,1.0,0,0,3,6,980,220,1943,0,98106,47.5276,-122.346,1040,4880,3680,3840,50.204918032786885,0.022295081967213116,Very Cheap
20140605T000000,456000.0,4,1.75,1670,9886,1.0,0,0,5,7,1670,0,1947,0,98125,47.7249,-122.287,2590,9997,8216,7407,46.12583451345337,0.0499672131147541,Very Cheap
20140813T000000,465000.0,4,2.25,2140,7701,1.0,0,0,4,7,1470,670,1977,0,98034,47.7213,-122.171,2130,8050,5561,5920,60.381768601480324,0.051147540983606556,Very Cheap
20150107T000000,445000.0,2,1.75,1440,4660,1.0,0,2,3,8,1440,0,2008,0,98053,47.7092,-122.015,1680,4989,3220,3309,95.49356223175965,0.04852459016393443,Very Cheap
20140728T000000,517850.0,5,2.75,3050,7500,1.0,0,0,4,8,1800,1250,1966,0,98034,47.7249,-122.187,2060,7848,4450,5788,69.04666666666667,0.058078688524590166,Very Cheap
20140930T000000,329000.0,5,2.75,2570,7260,2.0,0,0,3,8,2570,0,1996,0,98092,47.2622,-122.212,2200,7421,4690,5221,45.3168044077135,0.03331147540983607,Very Cheap
20140515T000000,512500.0,3,2.5,1840,2875,2.0,0,0,4,7,1840,0,1997,0,98116,47.562,-122.393,1240,5750,1035,4510,178.2608695652174,0.05737704918032787,Very Cheap
20140604T000000,365000.0,2,1.0,1250,8100,1.0,0,0,4,7,1250,0,1947,0,98125,47.7294,-122.329,1710,8100,6850,6390,45.06172839506173,0.0380327868852459,Very Cheap
20150320T000000,450500.0,3,1.0,1410,9384,1.0,0,0,3,7,1410,0,1948,0,98133,47.7161,-122.33,1990,9384,7974,7394,48.007246376811594,0.04924590163934426,Very Cheap
20141016T000000,915000.0,3,1.0,1560,8232,1.0,0,0,3,7,1560,0,1952,0,98004,47.623,-122.205,1930,8286,6672,6356,111.15160349854227,0.11016393442622952,Cheap
20140620T000000,205000.0,3,1.0,960,7314,1.0,0,0,5,6,960,0,1960,0,98002,47.2891,-122.221,990,7314,6354,6324,28.02843861088324,0.017049180327868854,Very Cheap
20140811T000000,314000.0,4,2.5,1870,8449,2.0,0,0,3,8,1870,0,1992,0,98188,47.4435,-122.274,2160,8113,6579,5953,37.16416143922358,0.03134426229508197,Very Cheap
20140702T000000,496000.0,2,1.0,900,9260,1.0,0,0,3,7,900,0,1946,0,98107,47.6695,-122.36,1230,6913,8360,5683,53.563714902807774,0.05521311475409836,Very Cheap
20150416T000000,329950.0,4,1.0,2050,7590,1.0,0,0,3,7,1280,770,1957,0,98178,47.4916,-122.224,2050,7800,5540,5750,43.47167325428195,0.03343606557377049,Very Cheap
20140616T000000,375000.0,4,2.0,2400,6000,2.0,0,0,3,6,2400,0,1913,1945,98011,47.7607,-122.209,1780,8732,3600,6952,62.5,0.03934426229508197,Very Cheap
20140620T000000,623000.0,3,2.5,1850,7777,2.0,0,0,5,8,1850,0,1989,0,98033,47.6908,-122.169,1850,8482,5927,6632,80.10801080108011,0.07186885245901639,Very Cheap
20140619T000000,310000.0,4,1.5,1220,9600,1.0,0,0,3,6,1220,0,1980,0,98014,47.6462,-121.909,1180,9000,8380,7820,32.291666666666664,0.03081967213114754,Very Cheap
20150304T000000,532500.0,3,3.25,3140,37120,1.0,0,0,3,9,1760,1380,1984,0,98065,47.5244,-121.842,2100,13500,33980,11400,14.345366379310345,0.06,Very Cheap
20140528T000000,960000.0,4,2.25,2410,4560,2.0,0,2,5,9,1800,610,1929,0,98117,47.6796,-122.402,2150,5100,2150,2950,210.52631578947367,0.1160655737704918,Cheap
20140628T000000,598000.0,4,2.5,3130,40918,2.0,0,0,3,9,3130,0,1994,0,98045,47.4761,-121.723,2760,35440,37788,32680,14.614595043746029,0.06859016393442623,Very Cheap
20140814T000000,683000.0,3,2.5,2300,9218,2.0,0,2,3,9,2300,0,1998,0,98027,47.5504,-122.077,2730,9930,6918,7200,74.09416359297028,0.07973770491803278,Very Cheap
20150217T000000,425000.0,5,2.5,2840,9425,1.0,0,0,4,7,1590,1250,1962,0,98155,47.7609,-122.297,1900,11600,6585,9700,45.09283819628647,0.04590163934426229,Very Cheap
20140506T000000,533000.0,5,2.75,1800,3780,1.5,0,0,3,7,1400,400,1926,0,98103,47.6831,-122.343,1400,3780,1980,2380,141.005291005291,0.060065573770491806,Very Cheap
20140513T000000,375000.0,3,1.0,1190,9486,1.0,0,0,4,7,1190,0,1953,0,98166,47.4319,-122.339,2100,10400,8296,8300,39.53194180898166,0.03934426229508197,Very Cheap
20140604T000000,250500.0,3,2.0,1710,7225,2.0,0,0,4,7,1710,0,1988,0,98023,47.2917,-122.373,1710,7225,5515,5515,34.67128027681661,0.023016393442622952,Very Cheap
20140806T000000,257000.0,4,1.75,1900,22896,1.5,0,0,3,7,1360,540,1922,1990,98010,47.3102,-122.023,1300,8960,20996,7660,11.224668064290706,0.023868852459016394,Very Cheap
20140624T000000,218000.0,3,1.0,880,18205,1.0,0,0,4,6,880,0,1945,0,98178,47.5013,-122.244,1110,16115,17325,15005,11.974732216424059,0.018754098360655738,Very Cheap
20140611T000000,460000.0,3,2.0,2060,4437,1.0,0,0,3,7,1030,1030,1929,0,98126,47.5705,-122.376,1750,4452,2377,2702,103.67365336939373,0.050491803278688525,Very Cheap
20150414T000000,255544.0,3,1.0,1360,6186,1.5,0,0,4,6,760,600,1941,0,98133,47.7503,-122.334,1610,7453,4826,5843,41.31005496281927,0.023677901639344263,Very Cheap
20140914T000000,560000.0,2,2.0,1680,4647,1.0,0,0,3,8,1680,0,2008,0,98053,47.7088,-122.015,1680,4950,2967,3270,120.50785452980418,0.06360655737704918,Very Cheap
20150211T000000,480000.0,4,2.5,2980,4074,2.0,0,0,3,8,2980,0,2011,0,98019,47.734,-121.965,2320,4255,1094,1935,117.82032400589101,0.05311475409836065,Very Cheap
20141010T000000,1300000.0,5,1.75,2130,19180,1.0,0,0,3,8,1500,630,1968,0,98004,47.638,-122.213,3650,19180,17050,15530,67.77893639207508,0.16065573770491803,Cheap
20150426T000000,580000.0,3,2.75,2650,9752,1.0,0,0,3,9,2650,0,1989,0,98028,47.768,-122.259,3030,9910,7102,6880,59.474979491386385,0.06622950819672131,Very Cheap
20140628T000000,475000.0,3,2.5,1700,9100,1.0,0,0,3,8,1160,540,1998,0,98126,47.5369,-122.378,1590,8374,7400,6784,52.1978021978022,0.05245901639344262,Very Cheap
20140630T000000,1309500.0,4,2.5,2680,12215,1.0,1,4,3,9,1590,1090,1956,0,98166,47.4396,-122.353,2960,19964,9535,17004,107.20425706099059,0.1619016393442623,Cheap
20150327T000000,700000.0,3,2.5,2530,623779,1.0,0,0,4,8,2530,0,1980,0,98038,47.4188,-121.949,2120,100623,621249,98503,1.1221923149064013,0.08196721311475409,Very Cheap
20140917T000000,590000.0,3,2.5,2520,10223,2.0,0,0,3,10,2520,0,1988,0,98074,47.631,-122.042,2630,10091,7703,7461,57.71300009781864,0.06754098360655737,Very Cheap
20150222T000000,264500.0,3,2.5,1630,8346,1.0,0,0,3,8,1630,0,1990,0,98092,47.2622,-122.219,2110,8619,6716,6509,31.691828420800384,0.024852459016393443,Very Cheap
20141027T000000,465000.0,2,1.0,730,2600,1.0,0,0,4,6,730,0,1918,0,98107,47.6751,-122.379,1480,3900,1870,2420,178.84615384615384,0.051147540983606556,Very Cheap
20150323T000000,290000.0,3,1.0,910,7620,1.0,0,2,3,7,910,0,1971,0,98106,47.5278,-122.343,1660,7620,6710,5960,38.05774278215223,0.02819672131147541,Very Cheap
20141121T000000,1815000.0,4,4.5,4510,12873,2.0,0,2,3,12,4510,0,1998,0,98033,47.6491,-122.201,2200,8528,8363,6328,140.99277557678863,0.22819672131147542,Cheap
20140615T000000,416000.0,3,1.0,1110,12150,1.0,0,0,4,7,1110,0,1957,0,98008,47.6034,-122.122,1490,8200,11040,6710,34.23868312757202,0.044721311475409836,Very Cheap
20150128T000000,360000.0,4,2.0,1450,8940,1.0,0,0,3,7,1450,0,1962,0,98034,47.7304,-122.24,1310,8914,7490,7604,40.26845637583892,0.037377049180327866,Very Cheap
20140602T000000,585083.0,5,2.75,2910,36250,1.0,0,0,3,8,1590,1320,1977,0,98075,47.5916,-122.076,2910,37376,33340,34466,16.140220689655173,0.06689613114754098,Very Cheap
20140512T000000,840000.0,4,2.75,2600,2750,1.5,0,0,3,7,1620,980,1936,0,98119,47.6413,-122.357,1960,3705,150,1745,305.45454545454544,0.10032786885245902,Cheap
20150324T000000,81000.0,2,1.0,730,9975,1.0,0,0,1,5,730,0,1943,0,98168,47.4808,-122.315,860,9000,9245,8140,8.1203007518797,0.0007868852459016393,Very Cheap
20150130T000000,1285000.0,3,2.25,2440,9200,1.0,0,1,4,8,2440,0,1950,0,98105,47.6629,-122.269,2750,6211,6760,3461,139.67391304347825,0.15868852459016394,Cheap
20141125T000000,326000.0,4,1.75,2290,7380,1.0,0,0,3,7,1390,900,1963,0,98178,47.5034,-122.245,1170,7381,5090,6211,44.173441734417345,0.032918032786885244,Very Cheap
20150224T000000,447000.0,2,1.0,720,7500,1.0,0,2,3,6,720,0,1925,0,98136,47.5185,-122.392,1390,5000,6780,3610,59.6,0.04878688524590164,Very Cheap
20141003T000000,185000.0,3,1.0,940,7125,1.5,0,0,4,7,940,0,1958,0,98032,47.3756,-122.297,1170,7125,6185,5955,25.964912280701753,0.014426229508196721,Very Cheap
20140723T000000,439950.0,3,2.5,1540,7773,2.0,0,0,4,8,1540,0,1982,0,98034,47.722,-122.194,1630,7340,6233,5710,56.59976842917792,0.04786229508196721,Very Cheap
20141001T000000,234000.0,3,1.5,1140,10300,1.5,0,0,4,6,1140,0,1967,0,98045,47.4452,-121.77,1250,9975,9160,8725,22.718446601941746,0.020852459016393442,Very Cheap
20141231T000000,485000.0,4,2.5,2100,8886,2.0,0,0,4,7,2100,0,1964,0,98007,47.5947,-122.134,1840,9058,6786,7218,54.5802385775377,0.05377049180327869,Very Cheap
20140715T000000,750000.0,4,1.75,2670,6250,2.0,0,0,4,8,2020,650,1941,0,98199,47.6499,-122.391,1820,6250,3580,4430,120.0,0.08852459016393442,Very Cheap
20150507T000000,865000.0,4,2.0,2750,5527,2.0,0,0,3,8,2130,620,1901,1987,98119,47.6513,-122.368,1290,1764,2777,474,156.5044327845124,0.10360655737704919,Cheap
20140618T000000,287500.0,4,2.5,2570,9000,1.0,0,0,4,8,1590,980,1979,0,98023,47.2986,-122.372,2120,8571,6430,6451,31.944444444444443,0.027868852459016394,Very Cheap
20140708T000000,375000.0,3,1.75,1660,9673,1.0,0,0,3,7,1130,530,1976,0,98072,47.7628,-122.162,1260,9681,8013,8421,38.767703918122606,0.03934426229508197,Very Cheap
20140905T000000,565000.0,3,2.25,1700,8800,1.0,0,0,5,7,850,850,1969,0,98033,47.6863,-122.189,2180,8960,7100,6780,64.20454545454545,0.06426229508196721,Very Cheap
20150219T000000,260000.0,4,3.0,1530,8306,2.0,0,0,3,7,1530,0,2010,0,98042,47.3528,-122.146,1930,6925,6776,4995,31.302672766674693,0.024262295081967214,Very Cheap
20141017T000000,190000.0,3,1.0,1260,10900,1.0,0,0,4,6,1260,0,1943,0,98056,47.491,-122.188,1090,8137,9640,7047,17.431192660550458,0.015081967213114755,Very Cheap
20140909T000000,399950.0,5,2.0,2760,6420,1.0,0,0,5,7,1380,1380,1964,0,98118,47.5396,-122.276,1400,7112,3660,5712,62.297507788161994,0.04261639344262295,Very Cheap
20150326T000000,275000.0,3,2.5,1830,7062,2.0,0,0,3,7,1830,0,1990,0,98023,47.2895,-122.352,1820,6434,5232,4614,38.940809968847354,0.02622950819672131,Very Cheap
20141202T000000,528000.0,3,2.75,2160,4086,1.0,0,0,3,7,1380,780,1987,0,98126,47.5352,-122.38,1300,4080,1926,2780,129.22173274596182,0.05940983606557377,Very Cheap
20141017T000000,315000.0,3,2.0,1770,9685,1.0,0,0,3,5,1770,0,1948,0,98166,47.4753,-122.342,1520,11122,7915,9602,32.52452245740837,0.031475409836065574,Very Cheap
20140821T000000,614306.0,2,2.25,2210,5500,1.0,0,0,4,8,1410,800,1968,0,98117,47.697,-122.39,2140,6600,3290,4460,111.692,0.07072865573770491,Very Cheap
20150331T000000,1490000.0,3,3.5,4560,14608,2.0,0,2,3,12,4560,0,1990,0,98034,47.6995,-122.228,4050,14226,10048,10176,101.99890470974809,0.1855737704918033,Cheap
20140729T000000,590000.0,3,2.5,2110,3870,2.0,0,0,3,9,2110,0,2004,0,98029,47.5513,-121.994,2300,3870,1760,1570,152.45478036175712,0.06754098360655737,Very Cheap
20150317T000000,261500.0,3,1.0,1130,3600,1.0,0,0,3,6,1130,0,1908,0,98144,47.5978,-122.299,1710,2231,2470,521,72.63888888888889,0.024459016393442622,Very Cheap
20140523T000000,300000.0,4,2.5,1960,9898,2.0,0,0,3,8,1960,0,2001,0,98030,47.3834,-122.168,2130,7662,7938,5532,30.309153364316025,0.029508196721311476,Very Cheap
20140904T000000,439000.0,3,2.25,2230,4551,1.5,0,2,5,8,1450,780,1928,0,98178,47.5078,-122.236,2060,7200,2321,5140,96.4623159745111,0.04773770491803279,Very Cheap
20140904T000000,277554.0,5,2.25,2350,13000,1.0,0,0,3,7,2350,0,1961,0,98178,47.4939,-122.256,1570,11440,10650,9870,21.35030769230769,0.026564459016393444,Very Cheap
20140623T000000,215000.0,3,2.0,1340,8505,1.0,0,0,3,6,1340,0,1931,0,98168,47.4727,-122.297,1370,9000,7165,7630,25.279247501469722,0.018360655737704918,Very Cheap
20140922T000000,1200000.0,2,2.25,2160,17861,2.0,1,4,4,9,2160,0,1956,0,98146,47.502,-122.385,2660,18530,15701,15870,67.18548793460613,0.14754098360655737,Cheap
20150224T000000,420000.0,4,2.0,1700,6375,1.0,0,0,4,7,850,850,1950,0,98115,47.6973,-122.295,1470,8360,4675,6890,65.88235294117646,0.04524590163934426,Very Cheap
20150408T000000,485000.0,3,2.5,1650,3436,2.0,0,0,3,7,1650,0,2003,0,98053,47.6819,-122.036,1680,3446,1786,1766,141.15250291036088,0.05377049180327869,Very Cheap
20141222T000000,202500.0,3,2.0,1540,8316,1.0,0,0,5,6,1540,0,1954,0,98002,47.323,-122.216,1250,8316,6776,7066,24.350649350649352,0.016721311475409836,Very Cheap
20150223T000000,710000.0,5,3.25,3920,8572,2.0,0,0,3,9,3920,0,2007,0,98065,47.5427,-121.887,3335,7258,4652,3923,82.82781147923471,0.08327868852459017,Very Cheap
20150430T000000,535000.0,4,2.5,3250,6933,2.0,0,0,3,8,3250,0,2009,0,98059,47.4956,-122.151,3030,5308,3683,2278,77.16717149862974,0.06032786885245902,Very Cheap
20141218T000000,260000.0,4,1.75,1360,7700,1.0,0,0,4,7,1360,0,1966,0,98058,47.4558,-122.177,1321,7756,6340,6435,33.76623376623377,0.024262295081967214,Very Cheap
20140528T000000,254000.0,3,2.0,1480,7480,1.0,0,0,4,7,1480,0,1992,0,98038,47.3542,-122.055,1680,7146,6000,5466,33.9572192513369,0.023475409836065574,Very Cheap
20140521T000000,600000.0,4,2.5,2360,5226,2.0,0,0,3,8,2360,0,2001,0,98034,47.712,-122.229,2440,5156,2866,2716,114.8105625717566,0.06885245901639345,Very Cheap
20140925T000000,285000.0,3,2.5,1800,2516,2.0,0,0,3,7,1800,0,2001,0,98108,47.5401,-122.293,1800,2562,716,762,113.27503974562798,0.02754098360655738,Very Cheap
20141023T000000,800000.0,4,3.75,2540,20662,2.0,0,0,3,10,2540,0,1998,0,98075,47.5882,-122.01,2490,37731,18122,35241,38.71842028845223,0.09508196721311475,Very Cheap
20140623T000000,165000.0,3,1.0,1200,13100,1.0,0,0,3,6,1200,0,1943,0,98168,47.475,-122.258,1960,11285,11900,9325,12.595419847328245,0.01180327868852459,Very Cheap
20141106T000000,216500.0,2,1.0,710,6960,1.0,0,0,4,6,710,0,1943,0,98178,47.4886,-122.246,940,7680,6250,6740,31.10632183908046,0.018557377049180326,Very Cheap
20140919T000000,387990.0,4,2.5,2640,5595,2.0,0,0,3,8,2640,0,2011,0,98038,47.3551,-122.054,1840,5011,2955,3171,69.34584450402144,0.041047868852459014,Very Cheap
20141104T000000,500000.0,4,2.5,3010,5040,2.0,0,0,3,8,3010,0,2006,0,98133,47.709,-122.35,1090,5040,2030,3950,99.2063492063492,0.05573770491803279,Very Cheap
20141023T000000,650000.0,4,2.5,2770,5612,2.0,0,0,3,7,2770,0,2001,0,98053,47.686,-122.036,2770,5177,2842,2407,115.8232359230221,0.07540983606557378,Very Cheap
20140619T000000,646000.0,4,2.5,2310,4079,2.0,0,0,3,8,2310,0,2008,0,98117,47.6937,-122.361,1220,4800,1769,3580,158.37215003677372,0.07488524590163935,Very Cheap
20150130T000000,323400.0,4,3.0,2060,9138,1.0,0,0,3,8,1430,630,1992,0,98092,47.321,-122.185,2250,7820,7078,5570,35.390676296782665,0.03257704918032787,Very Cheap
20140806T000000,300000.0,3,2.5,1880,4200,2.0,0,0,3,7,1880,0,2007,0,98038,47.366,-122.017,2090,4200,2320,2110,71.42857142857143,0.029508196721311476,Very Cheap
20141007T000000,712500.0,5,2.0,2280,5400,1.5,0,0,4,7,1340,940,1947,0,98105,47.6674,-122.279,1770,5000,3120,3230,131.94444444444446,0.08360655737704918,Very Cheap
20140609T000000,550000.0,3,1.75,1380,3402,1.5,0,0,3,7,1380,0,1900,2000,98122,47.6109,-122.302,1500,5496,2022,3996,161.66960611405057,0.06229508196721312,Very Cheap
20150217T000000,400000.0,3,1.0,1180,7537,1.0,0,0,3,7,1180,0,1969,0,98034,47.7233,-122.221,1220,7425,6357,6205,53.071513864932996,0.04262295081967213,Very Cheap
20141028T000000,255000.0,4,1.75,1650,7200,1.0,0,0,3,7,1100,550,1977,0,98031,47.3944,-122.187,1620,7374,5550,5754,35.416666666666664,0.02360655737704918,Very Cheap
20141205T000000,660000.0,3,1.75,2030,9032,2.0,0,2,4,7,2030,0,1963,0,98008,47.586,-122.117,2350,8937,7002,6587,73.07351638618246,0.07672131147540984,Very Cheap
20150323T000000,925000.0,4,2.25,2110,6375,1.0,0,2,4,8,1600,510,1941,0,98115,47.6819,-122.272,2760,6375,4265,3615,145.09803921568627,0.11147540983606558,Cheap
20140805T000000,534000.0,4,2.25,2130,7210,1.0,0,0,5,7,1330,800,1965,0,98008,47.629,-122.117,1310,7896,5080,6586,74.06380027739252,0.06019672131147541,Very Cheap
20141119T000000,215000.0,3,1.0,1690,7700,1.0,0,0,4,7,1690,0,1969,0,98003,47.3444,-122.304,1590,7700,6010,6110,27.92207792207792,0.018360655737704918,Very Cheap
20141014T000000,1950000.0,3,2.5,2510,12779,1.5,0,4,3,10,2510,0,1968,0,98034,47.6982,-122.231,2810,12225,10269,9415,152.5940996948118,0.2459016393442623,Cheap
20140513T000000,1400000.0,5,4.25,3530,7924,2.0,0,0,3,10,3530,0,2001,0,98040,47.5894,-122.243,1750,9226,4394,7476,176.67844522968198,0.1737704918032787,Cheap
20150203T000000,212000.0,3,1.75,1470,8350,1.0,0,0,3,7,1470,0,1990,0,98001,47.2587,-122.253,1590,8182,6880,6592,25.389221556886227,0.017967213114754098,Very Cheap
20140619T000000,265000.0,3,1.75,1840,7300,1.0,0,0,3,8,1840,0,1966,0,98023,47.3122,-122.369,1920,8010,5460,6090,36.3013698630137,0.024918032786885248,Very Cheap
20141205T000000,400000.0,3,1.75,1860,5750,1.5,0,0,5,6,1300,560,1918,0,98116,47.5586,-122.383,1550,5750,3890,4200,69.56521739130434,0.04262295081967213,Very Cheap
20150213T000000,311500.0,4,2.5,1940,10133,2.0,0,0,3,8,1940,0,1992,0,98031,47.3877,-122.171,1940,7265,8193,5325,30.741142800750026,0.031016393442622952,Very Cheap
20150326T000000,2328000.0,4,3.5,4420,20759,2.0,0,0,3,11,4420,0,2003,0,98004,47.6354,-122.221,3020,20666,16339,17646,112.1441302567561,0.2954754098360656,Cheap
20141017T000000,225000.0,2,1.0,800,6050,1.0,0,0,4,6,800,0,1944,0,98178,47.5001,-122.242,880,6050,5250,5170,37.1900826446281,0.019672131147540985,Very Cheap
20140610T000000,1250000.0,4,2.5,3700,21755,1.0,0,4,3,11,2620,1080,1988,0,98006,47.5662,-122.108,3480,13786,18055,10306,57.45805561939784,0.1540983606557377,Cheap
20150211T000000,380000.0,3,1.0,1400,8710,1.0,0,0,4,7,1400,0,1948,0,98146,47.5066,-122.377,1460,8710,7310,7250,43.62801377726751,0.04,Very Cheap
20140708T000000,600000.0,4,2.5,2250,11370,2.0,0,0,3,8,2250,0,1991,0,98034,47.7115,-122.239,2190,9611,9120,7421,52.770448548812666,0.06885245901639345,Very Cheap
20140521T000000,600000.0,3,2.25,2230,9053,2.0,0,0,4,9,2230,0,1987,0,98007,47.6594,-122.144,2390,8038,6823,5648,66.2763724732133,0.06885245901639345,Very Cheap
20141218T000000,315000.0,3,2.5,1950,3000,2.0,0,0,3,7,1950,0,2001,0,98146,47.4938,-122.337,1620,6000,1050,4380,105.0,0.031475409836065574,Very Cheap
20140603T000000,847000.0,5,1.0,2550,4623,2.5,0,0,4,9,2550,0,1905,0,98122,47.6092,-122.294,1570,3875,2073,2305,183.21436296776986,0.10124590163934426,Cheap
20150409T000000,730000.0,4,2.5,2750,10351,2.0,0,0,3,10,2750,0,1998,0,98075,47.5894,-121.98,3370,10351,7601,6981,70.52458699642547,0.0859016393442623,Very Cheap
20140514T000000,1058000.0,4,2.0,2290,11137,1.0,0,0,4,8,2290,0,1955,0,98004,47.5887,-122.201,2300,10463,8847,8163,94.99865313818802,0.12891803278688524,Cheap
20150513T000000,1620000.0,4,2.25,2350,17709,2.0,0,0,4,9,2350,0,1977,0,98039,47.6232,-122.236,3360,19855,15359,16495,91.47890902930713,0.20262295081967213,Cheap
20150415T000000,664000.0,2,1.75,1720,5785,1.0,0,0,3,6,860,860,1948,2002,98118,47.5554,-122.274,1680,5184,4065,3504,114.77960242005186,0.07724590163934426,Very Cheap
20150427T000000,454450.0,4,3.0,2810,6000,2.0,0,0,3,9,2810,0,2007,0,98038,47.3689,-122.057,2790,6000,3190,3210,75.74166666666666,0.049763934426229506,Very Cheap
20150116T000000,341000.0,3,1.0,940,4200,1.0,0,0,3,7,940,0,1955,0,98103,47.6878,-122.35,1380,4080,3260,2700,81.19047619047619,0.03488524590163934,Very Cheap
20141029T000000,276693.0,4,1.0,1190,8875,1.5,0,0,4,7,1190,0,1946,0,98155,47.7487,-122.303,1190,8875,7685,7685,31.176676056338028,0.026451540983606556,Very Cheap
20141119T000000,185000.0,2,1.0,1390,11340,1.0,0,0,4,7,1390,0,1969,0,98168,47.4969,-122.3,1200,10224,9950,9024,16.31393298059965,0.014426229508196721,Very Cheap
20140917T000000,160000.0,2,2.5,1660,2258,2.0,0,0,3,7,1660,0,1981,0,98042,47.3793,-122.146,1740,2390,598,650,70.859167404783,0.011147540983606558,Very Cheap
20140602T000000,270000.0,4,2.5,1920,8497,2.0,0,0,3,8,1920,0,1998,0,98092,47.2608,-122.209,1940,8436,6577,6496,31.775920913263505,0.025573770491803278,Very Cheap
20140718T000000,300000.0,4,1.5,1460,8760,1.0,0,0,3,7,1460,0,1958,0,98166,47.4698,-122.36,1610,9375,7300,7765,34.24657534246575,0.029508196721311476,Very Cheap
20140829T000000,264950.0,3,1.5,1370,10115,1.0,0,0,4,7,1370,0,1957,0,98022,47.2027,-122.0,1450,9282,8745,7832,26.19377162629758,0.024911475409836067,Very Cheap
20150401T000000,209950.0,2,1.0,1050,6250,1.0,0,0,4,6,840,210,1943,0,98168,47.5024,-122.333,1310,12500,5200,11190,33.592,0.017698360655737704,Very Cheap
20150330T000000,850000.0,3,2.5,3360,8708,2.0,0,0,3,9,3360,0,2006,0,98053,47.7037,-122.016,1810,4764,5348,2954,97.61139182361048,0.10163934426229508,Cheap
20140516T000000,645000.0,4,2.5,3160,11380,2.0,0,0,3,9,3160,0,1983,0,98074,47.6318,-122.039,2970,10385,8220,7415,56.67838312829525,0.07475409836065573,Very Cheap
20150113T000000,855000.0,4,2.25,2480,36974,2.0,0,0,4,9,2480,0,1973,0,98005,47.6441,-122.154,3160,35070,34494,31910,23.124357656731757,0.10229508196721311,Cheap
20141201T000000,632500.0,4,1.5,2720,37258,2.0,0,0,3,10,2720,0,1994,0,98077,47.7402,-122.035,3270,39714,34538,36444,16.976219872242204,0.07311475409836066,Very Cheap
20140821T000000,289950.0,3,2.5,2070,5013,2.0,0,0,3,8,2070,0,1987,0,98023,47.3202,-122.395,1670,5013,2943,3343,57.83961699581089,0.028190163934426228,Very Cheap
20140924T000000,850000.0,2,1.75,2170,25732,1.0,0,2,4,8,2170,0,1952,0,98177,47.7542,-122.372,3020,23135,23562,20115,33.032799626923676,0.10163934426229508,Cheap
20140620T000000,565000.0,4,2.75,3260,4900,2.0,0,0,3,9,3260,0,2013,0,98059,47.4812,-122.123,3260,6132,1640,2872,115.3061224489796,0.06426229508196721,Very Cheap
20150425T000000,792000.0,3,2.5,2250,19270,2.0,0,0,3,8,2250,0,1999,0,98074,47.6569,-122.088,2940,19541,17020,16601,41.10015568240789,0.0940327868852459,Very Cheap
20141222T000000,260000.0,3,2.25,1950,9600,1.0,0,0,4,7,1200,750,1987,0,98092,47.2762,-122.148,1760,8850,7650,7090,27.083333333333332,0.024262295081967214,Very Cheap
20150427T000000,585000.0,3,2.0,2220,209523,1.0,0,0,3,7,2220,0,1991,0,98019,47.7586,-121.911,1600,210830,207303,209230,2.7920562420354806,0.06688524590163934,Very Cheap
20140730T000000,295500.0,3,1.75,1330,10523,1.0,0,0,3,7,1000,330,1981,0,98055,47.4605,-122.206,1320,8775,9193,7455,28.08134562387152,0.028918032786885244,Very Cheap
20141211T000000,329000.0,4,2.0,1190,7877,1.5,0,0,5,7,1190,0,1946,0,98155,47.7538,-122.322,1480,9975,6687,8495,41.7671702424781,0.03331147540983607,Very Cheap
20150330T000000,750000.0,3,1.75,2770,15232,1.0,0,0,3,8,1570,1200,1976,0,98006,47.5706,-122.16,2340,11400,12462,9060,49.23844537815126,0.08852459016393442,Very Cheap
20150225T000000,495000.0,4,2.5,2310,7555,2.0,0,0,3,9,2310,0,1997,0,98155,47.7544,-122.303,1980,8416,5245,6436,65.51952349437458,0.05508196721311476,Very Cheap
20150504T000000,672500.0,3,1.75,1580,5750,1.0,0,2,4,8,1330,250,1947,0,98199,47.6339,-122.392,2480,5750,4170,3270,116.95652173913044,0.07836065573770491,Very Cheap
20140508T000000,1307000.0,5,3.25,2800,3200,1.5,0,0,5,10,1910,890,1932,2002,98109,47.6421,-122.35,2450,3500,400,1050,408.4375,0.16157377049180327,Cheap
20140801T000000,405000.0,3,2.5,1500,9636,2.0,0,0,3,7,1500,0,1994,0,98011,47.75,-122.176,1700,9656,8136,7956,42.029887920298876,0.043278688524590166,Very Cheap
20150116T000000,620000.0,3,1.75,2140,5808,1.0,0,1,3,7,1070,1070,1947,0,98119,47.6435,-122.373,1930,5808,3668,3878,106.74931129476585,0.07147540983606557,Very Cheap
20140922T000000,615000.0,4,2.25,2330,7020,1.0,0,0,4,8,1450,880,1973,0,98006,47.562,-122.139,2330,8500,4690,6170,87.6068376068376,0.07081967213114754,Very Cheap
20140904T000000,887000.0,6,2.25,3830,11180,1.0,0,2,5,9,2440,1390,1962,0,98008,47.5849,-122.113,2500,10400,7350,7900,79.3381037567084,0.10649180327868853,Cheap
20140922T000000,1057000.0,4,2.75,4510,5000,2.5,0,2,3,8,3270,1240,1941,2000,98117,47.6852,-122.4,2010,5000,490,2990,211.4,0.12878688524590165,Cheap
20140805T000000,753000.0,4,1.75,2160,39430,1.0,0,0,4,8,1660,500,1974,0,98005,47.6378,-122.185,2430,35329,37270,32899,19.09713416180573,0.08891803278688525,Very Cheap
20140715T000000,1600000.0,3,2.25,3170,5000,2.0,0,0,5,10,2230,940,1975,0,98102,47.6349,-122.318,3170,5400,1830,2230,320.0,0.2,Cheap
20140530T000000,3710000.0,4,3.5,5550,28078,2.0,0,2,4,12,3350,2200,2000,0,98039,47.6395,-122.234,2980,19602,22528,16622,132.131918227794,0.47672131147540986,High
20141231T000000,365000.0,3,1.5,1520,8519,1.0,0,0,3,7,1520,0,1954,0,98133,47.7712,-122.339,1570,9000,6999,7430,42.845404390186644,0.0380327868852459,Very Cheap
20140822T000000,870000.0,4,2.75,3410,23000,2.0,0,0,4,10,3410,0,1982,0,98006,47.5559,-122.149,2490,15512,19590,13022,37.82608695652174,0.10426229508196722,Cheap
20140701T000000,321000.0,4,2.5,1830,9601,2.0,0,0,3,7,1830,0,2003,0,98038,47.3541,-122.015,1830,5892,7771,4062,33.434017289865636,0.032262295081967214,Very Cheap
20150507T000000,280000.0,3,2.5,1550,4486,2.0,0,0,3,7,1550,0,2000,0,98001,47.3299,-122.269,1700,4487,2936,2787,62.41640659830584,0.026885245901639345,Very Cheap
20140703T000000,288000.0,3,2.5,1520,3593,2.0,0,0,3,7,1520,0,2004,0,98038,47.3842,-122.042,1610,3612,2073,2002,80.15585861397162,0.027934426229508195,Very Cheap
20150227T000000,248500.0,3,2.0,1240,12285,1.0,0,0,3,7,620,620,1939,1991,98023,47.3219,-122.341,1560,11564,11045,10004,20.22792022792023,0.02275409836065574,Very Cheap
20140622T000000,330000.0,4,2.5,2380,13550,2.0,0,0,3,7,2380,0,1999,0,98188,47.4486,-122.288,1230,9450,11170,8220,24.354243542435423,0.03344262295081967,Very Cheap
20140722T000000,740000.0,5,3.5,2720,11454,2.0,0,0,3,9,1830,890,1988,0,98052,47.6466,-122.119,2920,11310,8734,8390,64.60625109132181,0.08721311475409836,Very Cheap
20140923T000000,445000.0,3,2.5,2210,8010,2.0,0,0,3,8,2210,0,1998,0,98045,47.4845,-121.775,2430,9600,5800,7170,55.55555555555556,0.04852459016393443,Very Cheap
20150306T000000,198500.0,2,1.0,1050,9600,1.0,0,0,4,6,1050,0,1959,0,98023,47.3274,-122.346,990,8880,8550,7890,20.677083333333332,0.01619672131147541,Very Cheap
20140625T000000,280000.0,7,2.5,1940,5458,2.0,0,0,3,7,1940,0,1994,0,98092,47.3191,-122.177,1710,5688,3518,3978,51.30084279956028,0.026885245901639345,Very Cheap
20140710T000000,336500.0,3,2.25,1420,3433,2.0,0,0,4,7,1420,0,1981,0,98034,47.7245,-122.163,1150,3432,2013,2282,98.019225167492,0.03429508196721311,Very Cheap
20150211T000000,267000.0,3,2.5,1690,10336,2.0,0,0,4,7,1690,0,1989,0,98010,47.311,-122.003,1580,7700,8646,6120,25.83204334365325,0.025180327868852458,Very Cheap
20140502T000000,315000.0,3,1.0,1160,9180,1.0,0,0,3,7,1160,0,1968,0,98077,47.7427,-122.072,1160,10282,8020,9122,34.31372549019608,0.031475409836065574,Very Cheap
20140806T000000,545000.0,4,2.5,2040,7412,2.0,0,0,3,8,2040,0,1988,0,98074,47.6347,-122.026,2050,7830,5372,5780,73.52941176470588,0.06163934426229508,Very Cheap
20140804T000000,274950.0,3,1.75,1840,16679,1.0,0,0,3,8,1840,0,1989,0,98001,47.3207,-122.275,1910,15571,14839,13661,16.48480124707716,0.02622295081967213,Very Cheap
20141224T000000,500000.0,2,1.0,1440,7130,1.0,0,2,3,7,1210,230,1948,0,98115,47.6778,-122.267,1970,7130,5690,5160,70.12622720897616,0.05573770491803279,Very Cheap
20140528T000000,299000.0,3,1.0,1390,9624,1.5,0,0,4,7,1390,0,1954,0,98155,47.7758,-122.301,1440,9624,8234,8184,31.06816292601829,0.02937704918032787,Very Cheap
20150505T000000,420000.0,3,2.5,1470,1445,2.0,0,0,3,8,1160,310,2005,0,98029,47.5468,-121.998,1470,1525,-25,55,290.65743944636677,0.04524590163934426,Very Cheap
20150407T000000,620000.0,3,2.5,1776,1248,3.0,0,0,3,8,1604,172,2006,0,98103,47.6539,-122.352,1780,1248,-528,-532,496.79487179487177,0.07147540983606557,Very Cheap
20141210T000000,575950.0,3,2.25,1640,12000,1.0,0,0,3,7,1180,460,1967,0,98008,47.6252,-122.104,1620,12000,10360,10380,47.99583333333333,0.06569836065573771,Very Cheap
20140904T000000,666500.0,4,2.5,2860,6600,2.0,0,0,3,9,2860,0,2000,0,98074,47.6067,-122.017,2790,6723,3740,3933,100.98484848484848,0.07757377049180328,Very Cheap
20140522T000000,180000.0,4,1.5,1740,7292,1.0,0,0,3,7,1020,720,1962,0,98168,47.4787,-122.302,1740,7573,5552,5833,24.684585847504113,0.01377049180327869,Very Cheap
20140623T000000,261350.0,3,1.75,1390,18200,1.0,0,0,4,7,1390,0,1962,0,98023,47.3208,-122.337,1810,9675,16810,7865,14.35989010989011,0.024439344262295083,Very Cheap
20150224T000000,1030000.0,4,3.5,2730,5607,1.0,0,0,5,9,1660,1070,1948,0,98199,47.6387,-122.396,1720,5400,2877,3680,183.69894774389155,0.12524590163934426,Cheap
20150429T000000,390000.0,3,1.75,1435,8960,1.0,0,0,4,8,1435,0,1969,0,98058,47.4525,-122.149,2030,9450,7525,7420,43.526785714285715,0.04131147540983607,Very Cheap
20140626T000000,253500.0,3,1.0,1640,12384,1.0,0,0,4,7,1090,550,1954,0,98003,47.3256,-122.298,1550,11200,10744,9650,20.469961240310077,0.023409836065573772,Very Cheap
20140521T000000,625000.0,4,2.5,2630,48706,2.0,0,0,3,8,2630,0,1986,0,98072,47.775,-122.125,2680,48706,46076,46026,12.832094608467129,0.07213114754098361,Very Cheap
20140922T000000,255000.0,4,2.5,1580,7800,1.0,0,0,4,7,1580,0,1959,0,98059,47.481,-122.163,1320,7800,6220,6480,32.69230769230769,0.02360655737704918,Very Cheap
20141010T000000,257000.0,3,2.5,1740,3721,2.0,0,0,3,8,1740,0,2009,0,98002,47.3363,-122.213,2030,3794,1981,1764,69.06745498521903,0.023868852459016394,Very Cheap
20140722T000000,869000.0,2,1.75,1900,13122,1.0,1,4,3,7,1100,800,1954,0,98178,47.5121,-122.248,1650,13160,11222,11510,66.22466087486664,0.10413114754098361,Cheap
20141112T000000,745000.0,4,2.5,3130,10860,2.0,0,0,3,10,3130,0,1990,0,98075,47.56,-122.04,3130,10860,7730,7730,68.60036832412523,0.08786885245901639,Very Cheap
20140926T000000,1350000.0,4,3.5,3500,9525,2.0,0,0,3,10,3500,0,1999,0,98040,47.5641,-122.221,2630,9525,6025,6895,141.73228346456693,0.16721311475409836,Cheap
20141020T000000,350000.0,3,1.75,2130,7500,1.0,0,0,4,7,1090,1040,1956,0,98166,47.4593,-122.343,1590,7500,5370,5910,46.666666666666664,0.036065573770491806,Very Cheap
20140619T000000,475000.0,3,2.5,950,1110,2.0,0,0,3,8,950,0,2003,0,98102,47.6226,-122.319,1230,1215,160,-15,427.92792792792795,0.05245901639344262,Very Cheap
20140918T000000,540000.0,3,2.5,1720,11656,2.0,0,0,3,8,1720,0,1987,1999,98052,47.6791,-122.113,1890,10336,9936,8446,46.32807137954701,0.06098360655737705,Very Cheap
20140528T000000,175000.0,2,1.0,830,2699,1.0,0,0,3,7,830,0,1996,0,98038,47.3839,-122.038,1030,3574,1869,2544,64.83882919599851,0.013114754098360656,Very Cheap
20140703T000000,100000.0,2,0.75,660,5240,1.0,0,0,4,4,660,0,1912,0,98032,47.3881,-122.234,850,5080,4580,4230,19.083969465648856,0.003278688524590164,Very Cheap
20141009T000000,890000.0,5,1.0,2590,4652,2.0,0,0,4,8,2310,280,1907,0,98122,47.6038,-122.294,2360,4650,2062,2290,191.31556319862426,0.10688524590163935,Cheap
20140507T000000,280000.0,3,2.5,1600,4271,2.0,0,0,3,7,1600,0,2000,0,98001,47.3303,-122.269,1700,4746,2671,3046,65.55841723249824,0.026885245901639345,Very Cheap
20140627T000000,1050000.0,4,4.25,4390,13833,2.0,0,3,3,10,3320,1070,2003,0,98029,47.5566,-122.026,3850,11652,9443,7802,75.90544350466276,0.12786885245901639,Cheap
20140709T000000,486000.0,4,2.5,3560,12047,2.0,0,0,3,10,3560,0,1988,0,98023,47.3019,-122.341,3420,11250,8487,7830,40.341993857391884,0.053901639344262293,Very Cheap
20140707T000000,670000.0,5,2.5,2860,68519,2.0,0,0,5,8,2860,0,1958,0,98065,47.5265,-121.835,1670,35910,65659,34240,9.778309665932078,0.0780327868852459,Very Cheap
20140723T000000,480000.0,3,2.5,1640,7847,2.0,0,0,3,8,1640,0,1987,0,98029,47.5684,-122.018,1870,6079,6207,4209,61.16987383713521,0.05311475409836065,Very Cheap
20140507T000000,440000.0,3,1.75,1500,6180,1.0,0,0,4,6,1060,440,1947,0,98118,47.5689,-122.284,1740,6180,4680,4440,71.19741100323624,0.04786885245901639,Very Cheap
20140905T000000,1500000.0,3,3.25,3990,8505,2.0,0,2,3,9,2870,1120,1922,1999,98144,47.5744,-122.283,3640,8505,4515,4865,176.3668430335097,0.18688524590163935,Cheap
20140609T000000,743700.0,4,2.5,2610,33206,2.0,0,0,3,10,2610,0,1988,0,98053,47.6662,-122.057,2870,28295,30596,25425,22.39655483948684,0.0876983606557377,Very Cheap
20140814T000000,449950.0,3,1.75,1470,7590,1.0,0,0,3,7,1470,0,1988,0,98117,47.6964,-122.362,1700,5080,6120,3380,59.281949934123844,0.04917377049180328,Very Cheap
20140519T000000,367000.0,2,1.0,700,2334,1.0,0,0,3,7,700,0,1945,0,98117,47.701,-122.39,2300,5000,1634,2700,157.2407883461868,0.03829508196721312,Very Cheap
20141201T000000,1185000.0,4,3.25,3960,12895,2.0,0,0,3,11,3960,0,2001,0,98059,47.5211,-122.151,3870,12040,8935,8170,91.89608375339279,0.14557377049180328,Cheap
20150501T000000,201000.0,3,1.0,900,7576,1.0,0,0,4,6,900,0,1959,0,98002,47.2881,-122.22,1220,7452,6676,6232,26.5311510031679,0.016524590163934427,Very Cheap
20141223T000000,575000.0,3,1.75,2010,3800,2.0,0,0,2,7,2010,0,1922,0,98112,47.6408,-122.307,1540,3800,1790,2260,151.31578947368422,0.06557377049180328,Very Cheap
20150415T000000,295000.0,3,2.5,1940,10350,1.0,0,0,3,7,1420,520,1979,0,98001,47.3385,-122.256,1810,7800,8410,5990,28.502415458937197,0.028852459016393443,Very Cheap
20150220T000000,190000.0,3,1.0,1510,8760,1.0,0,0,4,6,1510,0,1946,0,98002,47.3015,-122.216,1040,7828,7250,6788,21.689497716894977,0.015081967213114755,Very Cheap
20150507T000000,742500.0,2,3.0,2020,5000,1.0,0,0,3,8,1350,670,1952,0,98117,47.6758,-122.375,1160,1118,2980,-42,148.5,0.08754098360655738,Very Cheap
20150312T000000,875000.0,6,3.5,4430,11453,2.0,0,0,3,9,3000,1430,2001,0,98056,47.5156,-122.204,2730,5661,7023,2931,76.39919671701738,0.10491803278688525,Cheap
20150421T000000,1387000.0,4,3.5,4010,10880,2.0,0,3,4,11,3150,860,1990,0,98040,47.5359,-122.213,3530,17310,6870,13780,127.48161764705883,0.1720655737704918,Cheap
20140619T000000,600000.0,4,2.25,3070,8400,2.0,0,0,4,8,3070,0,1970,0,98034,47.7316,-122.169,1880,8000,5330,6120,71.42857142857143,0.06885245901639345,Very Cheap
20140922T000000,207000.0,3,1.5,1460,11100,1.0,0,0,3,7,1460,0,1956,0,98003,47.3253,-122.298,1460,11100,9640,9640,18.64864864864865,0.017311475409836064,Very Cheap
20150421T000000,650000.0,4,2.75,3260,5335,2.0,0,0,3,9,3260,0,2003,0,98065,47.5414,-121.864,3180,5438,2075,2258,121.8369259606373,0.07540983606557378,Very Cheap
20150512T000000,275000.0,2,1.0,830,5610,1.0,0,0,3,6,830,0,1922,0,98126,47.5674,-122.367,1310,2793,4780,1483,49.01960784313726,0.02622950819672131,Very Cheap
20150408T000000,1200000.0,4,2.5,2390,4200,2.0,0,0,3,9,2150,240,1924,0,98102,47.6272,-122.318,2800,5250,1810,2450,285.7142857142857,0.14754098360655737,Cheap
20141014T000000,262500.0,3,2.0,1130,7200,1.0,0,0,4,6,1130,0,1944,0,98166,47.4779,-122.342,1270,7500,6070,6230,36.458333333333336,0.02459016393442623,Very Cheap
20140925T000000,399000.0,2,1.0,1120,8661,1.0,0,0,3,7,1120,0,1946,0,98125,47.7034,-122.307,1470,7205,7541,5735,46.068583304468305,0.042491803278688525,Very Cheap
20150224T000000,139000.0,4,1.5,1410,10648,1.0,0,0,4,7,1410,0,1966,0,98030,47.3736,-122.188,1410,10522,9238,9112,13.054094665664914,0.00839344262295082,Very Cheap
20140826T000000,575000.0,3,2.5,1750,4797,2.0,0,0,4,7,1750,0,1991,0,98033,47.6954,-122.199,1750,4293,3047,2543,119.86658328121743,0.06557377049180328,Very Cheap
20141120T000000,580000.0,2,1.0,1040,3200,1.0,0,0,3,7,1040,0,1926,0,98103,47.6558,-122.334,1890,4000,2160,2110,181.25,0.06622950819672131,Very Cheap
20140725T000000,468000.0,3,2.25,1630,2490,2.0,0,0,3,7,1630,0,2004,0,98053,47.6807,-122.031,1630,2680,860,1050,187.95180722891567,0.05154098360655738,Very Cheap
20150310T000000,230000.0,3,1.0,1380,10112,1.0,0,0,4,7,940,440,1963,0,98023,47.3196,-122.351,1240,10112,8732,8872,22.745253164556964,0.020327868852459016,Very Cheap
20140507T000000,675000.0,4,4.0,3680,18804,2.0,0,0,3,10,3680,0,1990,0,98074,47.6193,-122.014,3200,15954,15124,12754,35.89661774090619,0.07868852459016394,Very Cheap
20141010T000000,318000.0,3,1.0,1250,20040,1.0,0,0,3,7,1250,0,1970,0,98072,47.7514,-122.108,1640,19840,18790,18200,15.868263473053892,0.03186885245901639,Very Cheap
20141008T000000,332100.0,5,3.5,2660,6978,2.0,0,0,3,8,1980,680,1996,0,98092,47.2631,-122.212,2220,7294,4318,5074,47.59243336199484,0.033718032786885246,Very Cheap
20150317T000000,175000.0,2,1.0,620,6600,1.0,0,0,3,6,620,0,1963,0,98168,47.4862,-122.33,1050,6600,5980,5550,26.515151515151516,0.013114754098360656,Very Cheap
20140805T000000,817000.0,4,2.25,2600,10660,2.0,0,0,4,8,2600,0,1979,0,98006,47.5533,-122.156,3150,10660,8060,7510,76.64165103189494,0.09731147540983606,Very Cheap
20150408T000000,1200000.0,4,3.0,2150,8119,2.0,0,0,3,8,2150,0,1953,2004,98039,47.6335,-122.236,1590,8119,5969,6529,147.80145338095824,0.14754098360655737,Cheap
20150420T000000,525000.0,3,1.75,1470,6550,1.0,0,2,3,7,1070,400,1916,0,98126,47.5463,-122.381,1440,6550,5080,5110,80.1526717557252,0.05901639344262295,Very Cheap
20150211T000000,189000.0,3,1.0,1380,7282,1.5,0,0,5,6,1380,0,1915,0,98002,47.3006,-122.223,860,4826,5902,3966,25.954408129634714,0.014950819672131148,Very Cheap
20150305T000000,629950.0,3,2.5,1680,1683,2.0,0,0,3,9,1120,560,2014,0,98119,47.6425,-122.374,1610,1618,3,8,374.30184194890074,0.07278032786885245,Very Cheap
20150310T000000,641500.0,1,1.0,1000,9084,1.0,1,3,3,7,1000,0,1950,0,98146,47.5007,-122.382,1090,6536,8084,5446,70.6186701893439,0.07429508196721311,Very Cheap
20140912T000000,490000.0,3,2.25,1630,7573,1.0,0,2,3,7,1230,400,1983,0,98034,47.7273,-122.211,1550,7695,5943,6145,64.70355209296184,0.05442622950819672,Very Cheap
20150218T000000,415000.0,3,1.75,1790,15142,1.0,0,0,3,7,1360,430,1976,0,98072,47.7362,-122.172,1910,7500,13352,5590,27.40721172896579,0.04459016393442623,Very Cheap
20141015T000000,250000.0,2,1.0,890,6380,1.0,0,0,3,6,890,0,1951,0,98115,47.691,-122.303,990,6380,5490,5390,39.18495297805643,0.022950819672131147,Very Cheap
20140820T000000,781000.0,3,1.5,1290,8175,1.0,0,0,4,7,820,470,1952,0,98004,47.6296,-122.205,2130,8577,6885,6447,95.53516819571865,0.09259016393442623,Very Cheap
20140620T000000,400000.0,4,2.25,2420,7927,1.0,0,0,4,7,1400,1020,1973,0,98133,47.7583,-122.343,2120,7693,5507,5573,50.46045162104201,0.04262295081967213,Very Cheap
20140820T000000,935000.0,4,3.0,3680,7105,2.0,0,2,3,10,2890,790,2008,0,98115,47.6956,-122.311,1580,6815,3425,5235,131.59746657283603,0.11278688524590164,Cheap
20140515T000000,575000.0,4,2.5,3020,17810,1.0,0,0,3,9,1600,1420,1979,0,98155,47.7735,-122.281,2500,15815,14790,13315,32.285233015160024,0.06557377049180328,Very Cheap
20141015T000000,1660000.0,4,3.25,4240,11189,2.0,0,2,3,10,4240,0,2006,0,98033,47.6526,-122.191,3390,12540,6949,9150,148.35999642506033,0.2078688524590164,Cheap
20141229T000000,302300.0,5,2.75,3130,9450,1.0,0,0,4,8,1580,1550,1973,0,98023,47.3099,-122.384,1900,9000,6320,7100,31.98941798941799,0.02980983606557377,Very Cheap
20150507T000000,355000.0,2,1.0,900,6656,1.0,0,0,3,7,900,0,1940,0,98126,47.5467,-122.377,1230,6400,5756,5170,53.33533653846154,0.036721311475409836,Very Cheap
20140617T000000,1538000.0,3,2.25,2880,7599,1.0,0,2,3,9,1710,1170,1958,2002,98033,47.6938,-122.215,2920,12401,4719,9481,202.39505198052376,0.1918688524590164,Cheap
20150330T000000,926250.0,4,1.75,2390,17717,1.0,0,0,4,8,2390,0,1964,0,98040,47.5755,-122.218,2390,10730,15327,8340,52.280295761133374,0.11163934426229508,Cheap
20150323T000000,300000.0,3,1.75,1450,7620,1.0,0,0,4,7,1050,400,1955,0,98166,47.4569,-122.354,1380,7620,6170,6240,39.37007874015748,0.029508196721311476,Very Cheap
20140721T000000,361500.0,3,1.75,1070,9000,1.0,0,0,4,7,1070,0,1978,0,98052,47.6984,-122.132,1700,8400,7930,6700,40.166666666666664,0.03757377049180328,Very Cheap
20141105T000000,616000.0,3,1.5,1740,9840,1.0,0,0,4,8,1740,0,1963,0,98040,47.5748,-122.237,1930,9840,8100,7910,62.60162601626016,0.07095081967213114,Very Cheap
20150413T000000,395000.0,2,1.75,1210,1161,2.0,0,0,3,8,1210,0,2014,0,98029,47.5513,-121.998,1700,2285,-49,585,340.2239448751077,0.0419672131147541,Very Cheap
20141006T000000,245000.0,3,1.5,2100,10000,1.0,0,0,4,7,2100,0,1954,0,98198,47.4222,-122.331,1300,7500,7900,6200,24.5,0.022295081967213116,Very Cheap
20140603T000000,206000.0,3,1.0,1060,9600,1.0,0,0,4,6,1060,0,1962,0,98023,47.2878,-122.358,1060,9604,8540,8544,21.458333333333332,0.017180327868852457,Very Cheap
20141013T000000,706000.0,4,2.5,3280,16575,1.0,0,0,3,9,2190,1090,1972,0,98188,47.426,-122.285,1570,13209,13295,11639,42.594268476621416,0.08275409836065574,Very Cheap
20150126T000000,578000.0,3,1.5,1660,6000,1.5,0,0,3,7,1660,0,1937,0,98199,47.6409,-122.401,1640,6000,4340,4360,96.33333333333333,0.06596721311475409,Very Cheap
20140728T000000,341950.0,5,3.0,3070,5252,2.0,0,0,3,8,3070,0,2005,0,98042,47.3666,-122.128,2760,5203,2182,2443,65.10853008377761,0.03500983606557377,Very Cheap
20141211T000000,305000.0,3,1.0,1150,9048,1.0,0,0,2,7,1150,0,1922,0,98033,47.6755,-122.177,1550,8207,7898,6657,33.709106984969054,0.03016393442622951,Very Cheap
20141010T000000,575000.0,3,2.75,1710,3600,1.0,0,0,3,7,1590,120,1909,0,98119,47.642,-122.36,1710,3600,1890,1890,159.72222222222223,0.06557377049180328,Very Cheap
20140520T000000,330000.0,3,1.0,1180,43124,1.0,0,0,4,6,1180,0,1959,0,98027,47.5278,-122.063,1410,43560,41944,42150,7.65235135887209,0.03344262295081967,Very Cheap
20150107T000000,445000.0,4,2.25,2130,7200,2.0,0,0,3,7,2130,0,1972,0,98034,47.7152,-122.168,1990,7200,5070,5210,61.80555555555556,0.04852459016393443,Very Cheap
20140818T000000,333000.0,3,1.0,1050,7560,1.0,0,0,3,7,1050,0,1951,0,98126,47.525,-122.371,1490,7560,6510,6070,44.04761904761905,0.033836065573770495,Very Cheap
20140807T000000,598500.0,4,2.5,2520,3980,2.0,0,0,3,8,2520,0,2005,0,98027,47.5401,-122.07,2610,3980,1460,1370,150.37688442211055,0.06865573770491804,Very Cheap
20141014T000000,225000.0,2,1.0,700,6000,1.0,0,0,3,6,700,0,1943,0,98055,47.4671,-122.212,1320,6000,5300,4680,37.5,0.019672131147540985,Very Cheap
20140714T000000,570000.0,4,2.5,2640,4200,2.0,0,0,3,8,2640,0,1998,0,98074,47.6038,-122.02,2460,4200,1560,1740,135.71428571428572,0.06491803278688525,Very Cheap
20140807T000000,630000.0,5,2.0,2330,6783,1.0,0,0,3,7,1310,1020,1956,0,98115,47.6955,-122.295,1930,6783,4453,4853,92.87925696594428,0.07278688524590164,Very Cheap
20150416T000000,779000.0,5,2.25,2830,7738,2.0,0,0,4,8,2830,0,1977,0,98006,47.5582,-122.136,2300,9840,4908,7540,100.67200827087103,0.09232786885245901,Very Cheap
20150121T000000,760000.0,4,3.5,3720,13591,2.0,0,3,3,10,3720,0,2004,0,98065,47.536,-121.858,4210,14282,9871,10072,55.919358398940474,0.0898360655737705,Very Cheap
20150109T000000,322968.0,5,1.75,1890,9600,1.0,0,0,4,7,1890,0,1960,0,98028,47.7391,-122.241,2350,5308,7710,2958,33.6425,0.032520393442622954,Very Cheap
20140729T000000,595000.0,4,2.5,2910,7287,2.0,0,0,3,8,2910,0,1998,0,98065,47.5354,-121.869,2420,6180,4377,3760,81.65225744476464,0.06819672131147542,Very Cheap
20141013T000000,321000.0,4,1.0,1300,18836,1.0,0,0,4,7,1300,0,1941,0,98056,47.5029,-122.188,1540,8498,17536,6958,17.041834784455297,0.032262295081967214,Very Cheap
20150326T000000,653000.0,3,2.25,2770,57745,2.0,0,0,3,8,2770,0,1985,0,98072,47.775,-122.124,2720,46765,54975,44045,11.308338384275695,0.07580327868852459,Very Cheap
20140729T000000,750000.0,4,1.75,2520,21834,1.0,1,4,3,8,1420,1100,1960,0,98146,47.4996,-122.378,1700,8100,19314,6400,34.350096180269304,0.08852459016393442,Very Cheap
20140507T000000,530000.0,3,1.0,1340,4284,1.0,0,0,3,7,1080,260,1910,0,98105,47.6633,-122.324,1960,4080,2944,2120,123.71615312791783,0.05967213114754098,Very Cheap
20140609T000000,352750.0,2,1.75,1060,1241,2.0,0,0,3,7,960,100,2008,0,98144,47.5999,-122.3,1170,1400,181,230,284.24657534246575,0.03642622950819672,Very Cheap
20150204T000000,424950.0,4,2.5,2480,8563,2.0,0,0,3,8,2480,0,1992,0,98038,47.381,-122.033,2460,8660,6083,6200,49.62629919420764,0.04589508196721311,Very Cheap
20140530T000000,427000.0,5,2.75,2220,4000,1.0,0,0,3,7,1230,990,1973,0,98144,47.5754,-122.305,1580,4000,1780,2420,106.75,0.04616393442622951,Very Cheap
20140805T000000,558000.0,4,2.5,3220,5120,2.0,0,0,3,9,2420,800,2000,0,98118,47.5434,-122.27,1770,7680,1900,5910,108.984375,0.06334426229508197,Very Cheap
20141110T000000,438200.0,2,2.0,1600,5643,1.0,0,0,3,7,1600,0,1954,0,98115,47.6968,-122.279,1600,5746,4043,4146,77.65373028530924,0.0476327868852459,Very Cheap
20140929T000000,340000.0,1,1.0,640,4800,1.0,0,0,3,6,640,0,1918,0,98136,47.5551,-122.382,1250,2847,4160,1597,70.83333333333333,0.03475409836065574,Very Cheap
20140828T000000,830005.0,4,3.75,3610,7904,3.0,0,0,3,11,3290,320,1994,0,98117,47.6992,-122.385,2460,7300,4294,4840,105.010754048583,0.09901704918032787,Very Cheap
20140909T000000,548000.0,4,3.25,3420,5012,2.0,0,0,3,10,2330,1090,2008,0,98019,47.732,-121.982,2320,5465,1592,3145,109.33758978451716,0.062032786885245904,Very Cheap
20140604T000000,411715.0,3,1.75,1840,5101,1.0,0,0,5,7,1040,800,1952,0,98108,47.5585,-122.317,1340,5000,3261,3660,80.71260537149578,0.044159344262295085,Very Cheap
20141028T000000,865000.0,4,4.0,2790,16117,2.0,0,0,4,9,2790,0,1999,0,98005,47.6033,-122.155,2740,25369,13327,22629,53.670037848234784,0.10360655737704919,Cheap
20150202T000000,1750000.0,6,4.25,5860,13928,2.0,0,3,3,10,4150,1710,2013,0,98006,47.5382,-122.114,5790,13928,8068,8138,125.64618035611717,0.21967213114754097,Cheap
20140618T000000,688000.0,3,3.0,3450,16200,2.0,0,0,3,10,3450,0,1983,0,98074,47.6319,-122.041,3130,12150,12750,9020,42.46913580246913,0.08039344262295083,Very Cheap
20150317T000000,399950.0,4,2.5,2350,5100,2.0,0,0,3,8,2350,0,2003,0,98038,47.3507,-122.007,2190,5100,2750,2910,78.42156862745098,0.04261639344262295,Very Cheap
20150327T000000,555000.0,3,1.0,1250,4590,1.5,0,0,3,6,970,280,1903,0,98115,47.6757,-122.327,1830,4080,3340,2250,120.91503267973856,0.06295081967213115,Very Cheap
20140522T000000,677000.0,3,2.0,2000,3207,1.0,0,0,4,7,1100,900,1916,0,98103,47.6561,-122.341,1460,3200,1207,1740,211.1007171811662,0.07895081967213115,Very Cheap
20140606T000000,539000.0,3,2.0,2260,9568,1.0,0,0,3,8,1780,480,1985,0,98074,47.6457,-122.058,2250,9744,7308,7494,56.33361204013378,0.06085245901639344,Very Cheap
20140819T000000,410000.0,3,1.75,1510,6597,1.0,0,0,4,6,950,560,1939,0,98144,47.5938,-122.315,1460,5320,5087,3860,62.14946187661058,0.043934426229508196,Very Cheap
20150310T000000,472000.0,2,2.25,1800,2748,2.0,0,0,4,9,1800,0,1979,0,98008,47.6104,-122.113,1800,2755,948,955,171.7612809315866,0.052065573770491806,Very Cheap
20141026T000000,755000.0,3,2.5,2420,8856,1.0,0,3,3,9,1620,800,1957,0,98118,47.5405,-122.263,2650,9750,6436,7100,85.25293586269196,0.08918032786885247,Very Cheap
20140805T000000,269900.0,5,1.75,1750,8325,1.0,0,0,5,7,1750,0,1966,0,98031,47.4007,-122.198,1430,8325,6575,6895,32.42042042042042,0.02556065573770492,Very Cheap
20140722T000000,667400.0,4,2.5,2660,40312,2.0,0,0,4,8,2660,0,1977,0,98072,47.7532,-122.139,2650,45302,37652,42652,16.555864258781504,0.07769180327868852,Very Cheap
20141030T000000,1220000.0,3,2.25,2640,7544,1.0,0,0,3,10,2640,0,1995,0,98004,47.6224,-122.195,2650,7904,4904,5254,161.71792152704137,0.1501639344262295,Cheap
20140630T000000,544000.0,3,2.5,1460,1613,2.0,0,0,3,8,1180,280,2007,0,98117,47.6781,-122.375,1460,1403,153,-57,337.25976441413513,0.06150819672131148,Very Cheap
20150428T000000,800000.0,2,1.0,1570,5000,1.5,0,3,4,8,1570,0,1924,0,98144,47.5955,-122.294,1760,3000,3430,1240,160.0,0.09508196721311475,Very Cheap
20140822T000000,315000.0,3,1.0,1010,7500,1.0,0,0,4,7,1010,0,1975,0,98074,47.6172,-122.061,1250,10000,6490,8750,42.0,0.031475409836065574,Very Cheap
20140610T000000,227000.0,4,1.0,1200,7200,1.5,0,0,3,6,1200,0,1944,0,98178,47.4951,-122.248,1070,6050,6000,4980,31.52777777777778,0.019934426229508195,Very Cheap
20141020T000000,765000.0,4,2.5,4040,25752,2.0,0,0,3,10,4040,0,2000,0,98038,47.4579,-122.068,3230,22247,21712,19017,29.706430568499535,0.09049180327868853,Very Cheap
20140702T000000,625000.0,3,3.0,1820,1641,3.0,0,0,3,8,1540,280,2006,0,98119,47.6482,-122.358,1720,1501,-179,-219,380.86532602071907,0.07213114754098361,Very Cheap
20140902T000000,1875000.0,4,5.0,5810,7440,2.0,0,0,3,10,3790,2020,2004,0,98033,47.6878,-122.212,3010,7200,1630,4190,252.01612903225808,0.2360655737704918,Cheap
20150211T000000,822600.0,4,2.5,3010,9600,1.0,0,2,3,9,1510,1500,1979,0,98006,47.5519,-122.156,2780,10000,6590,7220,85.6875,0.09804590163934426,Very Cheap
20150423T000000,515000.0,4,2.5,1910,8947,1.0,0,0,4,8,1160,750,1970,0,98011,47.7374,-122.183,1920,7350,7037,5430,57.56119369621102,0.057704918032786885,Very Cheap
20150512T000000,377000.0,4,2.0,1640,5014,1.0,0,0,4,7,930,710,1982,0,98106,47.5545,-122.356,1600,5452,3374,3852,75.18946948544077,0.03960655737704918,Very Cheap
20150304T000000,600000.0,3,1.0,1480,17360,1.0,0,1,3,8,1480,0,1954,0,98136,47.5179,-122.387,2250,8720,15880,6470,34.56221198156682,0.06885245901639345,Very Cheap
20141114T000000,525300.0,4,1.75,2520,7770,1.0,0,0,3,8,1680,840,1965,0,98177,47.7721,-122.372,2340,7770,5250,5430,67.60617760617761,0.05905573770491803,Very Cheap
20140814T000000,760000.0,4,3.0,2840,13554,1.0,0,2,4,9,1990,850,1974,0,98034,47.7153,-122.257,2840,16940,10714,14100,56.072008263243326,0.0898360655737705,Very Cheap
20141229T000000,202000.0,2,1.0,840,7200,1.0,0,0,4,5,840,0,1907,0,98032,47.3769,-122.237,1030,7200,6360,6170,28.055555555555557,0.016655737704918034,Very Cheap
20140619T000000,470000.0,3,2.0,1730,38884,1.0,0,0,3,8,1730,0,1997,0,98038,47.4164,-121.951,2130,91040,37154,88910,12.087233823680691,0.05180327868852459,Very Cheap
20140725T000000,810000.0,3,2.5,3140,10983,2.0,0,0,3,10,3140,0,1991,0,98075,47.5595,-122.04,3140,10983,7843,7843,73.75034143676591,0.09639344262295083,Very Cheap
20150316T000000,175000.0,3,1.0,1480,8415,1.0,0,0,3,7,1080,400,1967,0,98188,47.4585,-122.283,1780,8512,6935,6732,20.7961972667855,0.013114754098360656,Very Cheap
20141015T000000,440000.0,4,1.75,1920,7986,1.0,0,0,3,7,960,960,1952,0,98125,47.7209,-122.318,1700,7452,6066,5752,55.09641873278237,0.04786885245901639,Very Cheap
20150330T000000,197000.0,2,1.0,770,8636,1.0,0,0,2,6,770,0,1951,0,98146,47.5075,-122.358,1110,8636,7866,7526,22.811486799444186,0.016,Very Cheap
20150306T000000,254000.0,3,1.0,1010,7384,1.0,0,2,5,6,1010,0,1943,0,98056,47.4905,-122.191,1010,8000,6374,6990,34.398699891657635,0.023475409836065574,Very Cheap
20140620T000000,405000.0,3,1.0,1460,10000,1.5,0,0,3,7,1460,0,2002,0,98074,47.6214,-122.063,1910,10000,8540,8090,40.5,0.043278688524590166,Very Cheap
20150327T000000,416000.0,2,1.0,940,4264,1.0,0,0,5,7,940,0,1949,0,98126,47.5314,-122.378,1630,4472,3324,2842,97.5609756097561,0.044721311475409836,Very Cheap
20140919T000000,779950.0,4,2.75,2840,4864,3.0,0,0,3,9,2840,0,2014,0,98052,47.7103,-122.108,2990,5314,2024,2324,160.3515625,0.09245245901639344,Very Cheap
20150112T000000,200000.0,4,2.75,1910,7210,1.0,0,0,4,7,1430,480,1980,0,98030,47.3693,-122.169,1750,7446,5300,5696,27.739251040221912,0.01639344262295082,Very Cheap
20140717T000000,658100.0,4,2.5,2430,8509,2.0,0,0,3,9,2430,0,1992,0,98029,47.5714,-121.991,2760,8509,6079,5749,77.34163826536609,0.07647213114754098,Very Cheap
20140714T000000,397000.0,2,1.75,1610,4104,1.0,0,0,3,7,950,660,1996,0,98118,47.5565,-122.275,1510,5284,2494,3774,96.73489278752437,0.04222950819672131,Very Cheap
20141015T000000,815000.0,3,3.75,2780,5002,2.0,0,0,3,10,2780,0,1999,0,98007,47.5939,-122.15,3110,5717,2222,2607,162.93482606957218,0.09704918032786886,Very Cheap
20141016T000000,345000.0,2,1.0,1160,8504,1.0,0,0,4,7,1160,0,1949,0,98155,47.7364,-122.295,1320,8504,7344,7184,40.56914393226717,0.03540983606557377,Very Cheap
20140924T000000,305500.0,4,2.5,1850,7199,2.0,0,0,4,7,1850,0,1989,0,98031,47.4031,-122.172,1940,7432,5349,5492,42.43644950687595,0.03022950819672131,Very Cheap
20140708T000000,340000.0,3,2.25,2120,13090,1.0,0,0,3,8,2120,0,1997,0,98002,47.296,-122.219,1400,12039,10970,10639,25.974025974025974,0.03475409836065574,Very Cheap
20150226T000000,330000.0,5,2.5,2620,12763,1.0,0,0,3,7,1400,1220,1979,0,98034,47.72,-122.213,2390,9156,10143,6766,25.85598997100995,0.03344262295081967,Very Cheap
20150421T000000,269000.0,4,2.5,2060,3608,2.0,0,0,3,7,2060,0,2004,0,98198,47.362,-122.309,2060,3608,1548,1548,74.55654101995566,0.02544262295081967,Very Cheap
20140612T000000,349950.0,3,1.0,1060,9525,1.0,0,0,3,7,1060,0,1966,0,98052,47.6855,-122.111,1630,9525,8465,7895,36.74015748031496,0.036059016393442625,Very Cheap
20150304T000000,431000.0,3,1.0,1500,6240,1.0,0,0,4,7,1500,0,1953,0,98125,47.7281,-122.311,1230,6240,4740,5010,69.07051282051282,0.046688524590163934,Very Cheap
20141017T000000,735000.0,4,1.75,2380,5700,2.0,0,1,4,7,1820,560,1946,0,98105,47.6656,-122.271,2190,5700,3320,3510,128.94736842105263,0.08655737704918033,Very Cheap
20140717T000000,414000.0,5,3.0,3045,5030,2.0,0,0,3,8,3045,0,1999,0,98058,47.4386,-122.127,3045,5322,1985,2277,82.30616302186878,0.04445901639344262,Very Cheap
20140520T000000,619500.0,3,2.5,1700,4105,2.0,0,0,3,8,1700,0,1992,0,98122,47.6078,-122.292,1880,3665,2405,1785,150.91352009744213,0.07140983606557377,Very Cheap
20141030T000000,675000.0,3,1.75,1240,13869,1.0,0,0,4,7,1240,0,1957,0,98033,47.6919,-122.21,1970,7790,12629,5820,48.66969500324465,0.07868852459016394,Very Cheap
20150423T000000,380500.0,3,1.0,1410,7854,1.0,0,0,4,7,1410,0,1971,0,98034,47.7303,-122.192,1460,7500,6444,6040,48.446651387827856,0.0400655737704918,Very Cheap
20140617T000000,253000.0,3,1.5,880,6600,1.0,0,0,5,6,880,0,1945,0,98178,47.5002,-122.247,1020,6600,5720,5580,38.333333333333336,0.023344262295081967,Very Cheap
20140528T000000,157500.0,2,1.0,740,9003,1.0,0,0,3,5,740,0,1949,0,98031,47.4217,-122.197,1230,8050,8263,6820,17.49416861046318,0.010819672131147541,Very Cheap
20140609T000000,627000.0,4,2.0,2030,9300,1.0,0,0,4,8,2030,0,1976,0,98052,47.6658,-122.149,1800,9018,7270,7218,67.41935483870968,0.07239344262295082,Very Cheap
20140924T000000,469500.0,4,2.5,2090,7241,1.0,0,0,4,7,1140,950,2001,0,98034,47.726,-122.221,1510,7402,5151,5892,64.8391106200801,0.051737704918032784,Very Cheap
20140619T000000,319950.0,2,1.0,920,8341,1.0,0,0,3,7,920,0,1939,0,98146,47.5015,-122.38,2330,9792,7421,7462,38.35870998681213,0.03212459016393442,Very Cheap
20150218T000000,249500.0,3,1.0,1180,7200,1.0,0,0,4,7,1180,0,1968,0,98058,47.4249,-122.178,1180,7200,6020,6020,34.65277777777778,0.022885245901639345,Very Cheap
20150223T000000,485000.0,3,1.0,1260,3230,1.5,0,0,3,7,1260,0,1907,0,98119,47.644,-122.369,1700,3500,1970,1800,150.1547987616099,0.05377049180327869,Very Cheap
20141024T000000,1125000.0,5,3.0,3690,10260,1.0,0,4,4,9,2070,1620,1967,0,98005,47.5919,-122.176,3160,14000,6570,10840,109.64912280701755,0.1377049180327869,Cheap
20140628T000000,314500.0,3,1.75,1700,17355,1.0,0,0,3,7,1200,500,1978,0,98038,47.3637,-122.057,1900,9528,15655,7628,18.1215787957361,0.03140983606557377,Very Cheap
20150403T000000,220000.0,2,1.0,770,8149,1.0,0,0,3,6,770,0,1948,0,98155,47.7467,-122.3,880,8149,7379,7269,26.99717756779973,0.01901639344262295,Very Cheap
20141124T000000,444950.0,3,2.5,2020,7800,1.0,0,0,4,7,1330,690,1958,0,98133,47.7368,-122.337,1870,7800,5780,5930,57.044871794871796,0.04851803278688525,Very Cheap
20140825T000000,598000.0,4,2.5,2030,9825,1.0,0,0,3,8,1330,700,1985,0,98115,47.6892,-122.3,2180,7500,7795,5320,60.86513994910941,0.06859016393442623,Very Cheap
20140616T000000,699850.0,4,3.5,2690,6164,2.0,0,0,3,9,2690,0,2002,0,98075,47.599,-121.973,2910,5000,3474,2090,113.53828682673588,0.08194754098360656,Very Cheap
20140508T000000,595000.0,3,2.5,1750,3354,2.0,0,0,4,7,1750,0,1991,0,98033,47.6953,-122.199,1750,4286,1604,2536,177.40011926058438,0.06819672131147542,Very Cheap
20141218T000000,735000.0,4,2.5,3270,45537,2.0,0,0,3,9,3270,0,1993,0,98053,47.6303,-121.984,2670,38827,42267,36157,16.14072073259108,0.08655737704918033,Very Cheap
20140509T000000,542500.0,4,2.5,2330,14289,2.0,0,0,4,8,2330,0,1978,0,98007,47.5916,-122.148,2210,12823,11959,10613,37.96626775841556,0.061311475409836065,Very Cheap
20150512T000000,450000.0,3,1.75,1720,6960,1.0,0,0,3,7,1140,580,1978,0,98052,47.6972,-122.129,1720,7280,5240,5560,64.65517241379311,0.04918032786885246,Very Cheap
20140728T000000,298500.0,3,2.0,2420,8800,1.0,0,0,4,7,1420,1000,1959,0,98188,47.4322,-122.291,1546,8666,6380,7120,33.92045454545455,0.029311475409836064,Very Cheap
20140609T000000,403950.0,2,1.0,710,1136,2.0,0,0,4,7,710,0,1943,0,98102,47.6414,-122.329,1370,1173,426,-197,355.58978873239437,0.043140983606557375,Very Cheap
20141229T000000,271000.0,2,1.0,710,4240,1.0,0,0,4,6,710,0,1942,0,98106,47.5226,-122.351,850,5200,3530,4350,63.91509433962264,0.025704918032786885,Very Cheap
20140911T000000,335000.0,2,1.0,1510,3844,1.0,0,0,4,7,1510,0,1923,1970,98133,47.7038,-122.348,1170,3844,2334,2674,87.14880332986472,0.03409836065573771,Very Cheap
20141216T000000,305000.0,2,2.25,1610,1968,2.0,0,0,5,7,1610,0,1979,0,98056,47.5184,-122.196,1950,1968,358,18,154.97967479674796,0.03016393442622951,Very Cheap
20150317T000000,630000.0,3,3.0,1880,2200,2.0,0,0,3,8,1520,360,2007,0,98107,47.6666,-122.367,1500,1426,320,-74,286.3636363636364,0.07278688524590164,Very Cheap
20140603T000000,253000.0,2,1.75,1220,5000,1.0,0,0,5,7,860,360,1921,0,98055,47.4906,-122.204,1120,5000,3780,3880,50.6,0.023344262295081967,Very Cheap
20140919T000000,395000.0,4,1.75,2060,7900,1.0,0,0,4,7,1070,990,1957,0,98008,47.6028,-122.12,1830,8000,5840,6170,50.0,0.0419672131147541,Very Cheap
20141017T000000,265000.0,3,2.5,1340,10290,1.0,0,0,4,7,1140,200,1981,0,98042,47.3553,-122.149,1760,7903,8950,6143,25.75315840621963,0.024918032786885248,Very Cheap
20140721T000000,225000.0,2,1.0,1030,9192,1.0,0,0,4,6,1030,0,1959,0,98058,47.4565,-122.181,1030,9190,8162,8160,24.47780678851175,0.019672131147540985,Very Cheap
20140917T000000,338500.0,4,2.5,2717,4513,2.0,0,0,3,8,2717,0,2005,0,98001,47.3373,-122.266,2550,4841,1796,2291,75.00553955240417,0.03455737704918033,Very Cheap
20140512T000000,300000.0,2,1.75,1360,8100,1.0,0,0,3,7,860,500,1975,0,98177,47.7295,-122.359,1830,6766,6740,4936,37.03703703703704,0.029508196721311476,Very Cheap
20140820T000000,255000.0,2,1.0,1260,7810,2.0,0,0,3,6,1260,0,1945,0,98178,47.5003,-122.248,1260,7755,6550,6495,32.65044814340589,0.02360655737704918,Very Cheap
20140620T000000,337000.0,4,3.0,2240,8504,2.0,0,0,3,7,2240,0,1992,0,98155,47.7348,-122.295,1570,8460,6264,6890,39.62841015992474,0.034360655737704915,Very Cheap
20150416T000000,324900.0,3,2.25,2080,9740,2.0,0,0,3,8,2080,0,1988,0,98092,47.261,-122.219,2080,8705,7660,6625,33.35728952772074,0.03277377049180328,Very Cheap
20140707T000000,821000.0,3,2.75,2760,8476,1.0,0,0,4,8,1690,1070,1967,0,98040,47.5402,-122.215,2610,9835,5716,7225,96.86172722982539,0.09783606557377049,Very Cheap
20141212T000000,500000.0,4,2.75,3000,213008,1.0,0,0,4,8,3000,0,1975,0,98038,47.4032,-121.982,2300,74191,210008,71891,2.347329677758582,0.05573770491803279,Very Cheap
20150302T000000,885000.0,4,3.5,3310,6000,2.0,0,2,3,8,2200,1110,2010,0,98136,47.5511,-122.391,1420,6000,2690,4580,147.5,0.1062295081967213,Cheap
20140610T000000,360000.0,4,2.0,1630,10375,1.0,0,0,5,7,1630,0,1968,0,98077,47.7566,-122.073,1360,10026,8745,8666,34.69879518072289,0.037377049180327866,Very Cheap
20140527T000000,304000.0,3,1.0,900,7500,1.0,0,0,4,7,900,0,1972,0,98034,47.7314,-122.237,1960,7500,6600,5540,40.53333333333333,0.030032786885245903,Very Cheap
20150316T000000,376000.0,2,1.0,880,2400,1.0,0,0,3,6,760,120,1918,0,98118,47.5643,-122.275,1180,6300,1520,5120,156.66666666666666,0.039475409836065574,Very Cheap
20141104T000000,425000.0,4,1.5,1620,7875,1.0,0,0,3,7,1620,0,1956,0,98008,47.6041,-122.126,1890,8400,6255,6510,53.96825396825397,0.04590163934426229,Very Cheap
20140522T000000,1180500.0,3,1.75,1610,7200,1.0,0,0,3,8,1090,520,1973,0,98112,47.6279,-122.287,3790,7200,5590,3410,163.95833333333334,0.14498360655737705,Cheap
20140722T000000,187000.0,3,2.5,1730,1803,2.0,0,0,3,7,1730,0,2005,0,98166,47.4648,-122.335,1190,7980,73,6790,103.71602884082085,0.014688524590163935,Very Cheap
20140627T000000,710000.0,2,1.5,1640,4080,1.5,0,0,5,7,1540,100,1916,0,98105,47.6624,-122.325,1880,4080,2440,2200,174.01960784313727,0.08327868852459017,Very Cheap
20150325T000000,585000.0,3,1.75,1840,7350,1.0,0,0,3,8,1370,470,1974,0,98033,47.6729,-122.166,1920,8518,5510,6598,79.59183673469387,0.06688524590163934,Very Cheap
20150409T000000,1400000.0,5,4.0,4700,22326,2.0,0,0,3,11,4700,0,2002,0,98006,47.5417,-122.111,4730,27110,17626,22380,62.70715757412882,0.1737704918032787,Cheap
20150225T000000,1980000.0,4,3.5,4500,44384,1.0,0,0,3,12,3340,1160,1990,0,98004,47.6323,-122.192,2540,26287,39884,23747,44.61067051189618,0.2498360655737705,Cheap
20141226T000000,250000.0,3,1.75,1780,35233,1.0,0,0,4,8,1420,360,1979,0,98001,47.2949,-122.269,1950,17334,33453,15384,7.095620582976187,0.022950819672131147,Very Cheap
20141218T000000,950000.0,4,2.75,3800,12200,2.0,0,3,4,10,3800,0,1986,0,98006,47.5689,-122.156,3710,14796,8400,11086,77.8688524590164,0.11475409836065574,Cheap
20140902T000000,725000.0,3,2.5,2980,16996,2.0,0,0,3,10,2980,0,1992,0,98075,47.595,-122.016,2980,15438,14016,12458,42.65709578724406,0.08524590163934426,Very Cheap
20140512T000000,505000.0,4,2.5,2780,6369,1.0,0,0,3,8,1590,1190,1978,0,98034,47.7284,-122.216,2170,7490,3589,5320,79.29031245093421,0.05639344262295082,Very Cheap
20150418T000000,90000.0,1,1.0,560,4120,1.0,0,0,3,4,560,0,1947,0,98106,47.5335,-122.348,980,4120,3560,3140,21.844660194174757,0.0019672131147540984,Very Cheap
20150409T000000,400000.0,4,2.0,2060,3060,2.0,0,0,3,7,2060,0,1968,0,98118,47.5631,-122.285,1630,3766,1000,2136,130.718954248366,0.04262295081967213,Very Cheap
20150217T000000,407000.0,3,1.0,1140,7785,1.0,0,0,3,8,1140,0,1954,0,98177,47.709,-122.363,2080,10620,6645,8540,52.280025690430314,0.04354098360655738,Very Cheap
20141219T000000,651000.0,3,1.5,1890,4400,1.5,0,0,5,7,1890,0,1919,0,98105,47.6662,-122.326,1620,4080,2510,2460,147.95454545454547,0.07554098360655738,Very Cheap
20150205T000000,485000.0,3,2.25,2090,7450,1.0,0,0,3,7,1350,740,1978,0,98155,47.7598,-122.303,1740,7644,5360,5904,65.1006711409396,0.05377049180327869,Very Cheap
20150113T000000,460000.0,4,2.75,3460,13168,2.0,0,0,4,8,3460,0,1932,1986,98022,47.2046,-121.996,1500,7670,9708,6170,34.933171324422844,0.050491803278688525,Very Cheap
20150309T000000,369000.0,2,1.0,1320,6135,1.0,0,0,4,7,880,440,1942,0,98126,47.5265,-122.379,1050,4693,4815,3643,60.14669926650367,0.03855737704918033,Very Cheap
20140620T000000,355000.0,2,1.0,1240,27042,1.0,0,1,3,6,1000,240,1943,0,98070,47.5026,-122.465,2140,20059,25802,17919,13.127727239109534,0.036721311475409836,Very Cheap
20140916T000000,155000.0,2,1.0,810,4755,1.0,0,0,3,7,810,0,1980,0,98118,47.5313,-122.28,1180,4755,3945,3575,32.597266035751844,0.010491803278688525,Very Cheap
20141215T000000,1000000.0,3,1.0,1880,5450,1.5,0,0,4,8,1880,0,1924,0,98112,47.6453,-122.302,2580,5450,3570,2870,183.4862385321101,0.12131147540983607,Cheap
20150211T000000,419625.0,4,2.5,2680,11590,2.0,0,0,4,9,2680,0,1988,0,98058,47.4395,-122.163,2580,8225,8910,5645,36.20578084555651,0.04519672131147541,Very Cheap
20150218T000000,435000.0,3,2.0,2040,6880,2.0,0,0,4,7,2040,0,1954,0,98133,47.7601,-122.351,1710,7597,4840,5887,63.22674418604651,0.04721311475409836,Very Cheap
20150511T000000,379000.0,4,1.75,2180,7876,1.0,0,0,4,7,1290,890,1977,0,98056,47.5157,-122.191,1960,7225,5696,5265,48.12087353986795,0.03986885245901639,Very Cheap
20150224T000000,293000.0,4,2.25,1870,5371,2.0,0,0,3,7,1870,0,2009,0,98038,47.3844,-122.036,2380,4502,3501,2122,54.55222491156209,0.02859016393442623,Very Cheap
20140806T000000,592100.0,4,2.75,2310,7851,1.0,0,0,4,8,1790,520,1989,0,98006,47.5473,-122.187,2230,7359,5541,5129,75.4171443128264,0.06781639344262295,Very Cheap
20141110T000000,362000.0,3,1.75,1120,9730,1.0,0,0,3,7,1120,0,1944,1989,98011,47.7372,-122.221,2530,8717,8610,6187,37.20452209660843,0.03763934426229508,Very Cheap
20141203T000000,227000.0,3,1.0,1340,10035,1.0,0,0,3,7,1340,0,1959,0,98178,47.4916,-122.254,2090,10035,8695,7945,22.620827105132037,0.019934426229508195,Very Cheap
20140819T000000,335500.0,3,1.75,1260,8487,1.0,0,0,3,7,1260,0,1970,0,98011,47.7664,-122.201,1890,13051,7227,11161,39.53104748438789,0.03416393442622951,Very Cheap
20140818T000000,213000.0,3,1.75,1200,55321,1.5,0,0,5,7,1200,0,1977,0,98010,47.3492,-121.935,1910,54450,54121,52540,3.8502557799027493,0.018098360655737705,Very Cheap
20150326T000000,338000.0,5,2.5,2400,4496,2.0,0,0,3,7,2400,0,2004,0,98042,47.3692,-122.126,1880,4319,2096,2439,75.1779359430605,0.034491803278688525,Very Cheap
20141022T000000,163500.0,3,1.0,940,7200,1.0,0,0,4,7,940,0,1954,0,98002,47.2979,-122.223,1090,7800,6260,6710,22.708333333333332,0.01160655737704918,Very Cheap
20141124T000000,199988.0,2,1.0,860,5000,1.0,0,0,3,7,860,0,1949,0,98178,47.5005,-122.267,1130,6000,4140,4870,39.9976,0.016391868852459017,Very Cheap
20140725T000000,1185000.0,3,2.25,2390,7875,1.0,0,1,3,10,1980,410,1948,0,98105,47.6515,-122.278,3720,9075,5485,5355,150.47619047619048,0.14557377049180328,Cheap
20150407T000000,320000.0,4,2.5,3130,5200,2.0,0,0,3,7,3130,0,2005,0,98042,47.3828,-122.098,3020,5200,2070,2180,61.53846153846154,0.032131147540983604,Very Cheap
20140616T000000,450000.0,6,2.25,3550,11780,1.0,0,0,4,8,2960,590,1948,0,98125,47.7218,-122.312,2360,8850,8230,6490,38.20033955857385,0.04918032786885246,Very Cheap
20141030T000000,249900.0,2,2.0,1470,2541,2.0,0,0,3,6,1470,0,2005,0,98038,47.3502,-122.02,1310,2721,1071,1411,98.34710743801652,0.02293770491803279,Very Cheap
20140612T000000,223000.0,2,1.0,910,9869,1.0,0,0,3,6,910,0,1957,0,98058,47.4572,-122.184,1480,9750,8959,8270,22.596007700881547,0.019409836065573772,Very Cheap
20150210T000000,631000.0,4,4.0,2630,59586,1.0,0,0,3,7,1470,1160,1963,0,98055,47.4496,-122.209,2230,5715,56956,3485,10.5897358439902,0.07291803278688525,Very Cheap
20150505T000000,350000.0,4,2.25,1780,10416,1.0,0,0,5,7,1060,720,1963,0,98055,47.4414,-122.189,1780,9975,8636,8195,33.60215053763441,0.036065573770491806,Very Cheap
20140714T000000,279000.0,3,1.75,1430,39160,1.0,0,0,3,7,900,530,1925,1987,98065,47.5513,-121.801,1430,40860,37730,39430,7.12461695607763,0.02675409836065574,Very Cheap
20150409T000000,310000.0,5,2.0,2730,7344,1.0,0,0,5,7,1510,1220,1962,0,98058,47.4602,-122.171,1730,7700,4614,5970,42.21132897603486,0.03081967213114754,Very Cheap
20140812T000000,185000.0,2,1.0,900,8000,1.0,0,0,4,6,900,0,1954,0,98198,47.4217,-122.317,1240,8000,7100,6760,23.125,0.014426229508196721,Very Cheap
20150316T000000,445000.0,3,2.5,1740,22089,1.0,0,0,4,8,1130,610,1977,0,98070,47.3948,-122.435,2000,24925,20349,22925,20.145773914618136,0.04852459016393443,Very Cheap
20141212T000000,365000.0,4,2.5,2905,4874,2.0,0,0,3,9,2905,0,2003,0,98031,47.4084,-122.169,2900,5271,1969,2371,74.887156339762,0.0380327868852459,Very Cheap
20150423T000000,333500.0,3,1.5,2230,9120,1.0,0,0,3,7,1390,840,1959,0,98146,47.5008,-122.358,1420,8450,6890,7030,36.56798245614035,0.033901639344262297,Very Cheap
20141120T000000,385000.0,3,2.25,1680,8450,1.0,0,0,3,8,1340,340,1960,0,98177,47.7575,-122.361,1850,8300,6770,6450,45.562130177514796,0.04065573770491803,Very Cheap
20140520T000000,345000.0,3,1.5,1240,11200,1.0,0,0,4,7,1240,0,1954,0,98006,47.5716,-122.138,1240,11008,9960,9768,30.803571428571427,0.03540983606557377,Very Cheap
20141110T000000,1260000.0,3,3.0,3230,8625,2.0,0,3,3,10,2220,1010,1998,0,98116,47.562,-122.404,2330,6022,5395,3692,146.08695652173913,0.15540983606557376,Cheap
20140523T000000,440000.0,4,2.5,2560,10400,1.0,0,0,4,7,1280,1280,1965,0,98027,47.5225,-122.04,1740,11050,7840,9310,42.30769230769231,0.04786885245901639,Very Cheap
20140925T000000,444500.0,3,2.5,2600,4724,2.0,0,0,3,7,2600,0,2002,0,98065,47.5359,-121.878,2400,4724,2124,2324,94.09398814563929,0.048459016393442626,Very Cheap
20141113T000000,340000.0,4,1.0,1200,11834,1.0,1,3,3,6,1200,0,1972,0,98070,47.4557,-122.443,1670,47462,10634,45792,28.730775730944735,0.03475409836065574,Very Cheap
20150312T000000,680000.0,4,1.0,1660,6075,1.5,0,0,5,7,1660,0,1915,0,98117,47.6755,-122.403,1810,5400,4415,3590,111.93415637860082,0.07934426229508197,Very Cheap
20140909T000000,420000.0,3,1.75,1140,8558,1.0,0,0,4,7,1140,0,1982,0,98033,47.7027,-122.198,1490,10530,7418,9040,49.076887123159615,0.04524590163934426,Very Cheap
20141229T000000,438500.0,3,2.25,3050,10689,2.0,0,0,4,9,3050,0,1988,0,98092,47.3326,-122.201,2697,10925,7639,8228,41.02348208438582,0.047672131147540986,Very Cheap
20140918T000000,109500.0,2,1.0,800,10625,1.0,0,0,3,6,800,0,1942,0,98168,47.496,-122.317,1130,10625,9825,9495,10.305882352941177,0.004524590163934426,Very Cheap
20150410T000000,461000.0,4,2.75,1700,7495,1.0,0,0,4,7,1200,500,1964,0,98133,47.7589,-122.354,1650,7495,5795,5845,61.50767178118746,0.05062295081967213,Very Cheap
20140811T000000,968000.0,4,1.75,2630,9645,1.0,0,0,4,9,2630,0,1963,0,98040,47.5459,-122.228,2690,10439,7015,7749,100.36288232244686,0.11711475409836065,Cheap
20140923T000000,355000.0,3,1.75,1960,7705,1.0,0,0,4,7,980,980,1950,0,98106,47.53,-122.347,1380,4349,5745,2969,46.07397793640493,0.036721311475409836,Very Cheap
20150327T000000,249000.0,3,1.5,1180,11579,1.0,0,0,4,7,1180,0,1962,0,98058,47.4502,-122.089,1780,22486,10399,20706,21.504447707055878,0.02281967213114754,Very Cheap
20150326T000000,256500.0,5,2.5,1960,7350,1.0,0,0,4,7,1360,600,1969,0,98058,47.4368,-122.165,1900,7350,5390,5450,34.89795918367347,0.02380327868852459,Very Cheap
20150302T000000,1810000.0,5,2.5,4250,20441,1.0,0,1,4,11,2490,1760,1984,0,98004,47.6377,-122.211,3620,16304,16191,12684,88.54752702901033,0.2275409836065574,Cheap
20141223T000000,269000.0,3,2.25,1950,8661,1.0,0,0,4,8,1950,0,1966,0,98023,47.3127,-122.362,1950,8800,6711,6850,31.058769195243045,0.02544262295081967,Very Cheap
20141112T000000,1350000.0,4,3.5,3600,5217,2.0,0,0,3,9,2720,880,1947,2014,98112,47.6189,-122.286,2270,5217,1617,2947,258.7694077055779,0.16721311475409836,Cheap
20140620T000000,885000.0,3,2.25,2060,9552,1.0,0,0,4,9,1610,450,1975,0,98040,47.5402,-122.231,2930,11212,7492,8282,92.65075376884423,0.1062295081967213,Cheap
20150423T000000,455000.0,3,2.0,1640,9825,1.0,0,0,4,7,1090,550,1971,0,98034,47.7244,-122.2,1500,9750,8185,8250,46.31043256997455,0.049836065573770495,Very Cheap
20140609T000000,980000.0,4,2.5,2730,4800,1.5,0,0,5,8,2230,500,1909,0,98119,47.642,-122.358,2190,4200,2070,2010,204.16666666666666,0.11868852459016394,Cheap
20140801T000000,412500.0,3,1.75,1530,6300,1.0,0,0,3,6,1530,0,1942,2004,98126,47.516,-122.375,920,6300,4770,5380,65.47619047619048,0.04426229508196721,Very Cheap
20141217T000000,740000.0,4,3.5,3060,4777,2.0,0,0,3,9,3060,0,2007,0,98029,47.555,-122.0,3060,4935,1717,1875,154.90893866443375,0.08721311475409836,Very Cheap
20140823T000000,1298000.0,4,2.25,2860,5658,2.0,0,3,3,10,2130,730,1933,0,98199,47.6395,-122.409,2700,5221,2798,2521,229.40968540120184,0.16039344262295083,Cheap
20150312T000000,326000.0,2,1.5,1030,798,3.0,0,0,3,8,1030,0,2008,0,98103,47.6975,-122.34,1020,1026,-232,6,408.52130325814534,0.032918032786885244,Very Cheap
20140607T000000,568500.0,4,2.5,2460,4200,2.0,0,0,3,8,2460,0,1998,0,98074,47.6041,-122.02,2460,4200,1740,1740,135.35714285714286,0.06472131147540984,Very Cheap
20140922T000000,620000.0,4,2.5,2500,8282,2.0,0,0,3,9,2500,0,2013,0,98056,47.5127,-122.169,2500,8046,5782,5546,74.86114465105047,0.07147540983606557,Very Cheap
20150417T000000,283000.0,3,1.75,1830,7600,2.0,0,0,3,7,1490,340,1947,0,98106,47.5317,-122.351,1300,4000,5770,2700,37.23684210526316,0.027278688524590165,Very Cheap
20140814T000000,875000.0,6,3.25,2820,4536,2.0,0,0,4,8,1930,890,1917,0,98105,47.6688,-122.309,2820,4536,1716,1716,192.90123456790124,0.10491803278688525,Cheap
20150527T000000,1310000.0,4,2.25,3750,5000,2.0,0,0,5,8,2440,1310,1924,0,98115,47.6747,-122.303,2170,4590,1250,2420,262.0,0.1619672131147541,Cheap
20141023T000000,289950.0,3,2.5,2070,6145,2.0,0,0,3,7,2070,0,2003,0,98092,47.3357,-122.172,2070,5297,4075,3227,47.18470301057771,0.028190163934426228,Very Cheap
20141114T000000,252500.0,3,2.5,1780,7192,1.0,0,0,4,7,1250,530,1974,0,98031,47.4093,-122.173,1870,8500,5412,6630,35.10845383759733,0.023278688524590165,Very Cheap
20141029T000000,376000.0,4,2.25,2200,6750,1.0,0,0,5,8,1480,720,1959,0,98056,47.5215,-122.202,2710,6750,4550,4040,55.7037037037037,0.039475409836065574,Very Cheap
20140522T000000,635700.0,4,2.5,3240,13978,1.0,0,0,3,9,1860,1380,1977,0,98074,47.6298,-122.057,3150,12767,10738,9617,45.478609243096294,0.07353442622950819,Very Cheap
20141028T000000,710000.0,4,2.5,2880,12349,2.0,0,0,3,10,2880,0,1996,0,98075,47.5879,-121.973,3490,11539,9469,8049,57.49453397036197,0.08327868852459017,Very Cheap
20150301T000000,440000.0,3,1.75,1570,5120,1.0,0,2,3,7,980,590,1947,0,98177,47.7166,-122.365,2420,7200,3550,4780,85.9375,0.04786885245901639,Very Cheap
20140630T000000,439000.0,3,2.5,3180,7904,1.0,0,0,3,8,1810,1370,2006,0,98056,47.489,-122.181,1950,7800,4724,5850,55.5414979757085,0.04773770491803279,Very Cheap
20140616T000000,455000.0,2,1.5,1310,12196,1.5,0,0,3,6,1310,0,1970,0,98052,47.6487,-122.122,2970,12196,10886,9226,37.307313873401114,0.049836065573770495,Very Cheap
20140519T000000,225000.0,2,1.0,910,9612,1.0,0,0,4,7,910,0,1981,0,98058,47.4297,-122.152,1410,9611,8702,8201,23.408239700374533,0.019672131147540985,Very Cheap
20140728T000000,250000.0,3,1.0,1460,10914,1.0,0,0,4,7,1460,0,1959,0,98058,47.4511,-122.173,1490,8314,9454,6824,22.906358805204324,0.022950819672131147,Very Cheap
20150407T000000,585000.0,4,3.25,3410,34939,2.0,0,0,4,9,2470,940,1992,0,98027,47.459,-122.003,2450,39045,31529,36595,16.743467185666447,0.06688524590163934,Very Cheap
20150407T000000,685000.0,3,1.75,2720,4720,1.5,0,0,4,7,1580,1140,1925,0,98105,47.6691,-122.29,1660,4640,2000,2980,145.1271186440678,0.08,Very Cheap
20140620T000000,420000.0,5,2.75,2280,10319,1.0,0,0,3,8,1300,980,1959,0,98177,47.7566,-122.363,2370,8056,8039,5686,40.70161837387344,0.04524590163934426,Very Cheap
20141122T000000,245000.0,2,1.0,670,1675,1.0,0,0,5,6,670,0,1960,0,98144,47.5918,-122.295,1220,1740,1005,520,146.26865671641792,0.022295081967213116,Very Cheap
20141104T000000,275000.0,4,2.0,1480,15000,1.0,0,0,4,7,1480,0,1957,0,98055,47.4312,-122.196,1450,8768,13520,7318,18.333333333333332,0.02622950819672131,Very Cheap
20141029T000000,270000.0,3,2.0,2330,8000,1.0,0,0,3,7,1390,940,1986,0,98023,47.2958,-122.368,1570,7227,5670,5657,33.75,0.025573770491803278,Very Cheap
20141021T000000,767250.0,4,3.0,2170,2500,2.0,0,0,3,8,1710,460,1997,0,98115,47.6742,-122.303,2170,4080,330,1910,306.9,0.09078688524590164,Very Cheap
20140904T000000,229000.0,3,2.0,1760,9900,1.0,0,0,4,7,1760,0,1943,0,98166,47.4783,-122.338,1190,9900,8140,8710,23.13131313131313,0.02019672131147541,Very Cheap
20150427T000000,400000.0,3,1.0,1240,4000,1.5,0,0,3,8,1240,0,1928,2000,98106,47.5467,-122.359,1200,17707,2760,16507,100.0,0.04262295081967213,Very Cheap
20140812T000000,2195000.0,5,3.25,5210,35765,2.5,0,4,5,10,4940,270,1911,0,98136,47.5463,-122.397,2590,10250,30555,7660,61.37285055221585,0.2780327868852459,Cheap
20140707T000000,665000.0,5,2.0,2800,17788,1.0,0,0,4,8,1400,1400,1963,0,98033,47.6719,-122.163,1760,18282,14988,16522,37.38475376658421,0.07737704918032787,Very Cheap
20150323T000000,500000.0,4,2.25,2060,44431,2.0,0,0,3,7,2060,0,1988,0,98077,47.744,-122.046,2160,45657,42371,43497,11.253404154756813,0.05573770491803279,Very Cheap
20150401T000000,355500.0,5,2.0,2360,19899,1.0,0,0,4,7,2360,0,1968,0,98010,47.3299,-122.046,1860,19998,17539,18138,17.865219357756672,0.03678688524590164,Very Cheap
20141205T000000,369000.0,4,2.5,2370,6557,2.0,0,0,3,9,2370,0,1998,0,98042,47.423,-122.155,2370,7378,4187,5008,56.27573585481165,0.03855737704918033,Very Cheap
20150202T000000,338500.0,2,1.0,720,6050,1.0,0,0,2,5,720,0,1951,0,98125,47.7259,-122.29,1480,7280,5330,5800,55.950413223140494,0.03455737704918033,Very Cheap
20150429T000000,256000.0,3,1.0,950,4000,1.0,0,0,3,7,780,170,1949,0,98118,47.5232,-122.284,1230,4000,3050,2770,64.0,0.023737704918032787,Very Cheap
20150304T000000,470000.0,3,2.5,1980,9725,2.0,0,0,3,8,1980,0,1994,0,98045,47.4856,-121.802,2070,9834,7745,7764,48.329048843187664,0.05180327868852459,Very Cheap
20140527T000000,675000.0,3,2.5,2540,7680,2.0,0,1,4,9,2540,0,1940,2001,98177,47.7175,-122.364,2490,7680,5140,5190,87.890625,0.07868852459016394,Very Cheap
20141110T000000,369950.0,4,2.75,2760,7533,1.0,0,0,3,8,1400,1360,1997,0,98042,47.371,-122.108,2340,7943,4773,5603,49.11058011416434,0.03868196721311475,Very Cheap
20140915T000000,615000.0,5,3.5,2950,7980,2.0,0,3,3,9,2350,600,2005,0,98065,47.5339,-121.858,2950,7980,5030,5030,77.06766917293233,0.07081967213114754,Very Cheap
20150505T000000,1200690.0,5,3.0,3640,28531,2.0,0,0,3,10,3640,0,1996,0,98006,47.5502,-122.13,3330,17186,24891,13856,42.0836984332831,0.14763147540983607,Cheap
20140728T000000,950000.0,3,1.75,2150,3503,2.0,0,0,3,8,1870,280,1921,0,98112,47.6285,-122.303,3920,6402,1353,2482,271.19611761347414,0.11475409836065574,Cheap
20141021T000000,799500.0,4,2.5,2760,5750,2.0,0,0,3,8,2760,0,1993,0,98112,47.627,-122.303,2760,5390,2990,2630,139.04347826086956,0.09501639344262296,Very Cheap
20140709T000000,187000.0,2,1.0,840,11600,1.0,0,0,3,6,840,0,1952,0,98168,47.492,-122.302,1610,9120,10760,7510,16.120689655172413,0.014688524590163935,Very Cheap
20140520T000000,598000.0,5,2.25,2890,12478,2.0,0,0,3,9,2890,0,1977,0,98074,47.6295,-122.052,2570,11880,9588,9310,47.92434685045681,0.06859016393442623,Very Cheap
20150417T000000,429950.0,3,2.25,2060,10160,1.0,0,0,4,8,1340,720,1967,0,98155,47.7712,-122.285,2320,11186,8100,8866,42.31791338582677,0.04655081967213115,Very Cheap
20150331T000000,347950.0,5,2.25,1700,13500,1.5,0,0,4,7,1700,0,1962,0,98059,47.4611,-122.067,1810,14550,11800,12740,25.774074074074075,0.03579672131147541,Very Cheap
20140509T000000,851000.0,3,2.5,3560,107290,2.0,0,0,3,10,3560,0,1987,0,98053,47.6652,-122.049,3660,89298,103730,85638,7.931773697455495,0.10177049180327868,Cheap
20141029T000000,205000.0,3,1.0,1210,10185,1.0,0,0,3,6,1210,0,1957,0,98146,47.4873,-122.345,1320,10245,8975,8925,20.127638684339715,0.017049180327868854,Very Cheap
20150327T000000,225000.0,3,2.25,1590,9200,1.0,0,0,4,7,1110,480,1979,0,98092,47.2917,-122.184,1880,9200,7610,7320,24.456521739130434,0.019672131147540985,Very Cheap
20141006T000000,705000.0,4,2.25,2620,10536,1.0,0,0,3,8,1520,1100,1979,0,98075,47.5847,-122.075,2760,12431,7916,9671,66.91343963553531,0.08262295081967214,Very Cheap
20150505T000000,535000.0,5,2.5,3190,6178,2.0,0,0,3,8,3190,0,2003,0,98059,47.5104,-122.154,2480,7548,2988,5068,86.59760440271933,0.06032786885245902,Very Cheap
20150121T000000,222500.0,3,2.0,1450,9044,2.0,0,0,3,7,1450,0,1990,0,98022,47.1955,-121.987,1450,9044,7594,7594,24.601946041574525,0.019344262295081967,Very Cheap
20150424T000000,313500.0,2,1.5,1270,1282,2.0,0,0,3,8,1000,270,2006,0,98106,47.5581,-122.363,1270,1325,12,55,244.53978159126365,0.03127868852459016,Very Cheap
20150317T000000,632000.0,3,2.25,2730,7521,2.0,0,2,3,9,2730,0,1992,0,98011,47.7704,-122.196,2700,8204,4791,5504,84.03137880600984,0.07304918032786885,Very Cheap
20150322T000000,467000.0,3,2.0,1840,3432,2.0,0,0,3,7,1840,0,2012,0,98155,47.7368,-122.295,1280,7573,1592,6293,136.07226107226109,0.05140983606557377,Very Cheap
20150424T000000,339000.0,3,2.25,1970,7210,1.0,0,0,4,8,1380,590,1978,0,98030,47.3821,-122.171,1970,7350,5240,5380,47.01803051317614,0.03462295081967213,Very Cheap
20140619T000000,712000.0,3,2.75,3200,6699,2.0,0,0,3,9,3200,0,2004,0,98075,47.5884,-121.991,3020,6699,3499,3679,106.28452007762353,0.08354098360655737,Very Cheap
20140520T000000,335000.0,3,1.0,1060,10050,1.0,0,0,4,7,1060,0,1967,0,98028,47.7355,-122.231,1570,9938,8990,8368,33.333333333333336,0.03409836065573771,Very Cheap
20140717T000000,470000.0,3,3.25,1740,1693,2.0,0,0,3,8,1360,380,2007,0,98116,47.558,-122.382,1130,1626,-47,496,277.61370348493796,0.05180327868852459,Very Cheap
20140724T000000,367000.0,3,1.0,810,7000,1.0,0,0,3,7,810,0,1968,0,98052,47.6591,-122.134,1820,7589,6190,5769,52.42857142857143,0.03829508196721312,Very Cheap
20140524T000000,440500.0,3,2.5,2460,4399,2.0,0,0,3,7,2460,0,2007,0,98065,47.5415,-121.884,2060,4399,1939,2339,100.13639463514436,0.0479344262295082,Very Cheap
20140527T000000,305000.0,4,1.0,2100,9288,1.0,0,0,4,7,1050,1050,1968,0,98058,47.4558,-122.171,1600,8550,7188,6950,32.8380706287683,0.03016393442622951,Very Cheap
20140908T000000,635000.0,3,1.75,1530,5000,1.0,0,2,3,7,1020,510,1948,0,98117,47.6806,-122.36,1530,5000,3470,3470,127.0,0.07344262295081967,Very Cheap
20140627T000000,1020000.0,3,2.25,1670,4800,1.5,0,3,3,8,1670,0,1903,0,98119,47.6356,-122.367,2300,4800,3130,2500,212.5,0.12393442622950819,Cheap
20140602T000000,342000.0,2,2.5,1175,1366,2.0,0,0,3,8,740,435,2005,0,98103,47.6962,-122.342,1710,1255,191,-455,250.36603221083456,0.03501639344262295,Very Cheap
20141111T000000,283000.0,3,2.25,2130,8800,1.0,0,0,3,8,1270,860,1978,0,98030,47.383,-122.168,1960,8075,6670,6115,32.15909090909091,0.027278688524590165,Very Cheap
20150424T000000,430000.0,4,2.75,2470,50123,1.0,0,0,3,8,1280,1190,1978,0,98022,47.2504,-122.0,2200,54520,47653,52320,8.578895916046525,0.04655737704918033,Very Cheap
20140808T000000,245000.0,4,2.5,1700,4268,2.0,0,0,3,7,1700,0,2000,0,98001,47.3303,-122.268,1700,4488,2568,2788,57.403936269915654,0.022295081967213116,Very Cheap
20140605T000000,355500.0,3,2.5,2600,5540,2.0,0,0,3,8,2600,0,2004,0,98038,47.3446,-122.041,2600,5540,2940,2940,64.16967509025271,0.03678688524590164,Very Cheap
20150409T000000,395000.0,3,1.0,1460,5000,1.0,0,0,4,7,1460,0,1934,1960,98115,47.6837,-122.32,1790,4000,3540,2210,79.0,0.0419672131147541,Very Cheap
20141216T000000,324900.0,4,2.25,2010,7280,2.0,0,0,4,8,2010,0,1988,0,98032,47.3585,-122.286,1660,7579,5270,5919,44.629120879120876,0.03277377049180328,Very Cheap
20140508T000000,660000.0,3,1.75,1320,5750,1.5,0,0,5,7,1320,0,1918,0,98116,47.5848,-122.391,1440,5750,4430,4310,114.78260869565217,0.07672131147540984,Very Cheap
20140811T000000,570000.0,3,2.5,3150,20189,2.0,0,0,3,10,3150,0,1990,0,98058,47.447,-122.088,2920,20612,17039,17692,28.233196295012135,0.06491803278688525,Very Cheap
20141106T000000,552321.0,3,2.5,1960,8469,2.0,0,0,4,8,1960,0,1984,0,98052,47.7236,-122.105,2040,8189,6509,6149,65.21679064824654,0.06259947540983607,Very Cheap
20140528T000000,1100000.0,2,1.75,2050,11900,1.0,0,0,4,8,2050,0,1950,0,98004,47.6209,-122.219,2980,11900,9850,8920,92.43697478991596,0.13442622950819672,Cheap
20140825T000000,237000.0,3,1.5,1800,9216,1.0,0,0,4,7,1800,0,1950,0,98001,47.2739,-122.249,1400,10022,7416,8622,25.716145833333332,0.021245901639344263,Very Cheap
20150504T000000,402000.0,2,1.0,1210,5600,1.5,0,0,3,7,1210,0,1922,0,98136,47.5322,-122.392,1400,5028,4390,3628,71.78571428571429,0.04288524590163934,Very Cheap
20141016T000000,470000.0,3,2.25,1830,39165,1.0,0,0,5,8,1830,0,1963,0,98027,47.4612,-121.992,2020,36184,37335,34164,12.000510660028086,0.05180327868852459,Very Cheap
20150320T000000,395900.0,3,1.75,1880,8706,1.0,0,0,3,7,940,940,1927,0,98155,47.7362,-122.292,1880,7200,6826,5320,45.47438548127728,0.04208524590163935,Very Cheap
20141022T000000,442000.0,2,1.75,860,5535,1.0,0,0,3,7,860,0,1948,0,98103,47.6901,-122.331,1420,4960,4675,3540,79.85546522131888,0.048131147540983604,Very Cheap
20141015T000000,795000.0,4,2.75,2890,16397,2.0,0,0,3,10,2890,0,1997,0,98077,47.7102,-122.072,3170,16397,13507,13227,48.484478868085624,0.09442622950819672,Very Cheap
20140812T000000,190500.0,3,2.0,1390,10155,1.0,0,0,3,7,1130,260,1980,0,98003,47.2575,-122.305,1790,10155,8765,8365,18.75923190546529,0.015147540983606557,Very Cheap
20141120T000000,808000.0,4,2.75,3340,7230,2.0,0,0,3,9,3340,0,1996,0,98027,47.549,-122.096,3230,7529,3890,4299,111.75656984785616,0.0961311475409836,Very Cheap
20140826T000000,500000.0,4,2.5,2040,6685,2.0,0,0,3,8,2040,0,1998,0,98133,47.7413,-122.354,1890,8253,4645,6363,74.79431563201197,0.05573770491803279,Very Cheap
20140619T000000,775000.0,4,2.75,3010,15992,2.0,0,0,3,11,3010,0,1996,0,98075,47.5895,-121.994,3330,12333,12982,9003,48.46173086543271,0.09180327868852459,Very Cheap
20141110T000000,300000.0,5,1.75,2110,8500,1.0,0,0,3,7,1100,1010,1962,0,98133,47.7737,-122.35,2020,8500,6390,6480,35.294117647058826,0.029508196721311476,Very Cheap
20150410T000000,496000.0,5,1.75,2110,8500,1.0,0,0,3,7,1100,1010,1962,0,98133,47.7737,-122.35,2020,8500,6390,6480,58.35294117647059,0.05521311475409836,Very Cheap
20140620T000000,448000.0,4,2.5,2510,6853,2.0,0,2,3,9,2510,0,2006,0,98038,47.3547,-122.003,3400,6965,4343,3565,65.37282941777323,0.048918032786885245,Very Cheap
20141125T000000,645000.0,2,2.25,2770,11884,1.0,0,3,4,8,1570,1200,1969,0,98070,47.5098,-122.474,2310,17097,9114,14787,54.27465499831707,0.07475409836065573,Very Cheap
20140523T000000,464600.0,3,1.75,1120,5500,1.5,0,0,4,7,1120,0,1925,0,98136,47.5445,-122.391,1490,5500,4380,4010,84.47272727272727,0.051095081967213116,Very Cheap
20140728T000000,590000.0,3,1.0,1530,2370,2.0,0,0,3,8,1530,0,1901,0,98122,47.6108,-122.303,1310,2370,840,1060,248.9451476793249,0.06754098360655737,Very Cheap
20141007T000000,399000.0,3,2.5,1800,3300,2.0,0,0,3,7,1690,110,2004,0,98118,47.5491,-122.276,1570,3902,1500,2332,120.9090909090909,0.042491803278688525,Very Cheap
20141015T000000,305000.0,2,1.0,1030,6000,1.0,0,0,3,7,1030,0,1925,0,98118,47.5669,-122.283,1510,5000,4970,3490,50.833333333333336,0.03016393442622951,Very Cheap
20141121T000000,478000.0,3,1.75,1210,6175,1.0,0,0,3,7,1210,0,1976,0,98034,47.7291,-122.202,1520,7475,4965,5955,77.4089068825911,0.05285245901639344,Very Cheap
20141217T000000,598800.0,1,1.0,1090,32010,1.0,0,0,4,6,1090,0,1958,0,98014,47.6928,-121.87,1870,25346,30920,23476,18.706654170571696,0.06869508196721312,Very Cheap
20140603T000000,430000.0,4,2.25,1790,7203,1.0,0,0,4,7,1110,680,1973,0,98155,47.7709,-122.294,2270,9000,5413,6730,59.69734832708593,0.04655737704918033,Very Cheap
20140701T000000,433000.0,4,1.5,1550,5053,1.0,0,0,4,7,1180,370,1963,0,98118,47.5499,-122.274,1450,5639,3503,4189,85.69166831585197,0.04695081967213115,Very Cheap
20150320T000000,420000.0,4,2.75,2400,20000,1.0,0,0,3,8,1170,1230,1961,2015,98058,47.4556,-122.087,1690,20000,17600,18310,21.0,0.04524590163934426,Very Cheap
20140609T000000,585000.0,4,1.75,2470,131790,2.0,0,2,3,8,2470,0,1937,0,98070,47.4421,-122.444,1470,92747,129320,91277,4.43888003642158,0.06688524590163934,Very Cheap
20140818T000000,255000.0,3,1.0,1170,7395,1.0,0,0,4,7,1170,0,1969,0,98055,47.4627,-122.19,1430,7920,6225,6490,34.48275862068966,0.02360655737704918,Very Cheap
20150422T000000,305000.0,3,1.0,1120,10125,1.0,0,0,3,6,1120,0,1961,0,98059,47.4794,-122.078,1120,8820,9005,7700,30.123456790123456,0.03016393442622951,Very Cheap
20150225T000000,396000.0,4,1.0,1040,4420,1.5,0,0,3,6,1040,0,1944,0,98117,47.6945,-122.368,1310,4920,3380,3610,89.59276018099547,0.0420983606557377,Very Cheap
20140508T000000,347500.0,4,2.5,2460,7350,2.0,0,0,3,9,2460,0,1989,0,98023,47.3061,-122.349,2390,8568,4890,6178,47.27891156462585,0.035737704918032784,Very Cheap
20140814T000000,900000.0,4,2.5,3690,11468,2.0,0,0,3,11,3690,0,1987,0,98027,47.5699,-122.092,3370,10751,7778,7381,78.47924659923265,0.10819672131147541,Cheap
20140930T000000,425000.0,3,1.75,1960,43332,1.0,0,0,4,7,1400,560,1982,0,98077,47.739,-122.048,2010,44431,41372,42421,9.807994092125911,0.04590163934426229,Very Cheap
20140519T000000,429000.0,3,2.5,1920,15124,2.0,0,0,3,8,1920,0,1995,0,98045,47.5015,-121.773,1920,16477,13204,14557,28.36551176937318,0.04642622950819672,Very Cheap
20150224T000000,540000.0,3,2.25,1670,3135,2.0,0,0,3,8,1220,450,2002,0,98199,47.6478,-122.396,1630,1596,1465,-34,172.2488038277512,0.06098360655737705,Very Cheap
20150127T000000,324950.0,3,2.0,1340,9750,1.0,0,0,4,7,890,450,1974,0,98024,47.5644,-121.898,1460,12900,8410,11440,33.32820512820513,0.03278032786885246,Very Cheap
20150429T000000,1049000.0,3,2.25,2610,3357,2.0,0,0,4,7,1980,630,1926,0,98112,47.638,-122.306,1940,3357,747,1417,312.481382186476,0.1277377049180328,Cheap
20141029T000000,221000.0,4,1.75,1540,7200,1.0,0,0,3,7,1260,280,1966,0,98003,47.3424,-122.308,1540,8416,5660,6876,30.694444444444443,0.01914754098360656,Very Cheap
20140611T000000,405000.0,3,2.0,1640,7201,1.0,0,0,3,8,1640,0,1948,0,98125,47.7216,-122.289,1750,7201,5561,5451,56.242188584918765,0.043278688524590166,Very Cheap
20150107T000000,1150000.0,3,2.5,2100,15120,1.0,0,0,4,8,2100,0,1953,0,98004,47.6201,-122.222,3070,16078,13020,13008,76.05820105820106,0.14098360655737704,Cheap
20140822T000000,588000.0,4,1.75,1930,7245,1.0,0,0,4,8,1510,420,1972,0,98008,47.6396,-122.112,1880,7245,5315,5365,81.15942028985508,0.06727868852459017,Very Cheap
20140909T000000,234950.0,3,2.0,1430,10850,1.0,0,0,3,7,1430,0,1994,0,98001,47.2671,-122.233,1610,8015,9420,6405,21.65437788018433,0.02097704918032787,Very Cheap
20141007T000000,580000.0,4,1.5,2430,4995,1.5,0,0,4,7,1730,700,1928,0,98144,47.5782,-122.292,2240,5000,2565,2760,116.11611611611612,0.06622950819672131,Very Cheap
20140716T000000,637000.0,5,3.0,2460,7240,1.0,0,0,3,9,1840,620,1991,0,98006,47.5486,-122.189,2530,7885,4780,5355,87.98342541436465,0.07370491803278688,Very Cheap
20141030T000000,704000.0,4,2.25,2490,6973,1.0,0,0,4,8,1490,1000,1953,0,98199,47.6516,-122.409,1780,5612,4483,3832,100.96084898895741,0.08249180327868852,Very Cheap
20140925T000000,210000.0,2,1.0,880,9750,1.0,0,0,5,6,880,0,1938,0,98168,47.4885,-122.298,1220,9406,8870,8186,21.53846153846154,0.017704918032786884,Very Cheap
20140516T000000,772000.0,4,2.5,2110,3750,2.0,0,0,3,8,2110,0,2000,0,98117,47.6789,-122.363,1700,5000,1640,3300,205.86666666666667,0.09140983606557378,Very Cheap
20150427T000000,763000.0,4,1.75,1850,4388,2.0,0,0,5,8,1850,0,1941,0,98117,47.6885,-122.381,1410,4107,2538,2697,173.88331814038287,0.0902295081967213,Very Cheap
20150218T000000,213500.0,2,1.5,2060,7713,1.5,0,0,4,7,2060,0,1930,0,98030,47.3722,-122.185,1780,7713,5653,5933,27.680539349150784,0.01816393442622951,Very Cheap
20141220T000000,255000.0,2,1.0,1360,9367,1.0,0,0,4,6,680,680,1924,0,98155,47.7689,-122.315,1360,7543,8007,6183,27.22323049001815,0.02360655737704918,Very Cheap
20141017T000000,423500.0,3,2.0,2000,10490,1.0,0,0,3,8,1430,570,1978,0,98033,47.6976,-122.166,1530,7659,8490,6129,40.371782650143,0.04570491803278689,Very Cheap
20141222T000000,520000.0,3,1.5,1810,18483,1.0,0,0,3,8,1810,0,1954,0,98177,47.7617,-122.378,2920,20279,16673,17359,28.133960937077315,0.058360655737704915,Very Cheap
20140908T000000,550000.0,3,2.75,2230,14400,1.0,0,0,4,8,1460,770,1977,0,98075,47.5791,-122.048,2200,13280,12170,11080,38.19444444444444,0.06229508196721312,Very Cheap
20150121T000000,795000.0,3,2.75,1820,7517,1.0,0,0,3,9,1820,0,1997,0,98116,47.5705,-122.406,2540,8035,5697,5495,105.76027670613277,0.09442622950819672,Very Cheap
20140815T000000,495000.0,4,3.0,2740,2811,2.0,0,0,3,8,2240,500,2003,0,98072,47.7738,-122.158,2740,3596,71,856,176.09391675560298,0.05508196721311476,Very Cheap
20150302T000000,455000.0,4,2.5,2710,6558,2.0,0,0,3,9,2710,0,1997,0,98058,47.434,-122.109,2710,7635,3848,4925,69.3809088136627,0.049836065573770495,Very Cheap
20150305T000000,85000.0,2,1.0,910,9753,1.0,0,0,3,5,910,0,1947,0,98032,47.3897,-122.236,1160,7405,8843,6245,8.715267097303395,0.0013114754098360656,Very Cheap
20141104T000000,239000.0,4,2.0,1980,10585,1.5,0,0,2,6,1980,0,1924,0,98055,47.4836,-122.214,1360,7810,8605,6450,22.579121398205007,0.021508196721311476,Very Cheap
20140730T000000,184900.0,3,1.0,1040,10080,1.0,0,0,3,6,1040,0,1959,0,98023,47.329,-122.343,1000,8736,9040,7736,18.34325396825397,0.014413114754098361,Very Cheap
20150421T000000,386000.0,4,2.25,2810,8560,1.0,0,0,3,8,1610,1200,1979,0,98058,47.4437,-122.124,2400,7600,5750,5200,45.09345794392523,0.04078688524590164,Very Cheap
20140604T000000,415000.0,4,2.5,2000,5962,2.0,0,0,3,8,2000,0,1999,0,98133,47.7695,-122.35,1790,10500,3962,8710,69.60751425696076,0.04459016393442623,Very Cheap
20150512T000000,387000.0,3,1.0,1530,6372,1.0,0,0,3,7,1210,320,1962,0,98118,47.535,-122.289,1960,6426,4842,4466,60.73446327683616,0.040918032786885244,Very Cheap
20150304T000000,2140000.0,6,4.0,5110,7128,2.5,0,0,4,11,5110,0,1906,0,98112,47.6285,-122.304,4110,6480,2018,2370,300.22446689113355,0.27081967213114755,Cheap
20150107T000000,685000.0,4,2.25,3133,16197,2.0,0,0,3,9,2533,600,1965,2010,98166,47.4255,-122.338,3090,15588,13064,12498,42.29178242884485,0.08,Very Cheap
20141031T000000,340000.0,4,2.5,2020,32710,1.0,0,0,3,7,1070,950,1941,0,98168,47.4969,-122.33,1340,17700,30690,16360,10.394374808926933,0.03475409836065574,Very Cheap
20150511T000000,422000.0,2,1.0,750,4000,1.0,0,0,4,6,750,0,1926,0,98118,47.5547,-122.272,1120,5038,3250,3918,105.5,0.04550819672131148,Very Cheap
20140808T000000,442000.0,3,2.5,1980,39932,2.0,0,0,3,8,1980,0,1994,0,98011,47.7433,-122.196,2610,12769,37952,10159,11.068816988881098,0.048131147540983604,Very Cheap
20140527T000000,280000.0,3,1.0,1200,6250,1.0,0,0,3,6,920,280,1943,0,98168,47.5095,-122.331,1280,9375,5050,8095,44.8,0.026885245901639345,Very Cheap
20140703T000000,1150000.0,5,2.5,3580,8921,2.0,0,0,3,9,3580,0,2000,0,98033,47.693,-122.202,2710,9308,5341,6598,128.90931509920412,0.14098360655737704,Cheap
20141110T000000,279000.0,3,2.5,2010,11618,2.0,0,0,3,7,2010,0,1990,0,98022,47.1956,-121.985,1550,9354,9608,7804,24.014460320192804,0.02675409836065574,Very Cheap
20140623T000000,569000.0,4,2.0,1730,3884,1.0,0,0,5,7,1060,670,1924,0,98103,47.6624,-122.349,1360,3563,2154,2203,146.49845520082388,0.06478688524590163,Very Cheap
20140529T000000,1355000.0,5,3.5,5960,13703,2.0,0,2,3,10,4770,1190,1984,0,98008,47.6151,-122.107,2810,17320,7743,14510,98.88345617747939,0.1678688524590164,Cheap
20150410T000000,209950.0,2,1.0,860,5080,1.0,0,0,3,7,860,0,1960,0,98032,47.39,-122.236,1250,6477,4220,5227,41.32874015748032,0.017698360655737704,Very Cheap
20150317T000000,468000.0,3,1.5,1370,7697,1.0,0,0,3,7,1370,0,1939,0,98177,47.7153,-122.361,1370,7697,6327,6327,60.8029102247629,0.05154098360655738,Very Cheap
20150430T000000,237100.0,3,1.75,1360,9603,1.0,0,0,3,7,1360,0,1963,0,98198,47.3959,-122.309,2240,10605,8243,8365,24.690200978860773,0.021259016393442624,Very Cheap
20140708T000000,336000.0,4,2.5,2530,8169,2.0,0,0,3,8,2530,0,1993,0,98003,47.2634,-122.312,2220,8013,5639,5793,41.131105398457585,0.03422950819672131,Very Cheap
20141222T000000,500000.0,4,2.0,1680,3813,2.0,0,0,4,7,1680,0,1900,0,98144,47.593,-122.293,2540,3996,2133,1456,131.13034356150013,0.05573770491803279,Very Cheap
20150426T000000,290000.0,3,2.5,1580,6860,2.0,0,0,3,7,1580,0,1995,0,98055,47.4447,-122.188,1580,7050,5280,5470,42.27405247813411,0.02819672131147541,Very Cheap
20150314T000000,1185000.0,7,3.5,3890,8342,2.0,0,4,3,9,2840,1050,1968,0,98117,47.7011,-122.392,2870,8342,4452,5472,142.05226564373052,0.14557377049180328,Cheap
20140725T000000,365000.0,5,2.0,1600,4168,1.5,0,0,3,7,1600,0,1927,0,98126,47.5297,-122.381,1190,4168,2568,2978,87.57197696737045,0.0380327868852459,Very Cheap
20150325T000000,146300.0,3,1.0,1200,9668,1.0,0,0,5,6,1200,0,1975,0,98092,47.3156,-122.128,1200,9800,8468,8600,15.132395531650808,0.009350819672131147,Very Cheap
20140609T000000,554000.0,3,1.75,1760,10780,1.0,0,0,3,8,1760,0,1977,0,98005,47.5938,-122.154,2090,10780,9020,8690,51.391465677179966,0.06281967213114754,Very Cheap
20140618T000000,424000.0,3,2.0,1670,7700,1.0,0,0,3,7,1170,500,1972,0,98034,47.725,-122.2,1500,7875,6030,6375,55.064935064935064,0.04577049180327869,Very Cheap
20150429T000000,1348000.0,4,3.5,4640,9827,2.0,0,2,3,10,3210,1430,2007,0,98027,47.5524,-122.078,3810,8207,5187,4397,137.17309453546352,0.16695081967213116,Cheap
20141119T000000,508500.0,4,1.5,1800,6750,1.5,0,0,4,7,1800,0,1950,0,98115,47.6868,-122.285,1420,5900,4950,4480,75.33333333333333,0.05685245901639344,Very Cheap
20150501T000000,244500.0,3,1.75,1210,8864,1.0,0,0,3,7,1210,0,1985,0,98042,47.3639,-122.08,1510,8062,7654,6552,27.583483754512635,0.02222950819672131,Very Cheap
20141120T000000,206000.0,2,2.5,1280,1566,2.0,0,0,3,7,1280,0,2005,0,98055,47.4336,-122.195,1460,1845,286,385,131.54533844189015,0.017180327868852457,Very Cheap
20140905T000000,643500.0,3,2.0,1650,7104,2.0,0,0,3,8,1650,0,1945,1986,98177,47.7053,-122.374,1730,7104,5454,5374,90.58277027027027,0.07455737704918033,Very Cheap
20140520T000000,372500.0,4,1.75,1590,10523,2.0,0,0,4,7,1590,0,1922,0,98133,47.7358,-122.342,1610,8568,8933,6958,35.398650574931104,0.03901639344262295,Very Cheap
20140715T000000,630000.0,5,2.0,1900,5000,1.0,0,2,3,8,1720,180,1957,0,98107,47.6735,-122.362,1770,5000,3100,3230,126.0,0.07278688524590164,Very Cheap
20140710T000000,418000.0,2,2.5,1500,3608,2.0,0,0,3,8,1500,0,2005,0,98029,47.5472,-121.994,2080,2686,2108,606,115.85365853658537,0.04498360655737705,Very Cheap
20150225T000000,425000.0,4,2.5,2689,6688,2.0,0,0,3,9,2689,0,2006,0,98030,47.3803,-122.184,2665,5700,3999,3035,63.54665071770335,0.04590163934426229,Very Cheap
20150205T000000,800000.0,4,2.75,3250,5500,2.0,0,0,3,9,3250,0,2007,0,98027,47.5398,-121.997,3920,6000,2250,2080,145.45454545454547,0.09508196721311475,Very Cheap
20141208T000000,208000.0,2,1.0,960,13438,1.0,0,0,3,7,960,0,1951,0,98168,47.4745,-122.295,1630,11656,12478,10026,15.478493823485637,0.01744262295081967,Very Cheap
20140714T000000,476000.0,3,1.75,1650,9600,1.0,0,0,4,7,1650,0,1977,0,98075,47.5779,-122.044,2040,12220,7950,10180,49.583333333333336,0.052590163934426226,Very Cheap
20150202T000000,277500.0,3,2.5,1690,5171,2.0,0,0,3,8,1690,0,2003,0,98023,47.2779,-122.347,2550,5025,3481,2475,53.66466834268033,0.026557377049180327,Very Cheap
20140813T000000,478000.0,3,1.75,2790,36585,1.0,0,0,4,8,1410,1380,1970,0,98027,47.4734,-121.999,1900,45302,33795,43402,13.065463987973214,0.05285245901639344,Very Cheap
20140708T000000,890000.0,4,2.75,2310,4020,3.0,0,0,5,8,2310,0,1979,0,98122,47.6154,-122.291,2270,3750,1710,1480,221.39303482587064,0.10688524590163935,Cheap
20150323T000000,450000.0,3,3.5,1790,1288,3.0,0,0,3,8,1390,400,2000,0,98199,47.651,-122.384,1560,1426,-502,-134,349.37888198757764,0.04918032786885246,Very Cheap
20140625T000000,205000.0,3,1.0,1230,8750,1.0,0,0,3,6,1230,0,1965,0,98003,47.3266,-122.334,1230,8750,7520,7520,23.428571428571427,0.017049180327868854,Very Cheap
20140718T000000,665000.0,3,2.0,1620,2640,1.5,0,0,5,8,1620,0,1929,0,98115,47.6884,-122.322,1470,4080,1020,2610,251.8939393939394,0.07737704918032787,Very Cheap
20141003T000000,518000.0,4,2.75,2440,12051,1.0,0,0,5,8,1440,1000,1966,0,98133,47.7456,-122.351,2030,8006,9611,5976,42.98398473155755,0.0580983606557377,Very Cheap
20140924T000000,465000.0,4,2.25,2100,7350,2.0,0,0,3,8,2100,0,1979,0,98033,47.7019,-122.171,1780,7350,5250,5570,63.265306122448976,0.051147540983606556,Very Cheap
20140617T000000,330000.0,3,2.5,3040,7232,2.0,0,0,3,7,3040,0,2003,0,98092,47.3355,-122.168,2760,6926,4192,4166,45.63053097345133,0.03344262295081967,Very Cheap
20141226T000000,449400.0,4,3.0,2490,5064,2.0,0,0,3,7,2490,0,2007,0,98056,47.5139,-122.189,2470,5064,2574,2594,88.74407582938389,0.049101639344262295,Very Cheap
20150206T000000,829000.0,3,2.75,2690,10443,1.0,0,0,3,9,2690,0,2007,0,98053,47.7185,-122.024,1440,4185,7753,2745,79.38331896964473,0.09888524590163934,Very Cheap
20150220T000000,450000.0,4,1.75,2190,9752,1.0,0,0,3,8,2190,0,1964,0,98034,47.7108,-122.239,2040,9964,7562,7924,46.14438063986874,0.04918032786885246,Very Cheap
20141001T000000,310000.0,3,1.75,1490,9120,1.0,0,0,5,7,1490,0,1959,0,98059,47.4806,-122.163,1340,8040,7630,6700,33.99122807017544,0.03081967213114754,Very Cheap
20140908T000000,615000.0,3,2.25,2530,45234,2.0,0,0,4,9,2530,0,1985,0,98072,47.7221,-122.12,3110,35617,42704,32507,13.595967634964849,0.07081967213114754,Very Cheap
20140603T000000,605000.0,3,2.0,2060,4040,1.0,0,0,4,8,1120,940,1947,0,98103,47.6798,-122.352,1500,4000,1980,2500,149.75247524752476,0.06950819672131148,Very Cheap
20140502T000000,437500.0,3,2.25,1970,35100,2.0,0,0,4,9,1970,0,1977,0,98027,47.4635,-121.991,2340,35100,33130,32760,12.464387464387464,0.047540983606557376,Very Cheap
20140922T000000,545000.0,3,1.75,1400,4000,1.5,0,0,4,7,1400,0,1925,0,98117,47.6902,-122.388,1050,4330,2600,3280,136.25,0.06163934426229508,Very Cheap
20140717T000000,770000.0,3,2.5,3680,35617,1.0,0,0,3,10,2390,1290,1985,0,98052,47.7213,-122.12,3570,35633,31937,32063,21.618889855967655,0.09114754098360656,Very Cheap
20140703T000000,600000.0,5,2.25,3000,13899,2.0,0,0,4,8,3000,0,1975,0,98052,47.6373,-122.105,2270,10763,10899,8493,43.16857327865314,0.06885245901639345,Very Cheap
20140513T000000,560000.0,3,1.0,1440,5000,2.0,0,0,3,7,1440,0,1910,0,98103,47.6741,-122.354,1850,4500,3560,2650,112.0,0.06360655737704918,Very Cheap
20150130T000000,1920000.0,5,5.75,7730,230868,2.0,0,0,3,12,6660,1070,2004,0,98077,47.7615,-122.084,2660,39292,223138,36632,8.316440563438848,0.2419672131147541,Cheap
20141124T000000,457000.0,3,1.0,1170,3348,1.5,0,0,4,7,1170,0,1924,0,98117,47.687,-122.378,1590,4219,2178,2629,136.4994026284349,0.0500983606557377,Very Cheap
20140505T000000,585000.0,2,1.0,1770,8640,1.5,0,0,3,6,1520,250,1949,0,98117,47.6926,-122.363,1060,4804,6870,3744,67.70833333333333,0.06688524590163934,Very Cheap
20140507T000000,560000.0,3,2.0,1860,13374,1.0,0,0,3,8,1860,0,1985,0,98027,47.5397,-122.054,1960,9797,11514,7837,41.87228951697323,0.06360655737704918,Very Cheap
20150405T000000,345000.0,2,1.0,770,3008,1.0,0,0,4,5,770,0,1917,0,98116,47.5686,-122.389,1550,4563,2238,3013,114.69414893617021,0.03540983606557377,Very Cheap
20140720T000000,550000.0,4,3.5,3820,17745,2.0,0,2,3,8,2440,1380,1955,0,98108,47.557,-122.295,2520,9640,13925,7120,30.994646379261763,0.06229508196721312,Very Cheap
20140624T000000,589950.0,4,2.5,3190,8195,2.0,0,0,3,10,3190,0,2006,0,98038,47.3555,-122.003,3400,7607,5005,4207,71.98901769371568,0.0675344262295082,Very Cheap
20140602T000000,327000.0,3,1.5,1320,13200,1.0,0,0,3,7,1320,0,1970,0,98059,47.5009,-122.143,1730,13200,11880,11470,24.772727272727273,0.033049180327868855,Very Cheap
20140530T000000,800000.0,2,2.25,1730,31491,2.0,1,2,4,7,1730,0,1947,1988,98070,47.373,-122.464,1400,12410,29761,11010,25.40408370645581,0.09508196721311475,Very Cheap
20140521T000000,150000.0,3,1.0,1010,25000,1.0,0,0,3,6,1010,0,1966,0,98014,47.6927,-121.901,2020,101494,23990,99474,6.0,0.009836065573770493,Very Cheap
20140603T000000,425000.0,2,2.5,1140,1182,3.0,0,0,3,8,1140,0,2007,0,98107,47.6713,-122.383,1290,1189,42,-101,359.5600676818951,0.04590163934426229,Very Cheap
20140801T000000,350000.0,3,1.0,860,7030,1.0,0,0,3,7,860,0,1973,0,98034,47.7151,-122.211,1360,7500,6170,6140,49.786628733997155,0.036065573770491806,Very Cheap
20150311T000000,273000.0,3,1.75,1540,10545,2.0,0,0,4,6,1540,0,1978,0,98045,47.4451,-121.763,1540,10000,9005,8460,25.889046941678522,0.025967213114754098,Very Cheap
20150320T000000,750000.0,4,2.25,2160,9525,1.0,0,0,3,8,1080,1080,1961,0,98040,47.5651,-122.221,2780,9525,7365,6745,78.74015748031496,0.08852459016393442,Very Cheap
20141009T000000,240000.0,3,1.5,1450,9477,1.0,0,0,4,7,1450,0,1963,0,98031,47.4215,-122.203,1460,9477,8027,8017,25.324469768914213,0.021639344262295083,Very Cheap
20150320T000000,400000.0,3,1.75,1830,9620,1.0,0,0,4,8,1830,0,1978,0,98023,47.3123,-122.389,1990,8280,7790,6290,41.58004158004158,0.04262295081967213,Very Cheap
20141003T000000,230000.0,3,1.5,1630,6625,1.0,0,0,5,7,980,650,1980,0,98023,47.29,-122.368,1440,7145,4995,5705,34.716981132075475,0.020327868852459016,Very Cheap
20150413T000000,372000.0,4,2.5,2500,8215,2.0,0,0,3,8,2500,0,1990,0,98031,47.4124,-122.204,2360,7801,5715,5441,45.283018867924525,0.03895081967213115,Very Cheap
20140705T000000,459500.0,3,1.75,1470,4950,1.0,0,0,3,7,1030,440,1984,0,98133,47.7325,-122.337,1100,5250,3480,4150,92.82828282828282,0.050426229508196724,Very Cheap
20140805T000000,582000.0,3,2.5,2380,19860,2.0,0,0,4,8,2380,0,1995,0,98056,47.5255,-122.173,2450,10220,17480,7770,29.305135951661633,0.06649180327868852,Very Cheap
20141106T000000,465000.0,4,2.5,2170,7700,1.0,0,0,3,7,1420,750,1969,0,98034,47.7216,-122.219,1710,7770,5530,6060,60.38961038961039,0.051147540983606556,Very Cheap
20140530T000000,386000.0,3,2.0,2120,7560,1.0,0,0,3,9,2120,0,1991,0,98058,47.435,-122.16,2660,7700,5440,5040,51.05820105820106,0.04078688524590164,Very Cheap
20140609T000000,546000.0,3,2.5,1530,3464,2.0,0,0,3,8,1530,0,1998,0,98007,47.6179,-122.141,1530,3446,1934,1916,157.62124711316397,0.06177049180327869,Very Cheap
20141027T000000,278000.0,3,1.75,2710,9088,1.0,0,0,4,7,2060,650,1965,0,98001,47.3073,-122.272,1690,10454,6378,8764,30.589788732394368,0.02662295081967213,Very Cheap
20140918T000000,540000.0,3,2.5,2860,8935,2.0,0,0,3,8,2860,0,2004,0,98065,47.5336,-121.855,2650,6167,6075,3517,60.4364857302742,0.06098360655737705,Very Cheap
20141208T000000,529000.0,4,1.75,2800,90169,2.0,0,0,3,7,2800,0,1934,1985,98065,47.5204,-121.829,1600,27194,87369,25594,5.866761303774024,0.05954098360655738,Very Cheap
20140617T000000,554000.0,4,1.0,1120,7104,1.5,0,0,3,7,1120,0,1946,0,98177,47.7055,-122.372,1370,7104,5984,5734,77.98423423423424,0.06281967213114754,Very Cheap
20140827T000000,210000.0,3,1.0,1730,7210,1.0,0,0,3,7,1430,300,1963,0,98001,47.3404,-122.28,1820,7210,5480,5390,29.12621359223301,0.017704918032786884,Very Cheap
20150504T000000,225000.0,2,1.0,1010,5408,1.0,0,0,4,6,1010,0,1926,0,98032,47.3759,-122.238,980,7800,4398,6820,41.60502958579882,0.019672131147540985,Very Cheap
20140715T000000,561600.0,4,2.5,2350,6624,2.0,0,0,3,9,2350,0,1990,0,98074,47.6262,-122.045,2590,11240,4274,8650,84.78260869565217,0.06381639344262295,Very Cheap
20140520T000000,300000.0,6,5.25,2860,5682,2.0,0,0,3,7,2860,0,1978,0,98002,47.303,-122.221,1390,5956,2822,4566,52.79831045406547,0.029508196721311476,Very Cheap
20140827T000000,1650000.0,4,3.5,4285,9567,2.0,0,1,5,10,3485,800,1946,0,98199,47.6434,-122.409,2960,6902,5282,3942,172.4678582627783,0.20655737704918034,Cheap
20140609T000000,1017100.0,4,3.75,4060,19290,2.0,0,0,3,10,4060,0,2002,0,98074,47.6051,-122.053,4020,13250,15230,9230,52.72680145152929,0.12355409836065574,Cheap
20140626T000000,150000.0,3,1.0,1310,9612,1.0,0,0,3,7,960,350,1962,0,98001,47.2958,-122.285,1310,9812,8302,8502,15.605493133583021,0.009836065573770493,Very Cheap
20140924T000000,400950.0,2,1.75,2320,6250,1.0,0,0,3,7,1400,920,1948,0,98136,47.5468,-122.386,1420,6250,3930,4830,64.152,0.04274754098360656,Very Cheap
20150121T000000,620000.0,4,2.25,2210,8101,2.0,0,0,3,9,2210,0,1985,0,98074,47.6475,-122.07,2330,8842,5891,6512,76.53376126404147,0.07147540983606557,Very Cheap
20140818T000000,449000.0,4,2.75,2090,14141,1.5,0,0,4,8,1680,410,1941,0,98166,47.4333,-122.347,1990,12920,12051,10930,31.751644155293118,0.049049180327868855,Very Cheap
20140728T000000,630000.0,4,2.5,2240,4025,1.0,0,2,3,7,1250,990,1926,2005,98115,47.6818,-122.311,1380,3500,1785,2120,156.52173913043478,0.07278688524590164,Very Cheap
20150414T000000,336000.0,2,1.0,1180,7200,1.0,0,0,4,6,1180,0,1949,0,98133,47.7475,-122.342,1180,7200,6020,6020,46.666666666666664,0.03422950819672131,Very Cheap
20140605T000000,299950.0,4,1.75,1560,31299,1.0,0,0,4,7,1560,0,1965,0,98092,47.3384,-122.164,2460,44907,29739,42447,9.583373270711524,0.029501639344262295,Very Cheap
20150309T000000,352500.0,4,2.0,1970,7451,1.0,0,0,3,8,1350,620,1962,0,98133,47.765,-122.335,1980,7510,5481,5530,47.30908602872098,0.03639344262295082,Very Cheap
20141016T000000,150000.0,2,1.0,840,12750,1.0,0,0,3,6,840,0,1925,0,98055,47.484,-122.211,1480,6969,11910,5489,11.764705882352942,0.009836065573770493,Very Cheap
20150424T000000,175000.0,2,1.0,840,12750,1.0,0,0,3,6,840,0,1925,0,98055,47.484,-122.211,1480,6969,11910,5489,13.72549019607843,0.013114754098360656,Very Cheap
20140731T000000,305000.0,3,2.0,1830,10873,1.0,0,0,3,8,1830,0,1989,0,98023,47.3066,-122.394,2490,8976,9043,6486,28.05113584107422,0.03016393442622951,Very Cheap
20140923T000000,2574000.0,4,3.75,4475,20424,2.0,1,4,3,12,2659,1816,1999,0,98033,47.6646,-122.208,4340,5250,15949,910,126.02820211515863,0.3277377049180328,Medium
20140715T000000,607500.0,3,1.5,1800,4700,1.0,0,0,3,7,1200,600,1941,0,98117,47.6858,-122.385,1580,4700,2900,3120,129.25531914893617,0.06983606557377049,Very Cheap
20141118T000000,505000.0,2,1.0,1250,5040,1.0,0,0,3,7,950,300,1920,0,98117,47.6959,-122.365,1290,5040,3790,3750,100.1984126984127,0.05639344262295082,Very Cheap
20141027T000000,280500.0,3,1.75,2440,10179,1.0,0,0,4,7,1220,1220,1962,0,98198,47.4118,-122.314,1650,9711,7739,8061,27.55673445328618,0.026950819672131147,Very Cheap
20140731T000000,610000.0,3,2.5,2910,12283,2.0,0,2,3,10,2910,0,1993,0,98058,47.4602,-122.152,2680,22499,9373,19819,49.66213465765692,0.07016393442622951,Very Cheap
20140812T000000,381000.0,5,2.75,3060,6895,2.0,0,0,3,8,3060,0,2003,0,98042,47.3809,-122.098,2590,6895,3835,4305,55.25743292240754,0.040131147540983604,Very Cheap
20140522T000000,482000.0,5,2.25,2230,9600,1.0,0,0,3,8,1320,910,1978,0,98077,47.7466,-122.076,2080,9760,7370,7680,50.208333333333336,0.05337704918032787,Very Cheap
20141022T000000,379950.0,3,1.0,1270,6900,1.0,0,0,3,7,1270,0,1977,0,98034,47.7279,-122.192,1480,7280,5630,5800,55.06521739130435,0.03999344262295082,Very Cheap
20141009T000000,2500000.0,4,4.5,4300,19844,2.0,0,0,3,11,4300,0,1985,1999,98039,47.6218,-122.237,3070,19845,15544,16775,125.98266478532554,0.3180327868852459,Medium
20140623T000000,425000.0,3,2.25,1580,39189,1.0,0,0,3,7,1180,400,1992,0,98053,47.6365,-121.972,1580,29649,37609,28069,10.844879940799714,0.04590163934426229,Very Cheap
20140910T000000,580000.0,4,2.25,2570,36465,2.0,0,0,4,8,2570,0,1980,0,98053,47.6555,-122.042,2390,41454,33895,39064,15.905662964486494,0.06622950819672131,Very Cheap
20150330T000000,605000.0,2,1.0,860,6510,1.0,0,0,3,7,860,0,1952,0,98004,47.6021,-122.202,1740,10800,5650,9060,92.93394777265745,0.06950819672131148,Very Cheap
20140520T000000,194000.0,1,1.0,820,1060,1.0,0,0,3,8,760,60,2007,0,98126,47.5472,-122.372,1770,1853,240,83,183.0188679245283,0.01560655737704918,Very Cheap
20150401T000000,546200.0,4,2.25,2090,8579,2.0,0,0,3,8,2090,0,1987,0,98074,47.6364,-122.03,1850,8843,6489,6993,63.667094066907566,0.06179672131147541,Very Cheap
20140815T000000,1395000.0,4,3.5,3560,16782,2.0,0,0,3,10,2560,1000,2014,0,98040,47.5569,-122.225,3100,18047,13222,14947,83.1247765462996,0.17311475409836066,Cheap
20150403T000000,315000.0,3,1.75,1860,9629,1.0,0,0,4,7,1240,620,1961,0,98059,47.4913,-122.143,1940,9629,7769,7689,32.71367743275522,0.031475409836065574,Very Cheap
20141217T000000,465000.0,3,1.5,900,8690,1.5,0,0,5,6,900,0,1941,0,98116,47.5751,-122.393,1000,6150,7790,5150,53.50978135788262,0.051147540983606556,Very Cheap
20141001T000000,330000.0,2,1.0,1160,32251,1.0,0,0,3,6,580,580,1963,2000,98010,47.3537,-121.939,1160,33656,31091,32496,10.232240860748504,0.03344262295081967,Very Cheap
20140808T000000,795000.0,4,2.75,3100,7501,2.0,0,0,3,10,3100,0,1998,0,98052,47.6859,-122.109,3140,8672,4401,5532,105.98586855085989,0.09442622950819672,Very Cheap
20140826T000000,265000.0,4,2.25,2300,9100,1.0,0,0,3,7,1280,1020,1977,0,98058,47.4576,-122.16,1640,9100,6800,7460,29.12087912087912,0.024918032786885248,Very Cheap
20150112T000000,1300000.0,4,2.5,3110,11857,2.0,0,4,3,11,2040,1070,1990,0,98117,47.6952,-122.402,3110,11570,8747,8460,109.63987517921903,0.16065573770491803,Cheap
20150505T000000,126500.0,3,1.0,1130,12212,1.0,0,0,3,6,1130,0,1942,0,98146,47.4952,-122.34,1190,9240,11082,8050,10.358663609564363,0.006754098360655738,Very Cheap
20140805T000000,760000.0,4,2.5,2920,7901,2.0,0,0,3,9,2920,0,2004,0,98052,47.7036,-122.125,3020,7900,4981,4880,96.1903556511834,0.0898360655737705,Very Cheap
20140903T000000,540000.0,2,1.25,1230,1569,2.0,0,0,3,9,1050,180,2009,0,98112,47.6193,-122.304,1100,1230,339,130,344.16826003824093,0.06098360655737705,Very Cheap
20140519T000000,446000.0,5,2.75,2190,12687,1.0,0,0,5,7,1370,820,1978,0,98028,47.7762,-122.257,2280,10784,10497,8504,35.15409474264996,0.04865573770491803,Very Cheap
20150326T000000,170000.0,1,0.75,850,5600,1.0,0,2,3,6,850,0,1903,1994,98019,47.7654,-121.48,900,12250,4750,11350,30.357142857142858,0.012459016393442624,Very Cheap
20141023T000000,379000.0,3,2.5,1500,7420,1.0,0,0,3,7,1000,500,1972,0,98034,47.7236,-122.174,1840,7272,5920,5432,51.078167115902964,0.03986885245901639,Very Cheap
20150317T000000,1400000.0,9,4.0,4620,5508,2.5,0,0,3,11,3870,750,1915,0,98105,47.6684,-122.309,2710,4320,888,1610,254.17574437182282,0.1737704918032787,Cheap
20140620T000000,800000.0,4,2.75,3150,7035,2.0,0,0,3,9,3150,0,2004,0,98075,47.5979,-121.974,3200,7035,3885,3835,113.71712864250178,0.09508196721311475,Very Cheap
20150316T000000,260000.0,3,1.0,1300,10139,1.0,0,0,3,7,1300,0,1962,2007,98042,47.3427,-122.087,1260,10139,8839,8879,25.64355459118256,0.024262295081967214,Very Cheap
20150310T000000,820000.0,5,2.5,3160,8000,1.0,0,0,4,7,1580,1580,1960,0,98040,47.5735,-122.208,2440,8079,4840,5639,102.5,0.09770491803278689,Very Cheap
20150414T000000,449950.0,3,1.75,2070,96703,1.0,0,3,4,7,2070,0,1999,0,98092,47.2853,-122.008,1820,117612,94633,115792,4.652906321417123,0.04917377049180328,Very Cheap
20140902T000000,392000.0,3,2.25,1790,7125,1.0,0,0,3,7,1220,570,1974,0,98034,47.7184,-122.226,2040,7950,5335,5910,55.01754385964912,0.04157377049180328,Very Cheap
20150422T000000,465000.0,3,2.5,1650,4636,2.0,0,0,3,8,1650,0,1999,0,98075,47.5997,-122.016,1650,4504,2986,2854,100.30198446937014,0.051147540983606556,Very Cheap
20140822T000000,449950.0,4,2.5,2070,7312,1.0,0,0,4,7,1230,840,1977,0,98052,47.6958,-122.12,1770,7668,5242,5898,61.53583150984683,0.04917377049180328,Very Cheap
20150428T000000,520000.0,3,1.5,1580,8841,1.5,0,0,5,7,1180,400,1923,0,98103,47.6931,-122.352,1580,7512,7261,5932,58.81687591901369,0.058360655737704915,Very Cheap
20140828T000000,546800.0,4,2.25,2170,10000,1.0,0,0,3,8,1420,750,1975,0,98008,47.6219,-122.109,2390,11000,7830,8610,54.68,0.06187540983606558,Very Cheap
20150324T000000,825000.0,4,2.75,2220,11925,1.0,0,0,3,7,1560,660,1953,1985,98004,47.6381,-122.205,2500,11377,9705,8877,69.18238993710692,0.09836065573770492,Very Cheap
20150422T000000,337000.0,3,1.75,1440,11364,1.0,0,0,3,7,1440,0,1985,0,98155,47.743,-122.328,1950,9390,9924,7440,29.65505103836677,0.034360655737704915,Very Cheap
20140611T000000,333000.0,2,1.0,720,6686,1.0,0,0,3,6,720,0,1942,0,98117,47.7003,-122.362,1200,6686,5966,5486,49.805563864792106,0.033836065573770495,Very Cheap
20141111T000000,380000.0,2,2.0,1120,780,2.0,0,0,3,8,760,360,2004,0,98116,47.5788,-122.41,1120,1322,-340,202,487.1794871794872,0.04,Very Cheap
20150428T000000,280000.0,3,2.5,1970,8426,2.0,0,0,3,8,1970,0,1992,0,98003,47.2674,-122.306,1970,9197,6456,7227,33.230477094706856,0.026885245901639345,Very Cheap
20141120T000000,202000.0,3,1.5,1420,9081,1.0,0,0,4,6,1420,0,1990,0,98022,47.1948,-121.999,1090,8410,7661,7320,22.244246228388945,0.016655737704918034,Very Cheap
20150427T000000,585000.0,4,2.5,2250,4119,2.0,0,0,3,8,2250,0,2001,0,98075,47.5973,-122.034,2290,3115,1869,825,142.02476329206118,0.06688524590163934,Very Cheap
20141104T000000,435000.0,4,2.0,2630,9663,1.0,0,1,4,8,1330,1300,1956,0,98056,47.4841,-122.19,1900,8894,7033,6994,45.01707544240919,0.04721311475409836,Very Cheap
20140523T000000,1200000.0,4,3.5,4740,172497,2.0,0,0,3,11,4740,0,2003,0,98053,47.6779,-122.075,2120,49658,167757,47538,6.9566427242212905,0.14754098360655737,Cheap
20140924T000000,364000.0,2,2.25,1280,2574,2.0,0,0,3,7,1280,0,1992,0,98144,47.5939,-122.302,1250,3960,1294,2710,141.41414141414143,0.03790163934426229,Very Cheap
20140514T000000,300000.0,3,1.0,1260,8280,1.0,0,0,3,6,1260,0,1946,0,98115,47.7,-122.299,2100,8280,7020,6180,36.231884057971016,0.029508196721311476,Very Cheap
20150317T000000,558000.0,2,1.75,1930,4601,1.0,0,0,3,8,1930,0,2006,0,98053,47.7196,-122.022,1670,4500,2671,2830,121.27798304716366,0.06334426229508197,Very Cheap
20140811T000000,199950.0,1,1.5,1048,4800,1.0,0,0,3,7,1048,0,1942,0,98055,47.4759,-122.212,950,4800,3752,3850,41.65625,0.01638688524590164,Very Cheap
20140827T000000,515000.0,3,2.25,1640,8400,1.0,0,0,4,8,1640,0,1962,0,98006,47.5484,-122.172,2110,8400,6760,6290,61.30952380952381,0.057704918032786885,Very Cheap
20141107T000000,590000.0,4,2.5,2380,4950,2.0,0,0,3,8,2380,0,2004,0,98136,47.5382,-122.391,1370,5120,2570,3750,119.1919191919192,0.06754098360655737,Very Cheap
20140723T000000,813500.0,4,2.0,2530,15520,1.0,0,0,5,8,2220,310,1964,0,98005,47.613,-122.167,2500,13300,12990,10800,52.41623711340206,0.09685245901639344,Very Cheap
20150423T000000,725000.0,4,2.5,2700,25870,2.0,0,0,4,8,2700,0,1992,0,98033,47.6934,-122.161,1540,20720,23170,19180,28.02473908001546,0.08524590163934426,Very Cheap
20150428T000000,490000.0,3,2.25,2330,3600,1.5,0,0,3,8,2330,0,1971,0,98074,47.631,-122.061,2050,4275,1270,2225,136.11111111111111,0.05442622950819672,Very Cheap
20140827T000000,277000.0,3,2.25,2160,9612,2.0,0,0,3,7,2160,0,1994,0,98022,47.1927,-122.011,1970,9247,7452,7277,28.818143986683314,0.026491803278688525,Very Cheap
20140509T000000,325000.0,4,1.5,1470,70800,1.0,0,0,3,7,1470,0,1976,0,98010,47.3458,-121.948,1810,72337,69330,70527,4.590395480225989,0.03278688524590164,Very Cheap
20140925T000000,649800.0,4,2.5,2280,9827,2.0,0,0,3,8,2280,0,1995,0,98033,47.6883,-122.168,1660,9827,7547,8167,66.12394423527017,0.07538360655737705,Very Cheap
20140723T000000,425000.0,3,1.0,1280,3200,1.5,0,0,3,7,1280,0,1903,0,98122,47.6029,-122.307,1320,1676,1920,356,132.8125,0.04590163934426229,Very Cheap
20150329T000000,460000.0,2,1.0,850,4650,1.0,0,0,3,7,850,0,1975,0,98117,47.6926,-122.365,980,4700,3800,3720,98.9247311827957,0.050491803278688525,Very Cheap
20140805T000000,750000.0,3,3.25,4610,81935,2.0,0,0,4,9,4610,0,1984,0,98074,47.6217,-122.021,2900,43500,77325,40600,9.153597363763959,0.08852459016393442,Very Cheap
20140710T000000,469000.0,5,2.5,2690,11745,1.0,0,0,3,8,1790,900,1960,0,98177,47.7708,-122.362,2670,7905,9055,5235,39.93188590889741,0.05167213114754098,Very Cheap
20140610T000000,566000.0,4,1.75,2440,5000,1.0,0,0,3,8,1340,1100,1954,0,98117,47.6823,-122.371,2170,5000,2560,2830,113.2,0.06439344262295082,Very Cheap
20140502T000000,407500.0,3,2.5,1930,10460,2.0,0,0,3,8,1930,0,1996,0,98059,47.4938,-122.161,2290,8228,8530,5938,38.95793499043977,0.04360655737704918,Very Cheap
20141028T000000,353500.0,2,1.0,800,8775,1.0,0,0,3,6,800,0,1942,0,98125,47.7171,-122.307,1470,8976,7975,7506,40.28490028490028,0.036524590163934424,Very Cheap
20140508T000000,524000.0,3,2.25,2430,73151,1.0,0,0,3,8,2430,0,1974,0,98059,47.4749,-122.092,2800,39250,70721,36450,7.163265027135651,0.05888524590163934,Very Cheap
20140822T000000,264950.0,4,2.5,1990,9656,2.0,0,0,3,7,1990,0,1994,0,98010,47.3125,-121.998,1500,9656,7666,8156,27.438898094449048,0.024911475409836067,Very Cheap
20141028T000000,547500.0,3,2.5,2550,10355,2.0,0,0,3,9,2550,0,1990,0,98011,47.739,-122.203,2550,10084,7805,7534,52.87300820859488,0.061967213114754095,Very Cheap
20141117T000000,264500.0,3,2.25,1370,7087,2.0,0,0,3,7,1370,0,1993,0,98038,47.3504,-122.035,1400,6600,5717,5200,37.321856921123185,0.024852459016393443,Very Cheap
20140520T000000,507500.0,3,2.0,2020,8118,1.0,0,0,3,7,1020,1000,1963,0,98008,47.5866,-122.118,1670,8118,6098,6448,62.51539788125154,0.05672131147540983,Very Cheap
20141008T000000,560000.0,3,3.5,1560,2198,2.0,0,0,3,8,1180,380,2006,0,98116,47.5812,-122.403,1550,1467,638,-83,254.77707006369425,0.06360655737704918,Very Cheap
20141216T000000,995000.0,5,4.0,5610,22529,2.0,0,0,3,11,4090,1520,1996,0,98072,47.7239,-122.092,3860,24751,16919,20891,44.16529806027786,0.12065573770491804,Cheap
20150324T000000,835000.0,6,2.0,3560,5120,2.5,0,2,3,9,3560,0,1900,0,98122,47.6056,-122.311,2130,5120,1560,2990,163.0859375,0.09967213114754099,Very Cheap
20140626T000000,440000.0,3,1.5,2120,6290,1.0,0,0,4,8,1220,900,1949,0,98108,47.5658,-122.318,1620,5400,4170,3780,69.9523052464229,0.04786885245901639,Very Cheap
20140728T000000,1015000.0,3,2.5,2920,5629,1.0,0,2,5,8,1460,1460,1955,0,98199,47.642,-122.405,2380,5000,2709,2620,180.31621957718954,0.12327868852459016,Cheap
20140523T000000,300000.0,2,1.0,1340,7788,1.0,0,2,3,7,1340,0,1947,0,98178,47.5094,-122.244,2550,7788,6448,5238,38.52080123266564,0.029508196721311476,Very Cheap
20141210T000000,125000.0,3,1.0,1230,4800,1.5,0,0,1,6,1230,0,1916,0,98117,47.6941,-122.365,1230,4800,3570,3570,26.041666666666668,0.006557377049180328,Very Cheap
20141105T000000,986000.0,4,3.5,2840,5900,2.0,0,0,3,10,1920,920,1910,2008,98118,47.5543,-122.268,1300,4900,3060,3600,167.11864406779662,0.11947540983606557,Cheap
20140812T000000,315000.0,4,2.5,2080,5650,1.0,0,0,3,7,1680,400,1950,0,98178,47.5107,-122.257,1270,5650,3570,4380,55.75221238938053,0.031475409836065574,Very Cheap
20140812T000000,320000.0,4,2.5,2070,7007,2.0,0,0,3,7,2070,0,1996,0,98031,47.3968,-122.171,2130,8100,4937,5970,45.66861709718852,0.032131147540983604,Very Cheap
20141204T000000,972000.0,4,3.25,4010,13797,2.0,0,0,3,11,4010,0,2003,0,98059,47.5229,-122.152,3980,12120,9787,8140,70.45009784735812,0.11763934426229508,Cheap
20140909T000000,760000.0,3,2.5,2190,10000,1.0,0,0,4,7,1540,650,1957,0,98040,47.5419,-122.214,2880,11782,7810,8902,76.0,0.0898360655737705,Very Cheap
20140903T000000,265000.0,4,3.0,1730,7264,2.0,0,0,3,6,1730,0,1920,0,98168,47.4738,-122.264,1500,12104,5534,10604,36.481277533039645,0.024918032786885248,Very Cheap
20141118T000000,355000.0,2,1.0,1250,4558,1.0,0,0,3,7,1250,0,1948,0,98126,47.5318,-122.379,1180,4494,3308,3314,77.88503729706011,0.036721311475409836,Very Cheap
20140827T000000,300000.0,3,1.0,1300,20812,1.0,0,0,3,6,1300,0,1927,0,98106,47.5435,-122.359,1210,17340,19512,16130,14.41476071497213,0.029508196721311476,Very Cheap
20140826T000000,474950.0,5,2.5,2080,8347,1.0,0,0,4,7,1460,620,1975,0,98034,47.7334,-122.168,1840,7713,6267,5873,56.90068288007667,0.05245245901639344,Very Cheap
20140827T000000,470000.0,4,2.0,2180,17180,2.0,0,0,4,7,2180,0,1977,0,98014,47.698,-121.92,1880,14043,15000,12163,27.357392316647264,0.05180327868852459,Very Cheap
20141125T000000,437500.0,3,1.0,1630,16393,1.0,0,0,3,7,1630,0,1969,0,98033,47.6576,-122.186,1880,23497,14763,21617,26.68822058195571,0.047540983606557376,Very Cheap
20141028T000000,520000.0,2,1.5,1840,3825,1.0,0,0,3,8,1040,800,1928,0,98117,47.6808,-122.38,1290,5100,1985,3810,135.94771241830065,0.058360655737704915,Very Cheap
20141117T000000,237600.0,2,1.0,1370,11584,1.0,0,0,4,6,1370,0,1950,0,98198,47.4224,-122.293,1330,8012,10214,6682,20.511049723756905,0.021324590163934426,Very Cheap
20140711T000000,162950.0,2,1.0,950,2784,1.0,0,0,4,8,950,0,1972,0,98198,47.3793,-122.321,1080,3899,1834,2819,58.5308908045977,0.011534426229508198,Very Cheap
20141111T000000,457000.0,3,1.75,1690,6375,1.0,0,0,3,8,1690,0,1903,2002,98024,47.5247,-121.926,1270,7774,4685,6504,71.68627450980392,0.0500983606557377,Very Cheap
20140808T000000,635000.0,3,2.5,1780,11000,1.0,0,0,4,8,1210,570,1980,0,98006,47.5574,-122.149,2310,9700,9220,7390,57.72727272727273,0.07344262295081967,Very Cheap
20140530T000000,735000.0,4,3.0,2840,4120,1.5,0,0,4,8,2060,780,1931,0,98118,47.5683,-122.283,1840,5871,1280,4031,178.39805825242718,0.08655737704918033,Very Cheap
20140918T000000,910000.0,2,2.5,2000,5150,2.0,0,4,3,9,2000,0,1992,0,98034,47.7056,-122.223,2510,6800,3150,4290,176.6990291262136,0.10950819672131147,Cheap
20141021T000000,346500.0,3,3.25,1570,2048,2.0,0,0,3,8,1290,280,2006,0,98126,47.548,-122.375,1570,2006,478,436,169.189453125,0.03560655737704918,Very Cheap
20140905T000000,655000.0,4,2.5,2370,9517,1.0,0,0,3,9,1630,740,1984,0,98074,47.6222,-122.034,2440,9035,7147,6595,68.82420930965641,0.0760655737704918,Very Cheap
20141110T000000,425000.0,3,1.75,1610,144619,1.0,0,0,3,7,1610,0,1977,0,98024,47.5659,-121.863,2220,144619,143009,142399,2.9387563183260843,0.04590163934426229,Very Cheap
20150217T000000,137000.0,3,1.0,1300,10125,1.0,0,0,4,6,1300,0,1959,0,98002,47.2921,-122.215,1300,10125,8825,8825,13.530864197530864,0.008131147540983607,Very Cheap
20140715T000000,557500.0,3,2.5,2620,11056,2.0,0,0,3,9,2620,0,1988,0,98011,47.7378,-122.218,2560,8688,8436,6128,50.425108538350216,0.06327868852459016,Very Cheap
20140509T000000,415000.0,4,2.25,3060,48787,2.0,0,0,3,8,3060,0,1992,0,98010,47.3397,-121.918,2090,48787,45727,46697,8.506364400352552,0.04459016393442623,Very Cheap
20140620T000000,830000.0,5,2.25,2780,10192,2.0,0,0,4,9,2780,0,1978,0,98007,47.6134,-122.152,2740,9900,7412,7160,81.43642072213501,0.09901639344262295,Very Cheap
20150415T000000,949000.0,4,3.0,4270,85643,2.0,0,0,3,11,4270,0,1991,0,98077,47.7711,-122.048,3760,51170,81373,47410,11.080882267085459,0.11462295081967214,Cheap
20141014T000000,420000.0,3,1.0,1310,3963,1.0,0,0,5,7,1310,0,1986,0,98052,47.6826,-122.096,1010,3363,2653,2353,105.98031794095382,0.04524590163934426,Very Cheap
20150403T000000,353000.0,2,1.0,1100,7500,1.0,0,0,3,7,1100,0,1951,0,98125,47.7235,-122.326,1920,7149,6400,5229,47.06666666666667,0.03645901639344262,Very Cheap
20140904T000000,560000.0,3,1.75,1480,383328,1.5,0,0,3,8,1480,0,1980,0,98019,47.7192,-121.932,1480,67082,381848,65602,1.4608898906419567,0.06360655737704918,Very Cheap
20140502T000000,445700.0,3,2.5,1270,1180,3.0,0,0,3,8,1270,0,2001,0,98107,47.6697,-122.392,1320,1180,-90,-140,377.7118644067797,0.04861639344262295,Very Cheap
20140717T000000,226000.0,4,1.0,1270,6459,1.5,0,0,3,7,1270,0,1918,0,98118,47.5441,-122.273,1300,4100,5189,2800,34.98993652268153,0.01980327868852459,Very Cheap
20141205T000000,358000.0,3,1.0,890,9870,1.0,0,0,4,7,890,0,1960,0,98056,47.5398,-122.178,1270,9861,8980,8591,36.271529888551164,0.03711475409836065,Very Cheap
20150305T000000,501000.0,3,1.75,1480,8667,1.0,0,0,5,7,740,740,1954,0,98006,47.5718,-122.136,1600,10644,7187,9044,57.805469020422294,0.05586885245901639,Very Cheap
20150321T000000,609000.0,4,2.5,3240,23870,1.0,0,0,3,9,1840,1400,1972,0,98155,47.7731,-122.282,2290,13340,20630,11050,25.513196480938415,0.0700327868852459,Very Cheap
20140709T000000,734950.0,4,3.25,4280,47179,2.0,0,0,3,10,3050,1230,2002,0,98092,47.3017,-122.127,2820,43401,42899,40581,15.5779054240234,0.08655081967213114,Very Cheap
20140613T000000,725000.0,5,2.5,3210,12000,1.0,0,0,4,8,1830,1380,1968,0,98007,47.6205,-122.148,2450,12000,8790,9550,60.416666666666664,0.08524590163934426,Very Cheap
20140811T000000,350500.0,3,2.25,1870,7200,1.0,0,0,3,7,1390,480,1975,0,98072,47.734,-122.174,1830,7876,5330,6046,48.68055555555556,0.03613114754098361,Very Cheap
20140602T000000,610000.0,5,2.5,3990,3839,1.0,0,0,4,8,1990,2000,1962,0,98112,47.6236,-122.299,2090,5000,-151,2910,158.89554571502995,0.07016393442622951,Very Cheap
20141106T000000,605125.0,2,1.0,1160,5029,1.0,0,0,3,7,910,250,1940,0,98115,47.6723,-122.266,1220,5029,3869,3809,120.32710280373831,0.06952459016393443,Very Cheap
20150428T000000,1388000.0,4,2.25,2940,20384,2.0,0,0,4,9,2940,0,1970,0,98004,47.6214,-122.227,3410,19910,17444,16500,68.09262166405024,0.1721967213114754,Cheap
20150421T000000,550000.0,3,2.25,1850,37264,2.0,0,0,3,8,1850,0,1981,0,98053,47.6486,-122.035,2390,36036,35414,33646,14.759553456419065,0.06229508196721312,Very Cheap
20141007T000000,335000.0,2,1.75,1060,1202,2.0,0,0,3,7,760,300,2003,0,98136,47.5426,-122.388,1060,1493,142,433,278.7021630615641,0.03409836065573771,Very Cheap
20141231T000000,397000.0,3,2.0,1100,9165,1.0,0,0,4,7,1100,0,1969,0,98034,47.7304,-122.231,1510,8500,8065,6990,43.31696672122204,0.04222950819672131,Very Cheap
20141124T000000,240000.0,3,2.0,1190,10299,1.0,0,0,3,7,1190,0,1994,0,98010,47.314,-122.0,1700,9849,9109,8149,23.30323332362365,0.021639344262295083,Very Cheap
20140926T000000,240000.0,3,2.0,1030,11118,1.0,0,0,5,7,1030,0,1970,0,98003,47.3463,-122.308,1300,7920,10088,6620,21.586616297895304,0.021639344262295083,Very Cheap
20141120T000000,262500.0,2,1.5,1140,14373,1.0,0,0,3,7,1140,0,1949,1996,98011,47.7354,-122.219,2140,9860,13233,7720,18.26341056146942,0.02459016393442623,Very Cheap
20140922T000000,440000.0,3,1.5,2260,5300,1.0,0,0,3,7,1200,1060,1940,0,98103,47.6756,-122.348,1950,5000,3040,3050,83.01886792452831,0.04786885245901639,Very Cheap
20150323T000000,160000.0,3,1.0,1140,3240,1.5,0,0,4,6,1140,0,1910,0,98014,47.7093,-121.364,1140,4700,2100,3560,49.382716049382715,0.011147540983606558,Very Cheap
20140611T000000,427000.0,4,1.0,1860,4736,1.5,0,0,1,7,1860,0,1901,0,98112,47.6251,-122.3,1800,4000,2876,2200,90.16047297297297,0.04616393442622951,Very Cheap
20140701T000000,920000.0,4,3.5,4080,10666,2.0,0,0,3,9,4080,0,2005,0,98053,47.6818,-122.023,3920,8154,6586,4234,86.25539096193512,0.11081967213114755,Cheap
20140805T000000,2300000.0,4,2.5,3280,7100,2.0,0,4,3,10,2180,1100,1911,1987,98119,47.6285,-122.362,3240,6674,3820,3434,323.943661971831,0.29180327868852457,Cheap
20141124T000000,480000.0,4,2.5,2870,35757,2.0,0,0,4,9,2870,0,1977,0,98077,47.7568,-122.05,2700,41221,32887,38521,13.423944961825656,0.05311475409836065,Very Cheap
20140505T000000,615000.0,4,1.75,2300,11700,1.0,0,0,4,9,1960,340,1977,0,98052,47.6331,-122.094,2840,12000,9400,9160,52.56410256410256,0.07081967213114754,Very Cheap
20140822T000000,736500.0,3,2.0,2230,4800,1.5,0,0,4,7,1290,940,1915,0,98199,47.645,-122.386,1650,5040,2570,3390,153.4375,0.08675409836065574,Very Cheap
20141119T000000,542500.0,3,2.5,1920,1649,2.5,0,0,3,8,1600,320,2004,0,98116,47.5901,-122.388,1650,3053,-271,1403,328.9872650090964,0.061311475409836065,Very Cheap
20150319T000000,191000.0,2,1.0,700,5000,1.0,0,0,5,6,700,0,1952,0,98056,47.4927,-122.172,1040,5200,4300,4160,38.2,0.01521311475409836,Very Cheap
20140718T000000,730000.0,4,2.5,2740,11975,2.0,0,0,4,8,2740,0,1991,0,98074,47.6315,-122.028,2310,9068,9235,6758,60.96033402922756,0.0859016393442623,Very Cheap
20141125T000000,1225000.0,5,2.25,3440,5000,2.0,0,2,5,9,3440,0,1901,0,98122,47.6127,-122.286,2822,5000,1560,2178,245.0,0.15081967213114755,Cheap
20140604T000000,129000.0,1,1.0,650,15364,1.0,0,0,4,5,650,0,1967,0,98042,47.3721,-122.159,1630,7952,14714,6322,8.396250976308252,0.007081967213114754,Very Cheap
20140709T000000,284000.0,3,1.5,1500,10018,1.0,0,0,4,7,1500,0,1957,0,98058,47.468,-122.163,1500,10937,8518,9437,28.348971850668796,0.027409836065573772,Very Cheap
20150321T000000,645000.0,3,2.5,2490,5978,2.0,0,0,3,9,2490,0,2003,0,98074,47.6298,-122.022,2710,6629,3488,3919,107.89561726329876,0.07475409836065573,Very Cheap
20140624T000000,218000.0,3,1.5,1330,7600,1.0,0,0,4,7,1330,0,1968,0,98023,47.3103,-122.366,1500,7776,6270,6276,28.68421052631579,0.018754098360655738,Very Cheap
20141009T000000,675000.0,4,3.5,3190,6875,2.0,0,2,3,8,2120,1070,1999,0,98034,47.7082,-122.221,2550,6875,3685,4325,98.18181818181819,0.07868852459016394,Very Cheap
20141229T000000,575000.0,3,2.5,1590,2910,2.0,0,0,3,7,1110,480,1984,0,98115,47.6855,-122.321,1590,3880,1320,2290,197.59450171821305,0.06557377049180328,Very Cheap
20141030T000000,225000.0,2,1.0,830,5720,1.0,0,0,4,6,830,0,1950,0,98133,47.7339,-122.339,1150,5250,4890,4100,39.33566433566433,0.019672131147540985,Very Cheap
20150408T000000,626000.0,3,2.25,1810,5107,2.0,0,0,3,8,1810,0,1989,0,98033,47.6882,-122.171,1760,5454,3297,3694,122.57685529665166,0.07226229508196721,Very Cheap
20150319T000000,499950.0,4,2.5,2910,20067,2.0,0,0,3,9,2910,0,2001,0,98168,47.4714,-122.273,1730,21420,17157,19690,24.91403797279115,0.05573114754098361,Very Cheap
20140513T000000,405000.0,4,1.75,2180,13529,1.0,0,0,3,7,1090,1090,1956,0,98155,47.7516,-122.294,2000,13529,11349,11529,29.9356936950255,0.043278688524590166,Very Cheap
20141029T000000,152500.0,3,1.0,1090,3523,1.0,0,0,4,6,1090,0,1969,0,98092,47.3161,-122.182,1030,3200,2433,2170,43.28697133125178,0.010163934426229508,Very Cheap
20140716T000000,325000.0,4,2.5,2160,6825,2.0,0,0,3,8,2160,0,1994,0,98031,47.4111,-122.2,2020,7035,4665,5015,47.61904761904762,0.03278688524590164,Very Cheap
20140529T000000,475300.0,3,1.0,2110,10005,1.0,0,0,5,7,1110,1000,1924,0,98033,47.688,-122.168,1360,9827,7895,8467,47.50624687656172,0.05249836065573771,Very Cheap
20150408T000000,485000.0,3,1.75,2180,7318,1.0,0,0,4,7,1210,970,1967,0,98126,47.5251,-122.37,2140,7560,5138,5420,66.27493850778902,0.05377049180327869,Very Cheap
20150412T000000,720000.0,3,2.5,2100,2200,2.0,0,0,4,7,1500,600,1919,0,98122,47.614,-122.294,1750,4400,100,2650,327.27272727272725,0.08459016393442623,Very Cheap
20140515T000000,465000.0,3,1.75,1410,6886,1.0,0,0,3,7,1410,0,1924,2013,98133,47.7183,-122.353,1410,6561,5476,5151,67.52831832704037,0.051147540983606556,Very Cheap
20140604T000000,489000.0,3,1.5,1020,9072,1.0,0,0,3,7,920,100,1930,0,98115,47.695,-122.301,1620,7930,8052,6310,53.902116402116405,0.05429508196721312,Very Cheap
20140729T000000,3100000.0,5,5.25,5090,23669,2.0,0,0,3,12,5090,0,2006,0,98004,47.6297,-122.216,3830,22605,18579,18775,130.97300266170942,0.39672131147540984,Medium
20150108T000000,288000.0,3,2.25,2090,7500,1.0,0,0,4,7,1280,810,1977,0,98031,47.3951,-122.172,1800,7350,5410,5550,38.4,0.027934426229508195,Very Cheap
20140808T000000,225000.0,3,1.75,1350,9793,1.0,0,0,4,7,1350,0,1968,0,98022,47.1981,-122.003,1690,8080,8443,6390,22.97559481262126,0.019672131147540985,Very Cheap
20150421T000000,499000.0,3,1.75,2650,11774,1.0,0,1,3,8,2240,410,1952,0,98146,47.4909,-122.363,2650,10120,9124,7470,42.38151860030576,0.05560655737704918,Very Cheap
20141111T000000,632000.0,5,3.0,3520,36558,2.0,0,0,4,8,2100,1420,1985,0,98027,47.4658,-122.007,3000,36558,33038,33558,17.287597789813447,0.07304918032786885,Very Cheap
20140613T000000,580000.0,3,2.5,2040,4627,2.0,0,0,3,8,2040,0,1992,0,98052,47.6365,-122.108,2230,4500,2587,2270,125.35119948130539,0.06622950819672131,Very Cheap
20150423T000000,730000.0,4,1.5,2340,5000,2.0,0,0,3,8,2100,240,1912,0,98122,47.6065,-122.291,2320,5500,2660,3180,146.0,0.0859016393442623,Very Cheap
20150327T000000,325000.0,4,2.25,1770,7799,2.0,0,0,3,7,1770,0,1998,0,98031,47.4192,-122.202,1770,7778,6029,6008,41.67200923195281,0.03278688524590164,Very Cheap
20150415T000000,421000.0,3,1.75,1100,8662,1.0,0,0,5,7,1100,0,1964,0,98056,47.5368,-122.173,1100,9240,7562,8140,48.603093973678135,0.045377049180327866,Very Cheap
20150120T000000,316000.0,3,2.5,1490,4078,2.0,0,0,3,8,1490,0,1998,0,98059,47.4915,-122.155,1310,2767,2588,1457,77.48896517900931,0.03160655737704918,Very Cheap
20140804T000000,415000.0,2,1.0,1460,4200,1.0,0,0,4,6,880,580,1914,0,98117,47.6774,-122.361,1540,4200,2740,2660,98.80952380952381,0.04459016393442623,Very Cheap
20140922T000000,401000.0,3,2.25,1350,2839,2.0,0,0,3,7,1350,0,2003,0,98053,47.6824,-122.036,1650,3093,1489,1443,141.24691792884818,0.04275409836065574,Very Cheap
20150224T000000,229950.0,3,0.75,1030,12700,1.0,0,0,4,5,1030,0,1944,0,98032,47.3877,-122.236,1140,6955,11670,5815,18.106299212598426,0.020321311475409835,Very Cheap
20150330T000000,539950.0,3,1.75,1820,9875,1.0,0,0,4,8,1820,0,1966,0,98008,47.6243,-122.094,2670,10000,8055,7330,54.678481012658224,0.06097704918032787,Very Cheap
20140605T000000,335000.0,3,2.0,1170,5360,1.0,0,0,3,6,1170,0,1919,0,98106,47.5181,-122.364,1180,7200,4190,6020,62.5,0.03409836065573771,Very Cheap
20140707T000000,339000.0,3,2.5,1450,3748,2.0,0,0,3,7,1450,0,2004,0,98065,47.532,-121.85,1970,3748,2298,1778,90.44823906083245,0.03462295081967213,Very Cheap
20141020T000000,414950.0,4,1.75,2200,8545,1.0,0,0,4,7,1100,1100,1918,1982,98133,47.7481,-122.353,1940,9315,6345,7375,48.560561732007024,0.04458360655737705,Very Cheap
20141202T000000,650000.0,4,2.0,1610,8976,1.0,0,0,4,8,1610,0,1966,0,98004,47.6011,-122.192,1930,8976,7366,7046,72.41532976827095,0.07540983606557378,Very Cheap
20141203T000000,445000.0,3,2.5,2690,21883,2.0,0,0,3,8,2690,0,1994,0,98014,47.6462,-121.904,2370,21781,19193,19411,20.335420189187953,0.04852459016393443,Very Cheap
20150320T000000,295000.0,3,2.25,1850,7800,2.0,0,0,3,9,1850,0,1974,0,98023,47.3146,-122.379,2360,8000,5950,5640,37.82051282051282,0.028852459016393443,Very Cheap
20150413T000000,975000.0,4,2.25,2250,3600,2.0,0,0,4,9,2010,240,1912,1994,98119,47.643,-122.37,1910,3990,1350,2080,270.8333333333333,0.1180327868852459,Cheap
20141219T000000,296500.0,3,1.5,1580,10100,1.0,0,0,4,7,1580,0,1961,0,98055,47.4423,-122.193,1650,10032,8520,8382,29.356435643564357,0.02904918032786885,Very Cheap
20141021T000000,440000.0,4,2.75,2030,56192,1.0,0,0,3,8,1550,480,1979,0,98077,47.752,-122.073,2510,44866,54162,42356,7.830296127562642,0.04786885245901639,Very Cheap
20141229T000000,420000.0,5,1.5,1890,10880,1.0,0,0,3,7,1890,0,1962,0,98034,47.7196,-122.197,1670,9750,8990,8080,38.60294117647059,0.04524590163934426,Very Cheap
20140723T000000,302000.0,3,2.5,2140,9492,2.0,0,0,3,8,2140,0,1994,0,98092,47.3289,-122.204,2180,9184,7352,7004,31.816266329540667,0.02977049180327869,Very Cheap
20150409T000000,350000.0,4,1.75,1770,7336,1.0,0,0,4,8,1770,0,1986,0,98058,47.4265,-122.163,2030,8183,5566,6153,47.70992366412214,0.036065573770491806,Very Cheap
20140626T000000,667000.0,3,1.75,3320,478288,1.5,0,3,4,8,2260,1060,1933,1982,98022,47.2407,-121.953,2960,217800,474968,214840,1.3945572542066704,0.07763934426229509,Very Cheap
20150513T000000,645000.0,3,2.0,1640,4218,1.0,0,0,4,7,910,730,1941,0,98103,47.6546,-122.344,1670,4000,2578,2330,152.91607396870555,0.07475409836065573,Very Cheap
20141111T000000,430000.0,4,2.75,1820,5400,1.0,0,0,4,7,1220,600,1988,0,98056,47.5204,-122.205,1630,5400,3580,3770,79.62962962962963,0.04655737704918033,Very Cheap
20140513T000000,413000.0,4,1.0,1410,6000,1.0,0,0,3,7,810,600,1925,0,98126,47.566,-122.373,1500,4800,4590,3300,68.83333333333333,0.04432786885245902,Very Cheap
20141201T000000,420000.0,3,1.0,1240,7300,1.0,0,0,3,7,1240,0,1968,0,98033,47.6775,-122.168,1240,8260,6060,7020,57.534246575342465,0.04524590163934426,Very Cheap
20141029T000000,495000.0,3,2.25,1780,8050,1.0,0,0,4,7,1230,550,1979,0,98052,47.6977,-122.126,1780,7200,6270,5420,61.49068322981366,0.05508196721311476,Very Cheap
20140812T000000,2187730.0,4,4.5,4240,13162,2.0,0,0,3,10,4240,0,2004,0,98039,47.6193,-122.229,3010,12163,8922,9153,166.21562072633338,0.2770793442622951,Cheap
20150426T000000,965000.0,4,2.5,3570,17411,2.0,0,0,3,10,3570,0,1990,0,98075,47.5617,-122.03,3510,16153,13841,12643,55.42473149158578,0.11672131147540983,Cheap
20141201T000000,500000.0,4,2.5,1900,5001,1.0,0,0,3,8,1200,700,2008,0,98133,47.7289,-122.335,1950,4680,3101,2730,99.98000399920016,0.05573770491803279,Very Cheap
20141001T000000,636100.0,3,1.0,1010,6000,1.5,0,0,3,7,1010,0,1919,1977,98119,47.6438,-122.357,1960,4000,4990,2040,106.01666666666667,0.07358688524590164,Very Cheap
20140603T000000,720000.0,4,2.5,2870,12648,2.0,0,0,4,9,2870,0,1986,0,98029,47.5632,-122.017,2560,12648,9778,10088,56.92599620493359,0.08459016393442623,Very Cheap
20150504T000000,298000.0,3,1.75,1620,12825,1.0,0,0,3,8,1340,280,1962,0,98003,47.3321,-122.323,2076,11200,11205,9124,23.235867446393762,0.029245901639344263,Very Cheap
20140729T000000,409000.0,2,1.75,1480,4000,1.0,0,0,4,6,740,740,1925,0,98117,47.6916,-122.38,1060,4000,2520,2940,102.25,0.04380327868852459,Very Cheap
20141226T000000,370000.0,4,2.5,2650,5706,2.0,0,0,3,9,2650,0,2005,0,98042,47.3515,-122.164,2760,5749,3056,2989,64.84402383456012,0.038688524590163934,Very Cheap
20140725T000000,230000.0,5,1.0,1410,9000,1.0,0,0,5,7,1410,0,1967,0,98023,47.3054,-122.369,1200,8346,7590,7146,25.555555555555557,0.020327868852459016,Very Cheap
20150324T000000,290000.0,3,2.0,1360,6685,1.0,0,0,3,7,1360,0,1952,0,98155,47.7365,-122.324,1300,8138,5325,6838,43.380703066566944,0.02819672131147541,Very Cheap
20150219T000000,420000.0,4,2.25,2930,9840,1.0,0,0,4,8,1560,1370,1977,0,98023,47.3103,-122.382,2800,8374,6910,5574,42.68292682926829,0.04524590163934426,Very Cheap
20140722T000000,917000.0,4,2.5,3500,10891,2.0,0,2,3,10,3500,0,1995,0,98027,47.5533,-122.093,3820,13521,7391,9701,84.19796161968598,0.11042622950819672,Cheap
20140625T000000,957000.0,5,3.25,3160,5000,2.0,0,2,3,10,2180,980,2005,0,98199,47.6464,-122.405,3160,5746,1840,2586,191.4,0.11567213114754098,Cheap
20140701T000000,482000.0,3,2.25,1710,21485,2.0,0,0,3,7,1710,0,1989,0,98074,47.6198,-122.053,1680,21485,19775,19805,22.43425645799395,0.05337704918032787,Very Cheap
20141121T000000,488000.0,3,1.75,2180,14734,2.0,0,0,3,9,2180,0,1990,0,98045,47.4831,-121.767,2300,21618,12554,19318,33.12067327270259,0.05416393442622951,Very Cheap
20141017T000000,760369.0,5,2.5,2870,4712,2.0,0,0,3,9,2870,0,2014,0,98006,47.5463,-122.182,2870,6768,1842,3898,161.36863327674024,0.08988445901639344,Very Cheap
20140604T000000,170000.0,2,1.0,1500,18540,1.0,0,0,3,8,1500,0,1950,0,98168,47.4727,-122.281,1700,9355,17040,7655,9.169363538295578,0.012459016393442624,Very Cheap
20150429T000000,625000.0,3,2.5,2120,10021,1.0,0,0,4,8,1230,890,1976,0,98006,47.5621,-122.135,2690,10183,7901,7493,62.369025047400456,0.07213114754098361,Very Cheap
20141202T000000,357000.0,3,1.5,1590,6750,1.0,0,0,3,7,1080,510,1976,0,98034,47.73,-122.191,1590,7400,5160,5810,52.888888888888886,0.03698360655737705,Very Cheap
20150407T000000,583000.0,3,2.25,1830,8276,1.0,0,0,3,8,1350,480,1989,0,98074,47.6336,-122.025,1920,8276,6446,6356,70.44465925567907,0.06662295081967214,Very Cheap
20140820T000000,173250.0,3,2.0,1210,9097,1.0,0,0,4,7,1210,0,1954,0,98168,47.4849,-122.303,1360,10125,7887,8765,19.044740024183795,0.012885245901639345,Very Cheap
20140716T000000,414050.0,4,2.0,1590,10331,1.5,0,0,4,7,1590,0,1956,0,98133,47.7273,-122.332,1400,9434,8741,8034,40.07840480108412,0.044465573770491804,Very Cheap
20140618T000000,400000.0,3,1.75,1050,6150,1.5,0,0,4,6,950,100,1928,0,98116,47.5715,-122.394,1360,6150,5100,4790,65.04065040650407,0.04262295081967213,Very Cheap
20150327T000000,537000.0,3,2.0,1550,27003,1.5,0,0,3,8,1550,0,1982,0,98074,47.606,-122.056,2400,27003,25453,24603,19.886679257860237,0.060590163934426226,Very Cheap
20140606T000000,465000.0,4,2.25,2070,7500,2.0,0,0,4,7,2070,0,1977,0,98034,47.727,-122.217,2080,7700,5430,5620,62.0,0.051147540983606556,Very Cheap
20140818T000000,425000.0,3,2.25,1740,9682,1.0,0,0,5,8,1740,0,1969,0,98056,47.5138,-122.173,2100,9536,7942,7436,43.895889279074574,0.04590163934426229,Very Cheap
20141118T000000,445000.0,4,2.0,1700,21780,1.0,0,0,4,6,1080,620,1940,0,98052,47.6289,-122.108,2070,12054,20080,9984,20.431588613406795,0.04852459016393443,Very Cheap
20141211T000000,179950.0,2,1.0,1200,9000,1.0,0,0,3,6,1200,0,1958,0,98023,47.3277,-122.349,1040,9600,7800,8560,19.994444444444444,0.013763934426229509,Very Cheap
20150421T000000,275000.0,3,2.5,1710,7230,2.0,0,0,3,7,1710,0,1996,0,98003,47.2778,-122.298,1720,6537,5520,4817,38.035961272475795,0.02622950819672131,Very Cheap
20140715T000000,190000.0,4,2.5,1840,13493,2.0,0,0,3,7,1840,0,1994,0,98001,47.2649,-122.242,1430,11463,11653,10033,14.081375528051582,0.015081967213114755,Very Cheap
20140506T000000,385000.0,3,1.75,1900,5520,1.0,0,0,3,7,1280,620,1982,0,98118,47.5549,-122.292,1330,5196,3620,3866,69.7463768115942,0.04065573770491803,Very Cheap
20150429T000000,303000.0,4,1.0,2300,9583,1.0,0,0,3,6,1220,1080,1928,0,98024,47.5671,-121.89,1200,11325,7283,10125,31.618491077950537,0.029901639344262296,Very Cheap
20150105T000000,165000.0,3,1.0,970,7503,1.0,0,0,4,6,970,0,1967,0,98058,47.4688,-122.163,1230,9504,6533,8274,21.991203518592563,0.01180327868852459,Very Cheap
20150430T000000,600000.0,2,2.0,1270,5000,1.0,0,0,3,6,1270,0,1944,0,98107,47.6729,-122.363,2190,5000,3730,2810,120.0,0.06885245901639345,Very Cheap
20140718T000000,710000.0,3,2.25,3130,65775,2.0,0,0,4,8,3130,0,1978,0,98027,47.5462,-122.085,3130,72309,62645,69179,10.794374762447738,0.08327868852459017,Very Cheap
20150327T000000,875000.0,5,3.25,4230,21455,2.0,0,0,3,10,2720,1510,1990,0,98074,47.6375,-122.015,3280,22393,17225,19113,40.783034257748774,0.10491803278688525,Cheap
20140902T000000,269950.0,3,2.5,1480,9743,2.0,0,0,4,7,1480,0,1996,0,98010,47.3293,-122.001,1810,9601,8263,7791,27.707071743816073,0.025567213114754097,Very Cheap
20140502T000000,838000.0,4,2.5,3310,42998,2.0,0,0,3,9,3310,0,2001,0,98052,47.7232,-122.131,3350,42847,39688,39497,19.48927857109633,0.1000655737704918,Cheap
20140523T000000,670500.0,4,2.0,1590,6750,1.0,0,0,3,7,1590,0,1951,0,98102,47.6406,-122.317,2370,4500,5160,2130,99.33333333333333,0.0780983606557377,Very Cheap
20150212T000000,420000.0,4,1.5,1690,9391,1.0,0,0,3,7,1290,400,1960,0,98155,47.7438,-122.329,1780,9390,7701,7610,44.723671600468535,0.04524590163934426,Very Cheap
20140913T000000,370000.0,3,1.5,1690,161913,1.0,0,0,2,7,1430,260,1952,0,98030,47.356,-122.189,1930,12548,160223,10618,2.285177842421547,0.038688524590163934,Very Cheap
20140624T000000,360000.0,3,1.75,1500,7200,1.0,0,0,3,7,1500,0,1957,0,98133,47.7748,-122.337,1650,7392,5700,5742,50.0,0.037377049180327866,Very Cheap
20141003T000000,562500.0,4,2.5,2320,8721,2.0,0,0,3,8,2320,0,1991,0,98034,47.7326,-122.226,2260,8268,6401,6008,64.49948400412796,0.06393442622950819,Very Cheap
20140818T000000,360500.0,3,2.5,3300,11525,1.0,0,0,5,8,1650,1650,1961,0,98198,47.4113,-122.315,1950,9680,8225,7730,31.27982646420824,0.037442622950819675,Very Cheap
20140521T000000,389999.0,3,2.25,1445,1471,2.0,0,0,3,7,1300,145,2003,0,98027,47.5342,-122.072,1410,1399,26,-11,265.12508497620667,0.04131134426229508,Very Cheap
20140827T000000,450000.0,4,3.0,1890,13140,1.0,0,0,4,7,1270,620,1967,0,98027,47.5221,-122.044,1900,11160,11250,9260,34.24657534246575,0.04918032786885246,Very Cheap
20150303T000000,247500.0,4,2.0,1760,8400,1.0,0,0,3,7,1060,700,1962,0,98003,47.3258,-122.323,1280,8415,6640,7135,29.464285714285715,0.02262295081967213,Very Cheap
20150219T000000,208000.0,3,1.0,1050,6240,1.0,0,0,5,5,1050,0,1948,0,98146,47.4933,-122.338,1410,6240,5190,4830,33.333333333333336,0.01744262295081967,Very Cheap
20141226T000000,455000.0,3,2.5,1980,7309,2.0,0,0,3,7,1980,0,1993,0,98034,47.7257,-122.172,2060,9681,5329,7621,62.252018059926115,0.049836065573770495,Very Cheap
20141110T000000,379400.0,4,1.75,2120,7680,1.0,0,0,4,7,1060,1060,1950,0,98177,47.7172,-122.361,1530,7680,5560,6150,49.401041666666664,0.03992131147540984,Very Cheap
20141230T000000,190000.0,3,1.5,760,40039,1.0,0,0,3,6,760,0,1906,0,98065,47.5295,-121.829,980,6000,39279,5020,4.745373261070457,0.015081967213114755,Very Cheap
20140821T000000,326188.0,3,1.0,1300,8800,1.0,0,0,3,7,1300,0,1977,0,98053,47.64,-121.966,1600,12210,7500,10610,37.066818181818185,0.03294268852459016,Very Cheap
20140522T000000,168000.0,2,2.5,1160,2174,2.0,0,0,3,7,1160,0,1998,0,98106,47.5264,-122.366,1380,1919,1014,539,77.27690892364305,0.01219672131147541,Very Cheap
20140516T000000,314000.0,4,2.5,2340,8990,2.0,0,0,3,8,2340,0,2003,0,98038,47.3781,-122.03,2980,6718,6650,3738,34.92769744160178,0.03134426229508197,Very Cheap
20140502T000000,630000.0,4,2.75,2710,37277,2.0,0,0,3,9,2710,0,2000,0,98027,47.4634,-121.987,2390,39299,34567,36909,16.900501649810874,0.07278688524590164,Very Cheap
20150316T000000,550000.0,3,1.75,1440,8957,1.0,0,0,4,7,1440,0,1957,0,98008,47.6008,-122.118,1340,8780,7517,7440,61.404488109858214,0.06229508196721312,Very Cheap
20140630T000000,530000.0,4,2.25,1980,15086,2.0,0,0,3,8,1980,0,1981,0,98074,47.647,-122.064,2100,10927,13106,8827,35.131910380485216,0.05967213114754098,Very Cheap
20150206T000000,637500.0,3,1.75,1680,10685,1.0,0,0,4,7,1680,0,1966,0,98033,47.6556,-122.193,3340,10390,9005,7050,59.66307908282639,0.07377049180327869,Very Cheap
20150428T000000,400000.0,3,2.5,1390,2815,2.0,0,0,3,8,1390,0,1999,0,98126,47.566,-122.366,1390,3700,1425,2310,142.09591474245116,0.04262295081967213,Very Cheap
20140610T000000,700000.0,5,2.75,3100,9825,2.0,0,2,4,8,3100,0,1950,1982,98125,47.7188,-122.281,2120,8400,6725,6280,71.2468193384224,0.08196721311475409,Very Cheap
20141114T000000,272000.0,3,2.5,1680,8512,2.0,0,0,3,7,1680,0,1991,0,98022,47.1952,-121.986,1580,8512,6832,6932,31.954887218045112,0.02583606557377049,Very Cheap
20150417T000000,600000.0,4,2.5,2710,6474,2.0,0,0,3,8,2710,0,2004,0,98065,47.5383,-121.878,2870,6968,3764,4098,92.67840593141798,0.06885245901639345,Very Cheap
20150402T000000,450600.0,2,1.0,840,7020,1.5,0,0,4,7,840,0,1943,0,98136,47.5513,-122.394,1310,7072,6180,5762,64.1880341880342,0.04925901639344262,Very Cheap
20141028T000000,550000.0,3,2.25,2090,8095,2.0,0,2,3,10,2090,0,1988,0,98136,47.5287,-122.385,1940,5635,6005,3695,67.9431747992588,0.06229508196721312,Very Cheap
20150123T000000,225000.0,3,1.0,1120,8407,1.0,0,0,5,6,1120,0,1987,0,98022,47.2051,-122.006,1250,8658,7287,7408,26.763411442845246,0.019672131147540985,Very Cheap
20150218T000000,132825.0,3,1.5,1210,5200,1.0,0,0,5,6,1210,0,1969,0,98042,47.3615,-122.087,1120,5200,3990,4080,25.54326923076923,0.00758360655737705,Very Cheap
20150430T000000,219950.0,3,1.5,1210,5200,1.0,0,0,5,6,1210,0,1969,0,98042,47.3615,-122.087,1120,5200,3990,4080,42.29807692307692,0.01900983606557377,Very Cheap
20140528T000000,580000.0,5,2.0,1940,6000,1.0,0,0,5,7,970,970,1945,0,98115,47.6875,-122.287,1700,6000,4060,4300,96.66666666666667,0.06622950819672131,Very Cheap
20140722T000000,568000.0,3,1.75,1930,213008,1.0,0,2,3,7,1300,630,1980,0,98053,47.6751,-121.993,2860,208652,211078,205792,2.666566513933749,0.06465573770491803,Very Cheap
20150402T000000,406000.0,3,1.75,1270,6017,1.0,0,0,4,7,1030,240,1990,0,98028,47.737,-122.225,1630,7381,4747,5751,67.47548612265248,0.04340983606557377,Very Cheap
20140716T000000,469000.0,3,1.75,1680,2400,1.5,0,0,3,7,1170,510,1929,0,98117,47.6849,-122.367,1080,4560,720,3480,195.41666666666666,0.05167213114754098,Very Cheap
20140610T000000,415000.0,3,2.5,2090,6045,2.0,0,0,3,8,2090,0,2000,0,98056,47.4947,-122.174,2040,6392,3955,4352,68.65177832919768,0.04459016393442623,Very Cheap
20141208T000000,390000.0,3,1.5,1000,13991,1.0,0,0,4,7,1000,0,1956,0,98006,47.5643,-122.138,1520,11465,12991,9945,27.875062540204418,0.04131147540983607,Very Cheap
20150415T000000,251000.0,3,1.75,1350,10125,1.0,0,0,3,8,1350,0,1967,0,98003,47.3334,-122.298,1520,9720,8775,8200,24.790123456790123,0.023081967213114753,Very Cheap
20150312T000000,750000.0,3,2.5,3280,6750,2.0,0,1,3,9,2440,840,2001,0,98126,47.5219,-122.38,1770,6387,3470,4617,111.11111111111111,0.08852459016393442,Very Cheap
20150407T000000,845000.0,4,2.5,2390,5071,2.0,0,0,3,9,1760,630,1988,0,98122,47.6144,-122.283,1940,5071,2681,3131,166.63380003943996,0.10098360655737705,Cheap
20141010T000000,350000.0,3,1.5,1860,17640,1.0,0,0,4,7,1860,0,1966,0,98059,47.484,-122.111,1860,17820,15780,15960,19.841269841269842,0.036065573770491806,Very Cheap
20150225T000000,322000.0,3,1.0,1380,5864,1.0,0,0,3,7,790,590,1944,0,98133,47.7049,-122.339,1509,5864,4484,4355,54.91132332878581,0.03239344262295082,Very Cheap
20150507T000000,664500.0,4,2.25,3070,9210,2.0,0,0,3,8,2740,330,2010,0,98011,47.7638,-122.196,2580,9660,6140,7080,72.14983713355049,0.07731147540983607,Very Cheap
20150107T000000,988000.0,3,1.75,2190,3800,1.5,0,2,4,8,2190,0,1923,0,98109,47.643,-122.355,2190,3880,1610,1690,260.0,0.11973770491803279,Cheap
20140706T000000,625000.0,2,1.75,1990,4000,1.0,0,0,5,7,1090,900,1952,0,98103,47.6889,-122.342,1270,5700,2010,4430,156.25,0.07213114754098361,Very Cheap
20140506T000000,675000.0,2,1.0,930,36478,1.0,0,2,3,6,930,0,1951,0,98006,47.5699,-122.164,2800,11141,35548,8341,18.504303964033117,0.07868852459016394,Very Cheap
20150407T000000,503000.0,3,1.75,2070,9827,1.0,0,0,4,7,1420,650,1967,0,98027,47.522,-122.05,2150,9827,7757,7677,51.18550931108172,0.056131147540983604,Very Cheap
20140509T000000,431000.0,4,2.25,2170,10500,1.0,0,2,4,8,1270,900,1960,0,98166,47.4394,-122.338,2080,11019,8330,8939,41.04761904761905,0.046688524590163934,Very Cheap
20141126T000000,250000.0,3,1.75,1910,10230,1.0,0,0,4,7,1290,620,1964,0,98031,47.4185,-122.207,1590,10800,8320,9210,24.437927663734115,0.022950819672131147,Very Cheap
20140605T000000,268500.0,4,2.5,2100,4237,2.0,0,0,3,8,2100,0,2006,0,98031,47.3901,-122.174,2100,4575,2137,2475,63.37030918102431,0.02537704918032787,Very Cheap
20150326T000000,1070000.0,6,3.25,3560,21400,2.0,0,4,4,9,3560,0,1952,0,98177,47.7602,-122.372,3560,24338,17840,20778,50.0,0.13049180327868853,Cheap
20140529T000000,295000.0,4,2.5,2290,4539,2.0,0,0,3,7,2290,0,2001,0,98058,47.4753,-122.172,1710,7200,2249,5490,64.99228905045165,0.028852459016393443,Very Cheap
20140725T000000,780000.0,3,2.25,2130,11782,1.0,0,0,4,8,1590,540,1977,0,98040,47.5423,-122.215,2700,11782,9652,9082,66.20268205737565,0.09245901639344262,Very Cheap
20150428T000000,354000.0,3,2.5,2160,15817,2.0,0,0,3,8,2160,0,1999,0,98031,47.4166,-122.183,1990,15817,13657,13827,22.38098248719732,0.03659016393442623,Very Cheap
20140818T000000,305000.0,2,1.0,860,7250,1.0,0,0,3,6,860,0,1949,0,98133,47.7206,-122.35,1270,7250,6390,5980,42.06896551724138,0.03016393442622951,Very Cheap
20150401T000000,733000.0,5,2.75,2880,4425,2.0,0,0,3,8,2880,0,2005,0,98052,47.7048,-122.109,2940,6581,1545,3641,165.6497175141243,0.08629508196721311,Very Cheap
20140916T000000,640000.0,4,2.75,2100,11894,1.0,0,0,4,8,1720,380,1968,0,98004,47.6006,-122.194,2390,9450,9794,7060,53.80864301328401,0.0740983606557377,Very Cheap
20150417T000000,840000.0,4,2.5,2360,9600,1.0,0,2,3,8,1630,730,1973,0,98040,47.5889,-122.249,2140,6300,7240,4160,87.5,0.10032786885245902,Cheap
20141210T000000,1475000.0,5,3.25,3680,10300,1.5,0,0,4,10,3680,0,1927,0,98105,47.6548,-122.28,2690,7200,6620,4510,143.20388349514562,0.18360655737704917,Cheap
20150326T000000,525000.0,3,1.0,1560,8100,1.0,0,0,4,8,1140,420,1952,0,98177,47.7261,-122.364,2130,8100,6540,5970,64.81481481481481,0.05901639344262295,Very Cheap
20140514T000000,625000.0,4,2.75,1680,11180,1.0,0,0,4,7,1680,0,1966,0,98052,47.6557,-122.127,2400,9627,9500,7227,55.90339892665474,0.07213114754098361,Very Cheap
20140617T000000,350000.0,3,2.0,1380,3600,3.0,0,0,3,8,1380,0,2015,0,98122,47.6074,-122.305,1480,3600,2220,2120,97.22222222222223,0.036065573770491806,Very Cheap
20140616T000000,650000.0,4,2.75,2610,4160,3.0,0,0,5,8,1910,700,1910,0,98103,47.6901,-122.357,1470,4140,1550,2670,156.25,0.07540983606557378,Very Cheap
20141023T000000,435000.0,2,1.0,870,4000,1.0,0,2,3,7,870,0,1950,0,98126,47.5682,-122.374,1690,4000,3130,2310,108.75,0.04721311475409836,Very Cheap
20140626T000000,660000.0,3,1.0,1210,9622,1.0,0,1,3,8,1210,0,1955,2009,98006,47.5728,-122.179,1580,9714,8412,8134,68.59280814799418,0.07672131147540984,Very Cheap
20150302T000000,350000.0,3,1.0,1150,12877,1.0,0,0,4,6,1150,0,1970,0,98053,47.6614,-122.056,1490,12150,11727,10660,27.180243845616214,0.036065573770491806,Very Cheap
20150325T000000,435000.0,3,2.5,3110,6000,1.0,0,2,3,8,1560,1550,1967,0,98106,47.5331,-122.353,2060,6000,2890,3940,72.5,0.04721311475409836,Very Cheap
20140603T000000,375900.0,6,1.5,2550,33740,1.0,0,0,4,8,1750,800,1958,0,98023,47.3222,-122.362,2010,28200,31190,26190,11.141078838174273,0.03946229508196721,Very Cheap
20141124T000000,272000.0,3,3.0,2430,10500,1.0,0,0,4,8,2150,280,1983,0,98003,47.2579,-122.312,1670,9800,8070,8130,25.904761904761905,0.02583606557377049,Very Cheap
20150115T000000,233000.0,3,1.75,1460,7800,1.0,0,0,2,7,1040,420,1979,0,98023,47.3035,-122.382,1310,7865,6340,6555,29.871794871794872,0.020721311475409836,Very Cheap
20140916T000000,500000.0,4,1.5,1330,5750,1.5,0,2,3,7,1330,0,1915,0,98116,47.5681,-122.384,1360,5750,4420,4390,86.95652173913044,0.05573770491803279,Very Cheap
20150402T000000,540000.0,4,1.75,2040,9322,1.0,0,0,3,8,1440,600,1977,0,98155,47.7611,-122.298,1910,10026,7282,8116,57.927483372666806,0.06098360655737705,Very Cheap
20140701T000000,712000.0,3,2.5,2375,4094,2.0,0,0,3,9,2375,0,2002,0,98052,47.6627,-122.086,2095,4442,1719,2347,173.91304347826087,0.08354098360655737,Very Cheap
20140925T000000,425000.0,4,2.5,2480,4504,2.0,0,0,3,7,2480,0,2005,0,98059,47.4998,-122.15,2950,4504,2024,1554,94.36056838365897,0.04590163934426229,Very Cheap
20140805T000000,242000.0,3,1.75,1580,6099,1.0,0,0,5,7,790,790,1944,0,98168,47.4807,-122.29,1330,6099,4519,4769,39.6786358419413,0.021901639344262296,Very Cheap
20140703T000000,515000.0,5,3.25,2740,9629,1.0,0,0,5,7,1390,1350,1977,0,98011,47.7645,-122.197,2150,10500,6889,8350,53.48426627894901,0.057704918032786885,Very Cheap
20140708T000000,415000.0,4,1.75,1920,7700,2.0,0,0,4,7,1920,0,1970,0,98056,47.5381,-122.177,1310,7700,5780,6390,53.896103896103895,0.04459016393442623,Very Cheap
20141210T000000,375000.0,3,2.75,2200,9600,1.0,0,3,4,8,1570,630,1977,0,98003,47.3438,-122.323,2680,9896,7400,7216,39.0625,0.03934426229508197,Very Cheap
20141027T000000,182500.0,3,1.0,910,7194,1.0,0,0,4,7,910,0,1971,0,98001,47.3337,-122.275,1530,7200,6284,5670,25.36836252432583,0.014098360655737704,Very Cheap
20150323T000000,310000.0,3,1.5,1860,10379,1.0,0,0,3,7,1240,620,1963,0,98198,47.3962,-122.309,2240,11328,8519,9088,29.86800269775508,0.03081967213114754,Very Cheap
20141027T000000,360000.0,3,1.75,1510,6000,1.0,0,0,3,7,1060,450,1947,0,98136,47.5535,-122.39,1610,6000,4490,4390,60.0,0.037377049180327866,Very Cheap
20150408T000000,889000.0,4,3.5,3920,9555,2.0,0,0,3,9,3920,0,2004,0,98053,47.6797,-122.025,3920,8598,5635,4678,93.04029304029304,0.10675409836065573,Cheap
20150410T000000,450500.0,2,1.0,1330,3698,1.0,0,0,3,7,1330,0,1952,0,98117,47.6866,-122.372,1900,5000,2368,3100,121.82260681449432,0.04924590163934426,Very Cheap
20150422T000000,342000.0,4,2.25,1964,3541,2.0,0,0,3,9,1964,0,2013,0,98030,47.3594,-122.201,1757,3547,1577,1790,96.58288619034171,0.03501639344262295,Very Cheap
20140714T000000,413000.0,3,2.0,1520,3451,1.0,0,0,3,8,1520,0,1996,0,98177,47.7753,-122.375,1800,3451,1931,1651,119.67545638945234,0.04432786885245902,Very Cheap
20140527T000000,960000.0,5,4.0,3720,15200,2.0,0,0,3,10,3720,0,2005,0,98075,47.5956,-122.026,4100,19036,11480,14936,63.1578947368421,0.1160655737704918,Cheap
20140905T000000,180000.0,2,1.0,770,9370,1.0,0,0,3,7,770,0,1947,0,98155,47.762,-122.321,1060,9352,8600,8292,19.2102454642476,0.01377049180327869,Very Cheap
20140618T000000,770000.0,4,2.5,3210,14910,2.0,0,0,3,10,3210,0,1995,0,98074,47.6073,-122.062,3280,14910,11700,11630,51.64319248826291,0.09114754098360656,Very Cheap
20140813T000000,224400.0,3,1.75,1070,7200,1.0,0,0,3,7,1070,0,1994,0,98010,47.3129,-122.023,1280,7200,6130,5920,31.166666666666668,0.01959344262295082,Very Cheap
20150430T000000,280000.0,3,1.5,1430,8861,1.0,0,0,3,7,1430,0,1956,0,98188,47.4454,-122.289,1080,9425,7431,8345,31.59914230899447,0.026885245901639345,Very Cheap
20150319T000000,500000.0,3,2.5,1670,2575,2.0,0,0,3,8,1670,0,2000,0,98027,47.531,-122.047,1670,2897,905,1227,194.1747572815534,0.05573770491803279,Very Cheap
20150203T000000,153000.0,2,1.0,710,9000,1.0,0,0,5,6,710,0,1943,0,98166,47.4811,-122.339,1230,9000,8290,7770,17.0,0.010229508196721311,Very Cheap
20140613T000000,385000.0,3,2.25,1920,4833,1.0,0,0,4,7,1060,860,1921,0,98133,47.7067,-122.352,1580,5134,2913,3554,79.66066625284502,0.04065573770491803,Very Cheap
20140819T000000,325000.0,2,1.0,750,5534,1.0,0,0,3,7,750,0,1947,0,98177,47.7017,-122.36,1050,5534,4784,4484,58.7278641127575,0.03278688524590164,Very Cheap
20150409T000000,315000.0,4,3.0,2210,4191,2.0,0,0,3,7,2210,0,2004,0,98002,47.2959,-122.225,890,4288,1981,3398,75.16105941302791,0.031475409836065574,Very Cheap
20140617T000000,294999.0,4,2.5,1660,9760,2.0,0,0,3,7,1660,0,1994,0,98030,47.3635,-122.188,1580,9614,8100,8034,30.22530737704918,0.02885232786885246,Very Cheap
20141027T000000,175000.0,3,1.75,1910,17003,1.5,0,0,4,8,1910,0,1963,0,98001,47.3095,-122.283,1820,14806,15093,12986,10.29230135858378,0.013114754098360656,Very Cheap
20150406T000000,299000.0,3,1.75,1910,17003,1.5,0,0,4,8,1910,0,1963,0,98001,47.3095,-122.283,1820,14806,15093,12986,17.58513203552314,0.02937704918032787,Very Cheap
20150209T000000,146000.0,2,1.0,780,9750,1.0,0,0,3,6,780,0,1937,0,98168,47.4816,-122.322,1670,9750,8970,8080,14.974358974358974,0.009311475409836066,Very Cheap
20141105T000000,290000.0,3,2.25,1650,10336,1.0,0,0,3,7,1500,150,1962,0,98133,47.7757,-122.35,1420,10260,8686,8840,28.057275541795665,0.02819672131147541,Very Cheap
20140808T000000,1776000.0,3,3.25,3230,7800,2.0,0,3,3,10,3230,0,2005,0,98199,47.6348,-122.403,3030,6600,4570,3570,227.69230769230768,0.22308196721311477,Cheap
20140529T000000,367500.0,2,1.0,810,4800,1.0,0,0,3,6,810,0,1919,0,98118,47.5614,-122.27,1040,4800,3990,3760,76.5625,0.03836065573770492,Very Cheap
20150327T000000,535000.0,4,2.5,2750,15099,2.0,0,0,3,8,2750,0,1994,0,98019,47.7298,-121.972,2500,14564,12349,12064,35.43281011987549,0.06032786885245902,Very Cheap
20140805T000000,334999.0,3,2.5,1650,13816,2.0,0,0,3,7,1650,0,1998,0,98014,47.6553,-121.913,1630,18750,12166,17120,24.247177185871454,0.03409822950819672,Very Cheap
20140821T000000,655000.0,3,1.75,1960,5520,1.0,0,0,4,7,1080,880,1952,0,98199,47.6535,-122.397,1720,5760,3560,4040,118.65942028985508,0.0760655737704918,Very Cheap
20140603T000000,1298000.0,4,3.5,2790,10125,1.5,0,0,5,8,2790,0,1985,0,98040,47.5651,-122.22,2570,10125,7335,7555,128.19753086419752,0.16039344262295083,Cheap
20150321T000000,480000.0,4,2.25,2230,11200,1.0,0,0,4,7,1300,930,1977,0,98011,47.7691,-122.167,2090,10563,8970,8473,42.857142857142854,0.05311475409836065,Very Cheap
20150421T000000,465000.0,3,1.5,1280,4720,1.0,0,0,4,7,850,430,1941,0,98126,47.5509,-122.377,1280,4720,3440,3440,98.51694915254237,0.051147540983606556,Very Cheap
20140508T000000,297950.0,3,2.0,1240,10800,1.0,0,0,3,7,1240,0,1967,2010,98058,47.449,-122.155,1480,8840,9560,7360,27.587962962962962,0.029239344262295082,Very Cheap
20150415T000000,590000.0,3,2.0,1860,3600,1.5,0,0,3,7,1110,750,1915,0,98122,47.6102,-122.296,1680,3695,1740,2015,163.88888888888889,0.06754098360655737,Very Cheap
20140522T000000,805000.0,4,2.75,2410,6000,1.0,0,0,5,8,1410,1000,1950,0,98107,47.6707,-122.399,1760,6000,3590,4240,134.16666666666666,0.09573770491803278,Very Cheap
20150120T000000,204250.0,3,2.25,1960,7708,1.0,0,0,4,7,1490,470,1984,0,98023,47.2981,-122.374,1580,8063,5748,6483,26.49844317592112,0.016950819672131148,Very Cheap
20140716T000000,500000.0,3,2.25,1710,4561,2.0,0,0,4,8,1710,0,1994,0,98029,47.5691,-122.004,1810,4770,2851,2960,109.62508221881167,0.05573770491803279,Very Cheap
20140917T000000,490000.0,4,2.5,3480,12696,1.0,0,0,4,9,1980,1500,1977,0,98042,47.3816,-122.153,3480,14175,9216,10695,38.59483301827347,0.05442622950819672,Very Cheap
20150324T000000,2500000.0,4,3.75,3480,14850,1.0,0,4,3,9,1870,1610,1951,2013,98004,47.6227,-122.216,4780,18480,11370,13700,168.35016835016836,0.3180327868852459,Medium
20140729T000000,750000.0,3,2.5,2960,69351,2.0,1,3,4,9,2960,0,1990,0,98070,47.4,-122.42,2350,41433,66391,39083,10.814552061253623,0.08852459016393442,Very Cheap
20150409T000000,405000.0,4,2.5,2670,20894,2.0,0,0,3,9,2330,340,2002,0,98155,47.7735,-122.281,2440,15815,18224,13375,19.383555087584952,0.043278688524590166,Very Cheap
20140721T000000,209995.0,2,1.0,700,7303,1.0,0,0,5,5,700,0,1953,0,98056,47.4934,-122.166,960,6060,6603,5100,28.754621388470493,0.017704262295081968,Very Cheap
20141016T000000,680000.0,4,2.5,2830,8399,2.0,0,0,3,9,2830,0,1998,0,98075,47.5851,-122.034,2520,6890,5569,4370,80.96201928801048,0.07934426229508197,Very Cheap
20141002T000000,355000.0,3,1.75,1120,7740,1.0,0,0,4,6,860,260,1948,0,98125,47.7107,-122.291,1240,7740,6620,6500,45.8656330749354,0.036721311475409836,Very Cheap
20150422T000000,280000.0,2,1.0,1310,6600,1.0,0,0,3,6,1310,0,1942,0,98168,47.4834,-122.332,1240,6600,5290,5360,42.42424242424242,0.026885245901639345,Very Cheap
20140605T000000,385000.0,3,2.25,1710,11500,1.0,0,0,3,7,1210,500,1978,0,98028,47.7675,-122.267,1800,11500,9790,9700,33.47826086956522,0.04065573770491803,Very Cheap
20140701T000000,505000.0,4,2.75,2200,9778,1.0,0,0,4,8,1100,1100,1962,0,98006,47.5472,-122.176,2140,11321,7578,9181,51.64655348742074,0.05639344262295082,Very Cheap
20140822T000000,429900.0,4,3.25,3310,8897,2.0,0,0,3,9,2380,930,1991,0,98003,47.2655,-122.31,2490,8638,5587,6148,48.31965831179049,0.04654426229508197,Very Cheap
20140721T000000,560000.0,4,2.5,2280,9874,2.0,0,0,3,9,2280,0,1989,0,98034,47.7099,-122.229,2670,9782,7594,7112,56.71460401053271,0.06360655737704918,Very Cheap
20140929T000000,231000.0,3,2.0,1640,4875,1.0,0,0,4,7,1040,600,1977,0,98042,47.3661,-122.094,1640,5200,3235,3560,47.38461538461539,0.020459016393442622,Very Cheap
20150427T000000,135000.0,2,1.0,750,5217,1.0,0,0,4,6,750,0,1943,0,98106,47.5188,-122.353,760,4440,4467,3680,25.87694077055779,0.007868852459016393,Very Cheap
20140623T000000,800000.0,4,3.0,3520,4895,1.0,0,0,3,8,1980,1540,1954,0,98107,47.6678,-122.361,1570,2153,1375,583,163.4320735444331,0.09508196721311475,Very Cheap
20141220T000000,420000.0,3,2.5,2720,8622,2.0,0,0,3,8,2720,0,2002,0,98059,47.4954,-122.163,1950,8603,5902,6653,48.71259568545581,0.04524590163934426,Very Cheap
20141022T000000,360000.0,3,1.0,1660,9600,1.0,0,0,3,7,1660,0,1963,0,98034,47.708,-122.216,2020,9600,7940,7580,37.5,0.037377049180327866,Very Cheap
20140530T000000,642000.0,4,2.5,2560,8780,2.0,0,0,3,9,2560,0,1992,0,98029,47.5717,-121.991,2780,8357,6220,5577,73.12072892938497,0.07436065573770492,Very Cheap
20150406T000000,379950.0,3,2.0,1080,5077,1.0,0,0,3,7,1080,0,1985,0,98052,47.6836,-122.095,1070,3471,3997,2401,74.8375024620839,0.03999344262295082,Very Cheap
20140711T000000,745000.0,3,1.75,2050,11041,1.5,0,0,5,9,2050,0,1959,0,98005,47.5968,-122.174,2530,11041,8991,8511,67.47577212209039,0.08786885245901639,Very Cheap
20140729T000000,630000.0,4,2.0,2670,3240,1.5,0,0,4,9,1780,890,1930,0,98144,47.5841,-122.294,1820,4000,570,2180,194.44444444444446,0.07278688524590164,Very Cheap
20150505T000000,250000.0,3,2.5,1730,7200,2.0,0,0,4,7,1730,0,1985,0,98031,47.4029,-122.196,1770,7396,5470,5626,34.72222222222222,0.022950819672131147,Very Cheap
20140624T000000,275000.0,3,1.0,990,9798,1.0,0,0,3,7,990,0,1968,0,98072,47.767,-122.164,1210,9870,8808,8660,28.066952439273322,0.02622950819672131,Very Cheap
20150501T000000,435000.0,6,3.0,3560,4290,1.0,0,0,4,7,1780,1780,1957,0,98118,47.5282,-122.269,3040,6000,730,2960,101.3986013986014,0.04721311475409836,Very Cheap
20150305T000000,175000.0,2,1.0,700,8174,1.0,0,0,3,5,700,0,1941,0,98146,47.5136,-122.349,1250,8046,7474,6796,21.409346709077564,0.013114754098360656,Very Cheap
20140612T000000,560000.0,4,1.75,1880,3880,1.5,0,0,4,7,1090,790,1944,0,98107,47.6635,-122.362,1390,3880,2000,2490,144.3298969072165,0.06360655737704918,Very Cheap
20140520T000000,325000.0,4,2.25,1870,9680,1.0,0,0,4,7,1170,700,1959,0,98034,47.7157,-122.234,2000,9790,7810,7790,33.574380165289256,0.03278688524590164,Very Cheap
20140617T000000,1185000.0,3,2.75,2500,5568,2.0,0,0,5,9,2500,0,1905,0,98112,47.6258,-122.312,2810,5568,3068,2758,212.82327586206895,0.14557377049180328,Cheap
20140627T000000,399950.0,3,2.5,2570,10431,2.0,0,0,3,9,2570,0,1989,0,98031,47.4188,-122.213,2590,10078,7861,7488,38.342440801457194,0.04261639344262295,Very Cheap
20140617T000000,752000.0,4,2.5,2940,10382,2.0,0,0,4,9,2940,0,1991,0,98059,47.5333,-122.151,2980,10547,7442,7567,72.43305721440956,0.08878688524590164,Very Cheap
20150423T000000,1200000.0,4,3.5,3930,43560,2.0,0,0,3,10,3930,0,2003,0,98072,47.7497,-122.121,2860,36460,39630,33600,27.548209366391184,0.14754098360655737,Cheap
20140925T000000,400000.0,4,1.5,2150,11026,1.0,0,0,4,7,2150,0,1952,0,98028,47.7635,-122.263,1760,10283,8876,8523,36.27788862688192,0.04262295081967213,Very Cheap
20140530T000000,240000.0,3,2.0,1330,6000,1.0,0,0,4,7,630,700,1900,0,98108,47.5255,-122.327,1140,6000,4670,4860,40.0,0.021639344262295083,Very Cheap
20141111T000000,640000.0,5,2.5,3220,4759,2.0,0,0,3,8,3220,0,2003,0,98075,47.5957,-122.032,2550,4759,1539,2209,134.48203404076486,0.0740983606557377,Very Cheap
20150402T000000,564450.0,3,2.5,2710,6174,2.0,0,0,3,9,2710,0,1998,0,98056,47.512,-122.174,2730,7266,3464,4536,91.42371234207968,0.06419016393442623,Very Cheap
20150506T000000,300000.0,3,1.5,1630,82764,1.0,0,0,4,6,1630,0,1948,0,98027,47.4743,-122.026,1680,199069,81134,197389,3.6247643903146294,0.029508196721311476,Very Cheap
20150317T000000,286000.0,3,2.5,1680,4226,2.0,0,0,3,8,1680,0,2003,0,98042,47.3684,-122.123,1800,5559,2546,3759,67.67628963558921,0.027672131147540982,Very Cheap
20150219T000000,531800.0,3,2.5,1930,5344,2.0,0,0,3,7,1930,0,2004,0,98053,47.6783,-122.032,2410,5080,3414,2670,99.51347305389221,0.05990819672131147,Very Cheap
20141024T000000,502000.0,4,2.25,2140,10943,1.0,0,0,3,7,1550,590,1977,0,98034,47.7271,-122.215,2350,9000,8803,6650,45.874074750982366,0.056,Very Cheap
20140821T000000,993500.0,4,2.25,4070,23321,2.0,0,0,4,10,4070,0,1968,0,98040,47.5563,-122.219,2820,10871,19251,8051,42.60108914712062,0.12045901639344263,Cheap
20141020T000000,450000.0,3,1.0,1350,10000,1.0,0,0,4,7,1350,0,1954,0,98006,47.5741,-122.133,1450,10000,8650,8550,45.0,0.04918032786885246,Very Cheap
20141027T000000,997950.0,4,3.5,4270,117176,2.0,0,0,3,9,4270,0,2008,0,98024,47.5352,-121.883,2610,5251,112906,2641,8.516675769782207,0.12104262295081968,Cheap
20141013T000000,526000.0,3,1.0,1320,5250,1.5,0,0,5,7,1320,0,1913,0,98126,47.5566,-122.378,1490,5250,3930,3760,100.19047619047619,0.059147540983606556,Very Cheap
20150114T000000,335000.0,3,1.75,2100,8298,1.0,0,0,4,7,1230,870,1952,0,98166,47.4601,-122.36,1700,10830,6198,9130,40.37117377681369,0.03409836065573771,Very Cheap
20141203T000000,187250.0,2,1.0,710,14700,1.0,0,0,5,6,710,0,1926,0,98168,47.4939,-122.318,1320,14700,13990,13380,12.738095238095237,0.014721311475409836,Very Cheap
20140811T000000,735000.0,3,2.25,2350,6000,1.0,0,0,5,7,1020,1330,1948,0,98115,47.6809,-122.305,1570,5000,3650,3430,122.5,0.08655737704918033,Very Cheap
20150218T000000,425000.0,3,1.0,1180,8400,1.0,0,0,3,7,1180,0,1951,0,98125,47.7028,-122.295,1740,7020,7220,5280,50.595238095238095,0.04590163934426229,Very Cheap
20140512T000000,110000.0,3,1.0,1250,53143,1.0,0,0,5,6,1250,0,1945,0,98038,47.4235,-122.051,1820,217800,51893,215980,2.0698869089061587,0.0045901639344262295,Very Cheap
20140821T000000,305000.0,3,2.0,1490,7697,1.0,0,0,3,7,1490,0,1994,0,98059,47.4852,-122.164,1540,7529,6207,5989,39.62582824477069,0.03016393442622951,Very Cheap
20150414T000000,212000.0,3,1.0,1000,9450,1.0,0,0,3,6,1000,0,1962,0,98055,47.4562,-122.193,1300,13500,8450,12200,22.433862433862434,0.017967213114754098,Very Cheap
20150512T000000,1380000.0,5,4.25,4050,18827,1.0,0,2,4,10,2150,1900,1979,0,98040,47.5323,-122.237,3600,25120,14777,21520,73.29898549954852,0.17114754098360654,Cheap
20140918T000000,298950.0,5,2.25,2300,11505,1.0,0,0,3,8,1300,1000,1963,0,98030,47.3812,-122.223,2350,11505,9205,9155,25.984354628422427,0.02937049180327869,Very Cheap
20150316T000000,525000.0,3,1.75,1330,8136,1.0,0,0,4,7,1330,0,1977,0,98033,47.7001,-122.173,1330,8136,6806,6806,64.52802359882006,0.05901639344262295,Very Cheap
20140514T000000,707000.0,4,3.25,3200,7081,2.0,0,0,3,9,3200,0,2004,0,98075,47.5886,-121.989,3120,6094,3881,2974,99.84465470978675,0.08288524590163934,Very Cheap
20140626T000000,695000.0,3,2.75,2590,12063,2.0,0,0,3,10,2590,0,1993,0,98006,47.5527,-122.12,2850,8469,9473,5619,57.61419215783802,0.08131147540983606,Very Cheap
20141201T000000,796500.0,3,2.75,2590,12063,2.0,0,0,3,10,2590,0,1993,0,98006,47.5527,-122.12,2850,8469,9473,5619,66.02835115642876,0.09462295081967213,Very Cheap
20140723T000000,420000.0,4,2.5,2030,8100,1.0,0,0,3,7,1150,880,1973,0,98034,47.7404,-122.186,1770,8071,6070,6301,51.851851851851855,0.04524590163934426,Very Cheap
20140625T000000,625000.0,5,2.5,2700,21208,1.0,0,0,4,8,1950,750,1955,0,98005,47.6078,-122.154,2550,20409,18508,17859,29.470011316484346,0.07213114754098361,Very Cheap
20140823T000000,620000.0,3,1.75,1670,9900,1.0,0,0,4,8,1670,0,1957,0,98005,47.595,-122.172,2410,8800,8230,6390,62.62626262626262,0.07147540983606557,Very Cheap
20141031T000000,1450000.0,5,2.75,3090,19865,1.0,0,0,4,9,3090,0,1953,0,98039,47.6232,-122.235,2970,19862,16775,16892,72.99270072992701,0.18032786885245902,Cheap
20150409T000000,549950.0,5,2.5,2650,54380,2.0,0,0,3,9,2650,0,1984,0,98077,47.7726,-122.081,2560,49044,51730,46484,10.113093048915042,0.062288524590163936,Very Cheap
20150227T000000,275000.0,4,2.0,1440,10920,1.0,0,0,3,5,1440,0,1943,0,98056,47.5049,-122.18,1500,11902,9480,10402,25.183150183150182,0.02622950819672131,Very Cheap
20140924T000000,705000.0,3,2.5,2820,7200,1.0,0,3,3,9,1780,1040,1979,0,98177,47.7691,-122.388,2300,7200,4380,4900,97.91666666666667,0.08262295081967214,Very Cheap
20140506T000000,197000.0,3,1.75,1690,7735,1.0,0,0,4,7,1060,630,1976,0,98001,47.3324,-122.28,1580,7503,6045,5923,25.46864899806076,0.016,Very Cheap
20150505T000000,265000.0,3,1.75,1420,8126,1.0,0,0,3,8,1420,0,1991,0,98031,47.3871,-122.189,1730,7954,6706,6224,32.611370908195916,0.024918032786885248,Very Cheap
20141120T000000,297000.0,4,1.75,1790,5341,1.0,0,0,4,7,1050,740,1951,0,98166,47.4663,-122.363,1540,6916,3551,5376,55.60756412656806,0.029114754098360656,Very Cheap
20140819T000000,207500.0,3,1.75,1320,12528,1.0,0,0,4,7,1320,0,1970,0,98042,47.3234,-122.142,1340,11039,11208,9699,16.562899106002554,0.01737704918032787,Very Cheap
20140819T000000,410000.0,3,2.5,1509,1418,3.0,0,0,3,8,1509,0,2014,0,98133,47.7047,-122.34,1509,1991,-91,482,289.13963328631877,0.043934426229508196,Very Cheap
20141003T000000,268000.0,3,2.0,1610,8416,1.0,0,0,3,7,1610,0,1994,0,98031,47.397,-122.187,1600,8308,6806,6708,31.844106463878326,0.025311475409836064,Very Cheap
20140805T000000,330000.0,4,1.75,1550,50094,1.0,0,3,4,6,1550,0,1967,0,98022,47.2194,-122.059,1720,50094,48544,48374,6.587615283267457,0.03344262295081967,Very Cheap
20140818T000000,417500.0,3,1.0,1160,7491,1.0,0,0,4,6,1160,0,1917,0,98177,47.7024,-122.359,1800,2267,6331,467,55.733546922974234,0.04491803278688525,Very Cheap
20140804T000000,760000.0,4,2.25,2500,8500,2.0,0,0,4,8,2500,0,1979,0,98006,47.5569,-122.151,2470,9100,6000,6630,89.41176470588235,0.0898360655737705,Very Cheap
20140705T000000,499000.0,3,2.5,1540,1326,3.0,0,0,3,8,1390,150,1995,0,98119,47.6457,-122.374,1680,1592,-214,-88,376.31975867269983,0.05560655737704918,Very Cheap
20140618T000000,620000.0,4,2.5,1910,7683,2.0,0,0,3,8,1910,0,1987,0,98027,47.5644,-122.092,1980,8485,5773,6505,80.6976441494208,0.07147540983606557,Very Cheap
20140710T000000,315000.0,3,2.5,2340,6837,2.0,0,0,3,7,2340,0,1992,0,98030,47.3608,-122.194,1850,6209,4497,4359,46.07283896445809,0.031475409836065574,Very Cheap
20150409T000000,624950.0,3,2.5,2060,4730,2.0,0,0,4,8,2060,0,1994,0,98033,47.6874,-122.178,1980,5010,2670,3030,132.12473572938688,0.07212459016393442,Very Cheap
20150428T000000,525000.0,3,2.25,1960,12350,1.0,0,0,4,7,1960,0,1961,0,98027,47.5247,-122.052,1920,13608,10390,11688,42.51012145748988,0.05901639344262295,Very Cheap
20140808T000000,300000.0,2,1.5,1150,3927,2.0,0,0,3,7,1150,0,1982,0,98034,47.7248,-122.162,1400,3425,2777,2025,76.39419404125286,0.029508196721311476,Very Cheap
20150310T000000,299900.0,4,2.75,2330,7200,1.0,0,0,4,8,1560,770,1977,0,98023,47.3203,-122.385,2350,7600,4870,5250,41.65277777777778,0.029495081967213115,Very Cheap
20140612T000000,299000.0,3,2.5,2210,10119,1.0,0,0,4,7,1450,760,1966,0,98030,47.3783,-122.22,2110,10119,7909,8009,29.548374345291037,0.02937704918032787,Very Cheap
20140514T000000,1880000.0,4,2.75,3260,19542,1.0,0,0,4,10,2170,1090,1968,0,98039,47.6245,-122.236,3480,19863,16282,16383,96.20304984136732,0.23672131147540984,Cheap
20140613T000000,265000.0,4,1.75,1900,10588,1.0,0,0,5,6,1900,0,1958,0,98002,47.289,-122.212,1530,10587,8688,9057,25.028333962976955,0.024918032786885248,Very Cheap
20140609T000000,280000.0,2,1.75,1610,158558,1.5,0,0,2,6,1610,0,1948,0,98065,47.5319,-121.84,1800,3572,156948,1772,1.765915311747121,0.026885245901639345,Very Cheap
20140528T000000,124740.0,3,1.0,1340,15600,1.0,0,0,4,6,1340,0,1978,0,98042,47.3224,-122.143,1320,9800,14260,8480,7.996153846153846,0.00652327868852459,Very Cheap
20150106T000000,1085000.0,3,2.75,3170,34850,1.0,0,0,5,9,3170,0,1957,0,98033,47.6611,-122.169,3920,36740,31680,32820,31.133428981348636,0.13245901639344262,Cheap
20140528T000000,1970000.0,8,3.5,4440,6480,2.0,0,3,5,10,3140,1300,1959,0,98112,47.631,-122.303,4440,8640,2040,4200,304.01234567901236,0.24852459016393444,Cheap
20150215T000000,219000.0,4,1.0,1370,5339,1.5,0,0,4,6,1370,0,1948,0,98168,47.5046,-122.3,1280,7048,3969,5768,41.01891740026222,0.018885245901639345,Very Cheap
20150416T000000,569950.0,5,1.0,1420,6250,1.5,0,0,4,8,1420,0,1926,0,98116,47.5807,-122.389,1420,6250,4830,4830,91.192,0.06491147540983606,Very Cheap
20140609T000000,212500.0,2,2.0,1030,21712,1.0,0,0,4,6,1030,0,1938,0,98168,47.4905,-122.331,1790,9199,20682,7409,9.787214443625645,0.018032786885245903,Very Cheap
20140811T000000,680000.0,3,2.25,1820,8316,1.0,0,0,5,7,1320,500,1960,0,98005,47.5849,-122.169,1780,8400,6496,6620,81.77008177008177,0.07934426229508197,Very Cheap
20140929T000000,1457000.0,4,1.5,2650,6900,2.0,0,0,4,9,2400,250,1909,0,98112,47.6275,-122.305,2420,6900,4250,4480,211.15942028985506,0.18124590163934426,Cheap
20140618T000000,300000.0,3,1.0,910,7700,1.0,0,0,4,7,910,0,1971,0,98034,47.7303,-122.238,1250,7700,6790,6450,38.96103896103896,0.029508196721311476,Very Cheap
20150310T000000,629950.0,3,2.5,1680,1683,2.0,0,0,3,9,1120,560,2014,0,98119,47.6424,-122.374,1610,1249,3,-361,374.30184194890074,0.07278032786885245,Very Cheap
20141202T000000,349900.0,2,1.75,1550,9230,1.0,0,0,3,6,970,580,1969,0,98045,47.4701,-121.744,1550,10856,7680,9306,37.90899241603467,0.036052459016393444,Very Cheap
20140812T000000,690000.0,4,2.5,2780,6235,2.0,0,0,3,8,2780,0,2001,0,98075,47.5976,-122.039,2670,4410,3455,1740,110.66559743384121,0.08065573770491803,Very Cheap
20150225T000000,1454000.0,5,4.0,4070,11334,2.0,0,0,3,10,4070,0,2014,0,98033,47.6771,-122.187,2640,9401,7264,6761,128.28657137815424,0.18085245901639344,Cheap
20150121T000000,1288000.0,3,2.5,3240,12625,2.0,0,0,3,11,3240,0,1987,0,98040,47.5327,-122.232,3470,12331,9385,8861,102.01980198019803,0.15908196721311477,Cheap
20140709T000000,696000.0,4,3.5,3650,38546,2.0,0,0,3,9,2550,1100,1996,0,98045,47.4776,-121.73,2860,34284,34896,31424,18.056348259222748,0.08144262295081967,Very Cheap
20150330T000000,650000.0,3,2.25,2180,60112,2.0,0,0,3,8,2180,0,1976,0,98053,47.6723,-122.082,2060,120225,57932,118165,10.813148788927336,0.07540983606557378,Very Cheap
20140812T000000,640000.0,3,3.5,2480,10800,2.0,0,0,3,8,2480,0,1998,0,98074,47.6083,-122.06,2380,11310,8320,8930,59.25925925925926,0.0740983606557377,Very Cheap
20140808T000000,499950.0,5,2.5,3180,23809,1.0,0,0,3,9,3180,0,1978,0,98038,47.3727,-122.054,2500,15778,20629,13278,20.99836196396321,0.05573114754098361,Very Cheap
20141223T000000,490000.0,4,2.5,3630,8387,2.0,0,0,3,10,3630,0,1997,0,98042,47.3623,-122.127,3370,8869,4757,5499,58.42375104328127,0.05442622950819672,Very Cheap
20141010T000000,685000.0,5,2.5,3160,5635,2.0,0,0,3,9,3160,0,2003,0,98027,47.5362,-122.067,3670,6087,2475,2417,121.56166814551908,0.08,Very Cheap
20150403T000000,387500.0,4,1.0,1370,7140,2.0,0,0,3,6,1370,0,1942,0,98146,47.512,-122.376,1090,6300,5770,5210,54.27170868347339,0.040983606557377046,Very Cheap
20150421T000000,401750.0,2,1.5,1070,1236,2.0,0,0,3,8,1000,70,2005,0,98116,47.5619,-122.382,1170,1888,166,718,325.0404530744337,0.042852459016393445,Very Cheap
20140826T000000,254950.0,4,2.0,2180,8800,1.0,0,0,5,7,1170,1010,1977,0,98038,47.3676,-122.046,1630,8800,6620,7170,28.97159090909091,0.0236,Very Cheap
20150320T000000,500000.0,4,2.25,2420,36680,2.0,0,0,4,8,2420,0,1977,0,98027,47.4663,-122.006,2410,36680,34260,34270,13.631406761177754,0.05573770491803279,Very Cheap
20140715T000000,856500.0,4,2.5,3290,8147,2.0,0,0,3,10,3290,0,2003,0,98052,47.7048,-122.107,3290,7467,4857,4177,105.13072296550878,0.10249180327868852,Cheap
20140523T000000,552000.0,3,1.0,1430,5000,1.0,0,0,4,6,1080,350,1919,0,98115,47.6724,-122.296,1630,4600,3570,2970,110.4,0.06255737704918032,Very Cheap
20140910T000000,506500.0,4,2.5,1890,7200,1.0,0,0,4,7,1500,390,1978,0,98034,47.7278,-122.218,2070,7200,5310,5130,70.34722222222223,0.05659016393442623,Very Cheap
20140527T000000,500000.0,3,2.25,1760,4539,2.0,0,0,3,8,1760,0,1988,0,98029,47.5754,-122.013,1960,4808,2779,2848,110.15642211940956,0.05573770491803279,Very Cheap
20140729T000000,280000.0,4,2.75,2230,10160,1.0,0,0,3,7,1400,830,1968,0,98168,47.5123,-122.32,1740,10080,7930,8340,27.559055118110237,0.026885245901639345,Very Cheap
20150306T000000,308000.0,3,1.75,1630,11475,1.0,0,0,4,7,1330,300,1979,0,98045,47.4635,-121.746,1630,11475,9845,9845,26.84095860566449,0.030557377049180327,Very Cheap
20150205T000000,613500.0,3,2.5,2350,7035,2.0,0,0,3,8,2350,0,1989,0,98029,47.5713,-122.02,2270,7192,4685,4922,87.20682302771856,0.07062295081967213,Very Cheap
20140708T000000,255000.0,3,1.75,1550,9720,1.0,0,0,3,7,1050,500,1976,0,98010,47.3433,-122.037,1550,9750,8170,8200,26.234567901234566,0.02360655737704918,Very Cheap
20141028T000000,545000.0,3,2.5,3550,136343,2.0,0,0,3,10,3550,0,1977,0,98014,47.6223,-121.869,3080,215186,132793,212106,3.9972715871001814,0.06163934426229508,Very Cheap
20140923T000000,620000.0,4,2.5,2720,34498,1.0,0,0,5,7,1360,1360,1966,0,98075,47.5832,-122.02,1920,22474,31778,20554,17.972056351092817,0.07147540983606557,Very Cheap
20141025T000000,450000.0,3,1.75,1740,6800,1.5,0,0,4,7,1740,0,1949,0,98126,47.5314,-122.373,990,6800,5060,5810,66.17647058823529,0.04918032786885246,Very Cheap
20150508T000000,279000.0,4,1.75,1840,7275,1.0,0,0,3,7,1090,750,1976,0,98031,47.4002,-122.189,1840,7275,5435,5435,38.350515463917525,0.02675409836065574,Very Cheap
20150123T000000,625000.0,3,2.5,2010,3200,2.0,0,0,3,9,2010,0,2009,0,98027,47.5463,-122.015,2250,3200,1190,950,195.3125,0.07213114754098361,Very Cheap
20140527T000000,274950.0,3,1.75,1670,7415,1.0,0,0,3,7,1320,350,1987,0,98042,47.3776,-122.116,1650,8585,5745,6935,37.08024275118004,0.02622295081967213,Very Cheap
20141023T000000,423000.0,3,1.75,1820,6038,1.0,0,0,4,7,1040,780,1952,0,98126,47.5233,-122.378,1700,6040,4218,4340,70.0563100364359,0.04563934426229508,Very Cheap
20150226T000000,350000.0,2,1.0,720,5820,1.0,0,1,5,6,720,0,1950,0,98028,47.7598,-122.255,952,5820,5100,4868,60.13745704467354,0.036065573770491806,Very Cheap
20150330T000000,305000.0,4,1.75,2370,10140,1.0,0,0,3,7,1460,910,1968,0,98001,47.3352,-122.278,1450,7800,7770,6350,30.078895463510847,0.03016393442622951,Very Cheap
20141117T000000,368000.0,3,1.75,2120,11340,1.0,0,3,4,7,1060,1060,1966,0,98198,47.4109,-122.329,1830,8650,9220,6820,32.451499118165785,0.03842622950819672,Very Cheap
20140926T000000,232000.0,3,1.75,1290,6604,1.0,0,0,3,7,1290,0,1984,0,98023,47.323,-122.349,1440,6682,5314,5242,35.13022410660206,0.02059016393442623,Very Cheap
20141126T000000,250000.0,4,3.0,1800,2500,2.0,0,0,3,7,1800,0,2000,0,98108,47.5333,-122.294,1830,6900,700,5070,100.0,0.022950819672131147,Very Cheap
20150211T000000,220000.0,3,1.75,1230,8917,1.0,0,0,4,7,1230,0,1966,0,98058,47.4528,-122.172,1420,7938,7687,6518,24.67197487944376,0.01901639344262295,Very Cheap
20140813T000000,435000.0,3,2.0,1380,2500,1.0,0,0,3,7,750,630,1986,0,98107,47.6753,-122.363,1630,3800,1120,2170,174.0,0.04721311475409836,Very Cheap
20140624T000000,350000.0,2,1.0,740,7680,1.0,0,0,4,6,740,0,1922,0,98126,47.5245,-122.371,1080,7680,6940,6600,45.572916666666664,0.036065573770491806,Very Cheap
20140813T000000,206325.0,5,2.5,1720,10202,1.5,0,0,3,7,1720,0,1970,0,98058,47.4572,-122.167,1720,8478,8482,6758,20.223975691040973,0.01722295081967213,Very Cheap
20150227T000000,339000.0,5,2.5,1720,10202,1.5,0,0,3,7,1720,0,1970,0,98058,47.4572,-122.167,1720,8478,8482,6758,33.228778670848854,0.03462295081967213,Very Cheap
20150318T000000,399000.0,4,2.5,2100,7355,1.0,0,0,5,7,2100,0,1969,0,98059,47.5078,-122.161,1750,7200,5255,5450,54.24881033310673,0.042491803278688525,Very Cheap
20150219T000000,529000.0,2,1.0,1210,7667,1.0,0,0,3,6,900,310,1950,0,98199,47.6571,-122.396,1330,6462,6457,5132,68.99700013042911,0.05954098360655738,Very Cheap
20150304T000000,640000.0,4,2.5,2210,7722,2.0,0,0,3,9,2210,0,1999,0,98075,47.5992,-122.019,2970,8683,5512,5713,82.88008288008288,0.0740983606557377,Very Cheap
20141106T000000,735000.0,4,2.5,2470,2550,3.0,0,0,3,8,2470,0,2004,0,98117,47.6765,-122.389,1270,3060,80,1790,288.2352941176471,0.08655737704918033,Very Cheap
20140616T000000,378000.0,5,2.5,2760,8015,1.0,0,0,4,8,1600,1160,1960,0,98125,47.7255,-122.297,460,18000,5255,17540,47.161572052401745,0.03973770491803279,Very Cheap
20140507T000000,775000.0,3,2.0,2540,7200,1.5,0,3,4,8,1600,940,1905,0,98144,47.5972,-122.292,2040,5900,4660,3860,107.63888888888889,0.09180327868852459,Very Cheap
20140725T000000,2250000.0,3,4.25,5150,7800,2.5,0,2,3,11,4170,980,1954,0,98112,47.6288,-122.282,4270,7800,2650,3530,288.46153846153845,0.28524590163934427,Cheap
20150128T000000,1350000.0,4,4.5,3420,7440,3.0,0,0,3,9,3420,0,2014,0,98103,47.6875,-122.33,1360,5580,4020,4220,181.4516129032258,0.16721311475409836,Cheap
20140827T000000,380000.0,4,2.5,2270,11500,1.0,0,0,3,8,1540,730,1967,0,98034,47.7089,-122.241,2020,10918,9230,8898,33.04347826086956,0.04,Very Cheap
20150218T000000,624900.0,4,2.5,2270,11500,1.0,0,0,3,8,1540,730,1967,0,98034,47.7089,-122.241,2020,10918,9230,8898,54.33913043478261,0.07211803278688525,Very Cheap
20141107T000000,379770.0,3,2.5,1470,1779,2.0,0,0,3,8,1160,310,2005,0,98029,47.5472,-121.998,1470,1576,309,106,213.47386172006745,0.03996983606557377,Very Cheap
20141203T000000,340000.0,3,1.75,1280,16200,1.0,0,0,3,8,1030,250,1976,0,98077,47.7427,-122.071,1160,10565,14920,9405,20.987654320987655,0.03475409836065574,Very Cheap
20150115T000000,515500.0,4,2.75,2830,8126,2.0,0,0,3,8,2830,0,2005,0,98059,47.4863,-122.14,2830,7916,5296,5086,63.438346049716955,0.05777049180327869,Very Cheap
20141117T000000,600000.0,4,2.25,1970,7125,1.5,0,0,3,7,1500,470,1908,0,98115,47.6725,-122.293,1980,4750,5155,2770,84.21052631578948,0.06885245901639345,Very Cheap
20141011T000000,400000.0,1,1.0,1390,60984,1.0,0,0,3,6,1390,0,1960,0,98019,47.7652,-121.903,1620,24225,59594,22605,6.559097468188377,0.04262295081967213,Very Cheap
20141201T000000,364000.0,4,1.0,1020,11383,1.5,0,0,5,6,1020,0,1947,0,98155,47.7429,-122.321,1290,11213,10363,9923,31.977510322410613,0.03790163934426229,Very Cheap
20140626T000000,440000.0,4,2.5,2250,7526,2.0,0,0,3,8,2250,0,1989,0,98059,47.5123,-122.15,1980,7526,5276,5546,58.46399149614669,0.04786885245901639,Very Cheap
20140528T000000,285000.0,2,1.0,800,6240,1.0,0,0,3,6,800,0,1954,0,98125,47.7257,-122.296,1530,8000,5440,6470,45.67307692307692,0.02754098360655738,Very Cheap
20150401T000000,669000.0,3,1.0,1560,4500,1.5,0,0,5,7,1560,0,1915,0,98112,47.6204,-122.292,1530,4500,2940,2970,148.66666666666666,0.0779016393442623,Very Cheap
20140702T000000,475000.0,4,2.0,2100,13468,1.0,0,0,5,7,1050,1050,1962,0,98125,47.7139,-122.292,1470,8675,11368,7205,35.268785268785265,0.05245901639344262,Very Cheap
20150504T000000,747000.0,2,1.0,990,4000,1.0,0,0,4,7,990,0,1911,0,98103,47.6589,-122.341,1560,4000,3010,2440,186.75,0.08813114754098361,Very Cheap
20150105T000000,317000.0,3,1.5,1060,5750,1.0,0,0,2,7,1060,0,1981,0,98126,47.5532,-122.372,1060,5750,4690,4690,55.130434782608695,0.03173770491803279,Very Cheap
20140828T000000,390000.0,2,1.0,1270,8164,1.0,0,0,4,6,1270,0,1941,0,98125,47.7116,-122.311,1580,9095,6894,7515,47.77070063694268,0.04131147540983607,Very Cheap
20150422T000000,1070000.0,4,2.5,2740,5000,2.0,0,0,3,9,2740,0,2012,0,98107,47.674,-122.371,1660,5000,2260,3340,214.0,0.13049180327868853,Cheap
20141021T000000,1205000.0,4,2.75,2470,5500,1.0,0,3,3,9,1570,900,1960,2005,98107,47.6586,-122.358,1620,5500,3030,3880,219.0909090909091,0.1481967213114754,Cheap
20150327T000000,580000.0,3,1.75,1970,5100,1.0,0,0,3,7,1130,840,1908,1965,98117,47.6831,-122.379,1250,4080,3130,2830,113.72549019607843,0.06622950819672131,Very Cheap
20141113T000000,518000.0,4,2.5,2070,10244,1.0,0,0,3,8,1370,700,1969,0,98006,47.5592,-122.178,2070,9683,8174,7613,50.56618508395158,0.0580983606557377,Very Cheap
20141204T000000,147500.0,3,1.75,1010,6552,1.0,0,0,3,7,1010,0,1969,0,98042,47.375,-122.117,1010,6552,5542,5542,22.512210012210012,0.009508196721311476,Very Cheap
20150424T000000,555000.0,4,2.25,2220,8125,1.0,0,0,4,8,1450,770,1965,0,98006,47.5429,-122.177,1980,8700,5905,6720,68.3076923076923,0.06295081967213115,Very Cheap
20140630T000000,427500.0,2,2.0,1090,934,3.0,0,0,3,8,1090,0,2008,0,98109,47.6341,-122.342,1090,1376,-156,286,457.7087794432548,0.04622950819672131,Very Cheap
20140613T000000,1735000.0,3,2.5,4310,32093,1.5,0,4,5,10,2510,1800,1982,0,98177,47.7624,-122.38,3810,26400,27783,22590,54.0616333779952,0.21770491803278688,Cheap
20140717T000000,265950.0,3,2.5,1490,3840,2.0,0,0,3,7,1490,0,2002,0,98042,47.374,-122.133,2060,4384,2350,2324,69.2578125,0.025042622950819673,Very Cheap
20141201T000000,247500.0,2,1.0,700,6046,1.0,0,0,3,6,700,0,1950,0,98133,47.7172,-122.34,990,6790,5346,5800,40.93615613628845,0.02262295081967213,Very Cheap
20140523T000000,244000.0,4,1.0,1450,8960,1.0,0,0,3,6,1450,0,1943,0,98146,47.4972,-122.348,1160,7680,7510,6520,27.232142857142858,0.02216393442622951,Very Cheap
20150323T000000,578550.0,3,2.5,2120,6602,2.0,0,0,4,8,2120,0,1989,0,98029,47.5669,-122.012,2330,7795,4482,5465,87.63253559527416,0.06603934426229509,Very Cheap
20140617T000000,451000.0,4,2.5,1670,3315,2.0,0,0,3,7,1670,0,2005,0,98029,47.5532,-121.998,1650,2051,1645,401,136.04826546003017,0.04931147540983607,Very Cheap
20140826T000000,489000.0,2,1.75,1810,4220,2.0,0,0,3,8,1810,0,2004,0,98053,47.7177,-122.034,1350,4479,2410,3129,115.87677725118483,0.05429508196721312,Very Cheap
20150504T000000,190000.0,2,1.0,710,1164794,1.0,0,0,2,5,710,0,1915,0,98014,47.6888,-121.909,1680,16730,1164084,15050,0.16311897211008985,0.015081967213114755,Very Cheap
20150305T000000,475000.0,3,3.0,2540,18900,1.0,0,0,3,7,1580,960,1978,0,98072,47.754,-122.144,2270,16000,16360,13730,25.132275132275133,0.05245901639344262,Very Cheap
20140506T000000,485000.0,3,2.0,1420,4080,1.5,0,0,3,7,1420,0,1905,2013,98103,47.6872,-122.349,1420,4590,2660,3170,118.87254901960785,0.05377049180327869,Very Cheap
20141016T000000,530000.0,3,2.75,2440,45738,2.0,0,0,3,8,1840,600,1987,0,98027,47.5453,-121.957,2440,189100,43298,186660,11.587738860466134,0.05967213114754098,Very Cheap
20150128T000000,379000.0,4,2.5,2570,10155,2.0,0,0,3,9,2570,0,1994,0,98030,47.3842,-122.17,2770,10155,7585,7385,37.321516494337764,0.03986885245901639,Very Cheap
20150106T000000,1629000.0,5,2.5,3090,16583,2.0,0,0,4,9,3090,0,1964,0,98004,47.6458,-122.218,3740,17853,13493,14113,98.23313031417717,0.2038032786885246,Cheap
20150319T000000,739000.0,3,1.75,2050,5160,1.5,0,0,4,8,1300,750,1926,0,98112,47.6374,-122.304,2220,5960,3110,3740,143.2170542635659,0.08708196721311476,Very Cheap
20141125T000000,189950.0,3,1.0,920,6460,1.0,0,0,5,6,920,0,1969,0,98042,47.3665,-122.082,920,4770,5540,3850,29.404024767801857,0.015075409836065574,Very Cheap
20141222T000000,637500.0,4,3.0,2320,4468,2.0,0,0,3,8,2160,160,1999,0,98029,47.546,-122.009,2330,3541,2148,1211,142.6812891674127,0.07377049180327869,Very Cheap
20150127T000000,2225000.0,3,3.0,3450,16740,1.0,0,4,4,9,1960,1490,1949,1993,98177,47.7067,-122.38,3220,12528,13290,9308,132.9151732377539,0.2819672131147541,Cheap
20141204T000000,209950.0,3,1.0,1660,8800,1.0,0,0,4,7,960,700,1963,0,98023,47.3212,-122.352,1370,10112,7140,8742,23.857954545454547,0.017698360655737704,Very Cheap
20150220T000000,460000.0,3,1.0,1130,7000,1.0,0,0,3,6,830,300,1944,0,98125,47.7132,-122.283,1050,7000,5870,5950,65.71428571428571,0.050491803278688525,Very Cheap
20141020T000000,543500.0,4,2.5,2550,5835,2.0,0,0,3,8,2550,0,1998,0,98065,47.5373,-121.87,2420,5817,3285,3397,93.14481576692374,0.061442622950819675,Very Cheap
20140605T000000,376000.0,4,2.75,2420,5773,2.0,0,0,3,8,2420,0,2005,0,98038,47.3772,-122.029,2420,6200,3353,3780,65.13078122293435,0.039475409836065574,Very Cheap
20141028T000000,430000.0,3,2.25,1470,1703,2.0,0,0,3,8,1470,0,2005,0,98029,47.5478,-121.999,1380,1107,233,-273,252.4955960070464,0.04655737704918033,Very Cheap
20140904T000000,515000.0,4,2.5,2030,39049,1.0,0,0,4,7,1530,500,1953,0,98166,47.4413,-122.345,2400,14605,37019,12205,13.188557965632922,0.057704918032786885,Very Cheap
20140711T000000,580000.0,7,2.75,2310,2400,1.5,0,0,3,6,2310,0,1915,0,98117,47.6775,-122.39,1340,3825,90,2485,241.66666666666666,0.06622950819672131,Very Cheap
20150203T000000,600000.0,5,3.5,3370,16846,2.0,0,1,3,9,2650,720,1998,0,98027,47.5584,-122.089,3330,13000,13476,9670,35.61676362341208,0.06885245901639345,Very Cheap
20141112T000000,476800.0,3,1.75,1900,43700,1.5,0,0,4,6,1900,0,1919,0,98052,47.7265,-122.136,2070,43995,41800,41925,10.91075514874142,0.05269508196721311,Very Cheap
20150429T000000,815000.0,3,1.5,1940,3570,2.0,0,0,4,8,1740,200,1916,0,98105,47.6618,-122.325,1580,3570,1630,1990,228.29131652661064,0.09704918032786886,Very Cheap
20140527T000000,455600.0,3,2.5,2420,8252,2.0,0,0,3,7,2420,0,1998,0,98065,47.5382,-121.871,2420,5818,5832,3398,55.210857973824524,0.04991475409836066,Very Cheap
20140515T000000,270000.0,3,1.0,1010,9514,1.0,0,0,3,7,1010,0,1969,0,98059,47.4936,-122.105,1010,9514,8504,8504,28.379230607525752,0.025573770491803278,Very Cheap
20140814T000000,1200000.0,5,4.0,2710,2800,3.0,0,0,3,10,2380,330,1974,2008,98119,47.6346,-122.364,1530,3600,90,2070,428.57142857142856,0.14754098360655737,Cheap
20140710T000000,525000.0,2,1.5,1340,3600,1.5,0,0,3,7,1340,0,1903,0,98119,47.6358,-122.364,1340,3600,2260,2260,145.83333333333334,0.05901639344262295,Very Cheap
20140528T000000,242000.0,3,1.75,1310,9645,1.0,0,0,3,7,1310,0,1979,0,98198,47.4051,-122.29,1440,9893,8335,8453,25.090720580611716,0.021901639344262296,Very Cheap
20140623T000000,715000.0,4,2.5,2650,30500,1.0,0,0,4,8,1680,970,1960,0,98029,47.5535,-122.028,2650,30500,27850,27850,23.442622950819672,0.0839344262295082,Very Cheap
20150402T000000,475000.0,3,2.75,1890,3938,2.0,0,0,3,8,1890,0,1999,0,98065,47.5336,-121.867,1890,4142,2048,2252,120.61960385982732,0.05245901639344262,Very Cheap
20141111T000000,370000.0,4,3.0,2580,5511,2.0,0,0,3,8,2580,0,1999,0,98058,47.4286,-122.185,2010,5600,2931,3590,67.13845037198331,0.038688524590163934,Very Cheap
20140523T000000,788600.0,4,2.75,3500,7200,2.0,0,0,3,9,3500,0,2005,0,98053,47.6818,-122.025,3920,7666,3700,3746,109.52777777777777,0.09358688524590164,Very Cheap
20140507T000000,160000.0,2,1.0,1040,13100,1.0,0,0,5,6,1040,0,1912,0,98032,47.3877,-122.234,910,5080,12060,4170,12.213740458015268,0.011147540983606558,Very Cheap
20140814T000000,800000.0,5,1.75,1930,501376,2.0,0,0,3,7,1930,0,1930,0,98014,47.6294,-121.911,1710,87120,499446,85410,1.595608884350268,0.09508196721311475,Very Cheap
20140924T000000,520000.0,4,3.0,2190,5085,2.0,0,0,4,8,2190,0,1992,0,98029,47.5693,-122.002,2130,5142,2895,3012,102.26155358898721,0.058360655737704915,Very Cheap
20140718T000000,725000.0,3,1.75,1530,4000,2.0,0,0,3,8,1530,0,1985,0,98136,47.5239,-122.388,2140,5000,2470,2860,181.25,0.08524590163934426,Very Cheap
20141003T000000,335000.0,4,1.0,1480,6500,1.5,0,0,4,7,1480,0,1914,0,98118,47.5282,-122.267,2380,6000,5020,3620,51.53846153846154,0.03409836065573771,Very Cheap
20150116T000000,919000.0,4,2.5,3620,17133,1.0,0,4,3,10,2220,1400,1993,0,98075,47.5604,-122.027,3530,17026,13513,13496,53.63917585945252,0.11068852459016393,Cheap
20150513T000000,425000.0,3,2.75,3370,13929,2.0,0,0,3,9,2650,720,1986,0,98092,47.3411,-122.197,2150,14048,10559,11898,30.511881685691723,0.04590163934426229,Very Cheap
20150314T000000,420000.0,5,2.5,2100,14395,1.0,0,0,3,7,1140,960,1983,0,98155,47.7723,-122.317,1830,8700,12295,6870,29.17679749913164,0.04524590163934426,Very Cheap
20141124T000000,905000.0,4,3.0,3370,47959,2.0,0,0,4,10,3370,0,1981,0,98072,47.733,-122.129,3370,38896,44589,35526,18.870285035134177,0.10885245901639344,Cheap
20140919T000000,435000.0,2,1.0,2240,7200,1.0,0,0,4,7,1120,1120,1940,0,98118,47.5631,-122.271,1390,6000,4960,4610,60.416666666666664,0.04721311475409836,Very Cheap
20140717T000000,438000.0,3,2.5,1650,3031,2.0,0,0,3,7,1650,0,2003,0,98053,47.682,-122.034,1560,3070,1381,1510,144.5067634444078,0.04760655737704918,Very Cheap
20140617T000000,725000.0,4,2.75,2630,7505,2.0,0,0,3,8,2630,0,1994,0,98052,47.6846,-122.163,2670,7506,4875,4836,96.6022651565623,0.08524590163934426,Very Cheap
20140528T000000,840000.0,4,1.75,2330,4000,2.0,0,0,5,8,1300,1030,1924,0,98105,47.666,-122.289,2040,4000,1670,1960,210.0,0.10032786885245902,Cheap
20140715T000000,425500.0,3,2.5,1970,2752,2.0,0,0,3,8,1970,0,1978,0,98052,47.6345,-122.108,1850,2778,782,928,154.61482558139534,0.045967213114754095,Very Cheap
20140912T000000,853505.0,3,2.5,2820,14890,1.0,0,4,3,9,1770,1050,1985,0,98034,47.7019,-122.228,3740,14890,12070,11150,57.32068502350571,0.10209901639344263,Cheap
20140522T000000,398000.0,2,1.0,590,10945,1.5,0,0,3,5,590,0,1983,0,98010,47.3364,-122.033,2020,15180,10355,13160,36.36363636363637,0.042360655737704915,Very Cheap
20140604T000000,418500.0,3,2.5,2060,4399,2.0,0,0,3,7,2060,0,2007,0,98065,47.5415,-121.884,2060,4399,2339,2339,95.13525801318481,0.04504918032786885,Very Cheap
20141231T000000,826000.0,3,1.5,1890,5000,1.5,0,0,3,9,1890,0,1929,0,98109,47.6312,-122.353,2560,5000,3110,2440,165.2,0.09849180327868852,Very Cheap
20140611T000000,742000.0,4,2.5,2810,10986,2.0,0,0,3,10,2810,0,1997,0,98075,47.5943,-121.981,3540,10986,8176,7446,67.54050609867103,0.08747540983606557,Very Cheap
20140909T000000,180000.0,4,1.0,1470,18581,1.5,0,0,3,6,1470,0,1924,0,98055,47.4336,-122.197,1770,18581,17111,16811,9.687314999192724,0.01377049180327869,Very Cheap
20150114T000000,286000.0,4,1.75,2190,8400,2.0,0,0,2,8,2190,0,1978,0,98023,47.3003,-122.373,2410,7700,6210,5290,34.04761904761905,0.027672131147540982,Very Cheap
20141001T000000,421200.0,3,2.5,1440,3060,2.0,0,0,3,7,1440,0,2003,0,98053,47.6821,-122.035,1650,3060,1620,1410,137.64705882352942,0.04540327868852459,Very Cheap
20140731T000000,390000.0,3,3.0,2480,14141,1.0,0,0,3,8,1500,980,1994,0,98038,47.3778,-122.033,2480,10667,11661,8187,27.57937911038823,0.04131147540983607,Very Cheap
20140919T000000,739000.0,4,2.5,2780,6737,2.0,0,0,3,9,2780,0,2002,0,98006,47.5656,-122.122,2750,7950,3957,5200,109.6927415763693,0.08708196721311476,Very Cheap
20140724T000000,499900.0,4,3.0,2180,12196,2.0,0,0,4,7,2180,0,1968,0,98027,47.5338,-122.033,1500,6534,10016,5034,40.988848802886196,0.055724590163934426,Very Cheap
20141203T000000,670000.0,3,2.25,3340,13805,1.0,0,0,3,8,3340,0,1950,1992,98155,47.744,-122.292,2060,12304,10465,10244,48.5331401666063,0.0780327868852459,Very Cheap
20141013T000000,842500.0,3,2.25,2560,3996,1.5,0,0,3,8,2150,410,1910,0,98112,47.6321,-122.306,2970,4320,1436,1350,210.83583583583584,0.10065573770491804,Cheap
20141208T000000,492500.0,2,2.25,1600,80400,2.0,0,0,4,7,1600,0,1978,0,98070,47.4422,-122.505,1600,198414,78800,196814,6.125621890547263,0.054754098360655735,Very Cheap
20140903T000000,836500.0,3,2.5,2230,7200,3.0,0,3,3,9,2230,0,1996,0,98118,47.558,-122.265,2230,7200,4970,4970,116.18055555555556,0.09986885245901639,Very Cheap
20150326T000000,334000.0,2,1.0,900,1818,2.0,0,0,4,7,900,0,1945,0,98199,47.6485,-122.397,1570,1830,918,260,183.71837183718372,0.0339672131147541,Very Cheap
20140828T000000,179900.0,3,1.0,1010,9920,1.0,0,0,3,6,1010,0,1977,0,98042,47.3238,-122.14,1270,9680,8910,8410,18.135080645161292,0.013757377049180328,Very Cheap
20141126T000000,563000.0,3,2.0,1580,5289,1.0,0,0,3,7,870,710,1940,0,98103,47.6881,-122.342,1310,5535,3709,4225,106.44734354320288,0.064,Very Cheap
20150303T000000,310000.0,3,2.5,1890,6300,2.0,0,0,3,7,1890,0,2003,0,98038,47.3673,-122.031,2100,6525,4410,4425,49.20634920634921,0.03081967213114754,Very Cheap
20140819T000000,335000.0,4,2.25,2160,8817,1.0,0,0,3,7,1460,700,1965,0,98133,47.7595,-122.356,1880,8817,6657,6937,37.99478280594307,0.03409836065573771,Very Cheap
20150206T000000,499950.0,4,2.25,2160,8817,1.0,0,0,3,7,1460,700,1965,0,98133,47.7595,-122.356,1880,8817,6657,6937,56.702960190541,0.05573114754098361,Very Cheap
20140726T000000,658500.0,2,1.0,1410,5101,1.5,0,0,3,8,1410,0,1927,0,98103,47.6872,-122.333,1410,4224,3691,2814,129.0923348363066,0.07652459016393443,Very Cheap
20141029T000000,297000.0,2,1.5,1430,1650,3.0,0,0,3,7,1430,0,1999,0,98125,47.7222,-122.29,1430,1650,220,220,180.0,0.029114754098360656,Very Cheap
20140620T000000,725000.0,6,1.75,2380,4080,2.0,0,0,3,8,2380,0,1917,0,98105,47.6629,-122.325,2030,4080,1700,2050,177.69607843137254,0.08524590163934426,Very Cheap
20141205T000000,780000.0,3,2.25,2206,82031,1.0,0,2,3,6,866,1340,1983,0,98074,47.6302,-122.069,2590,53024,79825,50434,9.508600407163145,0.09245901639344262,Very Cheap
20140509T000000,252500.0,3,1.0,1030,6127,1.0,0,0,3,7,880,150,1947,0,98125,47.7192,-122.32,1610,6127,5097,4517,41.211033132038516,0.023278688524590165,Very Cheap
20140613T000000,330000.0,3,2.5,1070,1155,2.0,0,0,3,7,720,350,2005,0,98102,47.5617,-122.385,1120,2594,85,1474,285.7142857142857,0.03344262295081967,Very Cheap
20150210T000000,525000.0,3,2.5,2320,9610,1.0,0,0,3,9,1730,590,1990,0,98011,47.7394,-122.204,2450,9608,7290,7158,54.630593132154004,0.05901639344262295,Very Cheap
20140806T000000,365000.0,2,1.75,1270,7500,1.0,0,0,4,7,1270,0,1982,0,98074,47.6186,-122.063,1280,7500,6230,6220,48.666666666666664,0.0380327868852459,Very Cheap
20150327T000000,500000.0,4,3.0,2570,9104,2.0,0,2,3,7,2570,0,1930,0,98116,47.5821,-122.401,1630,4950,6534,3320,54.92091388400703,0.05573770491803279,Very Cheap
20141112T000000,179950.0,3,1.0,920,4875,1.0,0,0,5,6,920,0,1969,0,98042,47.3648,-122.081,960,5200,3955,4240,36.91282051282051,0.013763934426229509,Very Cheap
20140722T000000,440000.0,3,2.0,1790,32379,1.0,0,0,3,7,1790,0,2007,0,98045,47.4826,-121.698,2290,43560,30589,41270,13.589054634176472,0.04786885245901639,Very Cheap
20140825T000000,145000.0,1,0.75,480,9750,1.0,0,0,2,4,480,0,1948,0,98146,47.4982,-122.362,1550,9924,9270,8374,14.871794871794872,0.009180327868852459,Very Cheap
20150422T000000,331000.0,4,3.0,2483,5701,2.0,0,0,3,8,2483,0,2005,0,98030,47.3623,-122.199,2075,5720,3218,3645,58.05998947553061,0.03357377049180328,Very Cheap
20140620T000000,780000.0,3,2.25,2140,3000,2.0,0,0,3,9,2140,0,1905,2006,98103,47.6767,-122.351,1430,4712,860,3282,260.0,0.09245901639344262,Very Cheap
20150514T000000,855000.0,3,1.75,1900,4000,1.0,0,0,3,7,1300,600,1965,0,98103,47.6854,-122.331,1880,4000,2100,2120,213.75,0.10229508196721311,Cheap
20141014T000000,225000.0,3,2.25,1650,7739,1.0,0,0,3,8,1290,360,1986,0,98003,47.3532,-122.304,1650,6033,6089,4383,29.073523711073783,0.019672131147540985,Very Cheap
20140714T000000,199000.0,3,1.0,1510,9100,1.0,0,0,3,7,1510,0,1966,0,98003,47.3331,-122.319,1180,7220,7590,6040,21.86813186813187,0.016262295081967214,Very Cheap
20140502T000000,550000.0,3,1.75,2910,35200,1.5,0,0,3,8,2910,0,1979,0,98075,47.5747,-122.035,2590,37500,32290,34910,15.625,0.06229508196721312,Very Cheap
20140529T000000,1425000.0,4,4.25,4960,6000,2.5,0,0,3,11,3680,1280,1909,2003,98109,47.6437,-122.356,2160,4080,1040,1920,237.5,0.17704918032786884,Cheap
20140502T000000,805000.0,3,2.0,2710,4500,1.5,0,0,4,8,1880,830,1929,0,98115,47.6747,-122.295,2060,4500,1790,2440,178.88888888888889,0.09573770491803278,Very Cheap
20140604T000000,261000.0,3,1.5,1810,29308,1.0,0,0,3,7,950,860,1983,0,98042,47.3585,-122.067,1790,37531,27498,35741,8.905418315818206,0.02439344262295082,Very Cheap
20140909T000000,347000.0,3,1.0,940,9198,1.0,0,0,3,7,940,0,1968,0,98052,47.6889,-122.117,1430,8370,8258,6940,37.72559252011307,0.03567213114754098,Very Cheap
20140619T000000,390000.0,3,2.25,1600,10240,1.0,0,0,3,7,1090,510,1979,0,98034,47.7281,-122.232,1520,9394,8640,7874,38.0859375,0.04131147540983607,Very Cheap
20141110T000000,436000.0,4,2.5,2640,3899,2.0,0,0,3,7,2640,0,2000,0,98011,47.754,-122.217,2460,4057,1259,1597,111.82354449858938,0.047344262295081964,Very Cheap
20150331T000000,1802750.0,5,3.25,3890,20005,1.0,0,0,3,10,2260,1630,1977,0,98004,47.6312,-122.224,3450,20176,16115,16726,90.1149712571857,0.22659016393442624,Cheap
20140723T000000,557000.0,3,2.5,1630,1587,3.0,0,0,3,8,1630,0,2004,0,98107,47.6693,-122.393,1500,1527,-43,27,350.9766855702583,0.06321311475409835,Very Cheap
20150406T000000,135000.0,3,1.0,830,9600,1.0,0,0,3,7,830,0,1959,0,98032,47.3698,-122.297,1240,9198,8770,7958,14.0625,0.007868852459016393,Very Cheap
20150325T000000,425000.0,3,2.5,1800,14036,2.0,0,0,3,8,1800,0,1993,0,98019,47.7334,-121.97,2450,14025,12236,11575,30.279281846679964,0.04590163934426229,Very Cheap
20150408T000000,648752.0,3,2.25,2060,9953,1.0,0,0,5,8,1070,990,1964,0,98040,47.5767,-122.233,2340,9600,7893,7260,65.1815533005124,0.07524616393442624,Very Cheap
20140626T000000,1388000.0,4,3.0,4040,20001,1.0,0,0,3,9,2020,2020,1972,2001,98004,47.6408,-122.212,2990,20098,15961,17108,69.39653017349133,0.1721967213114754,Cheap
20150324T000000,630100.0,4,2.75,1910,11356,1.0,0,0,5,7,1160,750,1977,0,98033,47.6999,-122.2,1770,11357,9446,9587,55.486086650228955,0.0728,Very Cheap
20140609T000000,739000.0,4,2.5,2800,246114,2.0,0,0,3,9,2800,0,1999,0,98014,47.6586,-121.962,2750,60351,243314,57601,3.002673557782166,0.08708196721311476,Very Cheap
20140818T000000,269000.0,3,1.5,1320,2625,2.0,0,0,3,7,1320,0,1986,0,98133,47.7316,-122.338,1230,5250,1305,4020,102.47619047619048,0.02544262295081967,Very Cheap
20150427T000000,250000.0,3,1.0,1220,5038,1.0,0,0,5,6,1220,0,1942,0,98056,47.496,-122.189,1140,5038,3818,3898,49.622866216752676,0.022950819672131147,Very Cheap
20150320T000000,475000.0,5,2.75,3100,5298,2.0,0,0,3,7,3100,0,2007,0,98065,47.5369,-121.887,2440,5250,2198,2810,89.65647414118536,0.05245901639344262,Very Cheap
20141119T000000,290000.0,1,1.0,550,5700,1.0,0,0,2,6,550,0,1916,0,98117,47.6846,-122.366,1100,4560,5150,3460,50.87719298245614,0.02819672131147541,Very Cheap
20141118T000000,219000.0,3,1.0,1080,10639,1.5,0,0,3,7,1080,0,1953,0,98002,47.3171,-122.219,1470,10600,9559,9130,20.5846414136667,0.018885245901639345,Very Cheap
20140929T000000,416000.0,2,1.0,880,6650,1.0,0,0,5,6,880,0,1918,0,98117,47.6914,-122.372,1250,6650,5770,5400,62.556390977443606,0.044721311475409836,Very Cheap
20150413T000000,179000.0,2,1.0,720,8914,1.0,0,0,3,6,720,0,1949,0,98188,47.4488,-122.274,1100,8916,8194,7816,20.080771819609602,0.013639344262295083,Very Cheap
20140715T000000,302000.0,4,2.75,2030,9120,1.0,0,0,4,7,2030,0,1988,0,98003,47.282,-122.303,1790,7627,7090,5837,33.1140350877193,0.02977049180327869,Very Cheap
20150427T000000,565000.0,4,2.0,2040,8281,2.0,0,1,3,7,2040,0,1961,0,98033,47.6689,-122.195,2560,8281,6241,5721,68.22847482188142,0.06426229508196721,Very Cheap
20150422T000000,281700.0,3,1.0,1570,8316,1.0,0,0,3,7,1070,500,1962,0,98031,47.3943,-122.198,2030,8295,6746,6265,33.874458874458874,0.027108196721311477,Very Cheap
20140627T000000,480000.0,2,1.0,1500,3420,1.0,0,0,3,7,1500,0,1902,0,98103,47.661,-122.338,2050,3420,1920,1370,140.35087719298247,0.05311475409836065,Very Cheap
20141013T000000,775000.0,4,2.5,3180,15358,2.0,0,0,3,9,3180,0,1988,0,98027,47.5172,-122.053,3020,15522,12178,12502,50.46229977861701,0.09180327868852459,Very Cheap
20140904T000000,375000.0,3,1.75,1260,11224,1.0,0,0,5,7,1260,0,1947,0,98155,47.7444,-122.321,1570,11052,9964,9482,33.41054882394868,0.03934426229508197,Very Cheap
20141013T000000,345000.0,3,1.5,1390,13860,2.0,0,0,3,7,1390,0,1979,0,98045,47.4704,-121.747,1390,11860,12470,10470,24.89177489177489,0.03540983606557377,Very Cheap
20150223T000000,300000.0,3,3.0,2850,9375,1.0,0,0,3,8,2240,610,1977,0,98055,47.4655,-122.209,1800,9375,6525,7575,32.0,0.029508196721311476,Very Cheap
20150422T000000,364950.0,4,2.5,2070,2992,2.0,0,0,3,8,2070,0,2002,0,98058,47.4496,-122.12,1900,2957,922,1057,121.97526737967914,0.03802622950819672,Very Cheap
20141202T000000,410000.0,3,3.25,2650,7819,1.0,0,2,4,8,1760,890,1956,0,98056,47.4821,-122.192,2400,7727,5169,5327,52.436372937715824,0.043934426229508196,Very Cheap
20150414T000000,231000.0,3,1.75,1220,8817,1.0,0,0,3,7,1220,0,1978,0,98023,47.3111,-122.396,2000,8028,7597,6028,26.19938754678462,0.020459016393442622,Very Cheap
20140523T000000,445000.0,3,2.0,1630,8702,1.0,0,0,3,9,1630,0,1987,0,98056,47.5168,-122.193,2250,9890,7072,7640,51.13766950126408,0.04852459016393443,Very Cheap
20140708T000000,530000.0,2,2.5,1785,779,2.0,0,0,3,7,1595,190,1975,0,98004,47.5959,-122.198,1780,794,-1006,-986,680.3594351732991,0.05967213114754098,Very Cheap
20141226T000000,353500.0,3,2.5,1260,972,2.0,0,0,3,8,840,420,2008,0,98144,47.5872,-122.316,1270,925,-288,-345,363.6831275720165,0.036524590163934424,Very Cheap
20140507T000000,209950.0,3,1.5,1380,11130,1.0,0,0,3,7,1380,0,1960,0,98003,47.3146,-122.323,1380,9200,9750,7820,18.863432165318958,0.017698360655737704,Very Cheap
20150423T000000,650000.0,3,1.75,2330,7200,1.0,0,0,4,8,1320,1010,1950,0,98118,47.565,-122.274,1820,7200,4870,5380,90.27777777777777,0.07540983606557378,Very Cheap
20140620T000000,325000.0,2,1.0,840,4239,1.0,0,0,3,7,840,0,1948,0,98126,47.5319,-122.382,1120,4494,3399,3374,76.6690257136117,0.03278688524590164,Very Cheap
20140828T000000,257000.0,3,2.25,1730,9516,1.0,0,0,3,8,1180,550,1978,0,98030,47.3823,-122.166,1870,8165,7786,6295,27.007145859604876,0.023868852459016394,Very Cheap
20140630T000000,337000.0,4,2.5,2230,5970,2.0,0,0,4,7,2230,0,2002,0,98042,47.3745,-122.131,1970,4919,3740,2949,56.448911222780566,0.034360655737704915,Very Cheap
20140926T000000,541000.0,3,2.5,1790,4038,2.0,0,0,3,8,1790,0,2005,0,98029,47.5499,-121.998,1700,3365,2248,1665,133.97721644378404,0.06111475409836065,Very Cheap
20141114T000000,577500.0,3,2.5,2280,10879,2.0,0,0,3,9,2280,0,1984,0,98074,47.6217,-122.034,2400,9536,8599,7136,53.08392315470172,0.0659016393442623,Very Cheap
20141124T000000,560000.0,3,2.5,2430,5128,1.0,0,1,3,8,1270,1160,1978,0,98136,47.5198,-122.389,2510,5330,2698,2820,109.204368174727,0.06360655737704918,Very Cheap
20141029T000000,979700.0,5,3.0,3730,5500,1.5,0,0,3,7,2160,1570,1927,0,98102,47.6507,-122.32,1890,5500,1770,3610,178.12727272727273,0.11864918032786885,Cheap
20140725T000000,750000.0,5,3.0,2230,8560,1.0,0,0,3,8,1150,1080,1960,2014,98008,47.6154,-122.115,2040,8560,6330,6520,87.61682242990655,0.08852459016393442,Very Cheap
20140808T000000,407500.0,2,1.0,770,2971,1.0,0,2,3,7,770,0,1923,0,98102,47.6358,-122.322,1440,4000,2201,2560,137.15920565466172,0.04360655737704918,Very Cheap
20140523T000000,530000.0,4,1.75,1814,5000,1.0,0,0,4,7,944,870,1951,0,98115,47.684,-122.281,1290,5000,3186,3710,106.0,0.05967213114754098,Very Cheap
20150406T000000,235000.0,4,1.75,1920,9350,1.0,0,0,4,7,1000,920,1977,0,98002,47.292,-122.195,1910,8400,7430,6490,25.13368983957219,0.02098360655737705,Very Cheap
20150407T000000,715000.0,4,2.5,1860,3840,1.5,0,0,3,7,1170,690,1928,2014,98117,47.6886,-122.359,1400,3840,1980,2440,186.19791666666666,0.0839344262295082,Very Cheap
20150421T000000,795000.0,5,3.0,2750,10000,1.0,0,0,4,7,1730,1020,1957,0,98008,47.5878,-122.13,2520,10000,7250,7480,79.5,0.09442622950819672,Very Cheap
20140509T000000,465000.0,4,2.5,1930,9653,1.0,0,0,4,9,1930,0,1968,0,98023,47.3367,-122.335,2100,10454,7723,8354,48.171552885113435,0.051147540983606556,Very Cheap
20140513T000000,287600.0,3,2.5,1950,8251,2.0,0,0,3,7,1950,0,1990,0,98001,47.343,-122.28,1540,8588,6301,7048,34.85638104472185,0.027881967213114756,Very Cheap
20141230T000000,630000.0,6,3.0,2470,9328,2.0,0,0,3,8,2470,0,1982,0,98007,47.6025,-122.153,2470,9454,6858,6984,67.53859348198971,0.07278688524590164,Very Cheap
20150401T000000,445000.0,3,2.25,1630,6449,1.0,0,0,3,7,1310,320,1986,0,98011,47.7275,-122.232,1620,7429,4819,5809,69.00294619320825,0.04852459016393443,Very Cheap
20150105T000000,490000.0,4,2.25,2110,16200,1.0,0,0,3,8,1630,480,1978,0,98072,47.752,-122.144,2370,16000,14090,13630,30.246913580246915,0.05442622950819672,Very Cheap
20150225T000000,565000.0,3,1.75,1490,5000,1.0,0,1,3,8,1250,240,1954,0,98136,47.5257,-122.392,1980,5000,3510,3020,113.0,0.06426229508196721,Very Cheap
20140819T000000,330000.0,3,2.5,1740,1844,2.0,0,0,3,8,1320,420,2008,0,98106,47.5248,-122.365,1740,1789,104,49,178.9587852494577,0.03344262295081967,Very Cheap
20141218T000000,463000.0,4,2.75,1900,6000,1.0,0,2,3,7,1300,600,1961,0,98178,47.495,-122.229,2230,6000,4100,3770,77.16666666666667,0.05088524590163934,Very Cheap
20140506T000000,1870000.0,5,4.0,4510,15175,2.0,0,0,3,10,4510,0,1969,2002,98040,47.5309,-122.228,3510,13500,10665,9990,123.22899505766063,0.23540983606557378,Cheap
20140626T000000,219500.0,3,1.0,1090,6710,1.5,0,0,5,5,1090,0,1912,0,98002,47.3066,-122.217,1170,6708,5620,5538,32.7123695976155,0.018950819672131147,Very Cheap
20141027T000000,622200.0,3,1.75,1720,7200,1.0,0,0,3,7,1420,300,1959,0,98125,47.7062,-122.304,1380,8000,5480,6620,86.41666666666667,0.07176393442622951,Very Cheap
20140528T000000,474800.0,2,3.25,1400,1243,3.0,0,0,3,8,1400,0,2000,0,98103,47.6534,-122.353,1400,1335,-157,-65,381.9790828640386,0.0524327868852459,Very Cheap
20140611T000000,465000.0,4,2.5,2090,9702,1.0,0,0,5,7,1320,770,1965,0,98133,47.7467,-122.339,1850,7200,7612,5350,47.9282622139765,0.051147540983606556,Very Cheap
20141014T000000,389950.0,3,1.75,1580,9049,1.0,0,0,3,8,1580,0,1966,0,98177,47.7776,-122.375,2100,8446,7469,6346,43.09315946513427,0.04130491803278689,Very Cheap
20141024T000000,650000.0,4,2.5,2620,19864,2.0,0,0,4,8,2620,0,1984,0,98052,47.7014,-122.122,2500,13285,17244,10785,32.72251308900523,0.07540983606557378,Very Cheap
20140905T000000,395000.0,3,2.0,1500,2506,1.0,0,0,3,7,870,630,2003,0,98144,47.5962,-122.301,1500,4662,1006,3162,157.6217079010375,0.0419672131147541,Very Cheap
20141219T000000,304500.0,4,2.5,2030,5202,2.0,0,0,3,8,2030,0,2001,0,98031,47.388,-122.176,2260,5232,3172,2972,58.53517877739331,0.030098360655737705,Very Cheap
20150314T000000,307000.0,3,1.0,1020,8484,1.0,0,0,3,6,1020,0,1949,0,98155,47.7719,-122.31,1180,9660,7464,8480,36.18576143328619,0.03042622950819672,Very Cheap
20150107T000000,485000.0,3,2.5,1540,7120,1.0,0,0,3,7,770,770,1938,2013,98038,47.3729,-122.037,1000,6638,5580,5638,68.11797752808988,0.05377049180327869,Very Cheap
20141023T000000,1562000.0,5,3.0,3910,16200,1.0,0,0,4,9,2890,1020,1960,0,98004,47.6326,-122.217,3620,16200,12290,12580,96.41975308641975,0.19501639344262295,Cheap
20150122T000000,650500.0,5,4.25,3920,11412,2.0,0,0,3,7,3920,0,1955,2005,98006,47.5766,-122.151,1400,9750,7492,8350,57.00140203294777,0.07547540983606557,Very Cheap
20150202T000000,960000.0,4,2.5,3180,10105,2.0,0,0,4,9,3180,0,1986,0,98040,47.5328,-122.226,2670,10355,6925,7685,95.002474022761,0.1160655737704918,Cheap
20150213T000000,710000.0,3,2.5,2330,9160,2.0,0,0,3,9,2330,0,1997,0,98006,47.5467,-122.181,2460,9160,6830,6700,77.51091703056768,0.08327868852459017,Very Cheap
20150329T000000,540000.0,3,2.5,2600,23361,1.5,1,4,3,8,2150,450,1912,0,98146,47.4997,-122.379,1700,14700,20761,13000,23.115448824964684,0.06098360655737705,Very Cheap
20140724T000000,601000.0,4,1.75,1950,4200,1.0,0,0,5,7,1040,910,1951,0,98115,47.6755,-122.285,1450,5000,2250,3550,143.0952380952381,0.06898360655737705,Very Cheap
20150504T000000,463828.0,5,1.75,3250,13702,1.0,0,2,3,8,1650,1600,1965,0,98055,47.4883,-122.225,2620,11328,10452,8708,33.851116625310176,0.05099383606557377,Very Cheap
20150211T000000,293000.0,4,1.0,1130,8308,1.5,0,0,4,6,1130,0,1944,0,98166,47.4669,-122.355,1130,8652,7178,7522,35.26721232546943,0.02859016393442623,Very Cheap
20141020T000000,597500.0,3,2.5,2620,4800,2.0,0,0,3,7,2620,0,2002,0,98053,47.6849,-122.037,2400,4756,2180,2356,124.47916666666667,0.06852459016393443,Very Cheap
20150326T000000,240000.0,2,1.0,1120,45302,1.0,0,2,4,5,1120,0,1932,0,98045,47.5105,-121.77,2150,101930,44182,99780,5.297779347490177,0.021639344262295083,Very Cheap
20140502T000000,284000.0,3,1.75,1800,23103,1.0,0,0,3,7,1800,0,1968,0,98014,47.6517,-121.906,1410,18163,21303,16753,12.29277582997879,0.027409836065573772,Very Cheap
20150126T000000,440000.0,4,1.75,2180,10200,1.0,0,2,3,8,2000,180,1966,0,98028,47.7638,-122.27,2590,10445,8020,7855,43.13725490196079,0.04786885245901639,Very Cheap
20140515T000000,340000.0,3,1.75,1960,8136,1.0,0,0,3,7,980,980,1948,0,98106,47.5208,-122.364,1070,7480,6176,6410,41.789577187807275,0.03475409836065574,Very Cheap
20150317T000000,363000.0,3,1.75,1960,8136,1.0,0,0,3,7,980,980,1948,0,98106,47.5208,-122.364,1070,7480,6176,6410,44.6165191740413,0.03777049180327869,Very Cheap
20140714T000000,270000.0,2,1.0,1150,3600,1.0,0,0,3,6,1150,0,1910,0,98144,47.5729,-122.31,1160,4000,2450,2840,75.0,0.025573770491803278,Very Cheap
20140827T000000,365000.0,4,2.5,2800,6820,2.0,0,0,4,7,2800,0,1997,0,98042,47.3695,-122.108,2060,6820,4020,4760,53.51906158357771,0.0380327868852459,Very Cheap
20140609T000000,428000.0,3,2.0,1310,2550,1.0,0,0,3,7,780,530,1986,0,98103,47.6911,-122.35,1460,5100,1240,3640,167.84313725490196,0.04629508196721312,Very Cheap
20150401T000000,600000.0,3,1.75,2340,57499,1.0,0,0,3,8,2340,0,1988,0,98053,47.6989,-122.044,3260,137649,55159,134389,10.434964086331936,0.06885245901639345,Very Cheap
20141024T000000,405000.0,3,2.5,1430,10200,1.0,0,0,3,7,1430,0,1960,0,98033,47.7012,-122.166,1470,10350,8770,8880,39.705882352941174,0.043278688524590166,Very Cheap
20140711T000000,339900.0,4,2.5,2340,9748,1.0,0,1,3,8,1610,730,1981,0,98003,47.3363,-122.331,2070,8241,7408,6171,34.86869101354124,0.03474098360655738,Very Cheap
20141223T000000,275000.0,3,1.0,1290,11250,1.0,0,0,3,7,1290,0,1956,0,98166,47.4743,-122.341,1410,11196,9960,9786,24.444444444444443,0.02622950819672131,Very Cheap
20140717T000000,361600.0,2,1.0,760,6380,1.0,0,0,3,6,760,0,1941,0,98115,47.6914,-122.31,1590,6380,5620,4790,56.677115987460816,0.03758688524590164,Very Cheap
20150320T000000,325000.0,6,2.0,2780,13950,2.5,0,0,4,7,2780,0,1955,1964,98030,47.3738,-122.226,2120,13950,11170,11830,23.29749103942652,0.03278688524590164,Very Cheap
20141219T000000,1050000.0,3,2.0,2090,4077,1.5,0,0,4,8,1530,560,1931,0,98112,47.6433,-122.3,2010,4132,1987,2122,257.54231052244296,0.12786885245901639,Cheap
20141110T000000,959750.0,4,3.0,3060,50002,1.0,0,2,4,8,2460,600,1957,0,98008,47.6205,-122.096,2740,16181,46942,13441,19.19423223071077,0.1160327868852459,Cheap
20140603T000000,210000.0,3,1.0,1110,7962,1.0,0,0,3,7,1110,0,1962,0,98146,47.5035,-122.36,1200,8094,6852,6894,26.37528259231349,0.017704918032786884,Very Cheap
20141201T000000,258000.0,3,2.0,1790,7879,1.5,0,0,3,7,1790,0,1998,0,98001,47.2634,-122.289,1790,7879,6089,6089,32.74527224267039,0.024,Very Cheap
20140708T000000,468000.0,3,1.5,1830,9848,1.0,0,0,5,7,1830,0,1962,0,98056,47.539,-122.18,1830,8168,8018,6338,47.52233956133225,0.05154098360655738,Very Cheap
20150504T000000,710000.0,4,3.5,2850,2910,2.0,0,2,3,8,1970,880,1905,1996,98115,47.6855,-122.321,1460,3880,60,2420,243.98625429553263,0.08327868852459017,Very Cheap
20150421T000000,268000.0,3,1.0,1420,6000,1.0,0,0,3,6,1420,0,1941,0,98146,47.4913,-122.336,1480,6000,4580,4520,44.666666666666664,0.025311475409836064,Very Cheap
20150116T000000,115000.0,2,1.0,790,7252,1.0,0,0,3,5,790,0,1930,0,98146,47.5048,-122.365,1260,11470,6462,10210,15.857694429123,0.005245901639344262,Very Cheap
20150513T000000,500000.0,3,2.5,2300,4307,2.0,0,0,3,8,2300,0,1998,0,98034,47.7326,-122.197,2010,4307,2007,2297,116.09008590666357,0.05573770491803279,Very Cheap
20141017T000000,431000.0,3,2.5,2440,71002,1.0,0,0,4,9,2440,0,1996,0,98022,47.2689,-122.01,3170,84000,68562,80830,6.0702515422100785,0.046688524590163934,Very Cheap
20150223T000000,241500.0,3,2.0,1310,7349,1.0,0,0,3,7,870,440,1995,0,98030,47.3639,-122.186,1690,6580,6039,4890,32.8616138250102,0.02183606557377049,Very Cheap
20150414T000000,300000.0,3,1.0,1380,12000,1.0,0,0,3,7,1380,0,1963,0,98031,47.3997,-122.215,1890,22001,10620,20111,25.0,0.029508196721311476,Very Cheap
20141107T000000,982000.0,4,2.5,2790,10289,2.0,0,0,3,9,2790,0,1987,0,98006,47.5483,-122.158,2650,10126,7499,7476,95.44173389056273,0.11895081967213114,Cheap
20150106T000000,248500.0,3,2.5,1360,7293,2.0,0,0,3,8,1360,0,1988,0,98003,47.3304,-122.302,1540,7353,5933,5813,34.07376936788702,0.02275409836065574,Very Cheap
20141231T000000,665000.0,4,2.5,2510,5936,2.0,0,0,3,9,2510,0,1998,0,98075,47.5847,-122.032,2760,6060,3426,3300,112.02830188679245,0.07737704918032787,Very Cheap
20140714T000000,1215000.0,3,3.0,4560,16339,2.0,0,2,3,10,4040,520,2001,0,98034,47.7024,-122.243,2620,11561,11779,8941,74.36195605606218,0.14950819672131146,Cheap
20140709T000000,380000.0,2,1.0,780,3910,1.0,0,0,3,6,780,0,1918,0,98126,47.566,-122.38,1500,5060,3130,3560,97.18670076726343,0.04,Very Cheap
20140616T000000,220000.0,3,2.0,1410,7998,1.0,0,0,4,7,1410,0,1940,0,98178,47.4968,-122.277,1780,8278,6588,6498,27.506876719179797,0.01901639344262295,Very Cheap
20140707T000000,631500.0,4,2.0,2530,5650,1.5,0,0,4,8,1910,620,1910,0,98116,47.5778,-122.382,1310,5750,3120,4440,111.76991150442478,0.07298360655737705,Very Cheap
20141219T000000,386100.0,3,2.0,1270,6760,1.0,0,0,5,7,1270,0,1972,0,98034,47.7381,-122.179,1550,5734,5490,4184,57.11538461538461,0.0408,Very Cheap
20140813T000000,1050000.0,4,4.5,3180,4606,2.0,0,3,4,9,1990,1190,1929,0,98199,47.6402,-122.405,2110,5323,1426,3213,227.96352583586625,0.12786885245901639,Cheap
20150122T000000,650000.0,2,1.75,1450,4000,1.5,0,0,4,7,1350,100,1903,0,98105,47.6571,-122.326,1310,4000,2550,2690,162.5,0.07540983606557378,Very Cheap
20150224T000000,545000.0,4,1.75,2040,53578,1.0,0,0,5,7,1160,880,1959,0,98038,47.3844,-122.0,2040,53578,51538,51538,10.172085557504946,0.06163934426229508,Very Cheap
20141010T000000,870000.0,4,2.5,2650,12001,2.0,0,0,4,9,2650,0,1984,0,98006,47.5496,-122.14,2880,14054,9351,11174,72.4939588367636,0.10426229508196722,Cheap
20140817T000000,380000.0,3,1.75,1240,8611,1.0,0,0,4,7,1240,0,1973,0,98133,47.7175,-122.331,1700,8037,7371,6337,44.12960167227964,0.04,Very Cheap
20150209T000000,265000.0,2,1.0,820,8423,1.0,0,2,3,6,820,0,1957,0,98055,47.4741,-122.2,1960,9140,7603,7180,31.46147453401401,0.024918032786885248,Very Cheap
20140530T000000,645500.0,2,1.0,1890,5202,1.5,0,0,4,7,1890,0,1909,0,98117,47.6786,-122.379,1670,5100,3312,3430,124.08688965782392,0.07481967213114754,Very Cheap
20140913T000000,570000.0,3,2.0,1270,3090,2.0,0,0,5,7,1270,0,1911,0,98117,47.685,-122.359,1440,3090,1820,1650,184.46601941747574,0.06491803278688525,Very Cheap
20150217T000000,1200000.0,4,2.5,3350,11688,1.0,0,2,3,10,1760,1590,1995,0,98006,47.5507,-122.133,4240,10804,8338,6564,102.6694045174538,0.14754098360655737,Cheap
20141027T000000,605000.0,2,1.0,1550,3200,1.5,0,0,3,8,1550,0,1927,0,98112,47.6368,-122.306,1800,3937,1650,2137,189.0625,0.06950819672131148,Very Cheap
20140610T000000,199500.0,3,1.0,920,9812,1.0,0,0,4,7,920,0,1962,0,98001,47.2958,-122.284,1188,9812,8892,8624,20.332246229107216,0.016327868852459015,Very Cheap
20150315T000000,445000.0,2,1.0,950,4800,1.0,0,0,3,6,950,0,1941,0,98144,47.5864,-122.301,1420,5400,3850,3980,92.70833333333333,0.04852459016393443,Very Cheap
20141016T000000,495000.0,4,1.75,2040,3570,1.0,0,0,4,7,1020,1020,1917,0,98144,47.5754,-122.288,1790,4206,1530,2416,138.65546218487395,0.05508196721311476,Very Cheap
20140612T000000,594000.0,4,1.75,1870,5200,2.0,0,0,4,7,1200,670,1937,0,98115,47.6843,-122.283,1790,5000,3330,3210,114.23076923076923,0.0680655737704918,Very Cheap
20140819T000000,465000.0,3,1.75,1720,5280,1.0,0,0,4,8,900,820,1943,0,98199,47.6493,-122.401,1600,6000,3560,4400,88.06818181818181,0.051147540983606556,Very Cheap
20150422T000000,160000.0,2,1.0,1020,13647,1.0,0,0,5,6,1020,0,1915,1974,98022,47.2848,-121.927,980,8250,12627,7270,11.724188466329597,0.011147540983606558,Very Cheap
20141204T000000,340000.0,4,2.5,2690,6099,2.0,0,0,3,9,2690,0,1998,0,98092,47.3314,-122.171,2520,6168,3409,3648,55.74684374487621,0.03475409836065574,Very Cheap
20140910T000000,870000.0,4,2.0,3090,41147,1.0,0,0,3,7,3090,0,1990,0,98052,47.6748,-122.049,3300,34280,38057,30980,21.143704279777385,0.10426229508196722,Cheap
20140818T000000,249000.0,3,1.5,1070,5150,1.0,0,0,4,6,1070,0,1940,0,98106,47.5335,-122.349,1020,4800,4080,3780,48.349514563106794,0.02281967213114754,Very Cheap
20150506T000000,500000.0,4,2.25,2050,7201,2.0,0,0,3,8,2050,0,1994,0,98033,47.7003,-122.165,1970,7350,5151,5380,69.43480072212192,0.05573770491803279,Very Cheap
20140626T000000,220000.0,3,1.5,1660,15600,2.0,0,0,3,7,1660,0,1981,0,98001,47.2589,-122.279,1660,14400,13940,12740,14.102564102564102,0.01901639344262295,Very Cheap
20140812T000000,368500.0,5,1.75,2810,9360,1.0,0,0,4,7,1520,1290,1965,0,98055,47.4361,-122.193,1770,9360,6550,7590,39.36965811965812,0.03849180327868852,Very Cheap
20140929T000000,439950.0,4,2.25,2460,14600,1.0,0,0,4,8,1720,740,1977,0,98042,47.3762,-122.16,2460,14600,12140,12140,30.133561643835616,0.04786229508196721,Very Cheap
20140924T000000,179900.0,3,1.75,1230,12000,1.0,0,0,3,6,1230,0,1970,0,98001,47.2878,-122.251,1550,12000,10770,10450,14.991666666666667,0.013757377049180328,Very Cheap
20140528T000000,490000.0,4,2.5,2360,4367,2.0,0,0,3,8,2360,0,2003,0,98011,47.7731,-122.167,2360,4868,2007,2508,112.20517517746737,0.05442622950819672,Very Cheap
20140929T000000,425000.0,4,1.75,1730,11890,1.0,0,0,2,7,980,750,1955,0,98004,47.5979,-122.194,2100,12325,10160,10225,35.74432296047098,0.04590163934426229,Very Cheap
20140829T000000,533300.0,4,2.5,2770,21806,2.0,0,0,3,9,2770,0,1991,0,98045,47.4815,-121.768,2500,21656,19036,19156,24.456571585802074,0.060104918032786885,Very Cheap
20150116T000000,447500.0,4,2.0,1770,3332,2.0,0,0,3,7,1630,140,1924,1975,98118,47.5563,-122.281,1640,4000,1562,2360,134.30372148859544,0.04885245901639344,Very Cheap
20140723T000000,768000.0,5,2.75,3030,13640,2.0,0,0,4,8,3030,0,1980,0,98007,47.6186,-122.146,2500,13225,10610,10725,56.3049853372434,0.09088524590163935,Very Cheap
20140521T000000,285000.0,3,1.75,2380,6000,1.5,0,0,3,7,1320,1060,1935,0,98178,47.498,-122.222,1290,6000,3620,4710,47.5,0.02754098360655738,Very Cheap
20140509T000000,336900.0,3,1.75,1780,120661,1.0,0,0,4,6,1780,0,1979,0,98019,47.7731,-121.897,1440,25000,118881,23560,2.79212007193708,0.03434754098360656,Very Cheap
20140714T000000,415000.0,4,1.5,1540,7886,2.0,0,0,3,7,1540,0,1967,0,98034,47.734,-122.193,1550,7396,6346,5846,52.62490489475019,0.04459016393442623,Very Cheap
20140723T000000,500000.0,3,2.25,1580,4379,2.0,0,0,4,8,1580,0,1994,0,98029,47.5694,-122.005,1770,4187,2799,2417,114.18131993605846,0.05573770491803279,Very Cheap
20141103T000000,337000.0,4,2.5,3200,5772,2.0,0,0,3,8,3200,0,2003,0,98042,47.3486,-122.153,3010,5772,2572,2762,58.385308385308385,0.034360655737704915,Very Cheap
20140919T000000,419950.0,4,2.5,2220,6800,2.0,0,0,3,7,2220,0,2002,0,98059,47.49,-122.15,2220,5303,4580,3083,61.75735294117647,0.04523934426229508,Very Cheap
20150107T000000,290000.0,4,2.75,2240,8162,2.0,0,0,5,7,1380,860,1946,0,98133,47.7427,-122.34,1550,8163,5922,6613,35.530507228620436,0.02819672131147541,Very Cheap
20140718T000000,349950.0,2,1.75,1640,4176,1.0,0,0,4,7,1040,600,1948,0,98118,47.5162,-122.26,1460,5200,2536,3740,83.80028735632185,0.036059016393442625,Very Cheap
20140516T000000,330000.0,3,1.5,1170,4950,1.0,0,0,4,7,1170,0,1960,0,98007,47.6057,-122.135,1570,7700,3780,6130,66.66666666666667,0.03344262295081967,Very Cheap
20140609T000000,965000.0,4,2.25,3160,34560,1.0,0,0,4,10,3160,0,1981,0,98072,47.7337,-122.132,3530,38045,31400,34515,27.922453703703702,0.11672131147540983,Cheap
20141031T000000,515000.0,3,2.5,2100,7851,2.0,0,0,3,8,2100,0,1986,0,98052,47.7242,-122.105,2100,8187,5751,6087,65.59673926888294,0.057704918032786885,Very Cheap
20140522T000000,665000.0,4,2.5,2600,17388,2.0,0,0,3,9,2600,0,1996,0,98059,47.5283,-122.146,2950,11553,14788,8603,38.24476650563607,0.07737704918032787,Very Cheap
20140826T000000,265000.0,3,1.75,1630,5999,1.5,0,0,4,7,1630,0,1985,0,98198,47.3816,-122.313,1540,7500,4369,5960,44.17402900483414,0.024918032786885248,Very Cheap
20140917T000000,545400.0,3,2.0,2850,19200,1.0,0,3,3,8,2340,510,2004,0,98023,47.3378,-122.348,2860,18240,16350,15380,28.40625,0.06169180327868853,Very Cheap
20140624T000000,350000.0,4,3.0,2560,5606,2.0,0,0,3,9,2560,0,2004,0,98092,47.3274,-122.178,2667,7334,3046,4667,62.433107384944705,0.036065573770491806,Very Cheap
20141113T000000,260000.0,2,1.5,980,1296,2.0,0,0,3,7,840,140,2001,0,98133,47.7075,-122.336,1100,1228,316,128,200.6172839506173,0.024262295081967214,Very Cheap
20150407T000000,2510000.0,3,3.25,5480,57990,2.0,1,4,3,11,5480,0,1991,0,98166,47.4558,-122.371,2500,22954,52510,20454,43.28332471115709,0.31934426229508195,Medium
20140926T000000,355000.0,3,2.0,2160,8091,1.5,0,0,3,8,2160,0,2000,0,98003,47.3474,-122.303,2190,8297,5931,6107,43.87591150661228,0.036721311475409836,Very Cheap
20141028T000000,879000.0,3,3.0,3030,5156,1.5,0,0,4,9,2080,950,1929,0,98119,47.647,-122.369,1910,5720,2126,3810,170.4809930178433,0.10544262295081967,Cheap
20140818T000000,833000.0,4,3.5,3560,7178,2.0,0,3,3,10,2590,970,2006,0,98052,47.7054,-122.107,3290,6978,3618,3688,116.0490387294511,0.09940983606557377,Very Cheap
20150107T000000,261590.0,2,1.0,760,6407,1.0,0,0,3,6,760,0,1943,0,98178,47.4977,-122.259,1050,8580,5647,7530,40.82878102075855,0.024470819672131147,Very Cheap
20141105T000000,512500.0,3,3.0,2260,2400,2.0,0,0,3,7,2260,0,1909,1972,98122,47.6094,-122.31,1320,2790,140,1470,213.54166666666666,0.05737704918032787,Very Cheap
20150427T000000,600000.0,2,1.75,1560,3200,1.0,0,0,5,7,880,680,1946,0,98199,47.6419,-122.394,2060,4940,1640,2880,187.5,0.06885245901639345,Very Cheap
20141006T000000,417500.0,5,3.0,2270,6664,1.0,0,0,3,7,1340,930,1995,0,98125,47.7191,-122.315,1870,6187,4394,4317,62.650060024009605,0.04491803278688525,Very Cheap
20140527T000000,970000.0,5,3.0,3480,15185,2.0,0,0,4,8,3480,0,1964,0,98040,47.5757,-122.216,3030,14257,11705,11227,63.87882779058281,0.11737704918032787,Cheap
20140812T000000,316000.0,3,2.25,1900,7479,2.0,0,0,4,7,1900,0,1992,0,98038,47.3495,-122.037,1520,6559,5579,5039,42.25163791950796,0.03160655737704918,Very Cheap
20150306T000000,397500.0,4,3.0,2350,9952,1.0,0,0,3,9,1650,700,1989,0,98031,47.4194,-122.211,2440,9100,7602,6660,39.94172025723473,0.04229508196721311,Very Cheap
20140721T000000,1350000.0,3,2.5,2390,5500,1.0,0,3,3,9,1700,690,1952,0,98199,47.6389,-122.409,2700,5500,3110,2800,245.45454545454547,0.16721311475409836,Cheap
20140821T000000,840000.0,4,2.5,3730,9847,2.0,0,0,3,10,3730,0,1997,0,98075,47.587,-121.976,3490,10219,6117,6729,85.30516908703159,0.10032786885245902,Cheap
20140626T000000,270000.0,2,1.0,1780,81021,1.0,0,3,4,9,1780,0,1954,0,98001,47.2712,-122.265,1780,26723,79241,24943,3.3324693597956085,0.025573770491803278,Very Cheap
20140527T000000,312900.0,4,2.5,1630,4473,2.0,0,0,3,7,1630,0,2003,0,98038,47.3546,-122.015,1830,5082,2843,3252,69.9530516431925,0.0312,Very Cheap
20150326T000000,325000.0,2,1.0,1130,6908,1.5,0,0,3,6,1130,0,1945,0,98155,47.745,-122.313,1150,6908,5778,5758,47.04690214244354,0.03278688524590164,Very Cheap
20140719T000000,680000.0,3,1.75,2140,3584,1.0,0,0,3,7,1070,1070,1952,0,98199,47.636,-122.391,1620,4000,1444,2380,189.73214285714286,0.07934426229508197,Very Cheap
20150304T000000,763000.0,4,2.5,3220,7873,2.0,0,0,3,10,3220,0,1994,0,98075,47.5849,-122.03,2610,8023,4653,5413,96.91350184173758,0.0902295081967213,Very Cheap
20140904T000000,375000.0,1,1.0,800,533610,1.5,0,0,5,5,800,0,1950,0,98038,47.4134,-121.986,1790,216057,532810,214267,0.7027604430201833,0.03934426229508197,Very Cheap
20150408T000000,475000.0,3,2.5,1800,3300,2.0,0,0,3,7,1690,110,2004,0,98118,47.5491,-122.276,1570,4097,1500,2527,143.93939393939394,0.05245901639344262,Very Cheap
20141121T000000,219000.0,2,2.5,809,940,2.0,0,0,3,7,809,0,2003,0,98136,47.5499,-122.384,1260,4240,131,2980,232.9787234042553,0.018885245901639345,Very Cheap
20150323T000000,415000.0,3,2.25,1820,9694,1.0,0,0,3,7,1240,580,1977,0,98074,47.6157,-122.05,1820,9694,7874,7874,42.80998555807716,0.04459016393442623,Very Cheap
20140523T000000,90000.0,2,1.0,580,7500,1.0,0,0,3,5,580,0,1943,0,98178,47.4852,-122.251,1700,11250,6920,9550,12.0,0.0019672131147540984,Very Cheap
20150331T000000,220000.0,2,1.0,580,7500,1.0,0,0,3,5,580,0,1943,0,98178,47.4852,-122.251,1700,11250,6920,9550,29.333333333333332,0.01901639344262295,Very Cheap
20150226T000000,616000.0,3,2.0,2900,5650,1.0,0,2,3,8,1520,1380,1959,0,98116,47.5789,-122.396,1810,6250,2750,4440,109.02654867256638,0.07095081967213114,Very Cheap
20140815T000000,269500.0,2,1.0,1140,74052,1.0,0,0,4,6,1140,0,1968,0,98022,47.2093,-121.962,1730,43560,72912,41830,3.639334521687463,0.025508196721311476,Very Cheap
20150424T000000,395350.0,2,1.0,1060,5754,1.0,0,0,4,6,1060,0,1917,0,98117,47.6931,-122.372,1460,7200,4694,5740,68.70872436565867,0.04201311475409836,Very Cheap
20150319T000000,770000.0,4,3.0,2320,7200,1.0,0,0,3,7,1260,1060,1943,2000,98040,47.5893,-122.232,1760,7200,4880,5440,106.94444444444444,0.09114754098360656,Very Cheap
20150429T000000,840000.0,4,2.5,3450,43216,2.0,0,0,3,9,3450,0,2000,0,98072,47.7625,-122.025,3030,50481,39766,47451,19.437245464642725,0.10032786885245902,Cheap
20141106T000000,428950.0,2,1.0,1760,4441,1.0,0,0,3,8,1310,450,1950,0,98126,47.5311,-122.381,1350,5748,2681,4398,96.58860616978158,0.04641967213114754,Very Cheap
20141217T000000,800000.0,4,3.75,3370,6766,2.0,0,0,3,9,3370,0,2005,0,98052,47.7063,-122.106,3530,6766,3396,3236,118.23825007389891,0.09508196721311475,Very Cheap
20140619T000000,401000.0,4,1.0,1940,5753,1.5,0,0,3,7,1940,0,1947,0,98177,47.7188,-122.358,2170,6075,3813,3905,69.70276377542152,0.04275409836065574,Very Cheap
20150226T000000,303697.0,4,2.0,2520,7334,1.0,0,0,3,7,1600,920,1955,0,98125,47.7263,-122.291,2040,7937,4814,5897,41.40946277611126,0.029993049180327868,Very Cheap
20140915T000000,355000.0,3,1.0,1360,8968,1.0,0,0,3,7,1360,0,1956,0,98125,47.7105,-122.289,1490,7355,7608,5865,39.58519179304193,0.036721311475409836,Very Cheap
20140820T000000,350000.0,2,1.0,800,5040,1.0,0,0,3,6,800,0,1960,0,98117,47.6953,-122.362,1020,5040,4240,4020,69.44444444444444,0.036065573770491806,Very Cheap
20150414T000000,754999.0,4,2.5,3010,9323,2.0,0,0,3,10,3010,0,1992,0,98075,47.578,-122.053,2840,8413,6313,5573,80.98240909578462,0.08918019672131147,Very Cheap
20150331T000000,982218.0,3,1.75,2340,5500,2.0,0,2,3,9,2340,0,1988,0,98102,47.6451,-122.319,2830,5500,3160,2670,178.58509090909092,0.11897940983606557,Cheap
20140927T000000,406500.0,3,2.0,1780,8621,1.0,0,0,3,8,1780,0,1992,0,98059,47.5062,-122.149,2470,8542,6841,6072,47.15230251710938,0.04347540983606557,Very Cheap
20150401T000000,1650000.0,4,3.25,4200,210394,2.0,0,0,4,10,4200,0,1993,0,98024,47.5607,-121.961,2370,184694,206194,182324,7.842428966605511,0.20655737704918034,Cheap
20150217T000000,565000.0,2,1.75,1720,3000,1.0,0,0,5,7,860,860,1925,0,98103,47.686,-122.351,1360,4500,1280,3140,188.33333333333334,0.06426229508196721,Very Cheap
20141106T000000,160000.0,2,1.0,830,4500,1.0,0,0,3,6,830,0,1920,0,98118,47.5248,-122.265,1092,5350,3670,4258,35.55555555555556,0.011147540983606558,Very Cheap
20150115T000000,220000.0,3,1.0,1090,6320,1.0,0,0,3,6,890,200,1954,0,98146,47.4976,-122.35,1460,7080,5230,5620,34.81012658227848,0.01901639344262295,Very Cheap
20150213T000000,1284000.0,5,4.25,5040,9466,2.0,0,0,3,11,5040,0,2004,0,98059,47.5282,-122.133,4300,9417,4426,5117,135.64335516585675,0.15855737704918033,Cheap
20140708T000000,970000.0,5,2.75,3500,5040,2.0,0,2,3,9,2950,550,1927,2007,98126,47.5527,-122.379,1450,5040,1540,3590,192.46031746031747,0.11737704918032787,Cheap
20140924T000000,115000.0,3,1.0,1080,6250,1.0,0,0,2,5,1080,0,1950,0,98168,47.5045,-122.33,1070,6250,5170,5180,18.4,0.005245901639344262,Very Cheap
20141215T000000,124000.0,3,1.0,1080,6250,1.0,0,0,2,5,1080,0,1950,0,98168,47.5045,-122.33,1070,6250,5170,5180,19.84,0.006426229508196721,Very Cheap
20150311T000000,157000.0,3,1.0,1080,6250,1.0,0,0,2,5,1080,0,1950,0,98168,47.5045,-122.33,1070,6250,5170,5180,25.12,0.010754098360655738,Very Cheap
20140725T000000,183000.0,3,1.0,870,5200,1.0,0,0,5,6,870,0,1969,0,98042,47.3702,-122.078,870,5200,4330,4330,35.19230769230769,0.014163934426229508,Very Cheap
20140909T000000,527000.0,4,2.5,2830,6163,2.0,0,0,3,9,2830,0,2000,0,98056,47.5227,-122.19,2730,6202,3333,3472,85.5103034236573,0.059278688524590166,Very Cheap
20140606T000000,407193.0,4,2.0,1880,14653,2.0,0,0,3,8,1880,0,1978,0,98014,47.6959,-121.921,1750,14858,12773,13108,27.78905343615642,0.043566295081967216,Very Cheap
20150313T000000,970000.0,4,2.75,3600,5040,2.0,0,0,3,9,2610,990,2004,0,98199,47.6487,-122.388,1590,5040,1440,3450,192.46031746031747,0.11737704918032787,Cheap
20140527T000000,535000.0,4,2.5,2340,5600,2.0,0,0,3,7,2340,0,1921,2013,98146,47.5117,-122.379,1310,5600,3260,4290,95.53571428571429,0.06032786885245902,Very Cheap
20140814T000000,245000.0,3,2.0,2040,13125,1.0,0,0,3,6,810,1230,1910,0,98168,47.478,-122.278,1460,10582,11085,9122,18.666666666666668,0.022295081967213116,Very Cheap
20140623T000000,337000.0,3,1.75,1310,12750,1.0,0,0,3,7,1310,0,1993,0,98059,47.4695,-122.07,1790,13500,11440,11710,26.431372549019606,0.034360655737704915,Very Cheap
20150321T000000,630000.0,3,2.0,1470,6000,1.0,0,0,3,8,1090,380,1950,1996,98033,47.6829,-122.202,1880,7799,4530,5919,105.0,0.07278688524590164,Very Cheap
20140606T000000,320000.0,3,1.75,1370,9900,1.0,0,0,4,7,1370,0,1983,0,98003,47.2575,-122.312,1490,9600,8530,8110,32.323232323232325,0.032131147540983604,Very Cheap
20150226T000000,228500.0,3,1.0,1080,7486,1.5,0,0,3,6,990,90,1942,0,98146,47.4838,-122.335,1170,7800,6406,6630,30.523644135720012,0.020131147540983607,Very Cheap
20150223T000000,293000.0,3,2.5,1990,7577,2.0,0,0,3,7,1990,0,1990,0,98023,47.2908,-122.351,1900,7152,5587,5252,38.66965817605912,0.02859016393442623,Very Cheap
20140924T000000,447000.0,3,1.0,1310,7000,1.0,0,0,4,7,1310,0,1958,0,98008,47.6019,-122.123,1280,7300,5690,6020,63.857142857142854,0.04878688524590164,Very Cheap
20140507T000000,226500.0,3,1.75,1640,10762,1.0,0,0,3,7,1130,510,1988,0,98042,47.3586,-122.074,1680,10259,9122,8579,21.04627392677941,0.019868852459016394,Very Cheap
20141209T000000,436000.0,3,2.25,1770,8000,1.0,0,0,4,7,1350,420,1976,0,98072,47.7358,-122.17,1850,7875,6230,6025,54.5,0.047344262295081964,Very Cheap
20140804T000000,451000.0,3,2.5,2050,4876,2.0,0,0,3,8,2050,0,2005,0,98072,47.7746,-122.158,2320,4065,2826,1745,92.49384741591469,0.04931147540983607,Very Cheap
20150408T000000,315000.0,3,1.0,1170,62290,2.0,0,0,3,5,1170,0,1986,0,98045,47.5104,-121.787,1810,42173,61120,40363,5.056991491411141,0.031475409836065574,Very Cheap
20141028T000000,450000.0,2,1.0,1340,7250,1.0,0,0,4,7,1340,0,1951,0,98125,47.7015,-122.32,1450,7026,5910,5576,62.06896551724138,0.04918032786885246,Very Cheap
20141201T000000,635000.0,3,1.5,2240,5300,1.0,0,0,5,7,1120,1120,1955,0,98117,47.6927,-122.395,1740,7110,3060,5370,119.81132075471699,0.07344262295081967,Very Cheap
20150325T000000,292500.0,2,1.0,880,17743,1.0,0,0,4,5,880,0,1951,0,98031,47.4115,-122.197,1217,13000,16863,11783,16.485374513892804,0.028524590163934428,Very Cheap
20140520T000000,329900.0,3,2.5,2170,4905,2.0,0,0,3,8,2170,0,2004,0,98038,47.3503,-122.039,2300,4935,2735,2635,67.2579001019368,0.03342950819672131,Very Cheap
20141118T000000,531000.0,2,1.5,1260,6660,1.5,0,0,4,7,1260,0,1926,0,98115,47.6792,-122.287,2140,4770,5400,2630,79.72972972972973,0.05980327868852459,Very Cheap
20140731T000000,725000.0,3,1.75,1880,13300,1.0,0,0,3,7,1380,500,1967,0,98004,47.634,-122.204,3550,10883,11420,7333,54.51127819548872,0.08524590163934426,Very Cheap
20140525T000000,355300.0,3,2.5,1620,7410,1.0,0,0,5,7,1620,0,1955,0,98133,47.7708,-122.335,1450,8121,5790,6671,47.94871794871795,0.03676065573770492,Very Cheap
20150427T000000,280000.0,3,2.5,1610,10022,2.0,0,0,3,7,1610,0,1996,0,98003,47.2583,-122.3,1820,10017,8412,8197,27.938535222510477,0.026885245901639345,Very Cheap
20140630T000000,1095000.0,4,2.75,3330,9143,2.0,0,0,4,10,3330,0,1995,0,98033,47.6821,-122.19,2390,9143,5813,6753,119.76375369134857,0.13377049180327868,Cheap
20140605T000000,605004.0,4,2.0,1370,4000,2.0,0,0,3,9,1370,0,1951,1994,98199,47.6593,-122.394,2010,5720,2630,3710,151.251,0.06950872131147541,Very Cheap
20150309T000000,260000.0,2,1.0,690,6000,1.0,0,0,3,6,690,0,1949,0,98118,47.5621,-122.283,840,3030,5310,2190,43.333333333333336,0.024262295081967214,Very Cheap
20140723T000000,748000.0,4,2.5,3170,4979,2.0,0,0,4,7,2570,600,1925,0,98103,47.6655,-122.34,2060,5000,1809,2940,150.2309700743121,0.08826229508196722,Very Cheap
20150416T000000,776000.0,2,2.0,1990,6180,1.0,0,0,4,7,1010,980,1941,0,98115,47.6792,-122.303,1470,5150,4190,3680,125.5663430420712,0.09193442622950819,Very Cheap
20140916T000000,425000.0,4,1.0,1080,6095,1.5,0,0,4,6,1080,0,1924,0,98103,47.6962,-122.346,1200,5060,5015,3860,69.7292863002461,0.04590163934426229,Very Cheap
20150108T000000,230000.0,4,1.0,1870,14703,1.5,0,0,3,6,1090,780,1928,0,98118,47.5274,-122.281,1650,6045,12833,4395,15.643066040944024,0.020327868852459016,Very Cheap
20150130T000000,418000.0,3,1.75,1670,12075,1.0,0,0,3,7,1370,300,1958,0,98155,47.7681,-122.307,1800,12123,10405,10323,34.616977225672876,0.04498360655737705,Very Cheap
20140804T000000,440000.0,4,2.5,2800,28254,2.0,0,0,3,9,2800,0,2001,0,98038,47.3552,-122.063,2530,4694,25454,2164,15.573016210094146,0.04786885245901639,Very Cheap
20141124T000000,858450.0,5,2.75,3460,7977,2.0,0,0,3,9,3460,0,2011,0,98074,47.5908,-122.062,3390,6630,4517,3240,107.61564497931553,0.10274754098360656,Cheap
20141007T000000,390000.0,3,2.0,1930,12443,1.0,0,0,3,7,1930,0,1969,0,98045,47.4906,-121.775,1400,12183,10513,10783,31.342923732218917,0.04131147540983607,Very Cheap
20140916T000000,957000.0,4,3.0,2370,3836,2.0,0,0,3,9,1750,620,1969,2008,98107,47.6718,-122.394,1690,4698,1466,3008,249.4786235662148,0.11567213114754098,Cheap
20140904T000000,507000.0,3,1.0,1180,6000,1.0,0,0,3,7,1180,0,1950,0,98115,47.6853,-122.286,1680,6000,4820,4320,84.5,0.05665573770491803,Very Cheap
20150225T000000,575000.0,2,1.0,1320,4750,1.5,0,0,4,7,1320,0,1928,0,98107,47.6729,-122.38,1360,2873,3430,1513,121.05263157894737,0.06557377049180328,Very Cheap
20150427T000000,700000.0,3,1.75,1350,4000,1.5,0,0,4,7,1350,0,1925,0,98103,47.6581,-122.354,1880,4000,2650,2120,175.0,0.08196721311475409,Very Cheap
20150205T000000,239950.0,2,1.5,1068,1452,2.0,0,0,3,7,1068,0,1990,0,98028,47.753,-122.244,1078,1357,384,279,165.2548209366391,0.021632786885245902,Very Cheap
20141103T000000,253000.0,3,1.0,1580,8240,1.0,0,0,4,7,1040,540,1978,0,98030,47.3542,-122.181,1480,9200,6660,7720,30.703883495145632,0.023344262295081967,Very Cheap
20150327T000000,540000.0,4,1.0,1690,3417,1.5,0,0,3,7,1690,0,1907,0,98199,47.663,-122.402,1970,4800,1727,2830,158.03336259877085,0.06098360655737705,Very Cheap
20150206T000000,1550000.0,3,4.0,5120,4600,3.0,0,2,3,11,4490,630,2008,0,98034,47.7052,-122.223,2510,5918,-520,3408,336.95652173913044,0.19344262295081968,Cheap
20141112T000000,805000.0,4,2.5,3960,38615,2.0,0,0,3,10,3960,0,2000,0,98077,47.7249,-122.024,3290,43560,34655,40270,20.846821183477925,0.09573770491803278,Very Cheap
20140612T000000,920000.0,4,3.25,2420,4000,1.5,0,0,5,9,1870,550,1911,0,98105,47.6567,-122.325,1810,4000,1580,2190,230.0,0.11081967213114755,Cheap
20141105T000000,496600.0,3,2.5,1910,5562,2.0,0,0,3,8,1910,0,1988,0,98029,47.5738,-122.017,1940,4647,3652,2707,89.28443006112909,0.055291803278688524,Very Cheap
20141016T000000,246000.0,3,2.25,1440,10500,1.0,0,0,3,8,1130,310,1983,0,98023,47.318,-122.391,1510,8125,9060,6615,23.428571428571427,0.02242622950819672,Very Cheap
20150505T000000,350000.0,5,3.0,2320,8400,1.0,0,0,3,7,1510,810,1963,0,98106,47.557,-122.365,1200,4800,6080,3600,41.666666666666664,0.036065573770491806,Very Cheap
20140523T000000,585000.0,3,2.0,1670,4572,1.5,0,0,3,8,1670,0,1931,0,98117,47.6854,-122.373,1480,4890,2902,3410,127.95275590551181,0.06688524590163934,Very Cheap
20150323T000000,450000.0,3,1.75,1390,11700,1.0,0,0,4,7,1390,0,1966,0,98033,47.7002,-122.192,1060,8686,10310,7626,38.46153846153846,0.04918032786885246,Very Cheap
20140512T000000,746000.0,3,2.5,2620,8950,2.0,0,0,3,9,2620,0,1992,0,98006,47.5523,-122.119,2850,8809,6330,5959,83.35195530726257,0.088,Very Cheap
20141027T000000,598555.0,3,2.5,3040,7880,2.0,0,0,3,9,3040,0,2004,0,98056,47.5277,-122.184,3040,7880,4840,4840,75.95875634517766,0.06866295081967214,Very Cheap
20141030T000000,820000.0,3,2.5,2990,10711,1.0,1,4,3,9,1560,1430,1976,1991,98198,47.3573,-122.324,2870,11476,7721,8606,76.55681075529829,0.09770491803278689,Very Cheap
20141021T000000,266500.0,3,2.25,1740,5460,1.0,0,0,3,7,1210,530,1998,0,98038,47.3648,-122.046,1740,7500,3720,5760,48.80952380952381,0.025114754098360656,Very Cheap
20150323T000000,370000.0,2,1.0,2360,105850,1.0,0,2,2,6,1180,1180,1947,0,98022,47.2495,-121.97,2640,386812,103490,384172,3.495512517713746,0.038688524590163934,Very Cheap
20140904T000000,625000.0,3,2.75,2240,3600,2.5,0,0,3,7,1650,590,1901,0,98102,47.6244,-122.326,1716,3120,1360,1404,173.61111111111111,0.07213114754098361,Very Cheap
20141210T000000,243500.0,4,2.0,1610,6200,1.0,0,0,4,7,1610,0,1979,0,98198,47.3833,-122.306,1610,7500,4590,5890,39.274193548387096,0.022098360655737705,Very Cheap
20150317T000000,340000.0,2,1.0,700,5829,1.0,0,0,3,6,700,0,1945,0,98103,47.6958,-122.357,1160,6700,5129,5540,58.329044433007375,0.03475409836065574,Very Cheap
20140918T000000,559950.0,5,3.0,2730,9519,1.0,0,0,3,8,1670,1060,2014,0,98155,47.7504,-122.307,1150,9519,6789,8369,58.824456350456984,0.0636,Very Cheap
20150219T000000,315000.0,3,2.75,1780,15114,1.0,0,0,3,7,1080,700,1980,0,98003,47.258,-122.305,1792,10155,13334,8363,20.841603811036126,0.031475409836065574,Very Cheap
20150428T000000,753000.0,3,2.5,3070,223463,2.0,0,0,3,9,3070,0,2003,0,98053,47.664,-121.993,3640,223463,220393,219823,3.3696853617824876,0.08891803278688525,Very Cheap
20150128T000000,800000.0,3,3.0,2060,3200,2.0,0,0,3,8,2060,0,1907,1984,98102,47.637,-122.324,1760,2669,1140,909,250.0,0.09508196721311475,Very Cheap
20140911T000000,550000.0,3,2.25,1360,5111,1.5,0,0,5,7,1360,0,1934,0,98115,47.6988,-122.313,1900,5111,3751,3211,107.61103502250049,0.06229508196721312,Very Cheap
20141106T000000,465000.0,3,2.0,1430,14250,1.0,0,0,3,7,1430,0,1953,0,98033,47.701,-122.199,1530,11475,12820,9945,32.63157894736842,0.051147540983606556,Very Cheap
20140528T000000,465000.0,3,2.25,1840,5752,2.0,0,0,3,7,1840,0,2003,0,98034,47.7042,-122.187,1670,2462,3912,792,80.84144645340751,0.051147540983606556,Very Cheap
20150410T000000,710000.0,4,2.25,2000,8068,2.0,0,0,5,8,2000,0,1976,0,98006,47.5584,-122.137,2080,7837,6068,5757,88.0019831432821,0.08327868852459017,Very Cheap
20141216T000000,505000.0,3,2.5,1820,11012,2.0,0,0,3,8,1820,0,1988,0,98074,47.6358,-122.026,1860,7767,9192,5907,45.8590628405376,0.05639344262295082,Very Cheap
20150318T000000,690000.0,3,1.75,2330,16300,2.0,0,0,3,9,2330,0,1964,0,98034,47.7037,-122.24,2330,16300,13970,13970,42.331288343558285,0.08065573770491803,Very Cheap
20141121T000000,217500.0,2,2.0,1070,8400,1.0,0,0,4,7,1070,0,1980,0,98031,47.4014,-122.186,1430,8190,7330,6760,25.892857142857142,0.018688524590163933,Very Cheap
20140902T000000,500000.0,2,1.0,930,3750,1.0,0,0,4,7,930,0,1909,0,98115,47.6733,-122.296,1740,4300,2820,2560,133.33333333333334,0.05573770491803279,Very Cheap
20150218T000000,325000.0,2,2.0,1040,5796,1.0,0,2,4,6,1040,0,1921,0,98155,47.7362,-122.29,2300,5796,4756,3496,56.07315389924086,0.03278688524590164,Very Cheap
20140825T000000,500000.0,4,2.25,1960,12436,2.0,0,0,3,8,1960,0,1984,0,98074,47.6276,-122.037,1960,12436,10476,10476,40.205853972338375,0.05573770491803279,Very Cheap
20150331T000000,721500.0,3,3.25,2970,234788,2.0,0,3,3,9,2040,930,1991,0,98024,47.5353,-121.897,2970,220413,231818,217443,3.072984990715028,0.08478688524590164,Very Cheap
20140519T000000,924000.0,3,1.5,2200,5000,1.5,0,0,3,9,2200,0,1932,0,98199,47.6404,-122.408,2860,5000,2800,2140,184.8,0.11134426229508197,Cheap
20140604T000000,2005000.0,6,4.5,3810,28176,1.0,0,4,5,10,3810,0,1969,0,98177,47.7612,-122.381,3810,26400,24366,22590,71.15985235661556,0.25311475409836065,Cheap
20150415T000000,345000.0,2,1.5,830,1034,2.0,0,0,3,8,830,0,2009,0,98144,47.5926,-122.3,1130,2534,204,1404,333.65570599613153,0.03540983606557377,Very Cheap
20150316T000000,825000.0,4,3.5,3920,11086,2.0,0,0,3,10,3920,0,1999,0,98065,47.5416,-121.869,3740,10880,7166,7140,74.41818509832221,0.09836065573770492,Very Cheap
20140926T000000,560000.0,3,2.0,2870,95396,1.0,0,0,4,9,1350,1520,1980,0,98027,47.4834,-122.001,2870,102366,92526,99496,5.8702670971529205,0.06360655737704918,Very Cheap
20140708T000000,599000.0,3,2.0,2560,14680,1.0,0,0,3,8,1330,1230,1987,0,98052,47.648,-122.118,2390,13848,12120,11458,40.80381471389646,0.06872131147540983,Very Cheap
20140512T000000,211000.0,3,1.5,1350,7620,1.0,0,0,5,6,1350,0,1941,0,98166,47.4565,-122.35,1350,7620,6270,6270,27.69028871391076,0.01783606557377049,Very Cheap
20150424T000000,425000.0,4,2.25,1240,21190,1.0,0,0,3,8,910,330,1974,0,98056,47.5123,-122.197,1760,8200,19950,6440,20.05663048607834,0.04590163934426229,Very Cheap
20150107T000000,750000.0,4,2.75,3210,8520,1.0,0,2,4,7,1810,1400,1976,0,98177,47.7743,-122.388,2450,7360,5310,4910,88.02816901408451,0.08852459016393442,Very Cheap
20150116T000000,479000.0,3,2.5,1690,3322,2.0,0,0,3,7,1690,0,2003,0,98053,47.6824,-122.036,1650,3446,1632,1796,144.19024683925346,0.05298360655737705,Very Cheap
20150227T000000,612500.0,4,2.5,2550,10623,2.0,0,0,3,9,2550,0,1992,0,98029,47.5695,-121.992,2750,8100,8073,5350,57.657912077567545,0.07049180327868852,Very Cheap
20150505T000000,605000.0,5,1.75,3240,34510,2.0,0,0,4,7,2690,550,1963,0,98029,47.5529,-122.027,2650,28250,31270,25600,17.53115039119096,0.06950819672131148,Very Cheap
20150223T000000,1364000.0,4,2.5,3560,8960,2.0,0,0,3,10,3560,0,2001,0,98033,47.6903,-122.213,1660,7680,5400,6020,152.23214285714286,0.16904918032786886,Cheap
20141202T000000,389900.0,3,2.5,2160,59241,1.0,0,0,3,7,2160,0,2007,0,98042,47.3304,-122.13,2290,125017,57081,122727,6.581590452558195,0.041298360655737706,Very Cheap
20141215T000000,710000.0,4,2.5,3060,5000,2.0,0,0,3,9,3060,0,2006,0,98059,47.5395,-122.188,2870,5548,1940,2678,142.0,0.08327868852459017,Very Cheap
20150505T000000,295000.0,3,2.5,1690,8564,2.0,0,0,4,7,1690,0,1992,0,98038,47.3518,-122.057,1690,7532,6874,5842,34.446520317608595,0.028852459016393443,Very Cheap
20140702T000000,275250.0,3,2.25,1520,7199,2.0,0,0,4,7,1520,0,1992,0,98038,47.3492,-122.034,1410,6751,5679,5341,38.23447701069593,0.026262295081967212,Very Cheap
20140912T000000,250000.0,4,2.5,2040,5770,2.0,0,0,3,7,2040,0,1994,0,98038,47.3522,-122.059,1570,6753,3730,5183,43.327556325823224,0.022950819672131147,Very Cheap
20150220T000000,709000.0,3,2.0,2360,18000,1.0,0,0,4,8,2180,180,1951,0,98177,47.7133,-122.367,2600,17300,15640,14700,39.388888888888886,0.08314754098360656,Very Cheap
20140708T000000,399500.0,4,1.75,1360,4840,1.5,0,0,4,7,1360,0,1928,0,98126,47.556,-122.376,1320,4840,3480,3520,82.54132231404958,0.04255737704918033,Very Cheap
20140509T000000,225000.0,3,2.5,2000,9202,2.0,0,0,4,7,2000,0,1992,0,98038,47.3516,-122.057,1750,7827,7202,6077,24.4512062595088,0.019672131147540985,Very Cheap
20150112T000000,500000.0,3,2.5,1650,4648,2.0,0,0,3,8,1650,0,2001,0,98075,47.5968,-122.015,1800,5637,2998,3837,107.57314974182444,0.05573770491803279,Very Cheap
20140609T000000,364900.0,3,3.0,2500,8304,2.0,0,0,3,8,2500,0,1997,0,98031,47.4022,-122.166,2290,7855,5804,5565,43.94267822736031,0.03801967213114754,Very Cheap
20141113T000000,356000.0,3,1.5,1140,7500,1.0,0,0,3,7,1140,0,1976,0,98074,47.619,-122.064,1380,7500,6360,6120,47.46666666666667,0.03685245901639344,Very Cheap
20150202T000000,616750.0,3,1.5,2140,47743,1.5,0,0,3,9,2140,0,1978,0,98106,47.5402,-122.365,1060,6016,45603,4956,12.91812412290807,0.07104918032786885,Very Cheap
20141202T000000,755000.0,3,2.75,2870,6600,2.0,0,2,3,8,2870,0,1984,0,98008,47.5745,-122.113,2570,7925,3730,5355,114.39393939393939,0.08918032786885247,Very Cheap
20140812T000000,327500.0,2,1.0,830,8183,1.0,0,0,5,6,830,0,1950,0,98155,47.7366,-122.302,1180,8184,7353,7004,40.02199682268117,0.033114754098360656,Very Cheap
20150415T000000,605000.0,3,2.25,1960,10139,2.0,0,0,3,8,1960,0,1984,0,98074,47.6481,-122.061,2080,9753,8179,7673,59.670578952559424,0.06950819672131148,Very Cheap
20150413T000000,179950.0,4,1.5,1130,5200,1.0,0,0,3,6,1130,0,1968,0,98042,47.3616,-122.089,1140,5200,4070,4060,34.60576923076923,0.013763934426229509,Very Cheap
20141219T000000,633000.0,5,2.75,3630,30570,2.0,0,0,3,11,3630,0,2000,0,98058,47.4243,-122.097,3620,41965,26940,38345,20.70657507360157,0.07318032786885247,Very Cheap
20150312T000000,349950.0,4,2.0,1764,15600,1.0,0,0,5,7,1764,0,1942,0,98058,47.4318,-122.181,1490,22387,13836,20897,22.432692307692307,0.036059016393442625,Very Cheap
20150407T000000,1080000.0,3,2.75,2770,5800,1.0,0,0,4,8,1650,1120,1959,0,98199,47.6496,-122.413,2340,5800,3030,3460,186.20689655172413,0.1318032786885246,Cheap
20150430T000000,425000.0,3,2.5,2650,12247,2.0,0,0,3,9,2650,0,2002,0,98001,47.3185,-122.259,2920,8965,9597,6045,34.70237609210419,0.04590163934426229,Very Cheap
20140917T000000,990000.0,3,2.75,2500,6350,2.0,0,0,5,9,2370,130,1979,0,98122,47.6035,-122.285,2090,5454,3850,3364,155.90551181102362,0.12,Cheap
20140627T000000,410000.0,3,1.0,2710,19000,2.0,0,3,4,7,2710,0,1950,0,98166,47.4462,-122.359,2150,19000,16290,16850,21.57894736842105,0.043934426229508196,Very Cheap
20141111T000000,590000.0,3,2.25,2490,8800,2.0,0,0,4,8,2490,0,1975,0,98006,47.5666,-122.132,2690,10000,6310,7310,67.04545454545455,0.06754098360655737,Very Cheap
20150408T000000,242000.0,3,1.75,1500,7560,1.0,0,0,3,7,1500,0,1979,0,98003,47.3467,-122.296,1500,7560,6060,6060,32.01058201058201,0.021901639344262296,Very Cheap
20141125T000000,775000.0,3,2.0,1160,13747,1.0,0,0,5,5,580,580,1931,0,98075,47.585,-122.051,2961,16320,12587,13359,56.37593656797847,0.09180327868852459,Very Cheap
20140625T000000,680000.0,4,1.5,1880,6200,1.0,0,2,5,8,1440,440,1954,0,98146,47.5035,-122.384,2070,6500,4320,4430,109.6774193548387,0.07934426229508197,Very Cheap
20150327T000000,217000.0,3,2.5,1340,4200,2.0,0,0,3,7,1340,0,2002,0,98002,47.2942,-122.226,990,4520,2860,3530,51.666666666666664,0.01862295081967213,Very Cheap
20150421T000000,395000.0,3,2.5,1960,3953,2.0,0,0,3,8,1960,0,1999,0,98059,47.4904,-122.158,1690,3593,1993,1903,99.92410827219832,0.0419672131147541,Very Cheap
20140519T000000,572500.0,3,2.25,2030,9791,1.0,0,0,4,8,1500,530,1984,0,98059,47.534,-122.161,2030,11031,7761,9001,58.472066183229494,0.06524590163934427,Very Cheap
20140909T000000,559900.0,5,3.0,2200,6380,1.0,0,0,3,7,1440,760,1987,0,98125,47.7033,-122.322,1960,5800,4180,3840,87.75862068965517,0.06359344262295082,Very Cheap
20140624T000000,845000.0,3,2.0,2540,4750,1.5,0,0,5,9,1840,700,1930,0,98117,47.6838,-122.4,2190,4750,2210,2560,177.89473684210526,0.10098360655737705,Cheap
20140728T000000,241000.0,3,2.0,1520,7131,1.0,0,0,3,8,1520,0,1993,0,98023,47.3061,-122.361,1890,7379,5611,5489,33.79610152853737,0.02177049180327869,Very Cheap
20141001T000000,1325000.0,3,2.25,2360,5504,2.0,0,0,4,8,2080,280,1913,0,98122,47.617,-122.288,2840,5470,3144,2630,240.73401162790697,0.16393442622950818,Cheap
20150429T000000,475000.0,3,1.75,1340,2805,1.5,0,0,3,7,1340,0,1919,0,98144,47.5922,-122.297,1650,2805,1465,1155,169.34046345811052,0.05245901639344262,Very Cheap
20150218T000000,575000.0,2,1.5,1400,5810,2.0,0,0,3,7,1400,0,1940,0,98103,47.6843,-122.341,1470,3920,4410,2450,98.96729776247848,0.06557377049180328,Very Cheap
20140828T000000,455000.0,4,2.75,3030,117378,1.0,0,0,4,8,1680,1350,1959,0,98042,47.401,-122.135,2060,110957,114348,108897,3.876365247320622,0.049836065573770495,Very Cheap
20140624T000000,839000.0,3,2.5,3200,203425,1.0,0,0,3,10,3200,0,2000,0,98077,47.7614,-122.015,3200,203425,200225,200225,4.124370160992995,0.1001967213114754,Cheap
20150430T000000,475000.0,4,1.5,1580,10260,1.0,0,0,4,7,1030,550,1955,0,98007,47.5984,-122.147,1520,7000,8680,5480,46.2962962962963,0.05245901639344262,Very Cheap
20141208T000000,600000.0,2,1.0,2120,6897,1.0,0,0,4,7,1060,1060,1923,0,98118,47.5566,-122.278,1900,4462,4777,2562,86.9943453675511,0.06885245901639345,Very Cheap
20141106T000000,515000.0,2,1.0,1640,5200,1.0,0,0,4,7,1040,600,1937,0,98199,47.6426,-122.403,1780,5040,3560,3260,99.03846153846153,0.057704918032786885,Very Cheap
20150318T000000,425000.0,3,2.25,1890,8400,1.0,0,0,3,8,1520,370,1977,0,98034,47.7103,-122.232,1830,7980,6510,6150,50.595238095238095,0.04590163934426229,Very Cheap
20141007T000000,565000.0,4,2.0,1710,3875,1.5,0,0,4,7,1710,0,1907,0,98122,47.6086,-122.294,1710,3812,2165,2102,145.80645161290323,0.06426229508196721,Very Cheap
20140523T000000,498000.0,2,2.0,1140,8282,1.0,0,0,3,6,1140,0,1924,2009,98033,47.6949,-122.21,1650,9000,7142,7350,60.13040328423086,0.055475409836065574,Very Cheap
20140606T000000,739000.0,4,3.0,2720,3800,2.0,0,0,5,8,1800,920,1919,0,98115,47.6756,-122.306,1940,4001,1080,2061,194.47368421052633,0.08708196721311476,Very Cheap
20140604T000000,355000.0,2,1.75,1650,4000,1.0,0,0,4,7,950,700,1947,0,98108,47.5622,-122.319,1060,4110,2350,3050,88.75,0.036721311475409836,Very Cheap
20140715T000000,263000.0,3,1.75,1790,7485,1.0,0,0,4,8,1330,460,1979,0,98023,47.3118,-122.34,1970,8097,5695,6127,35.136940547762194,0.024655737704918034,Very Cheap
20140905T000000,375000.0,4,1.75,1680,6834,1.5,0,0,3,7,1680,0,1948,0,98125,47.716,-122.307,950,7425,5154,6475,54.87269534679543,0.03934426229508197,Very Cheap
20140930T000000,322000.0,3,1.75,2200,12231,1.0,0,0,4,7,1250,950,1964,0,98056,47.5076,-122.173,2200,9825,10031,7625,26.326547297849725,0.03239344262295082,Very Cheap
20150429T000000,325000.0,2,1.0,830,5100,1.0,0,0,3,6,830,0,1941,0,98103,47.6932,-122.346,1050,5100,4270,4050,63.72549019607843,0.03278688524590164,Very Cheap
20141021T000000,290000.0,2,1.0,770,4800,1.0,0,0,3,7,770,0,1943,0,98136,47.527,-122.383,1390,4800,4030,3410,60.416666666666664,0.02819672131147541,Very Cheap
20140611T000000,809950.0,4,2.5,3280,6181,2.0,0,0,3,10,3280,0,2001,0,98074,47.6484,-122.081,3110,7570,2901,4460,131.0386668823815,0.09638688524590164,Very Cheap
20141009T000000,969500.0,3,3.25,2080,3025,2.0,0,2,4,8,1220,860,1984,0,98122,47.6051,-122.289,2680,6518,945,3838,320.495867768595,0.11731147540983607,Cheap
20140613T000000,665000.0,4,2.5,2790,43091,2.0,0,0,4,9,2790,0,1989,0,98077,47.7759,-122.08,2750,35290,40301,32540,15.432456893550858,0.07737704918032787,Very Cheap
20150206T000000,635000.0,5,3.5,4150,13232,2.0,0,0,3,11,4150,0,2006,0,98003,47.3417,-122.182,3840,15121,9082,11281,47.989721886336156,0.07344262295081967,Very Cheap
20141029T000000,272450.0,3,2.25,1780,7332,2.0,0,0,3,7,1780,0,1987,0,98038,47.3593,-122.051,1510,7625,5552,6115,37.15902891434806,0.025895081967213116,Very Cheap
20150424T000000,427000.0,4,1.75,1460,9750,1.0,0,0,4,7,1460,0,1967,0,98008,47.6205,-122.102,1820,9840,8290,8020,43.794871794871796,0.04616393442622951,Very Cheap
20150401T000000,261500.0,3,1.0,1410,8174,1.0,0,0,3,8,1410,0,1958,0,98056,47.4969,-122.178,1500,8058,6764,6558,31.99168093956447,0.024459016393442622,Very Cheap
20140620T000000,488800.0,4,2.25,2170,9665,1.0,0,0,4,8,1300,870,1976,0,98006,47.5444,-122.165,2170,12054,7495,9884,50.574236937403,0.054268852459016394,Very Cheap
20150225T000000,340000.0,2,1.0,690,5200,1.0,0,0,3,6,690,0,1918,0,98136,47.556,-122.395,1380,5700,4510,4320,65.38461538461539,0.03475409836065574,Very Cheap
20140811T000000,398950.0,4,3.0,3000,10297,2.0,0,0,3,8,3000,0,2003,0,98042,47.3684,-122.073,2520,8366,7297,5846,38.74429445469554,0.042485245901639344,Very Cheap
20150321T000000,217000.0,3,1.0,870,5200,1.0,0,0,5,6,870,0,1969,0,98042,47.3701,-122.078,1020,5200,4330,4180,41.73076923076923,0.01862295081967213,Very Cheap
20150316T000000,799000.0,4,2.5,3170,94855,1.0,0,0,4,9,1910,1260,1978,0,98072,47.7648,-122.112,2590,65340,91685,62750,8.423383058352222,0.09495081967213115,Very Cheap
20141230T000000,160000.0,4,1.0,1540,7350,1.0,0,0,4,6,770,770,1969,0,98023,47.3318,-122.34,910,8000,5810,7090,21.768707482993197,0.011147540983606558,Very Cheap
20140902T000000,447000.0,3,1.0,1270,8800,1.0,0,0,3,7,1270,0,1968,0,98052,47.6703,-122.15,1560,8250,7530,6690,50.79545454545455,0.04878688524590164,Very Cheap
20150424T000000,765000.0,3,1.75,2190,6450,1.0,0,0,3,8,1480,710,1957,0,98136,47.5284,-122.391,2190,6450,4260,4260,118.6046511627907,0.09049180327868853,Very Cheap
20140620T000000,1320000.0,4,3.5,4410,36200,2.0,0,0,3,11,4410,0,1989,0,98006,47.5487,-122.126,4760,35860,31790,31100,36.46408839779006,0.16327868852459015,Cheap
20140822T000000,445000.0,4,2.5,2790,8111,2.0,0,0,3,9,2480,310,2004,0,98058,47.4492,-122.116,2550,7634,5321,5084,54.86376525705832,0.04852459016393443,Very Cheap
20150328T000000,310000.0,3,1.0,1510,6000,1.0,0,0,3,8,1170,340,1953,0,98118,47.5168,-122.285,1125,6000,4490,4875,51.666666666666664,0.03081967213114754,Very Cheap
20150409T000000,380000.0,2,1.75,1800,7191,1.0,0,3,4,7,990,810,1952,0,98056,47.4828,-122.191,1940,7400,5391,5460,52.84383256848839,0.04,Very Cheap
20141124T000000,325000.0,4,1.0,2410,6975,1.0,0,0,3,7,1510,900,1957,0,98108,47.5692,-122.295,1880,6255,4565,4375,46.59498207885304,0.03278688524590164,Very Cheap
20140617T000000,345000.0,4,2.75,2250,7412,1.0,0,0,4,8,1480,770,1975,0,98058,47.4449,-122.129,2070,7632,5162,5562,46.54614139233675,0.03540983606557377,Very Cheap
20141118T000000,300000.0,3,1.0,950,4760,1.5,0,0,3,6,950,0,1929,0,98106,47.5236,-122.348,1080,4760,3810,3680,63.02521008403362,0.029508196721311476,Very Cheap
20140627T000000,530000.0,4,1.75,2860,48351,1.0,0,0,3,8,1710,1150,1978,0,98077,47.7605,-122.085,2460,43560,45491,41100,10.961510620256044,0.05967213114754098,Very Cheap
20150409T000000,583500.0,4,1.75,2860,48351,1.0,0,0,3,8,1710,1150,1978,0,98077,47.7605,-122.085,2460,43560,45491,41100,12.068002730036607,0.06668852459016393,Very Cheap
20150217T000000,410000.0,2,1.0,1560,10125,1.0,0,0,4,7,1130,430,1954,0,98155,47.7488,-122.304,1680,10125,8565,8445,40.49382716049383,0.043934426229508196,Very Cheap
20140919T000000,535000.0,2,1.5,1940,5700,1.0,0,0,3,7,970,970,1937,0,98117,47.6881,-122.367,1250,5700,3760,4450,93.85964912280701,0.06032786885245902,Very Cheap
20150115T000000,2050000.0,4,3.25,3580,19989,1.5,1,4,4,7,3480,100,1915,1965,98125,47.7087,-122.276,2410,6389,16409,3979,102.55640602331282,0.25901639344262295,Cheap
20140703T000000,345000.0,4,2.5,2040,5523,2.0,0,0,3,7,2040,0,1999,0,98148,47.432,-122.328,1720,6646,3483,4926,62.466051059206954,0.03540983606557377,Very Cheap
20150410T000000,539000.0,5,1.0,1700,11727,1.5,0,0,4,7,1700,0,1954,0,98033,47.686,-122.172,1740,8212,10027,6472,45.96230920098917,0.06085245901639344,Very Cheap
20141024T000000,590000.0,4,2.5,3700,12500,1.0,0,0,5,8,1920,1780,1973,0,98006,47.5403,-122.168,2020,8350,8800,6330,47.2,0.06754098360655737,Very Cheap
20140815T000000,187000.0,2,1.75,1050,2926,1.0,0,0,4,8,1050,0,1974,0,98198,47.3811,-122.317,1150,3802,1876,2652,63.909774436090224,0.014688524590163935,Very Cheap
20140509T000000,270000.0,3,2.0,1690,9583,1.0,0,0,4,7,1690,0,1969,0,98059,47.4825,-122.164,1690,9583,7893,7893,28.174893039757904,0.025573770491803278,Very Cheap
20150329T000000,546000.0,2,1.0,1120,6180,1.0,0,0,4,7,1120,0,1939,0,98115,47.6824,-122.301,1420,5356,5060,3936,88.3495145631068,0.06177049180327869,Very Cheap
20140702T000000,520000.0,3,1.75,1490,1036,2.0,0,0,3,10,1090,400,2008,0,98199,47.6588,-122.403,1460,1206,-454,-254,501.9305019305019,0.058360655737704915,Very Cheap
20141229T000000,515000.0,5,2.0,2220,6000,1.5,0,0,4,7,1390,830,1925,0,98144,47.5822,-122.295,1600,6000,3780,4400,85.83333333333333,0.057704918032786885,Very Cheap
20140717T000000,990000.0,3,2.5,2160,6000,1.5,0,0,4,8,1880,280,1939,0,98105,47.6582,-122.28,2300,6000,3840,3700,165.0,0.12,Cheap
20150507T000000,382000.0,2,1.0,870,10492,1.0,0,0,3,7,870,0,1937,0,98106,47.5467,-122.365,1300,7987,9622,6687,36.40869233701868,0.040262295081967214,Very Cheap
20150410T000000,1210000.0,3,1.75,1900,13600,1.0,0,0,4,8,1900,0,1956,0,98004,47.6163,-122.219,2510,16600,11700,14090,88.97058823529412,0.14885245901639343,Cheap
20140626T000000,900000.0,4,3.5,3370,5000,2.0,0,2,3,8,2470,900,2008,0,98126,47.5714,-122.38,1820,5000,1630,3180,180.0,0.10819672131147541,Cheap
20150421T000000,675000.0,3,2.75,3370,5350,1.5,0,1,4,7,2310,1060,1910,0,98136,47.5373,-122.39,1720,5618,1980,3898,126.16822429906541,0.07868852459016394,Very Cheap
20141114T000000,460000.0,2,1.0,880,3300,1.0,0,0,4,7,880,0,1909,0,98107,47.6566,-122.36,1960,5500,2420,3540,139.3939393939394,0.050491803278688525,Very Cheap
20140603T000000,234000.0,2,1.0,940,5375,1.0,0,0,4,5,940,0,1952,0,98198,47.4206,-122.324,1200,7500,4435,6300,43.53488372093023,0.020852459016393442,Very Cheap
20150429T000000,399000.0,3,1.0,1340,7191,1.0,0,0,3,7,1340,0,1974,0,98034,47.7148,-122.212,1340,7215,5851,5875,55.48602419691281,0.042491803278688525,Very Cheap
20150402T000000,253500.0,3,1.5,1440,12040,1.0,0,0,4,7,1440,0,1959,0,98042,47.3715,-122.16,1720,12040,10600,10320,21.05481727574751,0.023409836065573772,Very Cheap
20140820T000000,475000.0,3,1.5,1750,12632,1.0,0,0,4,7,1750,0,1952,0,98033,47.6736,-122.176,1740,12196,10882,10456,37.60291323622546,0.05245901639344262,Very Cheap
20150330T000000,740000.0,5,3.5,3990,5000,2.0,0,0,3,8,2910,1080,2004,0,98118,47.54,-122.27,1310,5000,1010,3690,148.0,0.08721311475409836,Very Cheap
20140613T000000,799000.0,3,2.5,2860,4442,2.0,0,0,3,8,2860,0,2000,0,98199,47.661,-122.396,1440,4400,1582,2960,179.87393066186402,0.09495081967213115,Very Cheap
20150423T000000,390000.0,4,2.5,1940,3864,2.0,0,0,3,8,1940,0,2003,0,98058,47.4507,-122.12,1900,3864,1924,1964,100.93167701863354,0.04131147540983607,Very Cheap
20140915T000000,421000.0,2,1.5,1400,11245,1.0,0,0,5,7,1400,0,1947,0,98155,47.7469,-122.321,1220,11241,9845,10021,37.438861716318364,0.045377049180327866,Very Cheap
20150128T000000,296500.0,3,2.5,1770,6033,2.0,0,0,4,7,1770,0,1987,0,98042,47.3764,-122.119,1590,6510,4263,4920,49.146361677440744,0.02904918032786885,Very Cheap
20140813T000000,895000.0,4,2.0,1710,4178,1.5,0,0,4,8,1710,0,1926,0,98112,47.6373,-122.3,1760,4178,2468,2418,214.21732886548588,0.10754098360655738,Cheap
20140811T000000,386000.0,4,2.5,2810,11897,2.0,0,0,3,8,2810,0,2003,0,98092,47.3251,-122.186,1770,4240,9087,2470,32.44515424056485,0.04078688524590164,Very Cheap
20141009T000000,424000.0,3,1.0,1580,13912,1.0,0,0,4,8,1580,0,1955,0,98155,47.7552,-122.276,2130,16420,12332,14290,30.47728579643473,0.04577049180327869,Very Cheap
20140610T000000,749000.0,3,1.0,1580,5000,1.5,0,0,3,7,1580,0,1926,0,98117,47.684,-122.386,1280,4000,3420,2720,149.8,0.08839344262295082,Very Cheap
20141110T000000,523000.0,3,1.0,1440,8681,1.5,0,0,3,7,1440,0,1937,0,98115,47.6976,-122.283,1700,7770,7241,6070,60.246515378412624,0.05875409836065574,Very Cheap
20141028T000000,389000.0,4,2.5,2420,9147,2.0,0,0,3,10,2420,0,1998,0,98003,47.3221,-122.322,1400,7200,6727,5800,42.527604679129766,0.04118032786885246,Very Cheap
20140825T000000,270000.0,4,1.5,1930,15000,1.0,0,0,5,7,1930,0,1946,0,98198,47.3864,-122.312,1620,7500,13070,5880,18.0,0.025573770491803278,Very Cheap
20140910T000000,275000.0,3,1.0,1190,27215,1.0,0,0,5,7,1190,0,1943,1989,98059,47.4978,-122.115,1450,56628,26025,55178,10.104721660848796,0.02622950819672131,Very Cheap
20140905T000000,287500.0,4,2.5,2240,6944,1.0,0,2,3,7,1310,930,1979,0,98001,47.338,-122.258,1780,7477,4704,5697,41.40264976958525,0.027868852459016394,Very Cheap
20140924T000000,345000.0,2,2.5,2550,216344,2.5,0,0,3,7,2550,0,1993,0,98092,47.2584,-122.124,1750,289978,213794,288228,1.5946825426173132,0.03540983606557377,Very Cheap
20140527T000000,427000.0,2,1.0,920,3780,1.0,0,0,3,6,920,0,1910,0,98103,47.6576,-122.348,1570,2640,2860,1070,112.96296296296296,0.04616393442622951,Very Cheap
20140905T000000,508450.0,4,1.75,1520,9600,1.0,0,0,4,7,1000,520,1955,0,98006,47.5763,-122.154,1510,9000,8080,7490,52.963541666666664,0.05684590163934426,Very Cheap
20141222T000000,705000.0,3,2.0,1460,6250,1.5,0,0,4,7,1460,0,1912,0,98103,47.6693,-122.333,1690,4750,4790,3060,112.8,0.08262295081967214,Very Cheap
20141029T000000,550000.0,1,1.5,1900,40600,1.5,0,0,5,9,1450,450,1977,0,98027,47.4718,-122.009,2920,40427,38700,37507,13.54679802955665,0.06229508196721312,Very Cheap
20150501T000000,380000.0,3,1.5,1430,11173,1.0,0,0,1,7,1430,0,1955,0,98006,47.5734,-122.153,1520,11659,9743,10139,34.01056117425937,0.04,Very Cheap
20140729T000000,539900.0,3,2.5,2500,4203,2.0,0,0,3,8,2500,0,2001,0,98065,47.5346,-121.875,2460,4798,1703,2338,128.45586485843444,0.06097049180327869,Very Cheap
20140903T000000,330000.0,2,1.0,720,7250,1.0,0,0,3,5,720,0,1943,0,98027,47.5267,-122.032,1760,7250,6530,5490,45.51724137931034,0.03344262295081967,Very Cheap
20140602T000000,455000.0,2,1.0,1140,5720,1.0,0,0,3,7,850,290,1947,0,98115,47.6827,-122.298,1410,5832,4580,4422,79.54545454545455,0.049836065573770495,Very Cheap
20141007T000000,510000.0,4,4.0,3530,10935,2.0,0,0,3,10,3530,0,1992,0,98023,47.3016,-122.342,3360,11250,7405,7890,46.63923182441701,0.057049180327868855,Very Cheap
20150402T000000,315000.0,3,2.0,1220,14645,1.0,0,0,3,6,1220,0,1970,0,98059,47.4842,-122.117,1980,24960,13425,22980,21.509047456469784,0.031475409836065574,Very Cheap
20140617T000000,206000.0,3,1.0,1320,7000,1.0,0,0,4,7,1320,0,1967,0,98002,47.2787,-122.205,1260,7455,5680,6195,29.428571428571427,0.017180327868852457,Very Cheap
20140522T000000,592500.0,4,3.0,2170,8240,1.0,0,0,4,8,1370,800,1968,0,98052,47.6291,-122.093,2020,7944,6070,5924,71.90533980582525,0.06786885245901639,Very Cheap
20141023T000000,744000.0,3,2.5,2020,7512,2.0,0,0,4,8,2020,0,1981,0,98033,47.6927,-122.206,2410,8500,5492,6090,99.04153354632588,0.08773770491803279,Very Cheap
20141027T000000,334500.0,3,2.5,1990,3694,2.0,0,0,3,8,1990,0,1989,0,98042,47.3872,-122.154,2110,3842,1704,1732,90.55224688684353,0.0340327868852459,Very Cheap
20140605T000000,886000.0,4,2.0,2660,3900,1.5,0,0,4,7,1480,1180,1923,0,98112,47.6398,-122.306,2350,3900,1240,1550,227.17948717948718,0.10636065573770492,Cheap
20141021T000000,600000.0,4,2.5,2360,13500,1.0,0,0,4,8,1780,580,1973,0,98052,47.6315,-122.103,2780,12400,11140,9620,44.44444444444444,0.06885245901639345,Very Cheap
20150422T000000,850000.0,3,2.0,2740,101930,1.0,0,2,3,9,2740,0,1999,0,98045,47.5056,-121.77,2140,83635,99190,81495,8.339056215049544,0.10163934426229508,Cheap
20150408T000000,550000.0,3,1.75,1360,5850,1.0,0,0,4,7,1000,360,1938,0,98116,47.5711,-122.391,1540,5850,4490,4310,94.01709401709402,0.06229508196721312,Very Cheap
20140821T000000,184900.0,2,1.0,1230,5000,1.0,0,0,5,6,1230,0,1911,0,98022,47.2064,-121.988,1230,5413,3770,4183,36.98,0.014413114754098361,Very Cheap
20140508T000000,245000.0,3,1.5,1260,7964,1.0,0,0,4,7,1260,0,1955,0,98148,47.4307,-122.334,1510,8776,6704,7266,30.763435459568058,0.022295081967213116,Very Cheap
20140923T000000,370000.0,2,1.0,1040,4172,1.0,0,0,3,7,1040,0,1946,0,98112,47.6308,-122.302,3120,4800,3132,1680,88.68648130393098,0.038688524590163934,Very Cheap
20150421T000000,480000.0,4,2.5,2700,9700,1.0,0,0,3,8,1670,1030,1978,0,98011,47.7752,-122.198,2470,9228,7000,6758,49.48453608247423,0.05311475409836065,Very Cheap
20141121T000000,579000.0,3,1.75,1800,4429,2.0,0,0,4,7,1800,0,1906,0,98103,47.6842,-122.357,1310,4429,2629,3119,130.72928426281328,0.06609836065573771,Very Cheap
20141009T000000,339275.0,3,1.5,1590,7260,1.0,0,0,3,7,1080,510,1964,0,98133,47.7753,-122.353,1590,7594,5670,6004,46.73209366391185,0.03465901639344262,Very Cheap
20150223T000000,425000.0,3,2.75,1360,542322,1.0,0,2,4,7,1140,220,1955,0,98022,47.2069,-122.024,1700,60548,540962,58848,0.7836672677855592,0.04590163934426229,Very Cheap
20150120T000000,170000.0,3,1.75,1370,10780,1.0,0,0,3,7,1370,0,1959,0,98168,47.4727,-122.298,1370,10317,9410,8947,15.769944341372913,0.012459016393442624,Very Cheap
20140514T000000,950000.0,4,2.5,3320,7644,2.0,0,0,3,10,3320,0,1995,0,98006,47.5541,-122.106,3320,9472,4324,6152,124.28048142333857,0.11475409836065574,Cheap
20140916T000000,623000.0,4,2.5,2980,9235,1.0,0,0,4,8,1690,1290,1977,0,98006,47.5513,-122.162,2690,10046,6255,7356,67.46074715755279,0.07186885245901639,Very Cheap
20140519T000000,477000.0,3,2.5,1350,2053,3.0,0,0,3,8,1350,0,2005,0,98117,47.6758,-122.386,1350,4150,703,2800,232.3429128105212,0.052721311475409836,Very Cheap
20141010T000000,330000.0,3,1.0,1160,9600,1.0,0,0,4,7,1160,0,1967,0,98077,47.7419,-122.073,1160,9730,8440,8570,34.375,0.03344262295081967,Very Cheap
20140612T000000,600000.0,3,2.25,1480,5400,2.0,0,0,4,8,1480,0,1914,0,98122,47.6095,-122.296,1280,3600,3920,2320,111.11111111111111,0.06885245901639345,Very Cheap
20140707T000000,570000.0,3,2.0,1640,2808,1.0,0,3,4,7,820,820,1924,0,98144,47.5945,-122.291,2270,5328,1168,3058,202.991452991453,0.06491803278688525,Very Cheap
20140528T000000,515000.0,4,2.5,2680,7178,2.0,0,0,3,8,2680,0,2004,0,98065,47.5325,-121.856,2540,7133,4498,4593,71.74700473669546,0.057704918032786885,Very Cheap
20150429T000000,805000.0,4,2.25,2440,9889,1.0,0,0,3,7,1540,900,1952,0,98115,47.6932,-122.3,1710,6284,7449,4574,81.40357973505915,0.09573770491803278,Very Cheap
20150206T000000,555000.0,4,2.5,2920,24074,2.0,0,0,3,9,2920,0,1997,0,98038,47.381,-122.056,2760,26023,21154,23263,23.05391708897566,0.06295081967213115,Very Cheap
20150204T000000,245000.0,3,2.25,1780,9598,2.0,0,0,4,7,1780,0,1985,0,98030,47.3718,-122.182,1820,7533,7818,5713,25.526151281516984,0.022295081967213116,Very Cheap
20140718T000000,638150.0,4,2.5,2170,7275,1.0,0,0,3,8,1820,350,1978,0,98027,47.5672,-122.09,2390,7275,5105,4885,87.71821305841924,0.07385573770491803,Very Cheap
20150501T000000,1650000.0,4,4.5,5550,16065,2.0,0,0,3,9,3880,1670,2003,0,98040,47.5455,-122.214,3470,16488,10515,13018,102.7077497665733,0.20655737704918034,Cheap
20140811T000000,269950.0,4,2.5,2060,13500,1.0,0,0,3,7,1260,800,1968,0,98042,47.4229,-122.153,1610,10714,11440,9104,19.996296296296297,0.025567213114754097,Very Cheap
20140920T000000,195000.0,3,1.5,1050,5525,1.0,0,0,5,6,1050,0,1969,0,98042,47.3608,-122.083,1100,5200,4475,4100,35.294117647058826,0.015737704918032787,Very Cheap
20150311T000000,159100.0,2,1.0,790,7095,1.0,0,0,3,6,790,0,1944,0,98178,47.4928,-122.239,1150,7200,6305,6050,22.424242424242426,0.011029508196721311,Very Cheap
20150306T000000,550000.0,3,1.0,1010,6120,1.0,0,0,3,6,1010,0,1942,0,98033,47.6648,-122.204,1260,5977,5110,4717,89.86928104575163,0.06229508196721312,Very Cheap
20140801T000000,299000.0,2,1.0,1040,4600,1.0,0,0,4,6,1040,0,1950,0,98118,47.5387,-122.277,1390,5897,3560,4507,65.0,0.02937704918032787,Very Cheap
20150121T000000,1375000.0,4,3.5,3130,4500,2.0,0,0,3,9,2060,1070,2014,0,98103,47.677,-122.33,1500,4500,1370,3000,305.55555555555554,0.17049180327868851,Cheap
20150407T000000,249500.0,2,1.0,900,4500,1.0,0,0,3,6,900,0,1951,0,98055,47.4881,-122.204,860,4500,3600,3640,55.44444444444444,0.022885245901639345,Very Cheap
20150225T000000,700000.0,4,1.0,1470,5450,1.5,0,0,3,7,1470,0,1918,0,98112,47.6458,-122.306,2160,5450,3980,3290,128.44036697247705,0.08196721311475409,Very Cheap
20140725T000000,275000.0,4,1.0,1080,26114,1.5,0,0,5,5,1080,0,1900,0,98030,47.3834,-122.215,1720,20360,25034,18640,10.530749789385004,0.02622950819672131,Very Cheap
20150319T000000,565000.0,3,2.25,2440,8378,1.0,0,0,3,7,1480,960,1962,0,98028,47.7705,-122.26,2510,9602,5938,7092,67.4385294819766,0.06426229508196721,Very Cheap
20150503T000000,425000.0,4,1.75,2520,11017,1.0,0,0,4,7,1320,1200,1956,0,98133,47.7604,-122.356,1660,8775,8497,7115,38.57674503040755,0.04590163934426229,Very Cheap
20150227T000000,620047.0,4,1.75,1760,6000,1.0,0,0,3,7,880,880,1946,0,98119,47.6508,-122.373,2040,6000,4240,3960,103.34116666666667,0.0714815737704918,Very Cheap
20140923T000000,480000.0,3,2.25,1820,13362,1.0,0,0,3,8,1220,600,1977,0,98075,47.5898,-122.052,2050,15000,11542,12950,35.92276605298608,0.05311475409836065,Very Cheap
20150407T000000,515000.0,3,2.25,1820,13362,1.0,0,0,3,8,1220,600,1977,0,98075,47.5898,-122.052,2050,15000,11542,12950,38.54213441101631,0.057704918032786885,Very Cheap
20140514T000000,420000.0,4,2.5,3040,24123,2.0,0,0,3,8,3040,0,1999,0,98092,47.2667,-122.216,2420,10026,21083,7606,17.410769804750654,0.04524590163934426,Very Cheap
20150126T000000,610000.0,5,3.25,3490,23400,1.0,0,0,4,8,1890,1600,1957,0,98006,47.5701,-122.124,2660,12400,19910,9740,26.068376068376068,0.07016393442622951,Very Cheap
20141001T000000,849000.0,4,1.5,2440,8040,1.0,0,0,4,8,1440,1000,1950,0,98177,47.7081,-122.374,2140,7920,5600,5780,105.59701492537313,0.10150819672131148,Cheap
20141119T000000,718000.0,3,1.75,2280,3446,2.0,0,0,3,8,2280,0,1949,1991,98125,47.715,-122.282,1610,6670,1166,5060,208.35751596053396,0.08432786885245902,Very Cheap
20140506T000000,295000.0,3,2.25,1980,8000,1.0,0,0,4,9,1560,420,1974,0,98023,47.3149,-122.378,2360,8000,6020,5640,36.875,0.028852459016393443,Very Cheap
20150430T000000,871000.0,5,1.75,2360,6150,1.0,0,0,5,7,1180,1180,1940,0,98107,47.6732,-122.4,2100,5500,3790,3400,141.6260162601626,0.10439344262295082,Cheap
20140528T000000,430000.0,3,3.75,3890,7140,1.0,0,2,3,8,2390,1500,1943,2007,98178,47.5073,-122.239,1820,7320,3250,5500,60.22408963585434,0.04655737704918033,Very Cheap
20140825T000000,440000.0,4,2.5,2300,10880,1.0,0,0,4,7,1190,1110,1961,0,98028,47.7341,-122.242,1960,10400,8580,8440,40.44117647058823,0.04786885245901639,Very Cheap
20140527T000000,405000.0,2,1.0,910,6490,1.0,0,0,3,7,910,0,1942,0,98115,47.6892,-122.306,1040,6490,5580,5450,62.40369799691834,0.043278688524590166,Very Cheap
20140811T000000,340000.0,3,2.0,1140,11620,1.0,0,0,3,7,1140,0,1994,0,98045,47.4991,-121.783,1140,8400,10480,7260,29.259896729776248,0.03475409836065574,Very Cheap
20140710T000000,675000.0,4,2.5,2390,5249,2.0,0,0,3,9,2390,0,2006,0,98074,47.6194,-122.026,2600,5342,2859,2742,128.59592303295867,0.07868852459016394,Very Cheap
20140527T000000,480000.0,3,1.0,1150,4945,1.0,0,2,3,7,1150,0,1943,0,98126,47.5663,-122.379,1390,4945,3795,3555,97.06774519716886,0.05311475409836065,Very Cheap
20141020T000000,362500.0,5,2.0,2330,8586,1.0,0,0,4,7,1270,1060,1961,0,98133,47.7671,-122.334,1550,8287,6256,6737,42.21989284882367,0.03770491803278689,Very Cheap
20140822T000000,752888.0,3,2.5,2420,9000,2.0,0,0,4,9,2420,0,1987,0,98007,47.6599,-122.146,2630,9000,6580,6370,83.65422222222222,0.08890334426229508,Very Cheap
20141118T000000,255000.0,4,1.75,960,8863,1.0,0,0,5,6,580,380,1949,0,98118,47.5372,-122.289,1720,8249,7903,6529,28.771296400767234,0.02360655737704918,Very Cheap
20140813T000000,283700.0,1,1.75,1010,10900,1.0,0,0,4,6,1010,0,1968,0,98019,47.7391,-121.982,1410,8359,9890,6949,26.027522935779817,0.027370491803278687,Very Cheap
20140825T000000,335000.0,4,2.5,2370,6000,2.0,0,0,3,8,2370,0,2001,0,98030,47.3732,-122.179,2190,6070,3630,3880,55.833333333333336,0.03409836065573771,Very Cheap
20140603T000000,285000.0,3,1.75,2880,18296,1.0,0,0,3,8,1580,1300,1958,0,98168,47.4881,-122.281,1380,9592,15416,8212,15.577175338871884,0.02754098360655738,Very Cheap
20140813T000000,278000.0,4,2.25,2400,7738,1.5,0,0,3,8,2400,0,1964,0,98148,47.4562,-122.33,2170,8452,5338,6282,35.92659601964332,0.02662295081967213,Very Cheap
20150327T000000,731000.0,5,2.5,3670,8960,1.5,0,0,3,8,3670,0,1973,0,98052,47.6654,-122.142,2340,9425,5290,7085,81.58482142857143,0.0860327868852459,Very Cheap
20150310T000000,335000.0,3,1.5,1140,15890,1.0,0,0,3,7,840,300,1985,0,98045,47.4752,-121.757,1200,15247,14750,14047,21.082441787287603,0.03409836065573771,Very Cheap
20150323T000000,334200.0,3,1.75,1410,45302,1.0,0,0,3,7,1410,0,1980,0,98019,47.7077,-121.914,2240,49222,43892,46982,7.3771577413800715,0.03399344262295082,Very Cheap
20150225T000000,642000.0,6,1.0,1530,4305,1.5,0,0,4,7,1530,0,1921,0,98115,47.6862,-122.31,1530,3800,2775,2270,149.12891986062718,0.07436065573770492,Very Cheap
20140602T000000,540000.0,4,1.75,1720,4240,1.5,0,0,4,7,1460,260,1925,0,98144,47.579,-122.294,1930,4280,2520,2350,127.35849056603773,0.06098360655737705,Very Cheap
20150331T000000,299000.0,3,2.5,1620,79993,1.0,0,2,4,6,1620,0,1960,0,98022,47.2138,-121.982,1620,15680,78373,14060,3.7378270598677386,0.02937704918032787,Very Cheap
20150120T000000,560000.0,3,1.75,1570,4375,1.0,0,0,3,7,970,600,1940,0,98116,47.5889,-122.389,1790,5750,2805,3960,128.0,0.06360655737704918,Very Cheap
20140822T000000,852000.0,5,2.75,1990,3750,1.5,0,0,4,7,1990,0,1913,0,98107,47.6733,-122.358,1820,5000,1760,3180,227.2,0.1019016393442623,Cheap
20150427T000000,306000.0,2,1.0,930,5650,1.0,0,2,3,7,930,0,1941,0,98126,47.5478,-122.377,1340,6400,4720,5060,54.15929203539823,0.030295081967213113,Very Cheap
20140910T000000,440000.0,3,1.75,1550,7820,1.0,0,0,4,7,1210,340,1981,0,98034,47.717,-122.163,1550,6900,6270,5350,56.265984654731454,0.04786885245901639,Very Cheap
20150428T000000,517000.0,4,1.0,1650,8250,1.0,0,0,3,7,1650,0,1966,0,98008,47.6366,-122.118,2240,9776,6600,7536,62.666666666666664,0.0579672131147541,Very Cheap
20140523T000000,379000.0,2,1.0,800,6380,1.0,0,2,3,7,800,0,1940,0,98115,47.691,-122.309,920,5940,5580,5020,59.40438871473354,0.03986885245901639,Very Cheap
20141013T000000,360000.0,2,1.0,930,6098,1.0,0,0,4,6,930,0,1919,0,98027,47.5289,-122.03,1730,9000,5168,7270,59.03574942604133,0.037377049180327866,Very Cheap
20141029T000000,645000.0,4,1.5,2550,4000,1.5,0,0,4,7,1760,790,1926,0,98115,47.6811,-122.318,1840,4000,1450,2160,161.25,0.07475409836065573,Very Cheap
20141107T000000,217000.0,2,1.0,720,4760,1.0,0,0,5,5,720,0,1942,0,98056,47.496,-122.186,840,4760,4040,3920,45.588235294117645,0.01862295081967213,Very Cheap
20141118T000000,255000.0,2,1.0,620,4760,1.0,0,0,3,6,620,0,1941,0,98126,47.5292,-122.376,620,4760,4140,4140,53.57142857142857,0.02360655737704918,Very Cheap
20140721T000000,625000.0,3,2.5,2360,12164,2.0,0,0,3,10,2360,0,1987,0,98029,47.5596,-122.022,2400,11260,9804,8860,51.3811246300559,0.07213114754098361,Very Cheap
20140610T000000,680000.0,3,1.75,1760,8400,1.0,0,0,4,8,1460,300,1960,0,98136,47.5355,-122.39,1980,8400,6640,6420,80.95238095238095,0.07934426229508197,Very Cheap
20140911T000000,440000.0,3,1.75,2100,29735,1.0,0,0,4,7,1080,1020,1957,0,98155,47.7622,-122.302,2100,11250,27635,9150,14.797376828653102,0.04786885245901639,Very Cheap
20140618T000000,615000.0,5,2.25,2480,12070,2.0,0,0,3,9,2480,0,1978,0,98074,47.631,-122.052,2570,12000,9590,9430,50.952775476387735,0.07081967213114754,Very Cheap
20140603T000000,239000.0,3,1.0,1040,6860,2.0,0,0,3,6,1040,0,1942,0,98146,47.5121,-122.375,1030,6512,5820,5482,34.839650145772595,0.021508196721311476,Very Cheap
20150413T000000,462500.0,3,2.5,1656,108900,1.0,0,0,4,7,1656,0,1985,0,98070,47.3758,-122.425,2030,29859,107244,27829,4.2470156106519745,0.05081967213114754,Very Cheap
20140611T000000,619400.0,4,2.0,2090,3610,1.5,0,0,5,7,1790,300,1927,0,98115,47.6881,-122.313,1660,3767,1520,2107,171.57894736842104,0.07139672131147541,Very Cheap
20140703T000000,975000.0,6,2.75,2520,54160,2.0,1,4,3,7,2520,0,1954,0,98146,47.4969,-122.376,2790,26809,51640,24019,18.00221565731167,0.1180327868852459,Cheap
20141013T000000,330000.0,2,1.0,700,4000,1.0,0,0,3,6,700,0,1943,0,98136,47.5487,-122.391,1060,6000,3300,4940,82.5,0.03344262295081967,Very Cheap
20140724T000000,985000.0,4,3.25,4030,36762,2.0,0,0,3,11,4030,0,1988,0,98077,47.7235,-122.039,4090,40371,32732,36281,26.793972036341874,0.11934426229508197,Cheap
20150323T000000,430000.0,2,1.0,760,7114,1.0,0,0,3,6,760,0,1946,0,98103,47.7005,-122.352,780,7102,6354,6322,60.4441945459657,0.04655737704918033,Very Cheap
20140708T000000,2458000.0,4,5.25,6500,14986,2.0,0,0,3,11,5180,1320,2001,0,98039,47.6304,-122.236,2270,8119,8486,5849,164.0197517683171,0.3125245901639344,Medium
20140723T000000,778000.0,3,2.0,1840,6000,2.0,0,0,5,7,1720,120,1946,0,98033,47.6828,-122.207,1390,6000,4160,4610,129.66666666666666,0.09219672131147541,Very Cheap
20140728T000000,219000.0,3,2.0,1090,7350,1.0,0,0,4,7,1090,0,1990,0,98042,47.3687,-122.085,1490,7741,6260,6251,29.79591836734694,0.018885245901639345,Very Cheap
20140917T000000,1595000.0,4,2.5,2980,13341,1.5,1,4,5,8,1800,1180,1928,0,98034,47.704,-122.245,2340,19810,10361,17470,119.55625515328686,0.19934426229508198,Cheap
20150130T000000,715000.0,4,2.25,1900,8272,1.0,0,0,4,9,1460,440,1966,0,98040,47.5803,-122.227,2040,8479,6372,6439,86.43617021276596,0.0839344262295082,Very Cheap
20140814T000000,950000.0,4,2.5,2790,15653,2.0,0,0,4,10,2790,0,1964,0,98040,47.5477,-122.215,3520,15653,12863,12133,60.69124129559829,0.11475409836065574,Cheap
20141212T000000,425000.0,2,1.0,1280,5026,1.0,0,2,4,8,1020,260,1951,0,98115,47.6938,-122.312,1540,6380,3746,4840,84.56028651014724,0.04590163934426229,Very Cheap
20140717T000000,239000.0,3,1.0,1510,15022,1.0,0,0,3,7,1510,0,1962,0,98003,47.3304,-122.304,1510,12970,13512,11460,15.909998668619359,0.021508196721311476,Very Cheap
20141216T000000,310000.0,1,1.0,920,8282,1.5,0,0,3,6,920,0,1944,1980,98011,47.761,-122.214,2260,14025,7362,11765,37.43057232552523,0.03081967213114754,Very Cheap
20150223T000000,400000.0,2,1.0,700,8120,1.0,0,0,3,7,700,0,1927,0,98115,47.6962,-122.321,1130,5599,7420,4469,49.26108374384236,0.04262295081967213,Very Cheap
20141124T000000,428000.0,2,1.75,1980,44550,2.0,0,1,5,7,1280,700,1977,0,98070,47.4193,-122.444,1680,25343,42570,23663,9.607182940516275,0.04629508196721312,Very Cheap
20140812T000000,600000.0,3,1.0,1440,4300,1.5,0,0,3,8,1440,0,1929,0,98117,47.6847,-122.372,1640,4500,2860,2860,139.53488372093022,0.06885245901639345,Very Cheap
20150126T000000,415000.0,4,4.0,2740,8250,2.0,0,0,4,9,2740,0,1990,0,98042,47.3735,-122.156,2290,8250,5510,5960,50.303030303030305,0.04459016393442623,Very Cheap
20140808T000000,401000.0,2,1.0,1400,8220,1.0,0,0,3,7,1400,0,1949,0,98133,47.7228,-122.357,1760,8220,6820,6460,48.78345498783455,0.04275409836065574,Very Cheap
20141215T000000,292000.0,3,1.75,2270,7156,1.0,0,0,3,7,1370,900,1948,0,98168,47.4864,-122.316,1210,7156,4886,5946,40.804918949133594,0.028459016393442622,Very Cheap
20140722T000000,291750.0,3,2.25,1310,12825,1.0,0,0,3,7,1310,0,1950,2013,98166,47.4515,-122.368,1600,11250,11515,9650,22.748538011695906,0.02842622950819672,Very Cheap
20150218T000000,227000.0,3,1.75,1680,7455,1.0,0,0,4,8,1680,0,1968,0,98023,47.3112,-122.378,2040,8214,5775,6174,30.44936284372904,0.019934426229508195,Very Cheap
20140717T000000,675000.0,3,2.25,2260,13209,1.0,0,0,3,9,2260,0,1977,0,98005,47.6385,-122.167,2820,12534,10949,9714,51.101521689756986,0.07868852459016394,Very Cheap
20141006T000000,397500.0,3,2.25,1350,980,2.0,0,0,3,8,1050,300,2007,0,98144,47.5998,-122.312,1350,1245,-370,-105,405.61224489795916,0.04229508196721311,Very Cheap
20140618T000000,206000.0,2,1.5,1820,8867,2.0,0,0,3,7,1820,0,1921,0,98168,47.4764,-122.269,1430,9288,7047,7858,23.23220931543927,0.017180327868852457,Very Cheap
20140730T000000,1190000.0,3,3.5,3380,3333,3.0,0,0,3,10,2800,580,2008,0,98122,47.6162,-122.288,2790,5000,-47,2210,357.03570357035704,0.14622950819672131,Cheap
20140716T000000,360000.0,4,1.75,2140,49658,1.0,0,0,5,7,2140,0,1959,0,98010,47.3583,-121.922,1720,99316,47518,97596,7.249587176285795,0.037377049180327866,Very Cheap
20141008T000000,427500.0,4,2.5,2430,3249,2.0,0,0,3,8,2430,0,2010,0,98059,47.5048,-122.155,2650,3844,819,1194,131.57894736842104,0.04622950819672131,Very Cheap
20140725T000000,115000.0,2,1.0,940,6000,1.0,0,0,3,6,940,0,1943,0,98146,47.4907,-122.336,1310,6000,5060,4690,19.166666666666668,0.005245901639344262,Very Cheap
20140609T000000,559000.0,3,1.5,2070,5386,1.0,0,0,4,7,1140,930,1948,0,98117,47.6896,-122.374,1770,5386,3316,3616,103.78759747493501,0.06347540983606557,Very Cheap
20141027T000000,420000.0,4,1.0,1510,1501,1.5,0,0,3,7,1510,0,1906,0,98103,47.6526,-122.342,1560,1602,-9,42,279.81345769487007,0.04524590163934426,Very Cheap
20141106T000000,550000.0,4,1.75,2550,39460,1.0,0,0,3,8,1890,660,1982,0,98072,47.7707,-122.123,2560,38638,36910,36078,13.93816523061328,0.06229508196721312,Very Cheap
20140922T000000,282150.0,2,1.0,700,5940,1.0,0,0,3,7,700,0,1948,0,98133,47.7289,-122.337,1070,5995,5240,4925,47.5,0.027167213114754098,Very Cheap
20150223T000000,260000.0,3,1.0,1150,3090,1.0,0,0,3,6,1150,0,1910,0,98118,47.5506,-122.276,1150,5664,1940,4514,84.14239482200647,0.024262295081967214,Very Cheap
20141002T000000,428000.0,3,2.5,2340,3466,2.0,0,0,3,7,2340,0,2004,0,98065,47.5322,-121.851,1970,3739,1126,1769,123.48528563185228,0.04629508196721312,Very Cheap
20141015T000000,319950.0,3,3.25,1510,1245,3.0,0,0,3,7,1510,0,2007,0,98133,47.7293,-122.343,1510,1245,-265,-265,256.9879518072289,0.03212459016393442,Very Cheap
20140801T000000,1350000.0,3,2.0,2070,9600,1.0,0,1,3,7,1590,480,1946,0,98039,47.616,-122.239,3000,16215,7530,13215,140.625,0.16721311475409836,Cheap
20140911T000000,552000.0,2,1.0,1150,5000,1.0,0,0,4,7,1050,100,1924,0,98115,47.6846,-122.317,1463,4320,3850,2857,110.4,0.06255737704918032,Very Cheap
20150209T000000,637000.0,4,2.75,2190,2867,1.5,0,0,5,7,1470,720,1929,0,98115,47.6868,-122.308,1600,3800,677,2200,222.18346703871643,0.07370491803278688,Very Cheap
20140609T000000,213000.0,4,1.75,1980,9000,1.0,0,0,2,7,1480,500,1978,0,98023,47.3071,-122.381,1980,9360,7020,7380,23.666666666666668,0.018098360655737705,Very Cheap
20150428T000000,215000.0,3,1.0,960,7200,1.0,0,0,4,6,960,0,1958,0,98166,47.4583,-122.353,1060,7620,6240,6560,29.86111111111111,0.018360655737704918,Very Cheap
20150217T000000,590000.0,3,1.75,2180,6120,1.0,0,2,3,8,1380,800,1949,0,98199,47.6501,-122.405,2020,6122,3940,4102,96.40522875816994,0.06754098360655737,Very Cheap
20141121T000000,390000.0,4,2.5,2560,43560,2.0,0,0,3,8,2560,0,1989,0,98038,47.3692,-122.047,2130,10150,41000,8020,8.953168044077135,0.04131147540983607,Very Cheap
20140922T000000,287000.0,4,2.25,2270,11997,1.0,0,2,4,7,1540,730,1959,0,98198,47.4095,-122.296,1920,9634,9727,7714,23.92264732849879,0.02780327868852459,Very Cheap
20140717T000000,580000.0,5,2.75,3550,9600,2.0,0,0,3,7,3550,0,1960,0,98033,47.6766,-122.186,3370,9600,6050,6230,60.416666666666664,0.06622950819672131,Very Cheap
20141028T000000,424000.0,3,2.0,1330,5632,1.0,0,0,3,8,1330,0,1988,0,98029,47.5745,-122.017,1900,4842,4302,2942,75.2840909090909,0.04577049180327869,Very Cheap
20150309T000000,610000.0,4,2.5,2110,6360,2.0,0,0,3,8,2110,0,1988,0,98029,47.5641,-122.012,2050,7000,4250,4950,95.9119496855346,0.07016393442622951,Very Cheap
20140729T000000,1320000.0,4,3.25,3470,11843,1.0,0,3,3,11,2270,1200,1989,0,98006,47.5513,-122.135,3910,13247,8373,9337,111.45824537701596,0.16327868852459015,Cheap
20141218T000000,623500.0,4,3.0,1550,3350,1.0,0,0,3,7,860,690,1918,2014,98107,47.6583,-122.362,1310,5000,1800,3690,186.11940298507463,0.0719344262295082,Very Cheap
20140804T000000,260000.0,2,1.0,570,81893,1.0,0,1,3,6,570,0,1936,0,98070,47.4433,-122.444,2040,115434,81323,113394,3.17487453140073,0.024262295081967214,Very Cheap
20150311T000000,906000.0,3,2.5,2030,1800,3.0,0,0,3,9,2030,0,2013,0,98112,47.6199,-122.3,1450,1441,-230,-9,503.3333333333333,0.10898360655737704,Cheap
20150406T000000,330000.0,3,2.0,1500,11233,1.0,0,0,3,7,1500,0,1987,0,98019,47.7279,-121.967,1580,14013,9733,12433,29.37772634202795,0.03344262295081967,Very Cheap
20150304T000000,275000.0,2,1.0,920,7688,1.0,0,0,3,6,920,0,1955,0,98106,47.5281,-122.362,1040,7440,6768,6400,35.77003121748179,0.02622950819672131,Very Cheap
20141119T000000,290000.0,3,1.0,1470,8200,1.0,0,0,3,7,1040,430,1953,0,98155,47.7347,-122.302,1420,8200,6730,6780,35.36585365853659,0.02819672131147541,Very Cheap
20140917T000000,599950.0,2,1.0,1150,3775,1.0,0,0,3,7,1150,0,1917,0,98103,47.6539,-122.329,2240,3753,2625,1513,158.9271523178808,0.06884590163934426,Very Cheap
20140924T000000,550000.0,4,3.0,4180,35169,2.0,0,0,3,11,4180,0,1986,1998,98038,47.4,-122.027,3010,35190,30989,32180,15.638772782848532,0.06229508196721312,Very Cheap
20140722T000000,289000.0,3,1.75,1690,3449,1.0,0,0,3,7,1690,0,1987,0,98055,47.4719,-122.191,1530,4093,1759,2563,83.792403595245,0.028065573770491802,Very Cheap
20140602T000000,411000.0,4,2.75,2150,9915,1.0,0,0,5,8,1240,910,1976,0,98056,47.5378,-122.17,1980,9325,7765,7345,41.45234493192133,0.044065573770491806,Very Cheap
20150325T000000,826000.0,3,3.25,2330,4000,1.0,0,2,3,10,1730,600,1964,2000,98144,47.5882,-122.295,2080,4000,1670,1920,206.5,0.09849180327868852,Very Cheap
20140710T000000,400000.0,4,2.0,2680,13680,2.0,0,2,4,7,2350,330,1943,1965,98056,47.4887,-122.192,1430,11000,11000,9570,29.239766081871345,0.04262295081967213,Very Cheap
20140814T000000,342000.0,3,2.5,1740,2226,2.0,0,0,3,8,1320,420,2008,0,98106,47.525,-122.366,1740,1789,486,49,153.63881401617252,0.03501639344262295,Very Cheap
20141010T000000,475000.0,2,1.75,1320,3420,1.0,0,1,3,7,1080,240,1955,0,98199,47.6639,-122.399,2070,6000,2100,3930,138.88888888888889,0.05245901639344262,Very Cheap
20140708T000000,1205000.0,4,3.5,3150,5500,2.0,0,0,3,9,3150,0,2014,0,98105,47.6644,-122.293,1550,4200,2350,2650,219.0909090909091,0.1481967213114754,Cheap
20140723T000000,455000.0,4,3.0,2480,9238,1.0,0,0,5,7,2050,430,1913,0,98166,47.4701,-122.364,1820,12214,6758,10394,49.25308508335137,0.049836065573770495,Very Cheap
20140624T000000,850000.0,4,3.0,3330,4000,1.0,0,0,3,8,1790,1540,1958,0,98103,47.6559,-122.344,1610,4000,670,2390,212.5,0.10163934426229508,Cheap
20150108T000000,185000.0,3,1.0,1010,6400,1.0,0,0,3,7,1010,0,1971,0,98023,47.3027,-122.376,1820,6500,5390,4680,28.90625,0.014426229508196721,Very Cheap
20140715T000000,850000.0,6,3.25,4920,20590,1.0,0,3,4,9,2730,2190,1960,0,98118,47.5468,-122.267,3700,14994,15670,11294,41.2821758135017,0.10163934426229508,Cheap
20140805T000000,239900.0,4,1.75,1570,18730,1.0,0,0,3,7,1200,370,1960,0,98198,47.3999,-122.301,1920,18295,17160,16375,12.808328884143085,0.02162622950819672,Very Cheap
20140515T000000,765000.0,5,3.75,3580,14275,2.0,0,0,3,10,3190,390,1999,0,98027,47.5322,-122.056,2740,14300,10695,11560,53.59019264448336,0.09049180327868853,Very Cheap
20140707T000000,437000.0,3,1.75,2220,17568,1.0,0,0,4,8,2220,0,1967,0,98072,47.749,-122.083,2070,11745,15348,9675,24.874772313296905,0.047475409836065574,Very Cheap
20140714T000000,240000.0,3,1.5,1010,10350,1.0,0,0,3,7,1010,0,1969,0,98032,47.379,-122.29,1640,7700,9340,6060,23.18840579710145,0.021639344262295083,Very Cheap
20150428T000000,395000.0,2,1.0,1440,7808,1.0,0,0,4,7,860,580,1949,0,98133,47.7431,-122.336,1550,7682,6368,6132,50.58913934426229,0.0419672131147541,Very Cheap
20150106T000000,320000.0,3,1.0,1230,7492,1.0,0,0,3,7,1230,0,1955,0,98155,47.7633,-122.315,1710,7238,6262,5528,42.71222637479978,0.032131147540983604,Very Cheap
20141022T000000,525000.0,3,1.75,1710,7350,1.0,0,0,3,8,1280,430,1981,0,98033,47.699,-122.167,2100,7560,5640,5460,71.42857142857143,0.05901639344262295,Very Cheap
20150422T000000,260000.0,3,3.0,2390,8993,2.0,0,0,3,8,1680,710,1988,0,98003,47.3532,-122.306,1820,10362,6603,8542,28.911375514288892,0.024262295081967214,Very Cheap
20150330T000000,450000.0,3,2.75,2840,39324,1.0,0,0,3,9,2200,640,1988,0,98092,47.3076,-122.101,2840,39413,36484,36573,11.443393347574,0.04918032786885246,Very Cheap
20140623T000000,560000.0,4,2.5,2300,7989,2.0,0,0,3,9,2300,0,1990,0,98074,47.6273,-122.034,2280,8835,5689,6555,70.09638252597321,0.06360655737704918,Very Cheap
20150414T000000,310000.0,5,3.0,2270,5001,1.0,0,0,3,7,1360,910,1989,0,98108,47.5539,-122.3,1950,5500,2731,3550,61.9876024795041,0.03081967213114754,Very Cheap
20150413T000000,440000.0,3,2.5,2290,6302,2.0,0,0,3,9,2290,0,1997,0,98058,47.435,-122.107,2700,7500,4012,4800,69.81910504601714,0.04786885245901639,Very Cheap
20141208T000000,458450.0,4,1.0,1330,9715,1.0,0,0,4,7,970,360,1957,0,98008,47.6038,-122.122,1590,8400,8385,6810,47.18991250643335,0.05028852459016393,Very Cheap
20150326T000000,200000.0,3,1.0,1200,10703,1.5,0,0,2,7,1200,0,1918,0,98118,47.5209,-122.28,1380,8068,9503,6688,18.68634962160142,0.01639344262295082,Very Cheap
20141206T000000,430000.0,3,2.25,2160,6527,2.0,0,0,4,7,1580,580,1987,0,98034,47.7292,-122.212,1950,9675,4367,7725,65.88018998008273,0.04655737704918033,Very Cheap
20150226T000000,360000.0,3,1.0,1120,10500,1.0,0,0,4,7,1120,0,1966,0,98034,47.7267,-122.226,1320,10500,9380,9180,34.285714285714285,0.037377049180327866,Very Cheap
20150109T000000,311000.0,4,2.5,2090,11645,1.0,0,0,3,7,1200,890,1962,0,98168,47.4759,-122.299,1450,9481,9555,8031,26.70674109059682,0.030950819672131147,Very Cheap
20140722T000000,615000.0,3,3.25,1470,1152,3.0,0,0,3,8,1470,0,2003,0,98103,47.6516,-122.337,1470,1506,-318,36,533.8541666666666,0.07081967213114754,Very Cheap
20141126T000000,575000.0,3,1.75,2270,10136,2.0,0,0,3,8,2270,0,1979,0,98027,47.535,-122.056,2260,9600,7866,7340,56.728492501973165,0.06557377049180328,Very Cheap
20140617T000000,2027000.0,4,3.75,4100,22798,1.5,0,3,5,11,2540,1560,1934,1979,98040,47.5648,-122.21,3880,18730,18698,14850,88.91130800947451,0.256,Cheap
20140922T000000,430000.0,3,1.75,1440,4025,1.0,0,0,4,6,720,720,1917,0,98126,47.567,-122.38,1500,5750,2585,4250,106.83229813664596,0.04655737704918033,Very Cheap
20140603T000000,400000.0,3,1.5,1200,4800,1.0,0,0,4,7,1200,0,1962,0,98007,47.6084,-122.136,1510,7668,3600,6158,83.33333333333333,0.04262295081967213,Very Cheap
20140828T000000,340000.0,3,1.75,1720,10710,1.0,0,0,3,7,860,860,1957,0,98146,47.5092,-122.362,1480,10359,8990,8879,31.746031746031747,0.03475409836065574,Very Cheap
20150504T000000,351000.0,1,0.75,930,6600,1.0,0,0,3,6,930,0,1924,0,98125,47.7127,-122.296,1590,6600,5670,5010,53.18181818181818,0.03619672131147541,Very Cheap
20140912T000000,440000.0,4,2.5,2400,8038,2.0,0,0,3,8,2400,0,2002,0,98059,47.4881,-122.143,2040,7756,5638,5716,54.739985070913164,0.04786885245901639,Very Cheap
20150422T000000,298000.0,4,2.5,1960,11798,2.0,0,0,3,8,1960,0,1999,0,98092,47.3293,-122.205,2360,11785,9838,9425,25.258518392947956,0.029245901639344263,Very Cheap
20150114T000000,300000.0,4,1.75,1890,9205,1.0,0,0,3,8,1260,630,1964,0,98133,47.774,-122.348,1430,6775,7315,5345,32.59098316132537,0.029508196721311476,Very Cheap
20141023T000000,310000.0,3,2.25,1590,3056,2.0,0,0,3,7,1590,0,2001,0,98108,47.5432,-122.293,1540,2890,1466,1350,101.43979057591623,0.03081967213114754,Very Cheap
20140808T000000,500000.0,4,2.5,2590,9354,2.0,0,0,4,9,2590,0,1993,0,98011,47.7703,-122.193,2730,9264,6764,6534,53.453068206115034,0.05573770491803279,Very Cheap
20150505T000000,399900.0,3,1.0,860,1664,1.5,0,0,3,7,860,0,1927,0,98117,47.6761,-122.384,1540,4080,804,2540,240.32451923076923,0.042609836065573774,Very Cheap
20140617T000000,343000.0,3,2.5,1270,2509,2.0,0,0,3,8,1270,0,2004,0,98106,47.5357,-122.365,1420,2206,1239,786,136.70785173375847,0.035147540983606555,Very Cheap
20141229T000000,415000.0,2,2.25,1130,2191,2.0,0,0,3,8,1130,0,2010,0,98052,47.6861,-122.103,1140,1710,1061,570,189.4112277498859,0.04459016393442623,Very Cheap
20141007T000000,410000.0,3,2.5,1860,15457,2.0,0,0,3,8,1860,0,1997,0,98019,47.7383,-121.955,2040,14055,13597,12015,26.52519893899204,0.043934426229508196,Very Cheap
20150108T000000,320000.0,2,1.0,1802,11225,1.0,0,0,3,7,1802,0,1961,0,98125,47.7205,-122.323,1810,7332,9423,5522,28.50779510022272,0.032131147540983604,Very Cheap
20140626T000000,1990000.0,5,3.0,4480,5000,2.5,0,0,5,12,3420,1060,1902,0,98112,47.6275,-122.315,3220,5600,520,2380,398.0,0.25114754098360653,Cheap
20140702T000000,253000.0,2,1.0,1310,7128,1.0,0,0,4,7,940,370,1980,0,98031,47.3958,-122.189,1400,7161,5818,5761,35.49382716049383,0.023344262295081967,Very Cheap
20140915T000000,630000.0,3,2.5,2320,32772,2.0,0,0,3,9,2320,0,1992,0,98053,47.6304,-121.988,2610,33305,30452,30695,19.22372757231783,0.07278688524590164,Very Cheap
20150106T000000,216000.0,2,1.0,1130,12500,1.0,0,0,4,7,1130,0,1953,0,98055,47.4514,-122.187,1270,10798,11370,9528,17.28,0.018491803278688525,Very Cheap
20150427T000000,540000.0,3,2.5,2180,11100,1.0,0,0,3,8,1230,950,1983,0,98052,47.717,-122.101,1930,12000,8920,10070,48.648648648648646,0.06098360655737705,Very Cheap
20140930T000000,212000.0,3,1.5,1830,12233,1.5,0,0,4,5,1830,0,1930,0,98022,47.2057,-122.003,1520,12233,10403,10713,17.330172484263876,0.017967213114754098,Very Cheap
20150129T000000,300000.0,3,2.75,2340,12282,1.0,0,2,3,8,1470,870,1978,0,98155,47.7379,-122.289,2640,8887,9942,6247,24.42598925256473,0.029508196721311476,Very Cheap
20140827T000000,969950.0,3,2.5,2830,3750,3.0,0,0,3,10,2830,0,2014,0,98117,47.6798,-122.385,1780,5100,920,3320,258.6533333333333,0.11737049180327869,Cheap
20140808T000000,715000.0,3,1.0,1610,7680,1.0,0,0,3,6,900,710,1956,0,98122,47.6038,-122.303,1940,2880,6070,940,93.09895833333333,0.0839344262295082,Very Cheap
20140825T000000,1321620.0,5,2.75,2410,19447,2.0,0,2,3,10,2290,120,1968,0,98040,47.5549,-122.211,2980,19447,17037,16467,67.96009667300869,0.1634911475409836,Cheap
20141201T000000,1444000.0,4,2.75,2660,9547,1.0,0,1,3,8,1930,730,1968,2006,98004,47.616,-122.218,2410,10001,6887,7591,151.25170210537343,0.17954098360655737,Cheap
20140715T000000,305000.0,3,1.0,1030,5350,1.0,0,0,3,7,1030,0,1924,2009,98055,47.4905,-122.206,1030,5250,4320,4220,57.00934579439252,0.03016393442622951,Very Cheap
20141204T000000,458000.0,3,4.0,1390,1569,2.0,0,0,3,9,1150,240,2006,0,98105,47.671,-122.269,1620,1855,179,235,291.9056724028043,0.05022950819672131,Very Cheap
20150414T000000,275000.0,3,1.75,1580,8775,1.0,0,0,3,6,1220,360,1942,0,98146,47.4845,-122.335,1180,8775,7195,7595,31.33903133903134,0.02622950819672131,Very Cheap
20141014T000000,550000.0,3,2.75,2330,4780,2.0,0,3,3,8,1730,600,1930,1988,98198,47.3459,-122.326,1100,5336,2450,4236,115.06276150627615,0.06229508196721312,Very Cheap
20140604T000000,742000.0,3,3.25,1540,704,3.0,0,0,3,9,1540,0,2011,0,98122,47.6177,-122.308,1540,1456,-836,-84,1053.9772727272727,0.08747540983606557,Very Cheap
20140725T000000,700000.0,3,1.0,1570,4000,2.0,0,0,5,8,1570,0,1908,0,98103,47.6575,-122.346,1640,4000,2430,2360,175.0,0.08196721311475409,Very Cheap
20141112T000000,640000.0,4,3.0,2940,5763,1.0,0,0,5,8,1640,1300,1955,0,98108,47.5589,-122.295,2020,7320,2823,5300,111.05327086586847,0.0740983606557377,Very Cheap
20150410T000000,352000.0,3,0.75,1240,7200,1.0,0,0,3,7,1240,0,1947,0,98133,47.7298,-122.342,1210,7200,5960,5990,48.888888888888886,0.03632786885245902,Very Cheap
20150201T000000,301500.0,3,1.0,1410,7419,1.0,0,0,3,7,1050,360,1969,0,98056,47.534,-122.173,1800,8000,6009,6200,40.63890012131015,0.029704918032786885,Very Cheap
20140702T000000,630000.0,4,2.5,2190,9880,1.0,0,0,4,8,1410,780,1979,0,98033,47.6926,-122.186,2190,9198,7690,7008,63.76518218623482,0.07278688524590164,Very Cheap
20150223T000000,340000.0,3,2.5,3040,6255,2.0,0,0,3,7,3040,0,1999,0,98030,47.3817,-122.206,2670,6259,3215,3589,54.35651478816946,0.03475409836065574,Very Cheap
20150310T000000,477500.0,4,1.75,1860,9364,1.0,0,0,3,7,1080,780,1953,0,98125,47.731,-122.301,1800,9364,7504,7564,50.99316531396839,0.05278688524590164,Very Cheap
20140813T000000,285000.0,3,2.5,1690,7460,1.0,0,0,3,7,870,820,1997,0,98146,47.4964,-122.353,1900,7302,5770,5402,38.20375335120644,0.02754098360655738,Very Cheap
20141010T000000,255000.0,3,2.75,1900,16117,1.0,0,0,4,7,1900,0,1958,0,98001,47.3144,-122.278,1640,19166,14217,17526,15.821803065086554,0.02360655737704918,Very Cheap
20140728T000000,315000.0,3,2.5,1600,7982,2.0,0,0,3,8,1600,0,1993,0,98001,47.3397,-122.266,1890,9830,6382,7940,39.463793535454776,0.031475409836065574,Very Cheap
20141217T000000,830000.0,6,3.0,2530,9000,1.0,0,0,3,6,2530,0,1978,0,98033,47.6716,-122.199,1886,6000,6470,4114,92.22222222222223,0.09901639344262295,Very Cheap
20150210T000000,539950.0,3,2.25,1860,1558,3.0,0,0,3,8,1860,0,2014,0,98103,47.7006,-122.339,1760,2456,-302,696,346.5661103979461,0.06097704918032787,Very Cheap
20140814T000000,980000.0,3,2.25,2390,4590,2.0,0,0,3,8,2090,300,1941,1998,98105,47.6615,-122.276,2280,5179,2200,2899,213.50762527233115,0.11868852459016394,Cheap
20140718T000000,735000.0,4,2.5,3100,8529,2.0,0,0,3,9,3100,0,1990,0,98074,47.6252,-122.029,2710,8344,5429,5634,86.17657404150545,0.08655737704918033,Very Cheap
20150122T000000,536000.0,5,2.25,2650,9140,1.0,0,1,3,8,1350,1300,1965,0,98177,47.7772,-122.387,2700,7800,6490,5100,58.64332603938731,0.06045901639344262,Very Cheap
20150223T000000,575000.0,3,2.0,1520,5000,1.5,0,0,3,7,1140,380,1945,0,98107,47.6733,-122.389,1530,4650,3480,3120,115.0,0.06557377049180328,Very Cheap
20140925T000000,500000.0,2,1.0,1510,4000,1.0,0,0,3,6,930,580,1924,0,98117,47.6917,-122.38,1300,4000,2490,2700,125.0,0.05573770491803279,Very Cheap
20140616T000000,285500.0,4,1.75,1960,7950,1.0,0,0,4,8,1960,0,1967,0,98023,47.3109,-122.377,1960,8400,5990,6440,35.911949685534594,0.02760655737704918,Very Cheap
20140514T000000,498000.0,4,2.75,2270,7375,1.0,0,0,4,7,1290,980,1973,0,98034,47.7222,-122.168,1750,7760,5105,6010,67.52542372881356,0.055475409836065574,Very Cheap
20140821T000000,412000.0,2,1.0,910,6282,1.0,0,0,4,7,910,0,1939,0,98103,47.6967,-122.354,970,6281,5372,5311,65.58420885068449,0.04419672131147541,Very Cheap
20150323T000000,607000.0,4,2.5,2100,8220,1.0,0,0,4,8,1300,800,1975,0,98052,47.6733,-122.145,2160,8348,6120,6188,73.84428223844282,0.06977049180327868,Very Cheap
20140624T000000,199000.0,3,1.0,1000,8512,1.0,0,0,3,6,1000,0,1991,0,98022,47.2151,-121.993,1490,10395,7512,8905,23.37875939849624,0.016262295081967214,Very Cheap
20140721T000000,492500.0,4,2.75,2760,18306,1.0,0,0,3,7,1630,1130,1978,0,98034,47.7302,-122.215,2470,9856,15546,7386,26.903747405222333,0.054754098360655735,Very Cheap
20140619T000000,585000.0,4,2.5,2840,11044,2.0,0,0,3,8,2840,0,2001,0,98034,47.7134,-122.237,1934,9605,8204,7671,52.969938428105756,0.06688524590163934,Very Cheap
20141208T000000,326995.0,3,2.5,1860,5321,2.0,0,0,3,7,1860,0,2000,0,98038,47.3848,-122.033,1940,5205,3461,3265,61.453674121405754,0.033048524590163934,Very Cheap
20140813T000000,372500.0,4,2.25,1920,9660,1.0,0,0,4,8,1920,0,1968,0,98058,47.4544,-122.143,1890,7800,7740,5910,38.56107660455486,0.03901639344262295,Very Cheap
20140627T000000,528000.0,2,0.75,840,40642,1.0,1,4,4,6,840,0,1937,0,98070,47.404,-122.447,1850,64069,39802,62219,12.991486639437035,0.05940983606557377,Very Cheap
20140924T000000,400000.0,3,1.5,2390,32109,1.0,0,0,3,7,2390,0,1975,2007,98092,47.3028,-122.102,1370,32109,29719,30739,12.457566414400947,0.04262295081967213,Very Cheap
20141029T000000,344000.0,4,2.5,2100,8501,2.0,0,0,5,7,2100,0,1993,0,98022,47.1951,-122.01,2130,8560,6401,6430,40.46582754970004,0.035278688524590165,Very Cheap
20140902T000000,409950.0,4,3.0,2430,7163,2.0,0,0,3,8,2430,0,2003,0,98038,47.3558,-122.013,2430,6028,4733,3598,57.231606868630465,0.043927868852459015,Very Cheap
20140715T000000,625000.0,3,2.0,1880,4000,1.0,0,2,3,8,1280,600,1950,0,98199,47.6375,-122.391,1920,4000,2120,2080,156.25,0.07213114754098361,Very Cheap
20150512T000000,304950.0,3,1.75,1350,9000,1.0,0,0,3,7,1350,0,1987,0,98045,47.4487,-121.773,1370,9500,7650,8130,33.88333333333333,0.03015737704918033,Very Cheap
20140929T000000,381500.0,2,2.0,2160,35183,1.0,0,0,3,9,2160,0,1985,0,98092,47.312,-122.115,2450,34992,33023,32542,10.843305005258221,0.04019672131147541,Very Cheap
20140723T000000,215000.0,3,1.75,1430,13399,1.0,0,0,4,7,900,530,1946,0,98168,47.4787,-122.275,1720,6415,11969,4695,16.04597358011792,0.018360655737704918,Very Cheap
20150427T000000,345000.0,5,1.75,2840,12870,2.0,0,2,4,7,2840,0,1925,0,98178,47.4961,-122.235,2170,9612,10030,7442,26.806526806526808,0.03540983606557377,Very Cheap
20150316T000000,363000.0,3,0.75,2510,20000,2.0,0,0,4,7,2510,0,1961,0,98001,47.2871,-122.287,2130,20000,17490,17870,18.15,0.03777049180327869,Very Cheap
20150205T000000,240000.0,3,1.0,1690,20063,1.5,0,0,4,7,1690,0,1913,0,98001,47.3556,-122.294,1700,15899,18373,14199,11.962318696107262,0.021639344262295083,Very Cheap
20150204T000000,548050.0,2,2.0,1930,5479,1.0,0,0,3,8,1930,0,2005,0,98053,47.7054,-122.011,1900,5479,3549,3579,100.02737725862383,0.062039344262295085,Very Cheap
20141027T000000,314000.0,2,1.0,720,4920,1.0,0,0,3,6,720,0,1941,0,98126,47.5352,-122.371,670,4920,4200,4250,63.82113821138211,0.03134426229508197,Very Cheap
20140626T000000,800000.0,4,2.5,2990,16809,2.0,0,0,3,11,2990,0,1990,0,98077,47.7123,-122.073,3340,18752,13819,15412,47.593551073829495,0.09508196721311475,Very Cheap
20140715T000000,400000.0,5,1.75,2300,6720,2.0,0,0,3,7,2300,0,1905,0,98108,47.528,-122.32,1200,6000,4420,4800,59.523809523809526,0.04262295081967213,Very Cheap
20141114T000000,247000.0,1,1.0,460,4120,1.0,0,0,3,4,460,0,1937,0,98055,47.4868,-122.199,990,4120,3660,3130,59.95145631067961,0.022557377049180326,Very Cheap
20150401T000000,540000.0,2,1.75,1240,4120,1.0,0,0,4,7,890,350,1906,0,98105,47.6689,-122.314,1640,3740,2880,2100,131.06796116504853,0.06098360655737705,Very Cheap
20140718T000000,410000.0,4,2.5,1900,15123,2.0,0,0,3,8,1900,0,1995,0,98045,47.5015,-121.772,1900,16477,13223,14577,27.111022945182835,0.043934426229508196,Very Cheap
20141002T000000,525000.0,3,1.75,2120,9146,1.0,0,0,3,8,1260,860,1981,0,98074,47.6475,-122.064,2040,10485,7026,8445,57.40214301333916,0.05901639344262295,Very Cheap
20150410T000000,820000.0,4,2.5,2440,5737,2.0,0,0,4,8,1700,740,1929,0,98119,47.6472,-122.367,2020,5543,3297,3523,142.93184591249783,0.09770491803278689,Very Cheap
20150310T000000,1250000.0,4,2.25,3300,15375,1.5,0,3,3,8,2820,480,1933,1984,98040,47.526,-122.225,3250,15375,12075,12125,81.30081300813008,0.1540983606557377,Cheap
20141218T000000,244000.0,2,1.0,1180,10200,1.0,0,0,4,7,1180,0,1955,0,98148,47.4358,-122.336,1330,10200,9020,8870,23.92156862745098,0.02216393442622951,Very Cheap
20141218T000000,275000.0,1,1.0,520,4800,1.0,0,0,3,5,520,0,1930,0,98106,47.5533,-122.363,800,4960,4280,4160,57.291666666666664,0.02622950819672131,Very Cheap
20141008T000000,577000.0,2,1.75,2070,23160,1.0,0,0,3,7,1260,810,1946,0,98199,47.6551,-122.394,1690,5458,21090,3768,24.91364421416235,0.06583606557377049,Very Cheap
20141202T000000,446950.0,5,2.5,2250,7945,1.0,0,0,4,7,1360,890,1977,0,98034,47.7316,-122.221,1820,7866,5695,6046,56.25550660792952,0.04878032786885246,Very Cheap
20140729T000000,457000.0,3,2.5,2050,5694,2.0,0,2,3,8,2050,0,2004,0,98065,47.5331,-121.855,2680,7187,3644,4507,80.25992272567615,0.0500983606557377,Very Cheap
20150428T000000,320000.0,4,1.5,1310,137214,1.5,0,0,4,7,1310,0,1926,0,98198,47.362,-122.316,1310,9450,135904,8140,2.3321235442447565,0.032131147540983604,Very Cheap
20140905T000000,210000.0,3,1.5,1250,9484,1.0,0,0,4,7,1250,0,1969,0,98042,47.3675,-122.147,1320,9600,8234,8280,22.14255588359342,0.017704918032786884,Very Cheap
20140922T000000,220000.0,4,2.5,2130,9100,1.0,0,0,3,8,1290,840,1978,0,98030,47.3815,-122.169,1770,7700,6970,5930,24.175824175824175,0.01901639344262295,Very Cheap
20140613T000000,589000.0,3,2.0,2250,8800,1.0,0,0,4,7,1250,1000,1925,0,98116,47.5737,-122.409,2250,4800,6550,2550,66.93181818181819,0.06740983606557377,Very Cheap
20140630T000000,435000.0,4,2.0,1880,3840,1.0,0,0,3,7,970,910,1904,0,98144,47.5929,-122.303,1670,1820,1960,150,113.28125,0.04721311475409836,Very Cheap
20140716T000000,375000.0,3,1.0,1520,10798,1.0,0,0,3,7,1520,0,1953,0,98028,47.7635,-122.262,1670,9876,9278,8206,34.728653454343394,0.03934426229508197,Very Cheap
20141017T000000,1735000.0,4,3.5,4010,9654,2.0,0,0,3,10,4010,0,2007,0,98004,47.5891,-122.2,1870,9873,5644,8003,179.7182515019681,0.21770491803278688,Cheap
20141211T000000,545000.0,2,1.75,1660,5581,1.0,0,0,3,8,1660,0,2005,0,98053,47.713,-122.033,1670,4871,3921,3201,97.65275040315356,0.06163934426229508,Very Cheap
20141022T000000,970000.0,3,2.25,3400,10000,2.0,0,0,3,10,3400,0,1983,0,98115,47.6846,-122.284,1860,5100,6600,3240,97.0,0.11737704918032787,Cheap
20140718T000000,705000.0,2,1.75,2320,6755,1.0,0,0,5,8,1380,940,1946,0,98199,47.6398,-122.403,1990,5000,4435,3010,104.36713545521836,0.08262295081967214,Very Cheap
20150316T000000,915557.0,5,3.25,3740,11536,2.0,0,0,4,9,2540,1200,1984,0,98006,47.5599,-122.108,2920,11258,7796,8338,79.36520457697642,0.11023698360655737,Cheap
20150209T000000,259000.0,4,1.5,1810,9000,1.5,0,0,3,7,1810,0,1960,0,98168,47.4911,-122.322,1520,9780,7190,8260,28.77777777777778,0.024131147540983607,Very Cheap
20140613T000000,1695000.0,2,2.25,3170,3000,2.0,0,2,5,10,1990,1180,1900,0,98109,47.6291,-122.351,2980,5061,-170,2081,565.0,0.2124590163934426,Cheap
20141201T000000,427000.0,3,1.75,1680,8610,1.0,0,0,4,7,1290,390,1969,0,98034,47.7246,-122.173,1640,8809,6930,7169,49.59349593495935,0.04616393442622951,Very Cheap
20140811T000000,390000.0,2,1.0,930,3100,1.0,0,0,3,6,930,0,1911,0,98144,47.5943,-122.302,1670,3800,2170,2130,125.80645161290323,0.04131147540983607,Very Cheap
20150212T000000,363000.0,3,2.5,2390,8000,2.0,0,0,3,8,2390,0,1995,0,98042,47.3895,-122.154,2070,7585,5610,5515,45.375,0.03777049180327869,Very Cheap
20140807T000000,612000.0,4,2.5,2680,3626,1.5,0,3,4,7,1680,1000,1928,0,98107,47.6727,-122.361,1950,4500,946,2550,168.78102592388308,0.07042622950819673,Very Cheap
20140916T000000,380000.0,4,1.75,1790,10186,1.0,0,0,4,8,1790,0,1965,0,98177,47.7769,-122.376,1790,9142,8396,7352,37.306106420577265,0.04,Very Cheap
20140818T000000,230000.0,4,3.0,1680,6003,1.0,0,0,3,7,1150,530,1997,0,98002,47.2885,-122.218,1820,6207,4323,4387,38.31417624521073,0.020327868852459016,Very Cheap
20150414T000000,580000.0,3,1.75,1570,2600,1.5,0,0,4,8,1570,0,1931,0,98117,47.6867,-122.37,1490,4000,1030,2510,223.07692307692307,0.06622950819672131,Very Cheap
20141119T000000,770000.0,3,1.0,2230,3200,2.0,0,2,3,8,1630,600,1918,0,98109,47.6334,-122.356,2280,5400,970,3120,240.625,0.09114754098360656,Very Cheap
20140924T000000,207200.0,4,2.0,1260,8400,1.0,0,0,3,6,1260,0,1991,0,98022,47.1946,-122.0,1120,8400,7140,7280,24.666666666666668,0.017337704918032788,Very Cheap
20150305T000000,525000.0,3,2.0,1790,11430,1.0,0,0,3,7,1190,600,1985,0,98074,47.6319,-122.035,1700,12114,9640,10414,45.93175853018373,0.05901639344262295,Very Cheap
20150209T000000,925000.0,3,2.5,2440,7419,1.0,0,0,3,7,1520,920,1961,0,98103,47.6857,-122.334,2440,4880,4979,2440,124.67987599406928,0.11147540983606558,Cheap
20140902T000000,883000.0,4,2.25,2410,4000,2.0,0,0,5,8,1650,760,1910,0,98115,47.6727,-122.316,1820,4000,1590,2180,220.75,0.1059672131147541,Cheap
20150508T000000,455000.0,4,2.5,1780,2992,2.0,0,0,3,7,1780,0,2003,0,98072,47.7633,-122.149,1610,2961,1212,1351,152.07219251336898,0.049836065573770495,Very Cheap
20140922T000000,343500.0,3,2.5,1900,5194,2.0,0,0,3,7,1900,0,2004,0,98058,47.4391,-122.117,2230,5194,3294,2964,66.13400077011937,0.035213114754098364,Very Cheap
20141114T000000,244000.0,2,1.0,960,8450,1.0,0,0,5,6,960,0,1950,0,98155,47.755,-122.316,1090,8450,7490,7360,28.875739644970412,0.02216393442622951,Very Cheap
20141119T000000,397000.0,3,1.75,1640,11730,1.0,0,0,5,7,1640,0,1967,0,98034,47.7351,-122.189,1640,7770,10090,6130,33.84484228473998,0.04222950819672131,Very Cheap
20150316T000000,180500.0,2,1.0,850,5000,1.0,0,0,3,6,850,0,1976,0,98198,47.3817,-122.314,1160,5000,4150,3840,36.1,0.013836065573770491,Very Cheap
20150304T000000,310000.0,3,2.75,2150,6576,1.0,0,0,4,7,1900,250,1926,0,98155,47.7539,-122.308,2150,9071,4426,6921,47.141119221411195,0.03081967213114754,Very Cheap
20150128T000000,315000.0,4,2.5,2780,3969,2.0,0,0,3,7,2780,0,2005,0,98042,47.3992,-122.164,2260,4160,1189,1900,79.36507936507937,0.031475409836065574,Very Cheap
20140603T000000,718000.0,3,1.0,1030,4958,1.0,0,0,5,7,1030,0,1952,0,98105,47.6647,-122.277,2230,6987,3928,4757,144.81645824929407,0.08432786885245902,Very Cheap
20141009T000000,279950.0,3,1.75,1930,7267,1.0,0,0,4,7,1330,600,1977,0,98002,47.3217,-122.205,1600,7698,5337,6098,38.52346222650337,0.026878688524590164,Very Cheap
20141021T000000,689000.0,3,2.5,2080,9612,1.0,0,3,4,8,1700,380,1940,0,98125,47.7293,-122.283,2560,10202,7532,7642,71.68123179359135,0.08052459016393443,Very Cheap
20140818T000000,828000.0,4,2.5,3520,9901,2.0,0,0,3,10,3520,0,1998,0,98074,47.6084,-122.011,3490,9667,6381,6177,83.62791637208363,0.09875409836065574,Very Cheap
20140625T000000,150000.0,2,1.0,890,8100,1.0,0,0,3,6,890,0,1942,0,98146,47.4839,-122.34,1260,8100,7210,6840,18.51851851851852,0.009836065573770493,Very Cheap
20150301T000000,505400.0,3,1.75,1640,3400,1.0,0,0,4,7,930,710,1926,0,98105,47.6694,-122.3,1380,3750,1760,2370,148.64705882352942,0.056445901639344265,Very Cheap
20140513T000000,1680000.0,5,3.25,4860,23723,2.0,0,2,4,11,3820,1040,1989,0,98040,47.5767,-122.215,4040,13860,18863,9820,70.81735025081144,0.21049180327868852,Cheap
20140515T000000,217450.0,3,1.0,1040,5000,1.0,0,0,3,7,1040,0,1959,0,98146,47.5122,-122.358,1440,5000,3960,3560,43.49,0.018681967213114756,Very Cheap
20141218T000000,677000.0,4,2.5,2820,4174,2.0,0,0,3,9,2820,0,2004,0,98034,47.7112,-122.226,2560,4853,1354,2293,162.19453761379972,0.07895081967213115,Very Cheap
20150427T000000,361000.0,2,2.5,1320,48787,1.0,0,0,3,8,1320,0,2004,0,98027,47.5157,-121.924,1830,155073,47467,153243,7.399512165125956,0.037508196721311476,Very Cheap
20140609T000000,620000.0,3,2.5,2590,7237,2.0,0,0,3,8,2590,0,2004,0,98125,47.7113,-122.309,1670,7648,4647,5978,85.67085809036894,0.07147540983606557,Very Cheap
20141210T000000,176000.0,3,2.25,1540,5449,1.0,0,0,2,7,1180,360,1989,0,98023,47.29,-122.358,1460,6740,3909,5280,32.299504496237844,0.013245901639344262,Very Cheap
20150414T000000,330000.0,3,1.0,960,7218,1.0,0,0,4,7,960,0,1969,0,98034,47.7278,-122.226,1580,9104,6258,7524,45.7190357439734,0.03344262295081967,Very Cheap
20141029T000000,290000.0,3,2.5,1190,8175,1.0,0,0,3,7,1190,0,1986,0,98055,47.4556,-122.203,2230,9520,6985,7290,35.47400611620795,0.02819672131147541,Very Cheap
20140715T000000,711000.0,4,2.5,2770,9532,2.0,0,0,4,9,2770,0,1988,0,98029,47.5688,-122.012,2770,9219,6762,6449,74.59085186739404,0.08340983606557377,Very Cheap
20150422T000000,295000.0,3,1.75,1060,8100,2.0,0,0,4,7,1060,0,1983,0,98038,47.3617,-122.047,1410,8100,7040,6690,36.41975308641975,0.028852459016393443,Very Cheap
20141111T000000,1096500.0,5,3.25,4010,12110,2.0,0,0,3,11,4010,0,2003,0,98059,47.5228,-122.151,4010,12334,8100,8324,90.54500412881916,0.1339672131147541,Cheap
20140925T000000,257500.0,3,2.0,1140,7078,1.0,0,0,4,7,1140,0,1991,0,98031,47.4057,-122.185,1460,7078,5938,5618,36.3803334275219,0.023934426229508195,Very Cheap
20140609T000000,240000.0,4,1.0,1910,16320,1.5,0,0,3,6,1910,0,1934,0,98106,47.5151,-122.366,1380,9000,14410,7620,14.705882352941176,0.021639344262295083,Very Cheap
20141212T000000,645000.0,4,2.5,2340,8955,2.0,0,0,3,9,2340,0,1990,0,98074,47.6283,-122.026,2340,8955,6615,6615,72.02680067001675,0.07475409836065573,Very Cheap
20140506T000000,499000.0,2,1.75,1170,2400,1.0,0,0,4,7,740,430,1903,0,98103,47.6653,-122.333,1570,3919,1230,2349,207.91666666666666,0.05560655737704918,Very Cheap
20141020T000000,321000.0,3,1.0,1290,9526,1.5,0,0,3,7,1290,0,1961,0,98034,47.7111,-122.213,1290,9508,8236,8218,33.69724963258451,0.032262295081967214,Very Cheap
20140822T000000,449000.0,3,2.5,1810,1658,3.0,0,0,3,8,1810,0,1998,0,98117,47.6955,-122.376,1470,1585,-152,115,270.80820265379975,0.049049180327868855,Very Cheap
20150107T000000,515000.0,3,2.5,1820,5280,1.0,0,0,4,7,910,910,1949,0,98117,47.6892,-122.375,1600,4820,3460,3220,97.53787878787878,0.057704918032786885,Very Cheap
20141002T000000,456000.0,4,1.5,2220,12385,1.0,0,0,3,8,1270,950,1978,0,98033,47.6734,-122.185,2030,8831,10165,6801,36.81873233750505,0.0499672131147541,Very Cheap
20140723T000000,865000.0,3,3.75,3830,219106,2.0,0,0,3,9,3830,0,1977,1999,98027,47.5432,-121.952,2440,219106,215276,216666,3.947860852737944,0.10360655737704919,Cheap
20140618T000000,515500.0,4,2.5,2920,7700,2.0,0,0,3,9,2920,0,2003,0,98019,47.7351,-121.975,2920,8943,4780,6023,66.94805194805195,0.05777049180327869,Very Cheap
20141119T000000,576925.0,4,2.5,2630,6100,2.0,0,0,3,8,2630,0,2004,0,98072,47.7735,-122.167,2360,5765,3470,3405,94.57786885245902,0.06582622950819672,Very Cheap
20150102T000000,243000.0,3,1.75,1320,10416,1.0,0,0,3,7,1320,0,1996,0,98031,47.3902,-122.208,1670,7991,9096,6321,23.329493087557605,0.022032786885245903,Very Cheap
20140528T000000,253400.0,3,2.0,1400,8640,1.0,0,0,5,7,1400,0,1968,0,98003,47.3182,-122.319,1270,9375,7240,8105,29.328703703703702,0.02339672131147541,Very Cheap
20150413T000000,292000.0,3,2.5,1600,3580,2.0,0,0,3,7,1600,0,2000,0,98178,47.4939,-122.261,2020,4327,1980,2307,81.56424581005587,0.028459016393442622,Very Cheap
20141203T000000,271500.0,3,2.5,1490,8005,1.0,0,0,3,7,1090,400,1976,0,98058,47.4359,-122.165,1880,7905,6515,6025,33.91630231105559,0.02577049180327869,Very Cheap
20140827T000000,765000.0,2,2.5,2170,6750,1.0,0,0,3,8,2170,0,2012,0,98053,47.7115,-122.014,2150,6074,4580,3924,113.33333333333333,0.09049180327868853,Very Cheap
20150312T000000,375000.0,3,3.25,1280,1730,2.0,0,0,3,8,1090,190,2005,0,98177,47.7032,-122.36,1280,2121,450,841,216.76300578034682,0.03934426229508197,Very Cheap
20150511T000000,382880.0,3,2.0,1620,9566,1.0,0,0,4,7,1620,0,1968,0,98059,47.474,-122.146,1660,10011,7946,8351,40.025088856366295,0.04037770491803279,Very Cheap
20140609T000000,852500.0,3,2.5,2630,10100,1.0,0,0,4,9,1580,1050,1967,0,98006,47.5638,-122.153,2400,9700,7470,7300,84.4059405940594,0.1019672131147541,Cheap
20141124T000000,475000.0,3,1.5,1240,8738,1.0,0,0,3,7,1240,0,1959,0,98005,47.5849,-122.17,1440,9344,7498,7904,54.360265506981,0.05245901639344262,Very Cheap
20140523T000000,462000.0,3,1.75,1300,2580,1.0,0,0,5,7,820,480,1919,0,98115,47.674,-122.319,1180,2820,1280,1640,179.06976744186048,0.05075409836065574,Very Cheap
20140611T000000,762400.0,3,1.75,2430,14607,1.0,0,1,3,8,1230,1200,1949,1970,98040,47.5588,-122.211,2750,17425,12177,14675,52.19415348805367,0.09015081967213115,Very Cheap
20150130T000000,330000.0,4,1.5,1890,7540,1.0,0,0,4,7,1890,0,1967,0,98155,47.7534,-122.318,1890,8515,5650,6625,43.76657824933687,0.03344262295081967,Very Cheap
20140725T000000,473000.0,3,2.25,1890,12236,1.0,0,0,3,8,1890,0,1978,0,98074,47.6232,-122.047,2390,12323,10346,9933,38.65642366786532,0.05219672131147541,Very Cheap
20141121T000000,550000.0,3,1.5,2440,7200,1.0,0,0,3,7,2440,0,1949,0,98118,47.5604,-122.274,1920,6900,4760,4980,76.38888888888889,0.06229508196721312,Very Cheap
20140623T000000,449500.0,3,2.25,1780,7280,1.0,0,2,3,7,1340,440,1972,0,98034,47.723,-122.215,2060,7280,5500,5220,61.744505494505496,0.049114754098360656,Very Cheap
20140521T000000,744000.0,4,2.75,2830,13059,2.0,0,0,3,10,2830,0,1998,0,98075,47.595,-121.986,3840,11596,10229,7756,56.97220307833678,0.08773770491803279,Very Cheap
20150507T000000,700000.0,4,2.0,2490,4700,1.0,0,0,4,7,1690,800,1952,0,98136,47.5254,-122.392,2240,5000,2210,2760,148.93617021276594,0.08196721311475409,Very Cheap
20140930T000000,511100.0,4,2.5,1560,12220,1.5,0,0,4,7,1560,0,1965,0,98027,47.5287,-122.053,1920,12220,10660,10300,41.824877250409166,0.05719344262295082,Very Cheap
20140916T000000,317950.0,3,2.5,1980,4500,2.0,0,0,3,7,1980,0,2012,0,98042,47.3671,-122.113,2200,4500,2520,2300,70.65555555555555,0.03186229508196722,Very Cheap
20141014T000000,542950.0,3,2.5,2070,39768,2.0,0,0,3,8,2070,0,1988,0,98077,47.7696,-122.036,2740,44866,37698,42126,13.65293703480185,0.061370491803278686,Very Cheap
20140815T000000,490000.0,3,1.75,1490,11360,1.0,0,0,3,8,1490,0,1975,0,98008,47.5896,-122.12,2350,10320,9870,7970,43.13380281690141,0.05442622950819672,Very Cheap
20150219T000000,760000.0,4,3.5,3090,4060,2.0,0,0,3,8,2420,670,1992,0,98144,47.5733,-122.287,1720,4080,970,2360,187.192118226601,0.0898360655737705,Very Cheap
20150421T000000,475000.0,3,2.25,1580,8659,1.0,0,0,4,7,1220,360,1961,0,98011,47.7599,-122.215,1970,9650,7079,7680,54.85621896292874,0.05245901639344262,Very Cheap
20140509T000000,1702500.0,5,4.5,5190,23716,2.0,0,2,3,11,3390,1800,1987,2000,98040,47.5846,-122.223,4460,22748,18526,18288,71.78697925451172,0.21344262295081967,Cheap
20150326T000000,435000.0,3,2.75,2692,6197,2.0,0,0,3,9,2692,0,2007,0,98030,47.3569,-122.202,2336,5700,3505,3364,70.19525576892045,0.04721311475409836,Very Cheap
20141101T000000,399000.0,3,2.5,1740,3690,2.0,0,0,3,8,1740,0,2000,0,98065,47.5345,-121.867,2100,4944,1950,2844,108.130081300813,0.042491803278688525,Very Cheap
20140826T000000,627000.0,3,2.0,1940,3800,1.0,0,0,4,7,1050,890,1927,0,98115,47.6842,-122.309,1700,3800,1860,2100,165.0,0.07239344262295082,Very Cheap
20141002T000000,346500.0,4,2.5,2150,5100,1.5,0,0,3,7,1290,860,1991,0,98106,47.5338,-122.36,1920,5100,2950,3180,67.94117647058823,0.03560655737704918,Very Cheap
20150414T000000,412000.0,3,1.5,1320,8000,1.0,0,0,3,7,1320,0,1957,0,98008,47.6027,-122.122,1720,8100,6680,6380,51.5,0.04419672131147541,Very Cheap
20150203T000000,845000.0,4,2.5,3360,40471,2.0,0,0,4,10,3360,0,1994,0,98077,47.742,-122.035,3150,36823,37111,33673,20.879148031924093,0.10098360655737705,Cheap
20141105T000000,373000.0,3,1.75,1850,9655,1.0,0,0,3,7,1100,750,1959,0,98155,47.7358,-122.319,1480,8683,7805,7203,38.63283272915588,0.03908196721311476,Very Cheap
20140808T000000,725000.0,4,2.25,2880,8882,2.0,0,0,4,8,2480,400,1965,0,98115,47.6999,-122.284,2460,9610,6002,7150,81.62575996397207,0.08524590163934426,Very Cheap
20140813T000000,376000.0,6,2.5,2420,11662,1.0,0,2,4,7,1420,1000,1965,0,98188,47.4459,-122.278,1630,11662,9242,10032,32.24146801577774,0.039475409836065574,Very Cheap
20140805T000000,552500.0,3,1.0,2020,4120,1.5,0,0,4,7,1520,500,1929,0,98118,47.5514,-122.271,1200,4635,2100,3435,134.10194174757282,0.06262295081967213,Very Cheap
20140626T000000,365000.0,5,2.0,2280,19000,1.5,0,0,3,6,2280,0,1924,0,98166,47.4683,-122.359,1790,11800,16720,10010,19.210526315789473,0.0380327868852459,Very Cheap
20140521T000000,700000.0,4,2.5,3010,46173,2.0,0,0,3,9,3010,0,1996,0,98053,47.6471,-121.964,2590,49222,43163,46632,15.160375110995604,0.08196721311475409,Very Cheap
20150305T000000,315000.0,4,2.25,2550,9736,1.0,0,0,4,8,2550,0,1967,0,98002,47.3193,-122.212,1770,9686,7186,7916,32.354149548069024,0.031475409836065574,Very Cheap
20150331T000000,262500.0,4,2.0,1540,5110,1.0,0,0,3,7,1540,0,1957,0,98118,47.5164,-122.268,1540,5110,3570,3570,51.36986301369863,0.02459016393442623,Very Cheap
20141104T000000,660000.0,3,2.25,2280,6150,2.0,0,2,3,8,2280,0,1984,0,98136,47.5423,-122.385,1920,6150,3870,4230,107.3170731707317,0.07672131147540984,Very Cheap
20150413T000000,340000.0,4,2.5,2450,6941,2.0,0,0,3,7,2450,0,2006,0,98042,47.4006,-122.162,3300,6941,4491,3641,48.98429621092062,0.03475409836065574,Very Cheap
20140702T000000,660500.0,5,2.5,2950,5500,1.5,0,0,5,7,1720,1230,1918,0,98144,47.5785,-122.293,2200,5000,2550,2800,120.0909090909091,0.07678688524590165,Very Cheap
20140627T000000,280000.0,1,1.0,690,1950,1.0,0,0,3,6,690,0,1928,0,98117,47.6849,-122.374,1650,4864,1260,3214,143.5897435897436,0.026885245901639345,Very Cheap
20140825T000000,267000.0,1,1.0,800,2480,1.0,0,0,4,6,800,0,1919,0,98108,47.5581,-122.316,1490,4650,1680,3160,107.66129032258064,0.025180327868852458,Very Cheap
20141106T000000,230000.0,2,1.0,1470,25661,1.5,0,0,3,4,1470,0,1932,0,98059,47.4878,-122.13,1670,43301,24191,41631,8.96301780912669,0.020327868852459016,Very Cheap
20140922T000000,417000.0,3,2.25,1840,11403,2.0,0,0,3,8,1840,0,1993,0,98045,47.4862,-121.797,2150,11403,9563,9253,36.569323862141545,0.04485245901639344,Very Cheap
20140714T000000,252000.0,3,1.0,1170,9730,1.0,0,0,3,7,1170,0,1968,1986,98055,47.4562,-122.196,1680,10125,8560,8445,25.899280575539567,0.02321311475409836,Very Cheap
20150320T000000,791000.0,5,1.75,2344,4800,1.5,0,0,4,7,1544,800,1921,0,98103,47.6537,-122.335,1770,4200,2456,2430,164.79166666666666,0.0939016393442623,Very Cheap
20140910T000000,415000.0,1,1.0,1230,3774,1.0,0,0,4,6,830,400,1924,0,98103,47.6886,-122.354,1300,3774,2544,2474,109.96290408055114,0.04459016393442623,Very Cheap
20140724T000000,339000.0,3,1.75,1150,13278,1.0,0,0,5,7,1150,0,1966,0,98053,47.6384,-121.969,1560,12400,12128,10840,25.53095345684591,0.03462295081967213,Very Cheap
20150504T000000,158000.0,3,1.0,1140,10477,1.0,0,0,3,6,1140,0,1942,0,98168,47.4874,-122.306,1190,9750,9337,8560,15.080652858642742,0.010885245901639345,Very Cheap
20140811T000000,535000.0,3,1.0,1660,5100,1.0,0,0,3,7,1260,400,1957,0,98136,47.5323,-122.383,1230,5100,3440,3870,104.90196078431373,0.06032786885245902,Very Cheap
20150304T000000,818900.0,3,1.0,1080,4120,1.0,0,0,3,7,980,100,1919,0,98115,47.6771,-122.319,1280,3090,3040,1810,198.7621359223301,0.09756065573770492,Very Cheap
20150422T000000,550000.0,4,2.0,1720,4000,1.0,0,0,3,7,1420,300,1950,0,98105,47.6651,-122.285,1350,1281,2280,-69,137.5,0.06229508196721312,Very Cheap
20150306T000000,240000.0,2,1.0,590,8717,1.0,0,0,3,6,590,0,1953,0,98133,47.7343,-122.335,1370,6760,8127,5390,27.532407938510957,0.021639344262295083,Very Cheap
20140917T000000,590000.0,3,3.25,1290,1230,2.0,0,2,3,9,1090,200,2008,0,98119,47.6367,-122.37,1710,1797,-60,87,479.6747967479675,0.06754098360655737,Very Cheap
20150224T000000,369300.0,3,1.5,1480,21320,1.0,0,0,4,7,1480,0,1967,0,98027,47.5234,-122.043,1850,17825,19840,15975,17.32176360225141,0.03859672131147541,Very Cheap
20150414T000000,510000.0,4,2.5,2600,118666,1.0,0,0,3,7,1400,1200,1981,0,98027,47.54,-121.97,2440,131116,116066,128676,4.297776953803111,0.057049180327868855,Very Cheap
20140707T000000,542500.0,3,2.5,2040,10086,2.0,0,0,3,8,2040,0,1987,0,98052,47.679,-122.113,1940,10272,8046,8332,53.78742811818362,0.061311475409836065,Very Cheap
20150102T000000,262500.0,3,1.0,970,7854,1.0,0,0,4,7,970,0,1980,0,98056,47.4899,-122.185,1480,7800,6884,6320,33.42245989304813,0.02459016393442623,Very Cheap
20150211T000000,900000.0,6,3.0,2620,4350,1.0,0,0,3,7,1760,860,1957,0,98117,47.678,-122.373,1760,4300,1730,2540,206.89655172413794,0.10819672131147541,Cheap
20141014T000000,1100000.0,4,3.5,4560,41636,2.0,0,0,3,9,4170,390,1995,0,98006,47.5589,-122.116,2990,11381,37076,8391,26.419444711307523,0.13442622950819672,Cheap
20140813T000000,368000.0,3,1.75,1750,14400,1.0,0,0,4,7,1750,0,1951,0,98166,47.4535,-122.361,2030,14400,12650,12370,25.555555555555557,0.03842622950819672,Very Cheap
20141022T000000,825000.0,4,3.5,3620,6499,2.5,0,0,3,9,3620,0,2003,2009,98177,47.7326,-122.36,2330,7200,2879,4870,126.94260655485459,0.09836065573770492,Very Cheap
20150114T000000,343500.0,3,2.0,1660,7509,1.0,0,0,3,7,1660,0,2002,0,98059,47.4872,-122.144,2380,8598,5849,6218,45.74510587295246,0.035213114754098364,Very Cheap
20141204T000000,273500.0,4,1.0,1360,6000,1.0,0,0,4,6,1020,340,1944,0,98168,47.4783,-122.285,1230,6000,4640,4770,45.583333333333336,0.026032786885245903,Very Cheap
20150120T000000,1000000.0,3,2.5,2044,5610,2.0,0,0,4,9,2044,0,1996,0,98033,47.6791,-122.209,2440,5610,3566,3170,178.25311942959001,0.12131147540983607,Cheap
20141029T000000,770000.0,5,3.0,2370,6000,1.5,0,2,3,8,1340,1030,1926,2003,98107,47.6645,-122.358,1350,4500,3630,3150,128.33333333333334,0.09114754098360656,Very Cheap
20150304T000000,400000.0,3,2.0,1170,3868,1.5,0,0,4,7,1170,0,1925,0,98118,47.5543,-122.29,1400,3800,2698,2400,103.41261633919338,0.04262295081967213,Very Cheap
20140513T000000,225000.0,3,1.0,1660,7210,1.0,0,0,3,7,1100,560,1963,0,98001,47.3394,-122.281,1660,7245,5550,5585,31.206657420249652,0.019672131147540985,Very Cheap
20150305T000000,345000.0,4,1.0,2020,18150,1.0,0,0,4,7,2020,0,1955,0,98028,47.739,-122.249,1530,11970,16130,10440,19.00826446280992,0.03540983606557377,Very Cheap
20141001T000000,450000.0,3,2.5,2530,8116,2.0,0,0,3,8,2530,0,2001,0,98011,47.7597,-122.167,2280,8791,5586,6511,55.44603252833908,0.04918032786885246,Very Cheap
20140718T000000,334850.0,2,1.0,870,5635,1.0,0,0,3,7,870,0,1948,0,98116,47.5676,-122.398,1310,5750,4765,4440,59.423247559893525,0.034078688524590166,Very Cheap
20150107T000000,605000.0,5,3.0,3670,9600,1.0,0,1,3,8,1980,1690,1955,0,98108,47.5648,-122.316,1730,4933,5930,3203,63.020833333333336,0.06950819672131148,Very Cheap
20141121T000000,760000.0,5,3.5,3180,14000,2.0,0,0,5,10,3180,0,1997,0,98006,47.5501,-122.128,3670,14450,10820,10780,54.285714285714285,0.0898360655737705,Very Cheap
20141006T000000,390000.0,2,1.5,1870,12960,1.5,0,0,4,6,1350,520,1926,0,98118,47.5234,-122.288,1380,7800,11090,6420,30.09259259259259,0.04131147540983607,Very Cheap
20140804T000000,488000.0,3,2.5,1940,5660,2.0,0,0,3,8,1940,0,2001,0,98072,47.7511,-122.17,2110,4581,3720,2471,86.21908127208481,0.05416393442622951,Very Cheap
20141230T000000,3300000.0,3,3.25,4220,41300,1.0,1,4,4,11,2460,1760,1958,1987,98008,47.6083,-122.11,3810,30401,37080,26591,79.90314769975787,0.42295081967213116,High
20150222T000000,1063000.0,5,4.5,4820,13165,2.0,0,0,4,11,3950,870,1990,0,98077,47.7295,-122.057,3880,13810,8345,9930,80.74439802506646,0.12957377049180327,Cheap
20150322T000000,608000.0,3,2.0,2400,217800,2.0,0,0,3,8,1590,810,1975,0,98038,47.4166,-121.94,2340,207781,215400,205441,2.7915518824609733,0.0699016393442623,Very Cheap
20140822T000000,1385000.0,3,2.25,2930,6000,2.0,0,2,3,11,1920,1010,2000,0,98112,47.6301,-122.301,1870,5040,3070,3170,230.83333333333334,0.1718032786885246,Cheap
20140915T000000,299950.0,2,1.0,800,3000,1.0,0,0,3,6,800,0,1904,0,98118,47.5602,-122.292,1640,3400,2200,1760,99.98333333333333,0.029501639344262295,Very Cheap
20150428T000000,818000.0,3,3.25,2200,4800,2.0,0,2,3,7,1910,290,1943,1996,98103,47.6551,-122.353,1410,4800,2600,3390,170.41666666666666,0.09744262295081967,Very Cheap
20140528T000000,355000.0,3,2.5,2400,9701,1.0,0,0,3,9,2400,0,1990,0,98023,47.3081,-122.392,2400,8258,7301,5858,36.594165549943305,0.036721311475409836,Very Cheap
20141015T000000,1855000.0,5,3.25,5570,9600,2.0,0,0,5,9,3860,1710,1952,0,98105,47.6708,-122.262,3170,10400,4030,7230,193.22916666666666,0.23344262295081966,Cheap
20140623T000000,660000.0,3,3.25,1980,2850,3.0,0,0,3,7,1980,0,1987,0,98103,47.6597,-122.331,1630,4560,870,2930,231.57894736842104,0.07672131147540984,Very Cheap
20140701T000000,2367000.0,3,2.25,3530,17450,1.0,1,3,3,9,1840,1690,1930,1993,98040,47.5358,-122.213,3530,17310,13920,13780,135.64469914040114,0.3005901639344262,Medium
20150424T000000,1211000.0,4,2.5,3430,35120,2.0,0,0,3,10,3430,0,1984,0,98033,47.6484,-122.182,3920,35230,31690,31310,34.481776765375855,0.14898360655737705,Cheap
20140625T000000,255950.0,3,2.5,1720,3676,2.0,0,0,3,7,1720,0,1992,0,98031,47.4039,-122.188,1720,3510,1956,1790,69.62731229597388,0.023731147540983606,Very Cheap
20140821T000000,475000.0,3,1.5,1930,11092,1.0,0,0,3,7,1500,430,1983,0,98074,47.634,-122.033,1230,10964,9162,9734,42.82365668950595,0.05245901639344262,Very Cheap
20141229T000000,362950.0,4,1.75,2140,159865,1.0,0,0,4,7,1140,1000,1960,0,98031,47.4235,-122.218,1830,15569,157725,13739,2.270353110436931,0.03776393442622951,Very Cheap
20140701T000000,452000.0,3,1.75,1110,9012,1.0,0,0,4,7,1110,0,1966,0,98052,47.6563,-122.131,1800,8679,7902,6879,50.15534842432312,0.04944262295081967,Very Cheap
20140804T000000,315000.0,3,1.75,1970,8200,1.0,0,0,3,7,1270,700,1964,0,98168,47.4731,-122.327,1890,8348,6230,6458,38.41463414634146,0.031475409836065574,Very Cheap
20150129T000000,330950.0,3,2.5,1630,2844,2.0,0,0,3,7,1630,0,2003,0,98118,47.5413,-122.288,1610,2582,1214,972,116.36779184247538,0.0335672131147541,Very Cheap
20140611T000000,535000.0,5,2.25,2520,49222,2.0,0,0,4,8,2520,0,1978,0,98027,47.4918,-122.064,2780,55321,46702,52541,10.869123562634595,0.06032786885245902,Very Cheap
20150225T000000,479000.0,4,2.25,2270,9464,1.5,0,0,4,7,1520,750,1940,0,98146,47.5007,-122.359,1770,9464,7194,7694,50.612848689771766,0.05298360655737705,Very Cheap
20140616T000000,340000.0,3,2.5,1212,1174,3.0,0,0,3,7,1212,0,2004,0,98125,47.7145,-122.311,1256,1226,-38,-30,289.60817717206135,0.03475409836065574,Very Cheap
20140916T000000,312000.0,4,2.0,1890,8362,1.0,0,0,3,7,1890,0,1966,0,98188,47.4377,-122.279,1600,9257,6472,7657,37.31164793111696,0.031081967213114754,Very Cheap
20150318T000000,305000.0,3,2.25,1370,6600,2.0,0,0,4,7,1370,0,1993,0,98038,47.3504,-122.035,1370,6600,5230,5230,46.21212121212121,0.03016393442622951,Very Cheap
20141202T000000,270000.0,3,2.5,1770,7336,2.0,0,0,3,7,1770,0,1996,0,98030,47.3639,-122.185,1770,7349,5566,5579,36.80479825517993,0.025573770491803278,Very Cheap
20140605T000000,529999.0,3,2.5,1710,1664,2.0,0,0,5,8,1300,410,2003,0,98199,47.6456,-122.383,1470,5400,-46,3930,318.5090144230769,0.059672,Very Cheap
20140723T000000,587100.0,2,1.0,1190,6967,1.0,0,0,3,7,1190,0,1946,0,98040,47.5896,-122.243,1700,6968,5777,5268,84.2686952777379,0.06716065573770492,Very Cheap
20141118T000000,459800.0,3,2.0,1690,16061,1.0,0,0,3,7,1690,0,1984,0,98074,47.6359,-122.035,1280,12436,14371,11156,28.628354398854366,0.0504655737704918,Very Cheap
20141212T000000,451000.0,4,1.75,1680,7800,1.0,0,0,3,7,1330,350,1966,0,98008,47.6286,-122.118,1680,7210,6120,5530,57.82051282051282,0.04931147540983607,Very Cheap
20140617T000000,2475000.0,3,3.25,4340,4947,2.0,0,3,3,11,3060,1280,1993,0,98107,47.6709,-122.406,1680,5250,607,3570,500.3032140691328,0.31475409836065577,Medium
20141222T000000,525000.0,3,2.25,2040,435600,2.0,0,2,4,7,2040,0,1983,0,98022,47.2328,-121.945,2020,223027,433560,221007,1.2052341597796143,0.05901639344262295,Very Cheap
20140529T000000,250000.0,2,1.0,1110,26051,1.0,0,0,3,6,1110,0,1951,0,98168,47.4711,-122.291,2240,12255,24941,10015,9.596560592683582,0.022950819672131147,Very Cheap
20141117T000000,475000.0,5,2.0,2040,6180,2.0,0,0,4,7,2040,0,1908,0,98118,47.5503,-122.28,1870,4365,4140,2495,76.86084142394822,0.05245901639344262,Very Cheap
20150312T000000,235000.0,4,1.5,1920,11595,1.0,0,0,4,7,1920,0,1962,0,98002,47.2858,-122.212,1400,10550,9675,9150,20.267356619232427,0.02098360655737705,Very Cheap
20140711T000000,230000.0,3,1.5,1330,9548,1.0,0,0,5,7,1330,0,1967,0,98042,47.3675,-122.11,1420,9548,8218,8128,24.088814411395056,0.020327868852459016,Very Cheap
20140701T000000,581000.0,4,1.0,1630,2566,1.5,0,0,3,7,1630,0,1921,0,98122,47.6183,-122.3,1220,2314,936,1094,226.4224473889322,0.06636065573770492,Very Cheap
20140702T000000,415000.0,3,1.0,1520,9030,1.0,0,0,3,7,1520,0,1956,0,98007,47.587,-122.134,1470,8712,7510,7242,45.95791805094131,0.04459016393442623,Very Cheap
20141016T000000,522500.0,3,1.0,1520,9030,1.0,0,0,3,7,1520,0,1956,0,98007,47.587,-122.134,1470,8712,7510,7242,57.862679955703214,0.05868852459016394,Very Cheap
20150105T000000,383000.0,3,1.5,1340,7725,1.0,0,0,4,8,1340,0,1967,0,98056,47.5389,-122.173,1990,7725,6385,5735,49.579288025889966,0.04039344262295082,Very Cheap
20141030T000000,315000.0,3,1.75,2500,8289,1.0,0,0,4,7,1250,1250,1958,0,98056,47.4973,-122.177,1710,8205,5789,6495,38.00217155266015,0.031475409836065574,Very Cheap
20140922T000000,591000.0,3,2.0,1460,3600,2.0,0,0,3,7,1460,0,1902,0,98122,47.6123,-122.314,1590,1210,2140,-380,164.16666666666666,0.06767213114754099,Very Cheap
20141219T000000,750000.0,4,2.25,3140,12150,2.0,0,0,3,9,3140,0,1979,0,98074,47.6361,-122.047,2370,12054,9010,9684,61.72839506172839,0.08852459016393442,Very Cheap
20140516T000000,430000.0,3,1.75,2150,4333,1.0,0,0,3,7,1200,950,1956,0,98136,47.5537,-122.388,1480,6500,2183,5020,99.2384029540734,0.04655737704918033,Very Cheap
20150501T000000,712000.0,4,2.5,3140,32336,1.5,0,0,3,10,3140,0,1995,0,98072,47.7412,-122.087,2340,19965,29196,17625,22.01880257298367,0.08354098360655737,Very Cheap
20150406T000000,510000.0,3,2.5,2310,53578,1.0,0,0,4,8,1340,970,1981,0,98072,47.7677,-122.135,2660,49658,51268,46998,9.518832356564262,0.057049180327868855,Very Cheap
20150123T000000,480000.0,2,1.0,710,4800,1.0,0,0,2,6,710,0,1950,0,98112,47.6212,-122.298,1480,1721,4090,241,100.0,0.05311475409836065,Very Cheap
20140613T000000,538000.0,3,1.0,1460,7200,1.0,0,0,3,7,1260,200,1906,0,98103,47.6875,-122.336,1430,4650,5740,3220,74.72222222222223,0.06072131147540984,Very Cheap
20141205T000000,464000.0,2,2.75,730,5000,1.0,0,0,3,7,730,0,1929,0,98126,47.5381,-122.374,980,5000,4270,4020,92.8,0.05101639344262295,Very Cheap
20150102T000000,476000.0,3,2.5,1440,3840,2.0,0,0,3,7,1440,0,2001,0,98053,47.6873,-122.043,1600,3131,2400,1531,123.95833333333333,0.052590163934426226,Very Cheap
20150326T000000,349500.0,3,2.0,1130,16875,1.0,0,0,4,7,1130,0,1947,0,98155,47.7489,-122.3,1600,14300,15745,12700,20.711111111111112,0.036,Very Cheap
20150207T000000,270000.0,3,2.25,1810,8262,2.0,0,0,4,8,1810,0,1981,0,98023,47.2994,-122.37,1820,8262,6452,6442,32.6797385620915,0.025573770491803278,Very Cheap
20141119T000000,740000.0,3,2.5,2710,18480,2.0,0,2,3,10,2000,710,1978,0,98034,47.7256,-122.259,2710,18077,15770,15367,40.04329004329004,0.08721311475409836,Very Cheap
20141013T000000,395000.0,4,2.5,2740,8336,2.0,0,0,4,9,2740,0,1990,0,98031,47.3904,-122.176,2460,9189,5596,6729,47.38483685220729,0.0419672131147541,Very Cheap
20150410T000000,498000.0,3,2.5,1690,4088,2.0,0,0,3,7,1690,0,2004,0,98053,47.6779,-122.034,1950,4088,2398,2138,121.81996086105676,0.055475409836065574,Very Cheap
20150130T000000,339900.0,3,2.5,1470,4675,2.0,0,0,3,7,1470,0,1999,0,98065,47.5261,-121.827,1500,4385,3205,2885,72.70588235294117,0.03474098360655738,Very Cheap
20140902T000000,539000.0,3,2.5,2830,9972,2.0,0,0,3,9,2830,0,2006,0,98019,47.7382,-121.975,3557,9159,7142,5602,54.0513437625351,0.06085245901639344,Very Cheap
20150226T000000,400000.0,3,1.0,1410,9704,1.0,0,0,3,8,1140,270,1983,0,98074,47.6203,-122.036,1910,13639,8294,11729,41.22011541632317,0.04262295081967213,Very Cheap
20150218T000000,225000.0,3,2.5,2170,11745,1.0,0,0,4,7,1410,760,1967,0,98058,47.4342,-122.17,1860,8643,9575,6783,19.157088122605366,0.019672131147540985,Very Cheap
20140910T000000,330000.0,3,2.25,1340,4080,1.5,0,0,3,6,1170,170,1907,0,98144,47.5722,-122.291,1670,4080,2740,2410,80.88235294117646,0.03344262295081967,Very Cheap
20140626T000000,1387800.0,3,3.0,2480,5500,2.0,0,3,3,10,1730,750,1950,2005,98199,47.6466,-122.404,2950,5670,3020,2720,252.3272727272727,0.1721704918032787,Cheap
20150430T000000,490000.0,3,2.75,1990,31200,1.0,0,0,3,8,1990,0,1986,0,98029,47.5544,-122.035,3120,29625,29210,26505,15.705128205128204,0.05442622950819672,Very Cheap
20141220T000000,260000.0,4,2.75,2240,7200,1.0,0,0,3,7,1140,1100,1967,0,98001,47.3357,-122.275,1580,7416,4960,5836,36.111111111111114,0.024262295081967214,Very Cheap
20140627T000000,469900.0,4,2.5,2990,8913,2.0,0,0,4,9,2990,0,1991,0,98058,47.4353,-122.159,2740,8030,5923,5290,52.720744979243804,0.05179016393442623,Very Cheap
20141112T000000,493000.0,6,1.75,2120,3801,1.5,0,0,4,7,1220,900,1925,0,98115,47.6832,-122.311,1850,4181,1681,2331,129.70270981320706,0.054819672131147544,Very Cheap
20140528T000000,740000.0,4,2.25,2920,46355,2.0,0,0,4,9,2920,0,1998,0,98024,47.569,-121.962,2310,184694,43435,182384,15.96375795491317,0.08721311475409836,Very Cheap
20141211T000000,148900.0,4,1.75,1700,6000,1.0,0,0,3,7,1700,0,1967,0,98002,47.3252,-122.208,1280,6000,4300,4720,24.816666666666666,0.009691803278688524,Very Cheap
20141118T000000,475000.0,2,2.5,1620,14467,2.0,0,0,3,7,1620,0,1981,0,98074,47.6306,-122.035,1470,13615,12847,12145,32.833344853805215,0.05245901639344262,Very Cheap
20141223T000000,415000.0,2,1.0,760,4000,1.0,0,0,3,7,760,0,1944,0,98117,47.6896,-122.396,1520,4000,3240,2480,103.75,0.04459016393442623,Very Cheap
20140707T000000,229500.0,3,1.0,1230,6000,1.0,0,0,4,7,1230,0,1967,0,98002,47.3256,-122.209,1240,6000,4770,4760,38.25,0.020262295081967214,Very Cheap
20140814T000000,1355000.0,5,3.75,4960,13990,2.0,0,2,3,11,3760,1200,2001,0,98006,47.5491,-122.137,5200,18116,9030,12916,96.85489635453895,0.1678688524590164,Cheap
20141210T000000,385000.0,4,2.5,2030,11375,1.0,0,0,3,7,1330,700,1969,0,98028,47.7765,-122.261,1500,9160,9345,7660,33.84615384615385,0.04065573770491803,Very Cheap
20150427T000000,230000.0,3,2.25,1830,11331,1.0,0,0,3,7,1250,580,1965,0,98001,47.2899,-122.287,2240,16433,9501,14193,20.298296708145795,0.020327868852459016,Very Cheap
20140808T000000,425000.0,2,1.0,970,2700,1.0,0,0,4,7,770,200,1926,0,98115,47.6852,-122.312,1570,3348,1730,1778,157.40740740740742,0.04590163934426229,Very Cheap
20140722T000000,189900.0,2,1.0,1000,4179,1.0,0,0,5,5,1000,0,1914,0,98002,47.297,-122.227,1010,6327,3179,5317,45.44149318018665,0.015068852459016393,Very Cheap
20150102T000000,238000.0,2,1.0,750,6480,1.0,0,0,3,6,750,0,1943,0,98106,47.5195,-122.35,1050,6390,5730,5340,36.72839506172839,0.02137704918032787,Very Cheap
20140819T000000,968060.0,4,2.5,2620,16200,1.0,0,2,4,7,1570,1050,1950,1993,98033,47.6623,-122.196,3050,11875,13580,8825,59.75679012345679,0.11712262295081967,Cheap
20140616T000000,921000.0,4,1.5,2220,9496,1.0,0,0,4,7,1490,730,1954,0,98004,47.6233,-122.206,1800,8286,7276,6486,96.98820556023588,0.11095081967213115,Cheap
20140507T000000,380000.0,5,1.75,3000,6000,1.0,0,0,5,7,1500,1500,1958,0,98178,47.492,-122.225,2230,7125,3000,4895,63.333333333333336,0.04,Very Cheap
20141117T000000,285000.0,1,1.0,1060,54846,1.0,1,4,3,5,1060,0,1935,0,98070,47.4716,-122.445,2258,31762,53786,29504,5.1963680122524885,0.02754098360655738,Very Cheap
20141022T000000,449000.0,4,2.5,1980,5400,2.0,0,0,3,8,1980,0,1998,0,98056,47.5182,-122.207,1980,5400,3420,3420,83.14814814814815,0.049049180327868855,Very Cheap
20140709T000000,625000.0,4,1.0,1600,5500,1.5,0,0,4,7,1600,0,1946,0,98117,47.6983,-122.393,1900,5500,3900,3600,113.63636363636364,0.07213114754098361,Very Cheap
20140521T000000,318989.0,4,2.25,2000,9000,1.0,0,0,4,8,2000,0,1978,0,98023,47.3125,-122.387,2190,8374,7000,6184,35.443222222222225,0.03199855737704918,Very Cheap
20141010T000000,445000.0,3,1.5,1310,1266,2.0,0,0,3,8,1120,190,2002,0,98116,47.5663,-122.408,1310,1378,-44,68,351.5007898894155,0.04852459016393443,Very Cheap
20150205T000000,750000.0,3,1.0,1120,8549,1.0,0,0,3,7,1120,0,1952,0,98004,47.6294,-122.205,1440,8640,7429,7200,87.72955901275003,0.08852459016393442,Very Cheap
20150306T000000,959000.0,3,2.5,3320,11875,1.0,0,0,5,10,3320,0,1979,0,98034,47.7212,-122.26,3730,11875,8555,8145,80.7578947368421,0.1159344262295082,Cheap
20141202T000000,330000.0,3,2.5,2370,9102,2.0,0,0,3,9,2370,0,1990,0,98023,47.3067,-122.394,2530,9883,6732,7353,36.255767963085034,0.03344262295081967,Very Cheap
20150216T000000,425000.0,2,1.5,830,1241,2.0,0,0,3,7,830,0,2005,0,98119,47.6363,-122.368,1610,2666,411,1056,342.4657534246575,0.04590163934426229,Very Cheap
20141202T000000,280000.0,3,1.0,940,7913,1.0,0,0,3,6,940,0,1948,0,98155,47.7657,-122.321,940,7913,6973,6973,35.38480980664729,0.026885245901639345,Very Cheap
20141023T000000,476500.0,4,2.5,2250,50155,2.0,0,0,3,8,2250,0,1998,0,98045,47.449,-121.756,2040,57857,47905,55817,9.500548300269166,0.052655737704918035,Very Cheap
20140521T000000,556000.0,3,2.25,2020,3600,2.0,0,0,3,8,2020,0,1998,0,98033,47.6678,-122.165,2070,3699,1580,1629,154.44444444444446,0.06308196721311475,Very Cheap
20140729T000000,1862000.0,4,5.25,5240,320917,2.0,0,2,3,10,5240,0,2006,0,98024,47.5605,-121.905,1930,68824,315677,66894,5.802123290445817,0.23436065573770493,Cheap
20140919T000000,637000.0,4,3.5,4083,68377,2.0,0,0,3,10,4083,0,2005,0,98001,47.3114,-122.262,2430,41382,64294,38952,9.315998069526303,0.07370491803278688,Very Cheap
20141204T000000,405000.0,3,2.0,1450,6081,1.0,0,0,4,7,1450,0,1969,0,98155,47.7522,-122.278,1880,6000,4631,4120,66.60088801184015,0.043278688524590166,Very Cheap
20140627T000000,397000.0,5,1.0,1170,6757,1.0,0,0,4,6,800,370,1944,0,98125,47.7332,-122.304,1590,6794,5587,5204,58.753884860145035,0.04222950819672131,Very Cheap
20140724T000000,895990.0,4,2.75,3555,6565,2.0,0,0,3,9,3555,0,2014,0,98053,47.6847,-122.017,3625,5637,3010,2012,136.47981721249047,0.10767081967213114,Cheap
20140828T000000,259000.0,3,2.0,1610,14046,2.0,0,0,3,7,1610,0,1933,1988,98028,47.7704,-122.264,2410,9000,12436,6590,18.43941335611562,0.024131147540983607,Very Cheap
20141022T000000,420000.0,2,1.0,960,112384,1.0,0,0,3,7,960,0,1955,0,98028,47.7642,-122.234,1210,24875,111424,23665,3.7371867881548977,0.04524590163934426,Very Cheap
20140519T000000,518000.0,3,2.5,1680,2096,2.0,0,0,3,8,1380,300,2008,0,98117,47.6904,-122.37,1360,2096,416,736,247.13740458015266,0.0580983606557377,Very Cheap
20140722T000000,425000.0,3,1.75,1380,8182,1.0,0,0,5,7,1380,0,1942,0,98133,47.7513,-122.349,1300,8188,6802,6888,51.943290149107796,0.04590163934426229,Very Cheap
20140808T000000,182500.0,2,1.0,1040,13920,1.0,0,0,3,6,1040,0,1973,0,98198,47.3756,-122.306,1100,7575,12880,6475,13.110632183908047,0.014098360655737704,Very Cheap
20140716T000000,549900.0,3,1.5,1380,3031,1.5,0,0,4,7,1380,0,1929,0,98117,47.6889,-122.38,1440,4005,1651,2565,181.4252721873969,0.062281967213114756,Very Cheap
20140916T000000,445000.0,3,1.75,1850,16863,1.0,0,0,4,7,1280,570,1980,0,98034,47.7166,-122.225,1790,9000,15013,7210,26.389135978177073,0.04852459016393443,Very Cheap
20140606T000000,452000.0,2,1.75,1740,5400,1.0,0,0,4,7,990,750,1946,0,98115,47.6971,-122.282,1980,5400,3660,3420,83.70370370370371,0.04944262295081967,Very Cheap
20141104T000000,715000.0,5,1.75,1920,6500,1.0,0,0,3,7,1260,660,1951,0,98112,47.6394,-122.308,1970,5500,4580,3530,110.0,0.0839344262295082,Very Cheap
20140911T000000,559000.0,3,2.5,2010,5200,2.0,0,0,3,8,2010,0,1989,0,98034,47.7142,-122.203,1860,4400,3190,2540,107.5,0.06347540983606557,Very Cheap
20140702T000000,3300000.0,5,6.25,8020,21738,2.0,0,0,3,11,8020,0,2001,0,98006,47.5675,-122.189,4160,18969,13718,14809,151.80789401048855,0.42295081967213116,High
20141015T000000,250000.0,4,1.75,1860,7350,1.0,0,0,4,7,1090,770,1977,0,98031,47.3979,-122.174,1710,7350,5490,5640,34.01360544217687,0.022950819672131147,Very Cheap
20140923T000000,1230000.0,5,4.0,4390,6656,2.0,0,0,3,9,2930,1460,2008,0,98199,47.648,-122.397,1560,6656,2266,5096,184.79567307692307,0.15147540983606558,Cheap
20150512T000000,276500.0,4,2.25,2380,128937,1.0,0,0,4,7,2380,0,1960,0,98038,47.4253,-122.043,1030,114998,126557,113968,2.1444581462264516,0.02642622950819672,Very Cheap
20141114T000000,440000.0,4,2.5,2880,7386,2.0,0,0,4,9,2880,0,1987,0,98058,47.4397,-122.15,2420,7663,4506,5243,59.572163552667206,0.04786885245901639,Very Cheap
20140508T000000,543200.0,6,2.25,2820,15600,1.5,0,2,5,7,1970,850,1940,0,98166,47.4635,-122.362,2520,7797,12780,5277,34.82051282051282,0.06140327868852459,Very Cheap
20140601T000000,250000.0,1,1.0,750,4000,1.0,0,0,3,6,750,0,1918,0,98136,47.5243,-122.39,1770,4850,3250,3080,62.5,0.022950819672131147,Very Cheap
20140728T000000,625000.0,4,2.5,1750,9000,1.0,0,0,3,8,1410,340,1977,2003,98052,47.6403,-122.105,2120,9600,7250,7480,69.44444444444444,0.07213114754098361,Very Cheap
20140613T000000,530100.0,3,1.0,1540,3399,1.5,0,0,3,7,1200,340,1926,0,98117,47.6853,-122.359,1500,3914,1859,2414,155.9576345984113,0.059685245901639344,Very Cheap
20140721T000000,549900.0,2,1.75,1140,936,2.0,0,0,3,8,940,200,2014,0,98105,47.6647,-122.284,1160,1327,-204,167,587.5,0.062281967213114756,Very Cheap
20150311T000000,430000.0,4,1.5,1560,6534,1.0,0,0,4,7,1560,0,1962,0,98007,47.6012,-122.152,1560,6969,4974,5409,65.80961126415671,0.04655737704918033,Very Cheap
20141210T000000,835000.0,3,2.5,2960,6856,2.0,0,0,3,10,2960,0,2009,0,98074,47.5906,-122.057,3320,6856,3896,3536,121.79113185530922,0.09967213114754099,Very Cheap
20140507T000000,409500.0,4,2.75,2140,13000,1.0,0,0,3,7,1320,820,1968,0,98028,47.7683,-122.252,2360,11000,10860,8640,31.5,0.043868852459016394,Very Cheap
20140520T000000,329000.0,4,2.5,1600,6765,1.0,0,0,3,7,830,770,1947,2011,98106,47.5469,-122.365,1600,8942,5165,7342,48.63266814486327,0.03331147540983607,Very Cheap
20140522T000000,940000.0,4,2.75,2080,4000,1.5,0,0,3,8,2080,0,1912,2000,98107,47.6737,-122.358,1730,5000,1920,3270,235.0,0.11344262295081967,Cheap
20140813T000000,539950.0,3,2.0,1560,3200,1.5,0,0,3,7,1560,0,1910,2007,98109,47.6398,-122.356,1240,3600,1640,2360,168.734375,0.06097704918032787,Very Cheap
20150414T000000,579950.0,4,2.5,2880,213444,1.0,0,0,5,8,2140,740,1984,0,98092,47.2887,-122.109,2810,213444,210564,210634,2.7171061261970353,0.06622295081967212,Very Cheap
20140611T000000,881000.0,5,3.0,2510,4125,1.5,0,3,5,8,1590,920,1925,0,98144,47.5968,-122.29,2190,5415,1615,3225,213.57575757575756,0.10570491803278688,Cheap
20140804T000000,362500.0,3,1.0,960,5424,1.5,0,0,3,6,960,0,1916,0,98115,47.6997,-122.32,1550,5687,4464,4137,66.83259587020649,0.03770491803278689,Very Cheap
20150421T000000,243950.0,2,1.0,1120,35500,1.0,0,0,5,6,1120,0,1961,0,98022,47.2411,-122.043,1680,66022,34380,64342,6.871830985915493,0.02215737704918033,Very Cheap
20140529T000000,658000.0,4,2.75,3310,6166,2.0,0,0,3,9,3310,0,2008,0,98065,47.521,-121.877,3200,7027,2856,3827,106.71423937722997,0.07645901639344262,Very Cheap
20141124T000000,218250.0,3,1.5,1080,9774,1.0,0,0,3,7,1080,0,1968,0,98023,47.3155,-122.401,1190,9611,8694,8421,22.32965009208103,0.01878688524590164,Very Cheap
20140522T000000,655000.0,4,2.5,2860,12394,2.0,0,0,3,10,2860,0,1999,0,98075,47.5832,-122.026,3070,8515,9534,5445,52.84815233177344,0.0760655737704918,Very Cheap
20150305T000000,255000.0,3,2.0,1490,7599,1.0,0,0,3,7,1490,0,1990,0,98042,47.3687,-122.088,1560,7710,6109,6150,33.557046979865774,0.02360655737704918,Very Cheap
20150115T000000,215000.0,3,1.0,1210,7175,1.0,0,0,3,7,1210,0,1918,0,98106,47.5339,-122.356,1640,5850,5965,4210,29.965156794425088,0.018360655737704918,Very Cheap
20150223T000000,1265000.0,3,1.75,2240,5657,1.5,0,2,4,8,1910,330,1941,0,98105,47.6621,-122.27,2970,5657,3417,2687,223.61675799893936,0.1560655737704918,Cheap
20140711T000000,2920000.0,4,4.75,4575,24085,2.5,0,2,5,10,3905,670,1926,0,98112,47.6263,-122.284,3900,9687,19510,5787,121.23728461698153,0.37311475409836065,Medium
20150402T000000,424305.0,3,2.5,1600,5960,2.0,0,2,5,8,1600,0,1910,0,98168,47.4758,-122.265,1410,13056,4360,11646,71.19211409395973,0.04581049180327869,Very Cheap
20140520T000000,494000.0,4,1.75,2090,4300,1.5,0,0,4,7,1250,840,1925,0,98136,47.5555,-122.397,1670,5000,2210,3330,114.88372093023256,0.05495081967213115,Very Cheap
20140605T000000,560000.0,4,2.5,2260,3713,2.0,0,0,3,9,2260,0,2003,0,98034,47.7247,-122.165,2260,3713,1453,1453,150.82143819014274,0.06360655737704918,Very Cheap
20140924T000000,130000.0,3,1.0,1200,7000,2.0,0,0,1,7,1200,0,1908,0,98116,47.5883,-122.384,3290,6000,5800,2710,18.571428571428573,0.007213114754098361,Very Cheap
20150504T000000,468000.0,4,2.5,2480,176418,1.5,0,3,5,8,2480,0,1927,0,98022,47.1941,-122.038,1640,112384,173938,110744,2.65279053157841,0.05154098360655738,Very Cheap
20141209T000000,480000.0,5,3.0,2240,15435,1.0,0,1,5,7,1390,850,1952,0,98155,47.7426,-122.288,2240,10750,13195,8510,31.09815354713314,0.05311475409836065,Very Cheap
20140811T000000,475000.0,3,1.75,1550,4054,1.5,0,0,4,7,1550,0,1926,0,98115,47.6743,-122.301,1510,3889,2504,2379,117.16822890971879,0.05245901639344262,Very Cheap
20150225T000000,285000.0,4,1.75,2130,8151,1.0,0,0,4,7,1330,800,1967,0,98031,47.3932,-122.201,1600,8587,6021,6987,34.96503496503497,0.02754098360655738,Very Cheap
20140630T000000,765000.0,5,3.0,2870,5700,1.0,0,0,3,7,1950,920,1964,0,98103,47.6621,-122.33,1730,5529,2830,3799,134.21052631578948,0.09049180327868853,Very Cheap
20150327T000000,208000.0,2,1.0,1160,5750,1.0,0,0,4,6,1160,0,1924,0,98065,47.5322,-121.829,1160,8250,4590,7090,36.17391304347826,0.01744262295081967,Very Cheap
20141003T000000,372000.0,3,2.5,2430,5000,2.0,0,0,3,8,2430,0,2001,0,98042,47.3786,-122.127,2910,5620,2570,2710,74.4,0.03895081967213115,Very Cheap
20141209T000000,470000.0,2,1.0,900,5512,1.0,0,0,3,7,900,0,1947,0,98115,47.6877,-122.289,1270,5512,4612,4242,85.26850507982583,0.05180327868852459,Very Cheap
20140626T000000,451000.0,5,2.75,2830,8925,1.5,0,0,3,7,2830,0,1967,0,98034,47.731,-122.179,1700,8539,6095,6839,50.53221288515406,0.04931147540983607,Very Cheap
20140827T000000,442200.0,4,1.75,1620,8132,1.0,0,0,3,8,1620,0,1974,0,98052,47.6788,-122.11,1920,8400,6512,6480,54.377766847024105,0.04815737704918033,Very Cheap
20140825T000000,330000.0,4,2.5,2510,8580,2.0,0,0,4,8,2510,0,1991,2012,98023,47.295,-122.37,2290,7809,6070,5519,38.46153846153846,0.03344262295081967,Very Cheap
20140924T000000,335000.0,3,1.75,1790,5120,1.0,0,0,4,6,940,850,1949,0,98106,47.5277,-122.355,1160,5120,3330,3960,65.4296875,0.03409836065573771,Very Cheap
20141114T000000,280000.0,3,2.0,1640,13249,1.0,0,0,3,7,1640,0,1995,0,98032,47.3589,-122.281,1640,9240,11609,7600,21.133670465695523,0.026885245901639345,Very Cheap
20140822T000000,625000.0,3,1.75,2240,6050,1.0,0,0,4,8,1250,990,1950,0,98116,47.5658,-122.4,1720,6050,3810,4330,103.30578512396694,0.07213114754098361,Very Cheap
20140903T000000,345000.0,3,2.5,1870,3584,2.0,0,0,3,8,1870,0,2003,0,98058,47.4521,-122.121,1900,3920,1714,2020,96.26116071428571,0.03540983606557377,Very Cheap
20141024T000000,255950.0,4,1.0,1500,11050,1.0,0,0,5,7,1500,0,1964,0,98058,47.4509,-122.088,1970,20800,9550,18830,23.16289592760181,0.023731147540983606,Very Cheap
20150105T000000,570000.0,4,1.0,1490,6000,1.5,0,0,3,7,1490,0,1918,0,98136,47.5518,-122.385,1700,6000,4510,4300,95.0,0.06491803278688525,Very Cheap
20150331T000000,685000.0,3,1.5,2230,8558,2.0,0,0,3,8,2230,0,1960,0,98040,47.5833,-122.219,2200,8558,6328,6358,80.04206590324843,0.08,Very Cheap
20140902T000000,273148.0,3,1.75,1710,7210,1.0,0,0,4,7,1240,470,1974,0,98031,47.4094,-122.175,1840,7245,5500,5405,37.88460471567268,0.02598662295081967,Very Cheap
20140625T000000,246500.0,3,2.5,1620,7686,2.0,0,0,3,7,1620,0,1989,0,98038,47.3613,-122.053,1370,7686,6066,6316,32.07129846474109,0.022491803278688525,Very Cheap
20150406T000000,349950.0,5,2.5,2250,7176,1.0,0,0,3,7,1310,940,1983,0,98055,47.4486,-122.194,1550,9081,4926,7531,48.76672240802676,0.036059016393442625,Very Cheap
20150210T000000,545000.0,4,2.0,1700,2350,1.0,0,0,3,6,850,850,1926,2014,98117,47.6865,-122.366,1600,4160,650,2560,231.91489361702128,0.06163934426229508,Very Cheap
20150227T000000,403000.0,3,2.5,1502,1400,3.0,0,0,3,7,1502,0,2005,0,98115,47.6951,-122.305,1377,1466,-102,89,287.85714285714283,0.04301639344262295,Very Cheap
20150211T000000,299950.0,4,2.5,1900,4054,2.0,0,0,3,7,1900,0,2003,0,98042,47.3767,-122.124,2520,4085,2154,1565,73.98865318204243,0.029501639344262295,Very Cheap
20150501T000000,792000.0,3,2.5,3320,12840,1.0,0,0,3,10,2600,720,1990,0,98075,47.5783,-121.994,3230,14933,9520,11703,61.6822429906542,0.0940327868852459,Very Cheap
20141002T000000,418000.0,5,2.5,1980,10205,1.0,0,0,4,7,1080,900,1929,0,98115,47.699,-122.307,1310,5413,8225,4103,40.96031357177854,0.04498360655737705,Very Cheap
20150427T000000,332500.0,4,1.0,1670,8102,1.5,0,0,3,6,1670,0,1944,0,98166,47.4692,-122.355,1310,7906,6432,6596,41.0392495680079,0.033770491803278686,Very Cheap
20150127T000000,337000.0,3,2.5,2235,43560,1.0,0,0,5,7,990,1245,1975,0,98010,47.3326,-122.046,1460,29621,41325,28161,7.736455463728191,0.034360655737704915,Very Cheap
20150121T000000,212000.0,2,1.0,1070,7386,1.0,0,0,3,6,1070,0,1949,0,98108,47.5434,-122.298,1330,6351,6316,5021,28.702951529921474,0.017967213114754098,Very Cheap
20150310T000000,542000.0,2,2.25,1800,2819,2.0,0,2,4,9,1800,0,1979,0,98008,47.6104,-122.113,1800,2755,1019,955,192.26676126285918,0.06124590163934426,Very Cheap
20140522T000000,622500.0,4,2.5,2980,8107,2.0,0,0,3,9,2980,0,2000,0,98065,47.5389,-121.876,2750,7760,5127,5010,76.78549401751573,0.0718032786885246,Very Cheap
20140829T000000,260000.0,3,1.75,1670,8511,1.0,0,0,3,7,1340,330,1985,0,98001,47.3257,-122.276,1580,7218,6841,5638,30.548701680178592,0.024262295081967214,Very Cheap
20150505T000000,525000.0,3,1.75,2620,38350,1.0,0,0,4,8,1320,1300,1977,0,98027,47.4619,-121.991,2170,36962,35730,34792,13.689700130378096,0.05901639344262295,Very Cheap
20141114T000000,975000.0,5,3.5,5470,35071,2.0,0,0,3,11,4590,880,1976,0,98005,47.6368,-122.159,3600,35074,29601,31474,27.80074705597217,0.1180327868852459,Cheap
20140909T000000,1140000.0,4,1.75,3080,6500,1.0,0,0,4,9,1700,1380,1941,0,98199,47.6353,-122.402,2960,5711,3420,2751,175.3846153846154,0.13967213114754098,Cheap
20150303T000000,500000.0,3,1.0,940,10360,1.0,0,0,4,7,940,0,1964,0,98033,47.688,-122.19,2019,10360,9420,8341,48.262548262548265,0.05573770491803279,Very Cheap
20140618T000000,554000.0,5,2.25,1870,11411,1.0,0,0,4,8,1170,700,1961,0,98155,47.7445,-122.289,2420,10793,9541,8373,48.549645079309435,0.06281967213114754,Very Cheap
20140605T000000,343000.0,4,2.5,2070,4500,2.0,0,0,3,7,2070,0,2004,0,98038,47.3497,-122.026,2760,5173,2430,2413,76.22222222222223,0.035147540983606555,Very Cheap
20150424T000000,515000.0,2,1.75,950,15219,1.0,0,0,3,8,950,0,2009,0,98028,47.7723,-122.262,1560,12416,14269,10856,33.83927984755897,0.057704918032786885,Very Cheap
20140712T000000,492000.0,2,1.0,1290,6272,1.0,0,0,4,6,890,400,1922,0,98115,47.6777,-122.305,1260,5376,4982,4116,78.4438775510204,0.054688524590163934,Very Cheap
20150213T000000,655000.0,4,3.0,2570,8022,1.0,0,0,4,8,1370,1200,1984,0,98052,47.6956,-122.099,2090,8022,5452,5932,81.65046123161306,0.0760655737704918,Very Cheap
20150506T000000,290000.0,3,2.5,1600,6848,2.0,0,0,3,7,1600,0,2000,0,98001,47.3303,-122.271,1700,7210,5248,5510,42.348130841121495,0.02819672131147541,Very Cheap
20140701T000000,952500.0,4,1.5,2550,5055,2.0,0,0,4,10,2550,0,1910,0,98112,47.636,-122.301,1970,4431,2505,2461,188.42729970326408,0.11508196721311476,Cheap
20140822T000000,235000.0,2,1.0,1010,7500,1.0,0,0,3,7,1010,0,1941,0,98108,47.5283,-122.32,1220,6000,6490,4780,31.333333333333332,0.02098360655737705,Very Cheap
20150401T000000,323000.0,3,1.5,1720,7110,1.0,0,0,3,8,1720,0,1955,0,98106,47.5417,-122.355,1730,6840,5390,5110,45.42897327707454,0.03252459016393443,Very Cheap
20140506T000000,1050000.0,3,2.5,2200,1970,2.0,0,0,3,9,1610,590,2008,0,98102,47.6426,-122.327,1890,3505,-230,1615,532.994923857868,0.12786885245901639,Cheap
20141029T000000,265000.0,0,0.75,384,213444,1.0,0,0,3,4,384,0,2003,0,98070,47.4177,-122.491,1920,224341,213060,222421,1.2415434493356572,0.024918032786885248,Very Cheap
20150129T000000,200000.0,2,1.0,1400,9600,1.5,0,0,4,6,1400,0,1941,0,98022,47.2113,-121.993,1230,9600,8200,8370,20.833333333333332,0.01639344262295082,Very Cheap
20141204T000000,419995.0,3,2.25,1830,7500,1.0,0,0,4,7,1330,500,1968,0,98155,47.7574,-122.31,1830,8720,5670,6890,55.99933333333333,0.04524524590163934,Very Cheap
20150310T000000,1500000.0,3,3.0,3110,9015,1.0,0,4,4,10,1590,1520,1980,0,98033,47.6624,-122.202,3150,11447,5905,8297,166.38935108153078,0.18688524590163935,Cheap
20140812T000000,455000.0,3,2.5,1600,7829,2.0,0,0,3,7,1600,0,1987,0,98034,47.7288,-122.227,1580,9104,6229,7524,58.117256354579126,0.049836065573770495,Very Cheap
20150325T000000,660000.0,3,3.5,3600,37982,2.0,0,0,4,8,3600,0,1996,0,98014,47.6982,-121.917,2050,18019,34382,15969,17.37665209836238,0.07672131147540984,Very Cheap
20140513T000000,319000.0,3,1.0,1390,12823,1.0,0,0,4,7,1390,0,1968,0,98077,47.7438,-122.075,1390,10095,11433,8705,24.877173828277314,0.032,Very Cheap
20141223T000000,390000.0,3,1.75,2092,250905,1.0,0,0,3,7,2092,0,1981,0,98022,47.2664,-122.027,2092,217800,248813,215708,1.5543731691277576,0.04131147540983607,Very Cheap
20140627T000000,718500.0,3,1.5,1200,6240,1.0,0,0,3,8,1030,170,1952,0,98112,47.6222,-122.287,2810,6240,5040,3430,115.14423076923077,0.08439344262295082,Very Cheap
20141203T000000,474000.0,2,1.0,1090,3160,1.0,0,0,3,7,840,250,1926,0,98109,47.6385,-122.344,1070,3160,2070,2090,150.0,0.05232786885245902,Very Cheap
20140825T000000,615750.0,4,2.0,2140,6360,2.0,0,0,3,7,1840,300,1945,0,98115,47.687,-122.286,1690,6360,4220,4670,96.81603773584905,0.07091803278688524,Very Cheap
20141114T000000,551000.0,3,2.5,2010,17362,2.0,0,0,3,8,2010,0,1994,0,98033,47.6904,-122.176,1920,7200,15352,5280,31.735975118073956,0.06242622950819672,Very Cheap
20150211T000000,230000.0,3,2.25,1500,7210,1.0,0,0,3,7,1150,350,1984,0,98023,47.3124,-122.352,1500,7210,5710,5710,31.9001386962552,0.020327868852459016,Very Cheap
20140711T000000,790000.0,4,2.5,3500,9198,2.0,0,0,3,9,3500,0,2004,0,98053,47.6785,-122.025,3990,8598,5698,4608,85.88823657316809,0.09377049180327869,Very Cheap
20150326T000000,1230000.0,3,2.5,2660,1967,3.0,0,3,3,9,1870,790,2007,0,98119,47.6264,-122.363,1640,1369,-693,-271,625.3177427554651,0.15147540983606558,Cheap
20141223T000000,325000.0,3,2.25,1440,6443,2.0,0,0,3,7,1440,0,1995,0,98019,47.7471,-121.979,1700,6749,5003,5049,50.44234052460034,0.03278688524590164,Very Cheap
20140801T000000,705000.0,4,2.75,2780,6207,2.0,0,0,3,8,2780,0,2001,0,98053,47.6867,-122.038,2660,5592,3427,2932,113.58144030932817,0.08262295081967214,Very Cheap
20141211T000000,259000.0,4,1.75,1580,8856,2.0,0,0,3,7,1580,0,1979,0,98045,47.4694,-121.745,1390,9490,7276,8100,29.245709123757905,0.024131147540983607,Very Cheap
20141204T000000,306000.0,3,1.5,1250,8700,1.0,0,0,4,7,1250,0,1959,0,98168,47.4744,-122.328,1300,8700,7450,7400,35.172413793103445,0.030295081967213113,Very Cheap
20141215T000000,315000.0,3,1.0,970,6828,1.0,0,0,3,6,970,0,1928,0,98106,47.5476,-122.36,1160,11666,5858,10506,46.1335676625659,0.031475409836065574,Very Cheap
20150413T000000,392500.0,3,1.0,1100,7650,1.0,0,0,3,7,1100,0,1952,0,98133,47.7219,-122.354,1430,7650,6550,6220,51.30718954248366,0.04163934426229508,Very Cheap
20141112T000000,1065000.0,4,2.25,3240,12930,2.0,0,0,4,9,2730,510,1968,0,98040,47.5373,-122.22,2610,12884,9690,10274,82.36658932714617,0.1298360655737705,Cheap
20140716T000000,350500.0,2,2.5,1290,1445,3.0,0,0,3,8,1290,0,1999,0,98117,47.6955,-122.376,1470,1503,155,33,242.560553633218,0.03613114754098361,Very Cheap
20140618T000000,825000.0,4,3.5,3810,9792,2.0,0,0,3,9,3810,0,1938,2013,98146,47.5018,-122.38,1950,9792,5982,7842,84.25245098039215,0.09836065573770492,Very Cheap
20140808T000000,235000.0,4,1.0,1500,6360,1.5,0,0,3,6,1500,0,1944,0,98178,47.4979,-122.24,1190,6360,4860,5170,36.9496855345912,0.02098360655737705,Very Cheap
20150302T000000,650000.0,3,2.0,2660,257875,1.0,0,2,4,8,1530,1130,1976,0,98024,47.553,-121.887,1710,64033,255215,62323,2.5206010664081435,0.07540983606557378,Very Cheap
20140512T000000,675000.0,4,3.0,2400,3340,1.0,0,0,4,7,1200,1200,1964,0,98107,47.6646,-122.365,1520,3758,940,2238,202.09580838323353,0.07868852459016394,Very Cheap
20141001T000000,265000.0,4,1.0,1860,8505,1.0,0,0,4,7,1860,0,1955,0,98055,47.4406,-122.194,1560,8505,6645,6945,31.158142269253382,0.024918032786885248,Very Cheap
20140812T000000,822500.0,2,1.0,1450,7098,1.0,0,4,3,7,1450,0,1924,0,98109,47.63,-122.349,2390,6098,5648,3708,115.87771203155819,0.0980327868852459,Very Cheap
20150428T000000,705000.0,3,2.75,2260,4000,2.0,0,0,4,8,1540,720,1956,0,98109,47.6435,-122.353,2120,4000,1740,1880,176.25,0.08262295081967214,Very Cheap
20141208T000000,2630000.0,6,4.75,5540,7200,2.5,0,2,4,11,3950,1590,1909,0,98119,47.6361,-122.366,2930,7200,1660,4270,365.27777777777777,0.33508196721311473,Medium
20140623T000000,685000.0,2,1.5,1300,1676,1.0,0,2,3,7,1300,0,1943,0,98122,47.6133,-122.308,1260,1740,376,480,408.7112171837709,0.08,Very Cheap
20141020T000000,630000.0,4,2.0,1610,5000,2.0,0,0,5,7,1610,0,1946,0,98117,47.6775,-122.398,1300,4950,3390,3650,126.0,0.07278688524590164,Very Cheap
20140508T000000,1250000.0,4,3.25,3820,24166,2.0,0,1,4,11,3310,510,1990,0,98040,47.5263,-122.227,2900,18786,20346,15886,51.72556484316809,0.1540983606557377,Cheap
20150112T000000,359000.0,4,2.5,1820,11325,1.0,0,0,3,8,1390,430,1976,0,98166,47.4574,-122.361,1990,10802,9505,8812,31.699779249448124,0.03724590163934426,Very Cheap
20150316T000000,784500.0,4,5.0,5820,13906,2.0,0,0,3,11,3750,2070,1993,0,98042,47.3814,-122.164,2980,13000,8086,10020,56.41449733927801,0.09304918032786885,Very Cheap
20140703T000000,850000.0,3,2.0,2470,8800,2.0,0,0,3,9,2470,0,1961,2004,98040,47.5753,-122.222,2340,10980,6330,8640,96.5909090909091,0.10163934426229508,Cheap
20140903T000000,410000.0,3,2.5,3040,6054,2.0,0,0,3,9,3040,0,2005,0,98042,47.3508,-122.163,2650,6054,3014,3404,67.72381896266931,0.043934426229508196,Very Cheap
20140709T000000,252000.0,4,1.75,1120,8250,1.0,0,0,4,7,1120,0,1966,0,98058,47.4555,-122.177,1330,7975,7130,6645,30.545454545454547,0.02321311475409836,Very Cheap
20140812T000000,618000.0,5,1.75,1880,18295,1.0,0,0,4,7,1880,0,1955,0,98005,47.6059,-122.154,2180,20674,16415,18494,33.77972123531019,0.07121311475409836,Very Cheap
20141002T000000,265000.0,3,1.0,1070,4800,1.0,0,0,3,6,970,100,1947,0,98126,47.5187,-122.377,1120,1198,3730,78,55.208333333333336,0.024918032786885248,Very Cheap
20140918T000000,465000.0,3,2.0,1560,8509,1.0,0,0,3,8,790,770,1969,0,98034,47.7261,-122.22,1410,7428,6949,6018,54.64801974380068,0.051147540983606556,Very Cheap
20150204T000000,240000.0,2,1.0,870,6552,1.0,0,0,3,6,870,0,1947,0,98133,47.7188,-122.353,1500,6678,5682,5178,36.63003663003663,0.021639344262295083,Very Cheap
20140731T000000,217000.0,3,1.0,1000,12000,1.0,0,0,3,7,1000,0,1959,0,98023,47.3321,-122.346,1490,14940,11000,13450,18.083333333333332,0.01862295081967213,Very Cheap
20140806T000000,415000.0,4,2.25,2520,4200,1.5,0,0,4,7,1510,1010,1909,0,98144,47.5814,-122.312,1460,4200,1680,2740,98.80952380952381,0.04459016393442623,Very Cheap
20141222T000000,274000.0,2,2.0,1700,7992,1.0,0,0,4,7,950,750,1980,0,98023,47.3031,-122.385,1700,8030,6292,6330,34.28428428428428,0.026098360655737705,Very Cheap
20150223T000000,420000.0,5,3.0,2150,6117,1.0,0,0,3,7,1370,780,2003,0,98106,47.538,-122.356,1990,6064,3967,4074,68.66110838646395,0.04524590163934426,Very Cheap
20150318T000000,1062500.0,4,2.75,1590,6000,1.5,0,0,4,8,1590,0,1925,0,98112,47.6401,-122.299,1590,4000,4410,2410,177.08333333333334,0.12950819672131147,Cheap
20140605T000000,1415000.0,4,5.25,4670,43950,2.0,0,0,3,12,4670,0,1989,0,98006,47.5456,-122.126,4900,35000,39280,30100,32.195676905574516,0.17573770491803278,Cheap
20140505T000000,618500.0,3,2.0,1800,5000,1.0,0,0,4,7,1080,720,1942,0,98115,47.6738,-122.297,1800,5000,3200,3200,123.7,0.07127868852459017,Very Cheap
20150109T000000,295000.0,3,1.5,1670,10800,1.0,0,0,4,8,1670,0,1956,0,98022,47.2004,-122.003,1670,9169,9130,7499,27.314814814814813,0.028852459016393443,Very Cheap
20150316T000000,400000.0,3,2.0,1010,12252,1.0,0,0,3,8,1010,0,1980,0,98074,47.6224,-122.045,1840,11497,11242,9657,32.6477309826967,0.04262295081967213,Very Cheap
20150326T000000,595000.0,3,2.5,2550,6677,2.0,0,0,3,8,2550,0,2002,0,98028,47.7336,-122.232,1930,7217,4127,5287,89.1118765912835,0.06819672131147542,Very Cheap
20140617T000000,1728000.0,4,3.0,3700,20570,1.0,0,0,4,10,1850,1850,1976,0,98004,47.6212,-122.224,3080,17595,16870,14515,84.00583373845406,0.21678688524590164,Cheap
20141231T000000,261000.0,3,1.75,1350,7686,1.0,0,0,3,7,1350,0,1987,0,98038,47.3617,-122.052,1370,7686,6336,6316,33.95784543325527,0.02439344262295082,Very Cheap
20141016T000000,780000.0,5,2.5,1660,4000,1.5,0,0,5,8,1660,0,1929,0,98109,47.6452,-122.352,1210,4000,2340,2790,195.0,0.09245901639344262,Very Cheap
20141118T000000,589000.0,3,1.5,1390,5040,1.0,0,0,3,7,1090,300,1947,0,98105,47.6611,-122.282,1910,4800,3650,2890,116.86507936507937,0.06740983606557377,Very Cheap
20150305T000000,230000.0,3,1.75,1720,9125,1.0,0,0,4,7,1140,580,1981,0,98092,47.3173,-122.181,1120,7506,7405,6386,25.205479452054796,0.020327868852459016,Very Cheap
20141018T000000,690000.0,4,3.5,2980,2147,2.5,0,0,3,10,2490,490,2006,0,98029,47.5463,-121.995,2880,2428,-833,-452,321.3786679087098,0.08065573770491803,Very Cheap
20150129T000000,524000.0,4,2.25,2190,15491,2.0,0,0,3,8,2190,0,1981,0,98074,47.6299,-122.039,2090,15039,13301,12949,33.826092569879286,0.05888524590163934,Very Cheap
20140522T000000,380000.0,2,2.5,1230,987,2.0,0,0,3,7,1060,170,2011,0,98144,47.6007,-122.305,1290,1328,-243,38,385.0050658561297,0.04,Very Cheap
20141112T000000,357500.0,3,1.0,1000,4080,1.0,0,0,4,7,740,260,1945,0,98126,47.5351,-122.381,1480,4080,3080,2600,87.62254901960785,0.03704918032786885,Very Cheap
20141027T000000,330000.0,3,2.0,2500,10697,1.0,0,0,3,8,2500,0,1994,0,98022,47.1927,-122.01,2560,9772,8197,7212,30.849770963821634,0.03344262295081967,Very Cheap
20150309T000000,635000.0,5,1.75,2240,4750,1.0,0,0,4,7,1120,1120,1920,0,98115,47.6727,-122.293,1980,4750,2510,2770,133.68421052631578,0.07344262295081967,Very Cheap
20150313T000000,934000.0,9,3.0,2820,4480,2.0,0,0,3,7,1880,940,1918,0,98105,47.6654,-122.307,2460,4400,1660,1940,208.48214285714286,0.11265573770491803,Cheap
20150128T000000,358500.0,2,1.75,1400,865,2.0,0,0,3,8,1110,290,2005,0,98029,47.5478,-121.999,1380,1107,-535,-273,414.4508670520231,0.03718032786885246,Very Cheap
20141006T000000,401000.0,3,1.5,1470,6867,1.0,0,0,3,8,1470,0,1955,0,98155,47.7495,-122.327,1470,6523,5397,5053,58.39522353283821,0.04275409836065574,Very Cheap
20150109T000000,270000.0,3,2.0,1820,7750,1.0,0,0,3,8,1820,0,1992,0,98023,47.3169,-122.352,2080,8084,5930,6004,34.83870967741935,0.025573770491803278,Very Cheap
20141014T000000,705000.0,4,2.0,2060,6000,1.0,0,1,4,8,1370,690,1954,0,98136,47.5237,-122.383,2060,6600,3940,4540,117.5,0.08262295081967214,Very Cheap
20141030T000000,325000.0,3,2.0,1670,17071,1.0,0,0,3,7,1100,570,1988,0,98014,47.69,-121.913,1660,15593,15401,13933,19.038134848573605,0.03278688524590164,Very Cheap
20140902T000000,384950.0,3,1.0,1540,7740,1.0,0,0,4,7,1540,0,1909,0,98126,47.522,-122.375,1220,7740,6200,6520,49.73514211886305,0.04064918032786885,Very Cheap
20140715T000000,310000.0,3,1.0,1210,9730,1.0,0,0,4,7,1210,0,1953,0,98133,47.762,-122.355,1470,9730,8520,8260,31.86022610483042,0.03081967213114754,Very Cheap
20141006T000000,829950.0,4,2.5,3430,42775,2.0,0,0,3,10,3430,0,1992,0,98077,47.765,-122.045,3190,36820,39345,33630,19.40268848626534,0.09900983606557377,Very Cheap
20150330T000000,353000.0,3,2.5,2550,6021,2.0,0,0,3,7,2550,0,2002,0,98030,47.3828,-122.211,2080,6021,3471,3941,58.62813486131872,0.03645901639344262,Very Cheap
20140707T000000,170500.0,2,1.0,1060,7700,1.0,0,0,3,7,820,240,1981,0,98055,47.4599,-122.205,1370,8833,6640,7463,22.142857142857142,0.012524590163934425,Very Cheap
20140716T000000,885250.0,4,2.5,3670,49658,2.0,0,0,3,10,3670,0,1999,0,98074,47.6219,-122.015,3040,49658,45988,46618,17.82693624390833,0.10626229508196722,Cheap
20140608T000000,2700000.0,4,3.25,4420,7850,2.0,1,4,3,11,3150,1270,2001,0,98008,47.572,-122.102,2760,8525,3430,5765,343.9490445859873,0.3442622950819672,Medium
20140925T000000,245000.0,3,1.5,1550,9126,1.0,0,0,5,7,1550,0,1957,0,98022,47.2012,-122.0,1450,9282,7576,7832,26.846373000219153,0.022295081967213116,Very Cheap
20141017T000000,469000.0,3,2.5,1190,1290,3.0,0,0,3,8,1190,0,2008,0,98107,47.6762,-122.378,1410,1923,100,513,363.5658914728682,0.05167213114754098,Very Cheap
20140608T000000,455000.0,3,1.0,1300,3550,1.5,0,0,3,7,1300,0,1927,0,98105,47.6696,-122.32,1410,4080,2250,2670,128.16901408450704,0.049836065573770495,Very Cheap
20141121T000000,305000.0,4,2.5,2430,5959,2.0,0,0,3,8,2430,0,2002,0,98092,47.3348,-122.19,2100,5414,3529,3314,51.183084410135926,0.03016393442622951,Very Cheap
20140530T000000,840000.0,7,4.5,4290,37607,1.5,0,0,5,10,4290,0,1982,0,98027,47.4812,-122.033,2810,40510,33317,37700,22.336267184300794,0.10032786885245902,Cheap
20140623T000000,905000.0,5,3.5,3500,10155,2.0,0,0,3,10,2570,930,1996,0,98006,47.5415,-122.133,2940,10753,6655,7813,89.11866075824717,0.10885245901639344,Cheap
20141231T000000,219200.0,3,2.0,1680,7000,1.5,0,0,4,7,1680,0,1968,0,98002,47.2775,-122.203,1540,7480,5320,5940,31.314285714285713,0.018911475409836065,Very Cheap
20150223T000000,455000.0,3,1.5,1250,8004,1.0,0,0,3,7,1250,0,1965,0,98008,47.6285,-122.117,1450,7931,6754,6481,56.846576711644175,0.049836065573770495,Very Cheap
20140627T000000,195000.0,2,1.0,1020,8100,1.0,0,0,3,6,1020,0,1940,0,98168,47.4971,-122.334,1200,12500,7080,11300,24.074074074074073,0.015737704918032787,Very Cheap
20141113T000000,799000.0,3,1.0,1510,4178,2.0,0,0,3,8,1510,0,1902,1979,98103,47.6849,-122.335,2140,4916,2668,2776,191.23982766874101,0.09495081967213115,Very Cheap
20140627T000000,285000.0,2,1.0,910,8155,1.0,0,0,4,6,910,0,1948,0,98155,47.7399,-122.3,1240,8155,7245,6915,34.94788473329246,0.02754098360655738,Very Cheap
20140922T000000,300000.0,3,1.5,1320,15053,1.0,0,0,3,7,1320,0,1979,0,98072,47.7405,-122.095,1250,13368,13733,12118,19.9295821430944,0.029508196721311476,Very Cheap
20140529T000000,83000.0,2,1.0,900,8580,1.0,0,0,3,5,900,0,1918,0,98168,47.4727,-122.27,2060,6533,7680,4473,9.673659673659674,0.0010491803278688525,Very Cheap
20150414T000000,220000.0,2,1.0,890,4804,1.0,0,0,4,7,890,0,1928,0,98133,47.7027,-122.346,1010,3844,3914,2834,45.79517069109076,0.01901639344262295,Very Cheap
20140603T000000,174500.0,2,2.5,1240,2689,2.0,0,0,3,7,1240,0,1986,0,98003,47.3236,-122.323,1430,3609,1449,2179,64.89401264410562,0.013049180327868852,Very Cheap
20150427T000000,695000.0,4,2.5,2960,10760,2.0,0,0,3,9,2960,0,1987,0,98029,47.5677,-122.013,2480,9528,7800,7048,64.59107806691449,0.08131147540983606,Very Cheap
20141204T000000,255000.0,3,1.5,1020,11410,1.0,0,0,3,7,1020,0,1959,0,98059,47.4811,-122.162,1290,8400,10390,7110,22.348816827344436,0.02360655737704918,Very Cheap
20150225T000000,539000.0,5,2.25,2590,7245,1.0,0,0,3,8,1510,1080,1973,0,98008,47.6398,-122.111,1930,7245,4655,5315,74.39613526570048,0.06085245901639344,Very Cheap
20150317T000000,552700.0,2,1.0,1100,2800,1.0,0,0,3,7,1100,0,1925,0,98119,47.6361,-122.371,1110,1673,1700,563,197.39285714285714,0.06264918032786886,Very Cheap
20140603T000000,571500.0,3,1.0,1300,6710,1.0,0,0,4,6,1300,0,1952,0,98040,47.5851,-122.242,1630,9946,5410,8316,85.17138599105812,0.06511475409836065,Very Cheap
20150313T000000,263700.0,3,1.0,1200,6561,1.0,0,0,3,6,1200,0,1950,1968,98177,47.7763,-122.36,1340,9450,5361,8110,40.1920438957476,0.024747540983606556,Very Cheap
20141020T000000,3300000.0,8,4.0,7710,11750,3.5,0,0,5,12,6090,1620,1904,0,98112,47.6263,-122.314,4210,8325,4040,4115,280.8510638297872,0.42295081967213116,High
20140528T000000,186950.0,2,2.0,1390,1302,2.0,0,0,3,7,1390,0,1986,0,98003,47.3089,-122.33,1390,1302,-88,-88,143.5867895545315,0.014681967213114754,Very Cheap
20141110T000000,520000.0,3,1.75,1430,53628,2.0,0,0,3,8,1430,0,1985,0,98024,47.5577,-121.891,2100,53628,52198,51528,9.696427239501753,0.058360655737704915,Very Cheap
20140730T000000,358000.0,3,1.5,1250,7194,1.0,0,0,4,7,1250,0,1969,0,98034,47.7298,-122.231,1340,7242,5944,5902,49.763691965526824,0.03711475409836065,Very Cheap
20140807T000000,210000.0,2,0.75,840,49658,1.0,0,0,2,6,840,0,1948,0,98168,47.4727,-122.292,1240,11000,48818,9760,4.22892585283338,0.017704918032786884,Very Cheap
20150511T000000,3650000.0,5,3.75,5020,8694,2.0,0,1,3,12,3970,1050,2007,0,98004,47.6146,-122.213,4190,11275,3674,7085,419.8297676558546,0.46885245901639344,High
20140811T000000,543000.0,4,2.25,2060,8767,2.0,0,0,3,8,2060,0,1983,0,98052,47.7228,-122.103,1610,8062,6707,6452,61.93680848636934,0.06137704918032787,Very Cheap
20150423T000000,330000.0,4,2.25,2000,10679,1.0,0,0,3,7,1350,650,1960,0,98148,47.4238,-122.329,1650,8875,8679,7225,30.90176982863564,0.03344262295081967,Very Cheap
20140806T000000,529000.0,3,2.0,1530,3400,1.0,0,0,3,7,990,540,1907,2014,98112,47.6204,-122.296,1880,4212,1870,2332,155.58823529411765,0.05954098360655738,Very Cheap
20140627T000000,295000.0,1,1.0,700,2500,1.0,0,0,4,7,700,0,1907,0,98106,47.5662,-122.364,1340,5000,1800,3660,118.0,0.028852459016393443,Very Cheap
20140922T000000,365000.0,3,1.0,950,8450,1.0,0,0,3,7,950,0,1962,0,98033,47.6884,-122.186,1610,10080,7500,8470,43.19526627218935,0.0380327868852459,Very Cheap
20141015T000000,473000.0,3,3.0,1380,1081,3.0,0,0,3,8,1380,0,2005,0,98107,47.6692,-122.39,1390,1140,-299,-250,437.5578168362627,0.05219672131147541,Very Cheap
20140623T000000,403500.0,3,1.0,1830,8004,1.0,0,0,3,8,1200,630,1960,0,98125,47.7259,-122.297,1860,7971,6174,6111,50.412293853073464,0.043081967213114754,Very Cheap
20140602T000000,544000.0,3,1.5,1790,8203,1.5,0,1,3,7,1790,0,1910,0,98116,47.5768,-122.403,1960,6047,6413,4087,66.3172010240156,0.06150819672131148,Very Cheap
20141023T000000,621000.0,3,1.0,1340,4000,1.5,0,0,4,7,1340,0,1927,0,98105,47.6652,-122.288,1510,4000,2660,2490,155.25,0.07160655737704918,Very Cheap
20140801T000000,672600.0,3,2.25,1520,5750,2.0,0,0,3,8,1400,120,1908,2006,98116,47.5787,-122.388,1420,5650,4230,4230,116.97391304347826,0.07837377049180327,Very Cheap
20150407T000000,689800.0,2,1.75,1370,3125,1.0,0,0,3,7,1090,280,1950,0,98199,47.6492,-122.391,1730,5966,1755,4236,220.736,0.08062950819672131,Very Cheap
20150507T000000,613000.0,3,1.5,1470,4480,1.0,0,0,4,7,1130,340,1918,0,98105,47.6693,-122.291,2120,4480,3010,2360,136.83035714285714,0.07055737704918033,Very Cheap
20140701T000000,808000.0,4,2.25,2500,8866,2.0,0,0,4,9,2500,0,1987,0,98007,47.6604,-122.146,2630,8847,6366,6217,91.13467177983307,0.0961311475409836,Very Cheap
20140725T000000,301000.0,3,1.0,1060,9241,1.0,0,0,4,7,1060,0,1956,0,98133,47.7465,-122.339,1900,6484,8181,4584,32.57223244237637,0.029639344262295083,Very Cheap
20140925T000000,340000.0,3,1.75,1210,9635,1.0,0,0,4,7,1210,0,1987,0,98019,47.7382,-121.98,1550,10707,8425,9157,35.28801245459263,0.03475409836065574,Very Cheap
20141223T000000,206000.0,3,1.0,920,8400,1.0,0,0,3,7,920,0,1963,0,98032,47.3771,-122.287,1260,8400,7480,7140,24.523809523809526,0.017180327868852457,Very Cheap
20141103T000000,550000.0,3,1.5,1340,6000,1.0,0,0,4,7,1340,0,1960,0,98040,47.5866,-122.25,1590,9000,4660,7410,91.66666666666667,0.06229508196721312,Very Cheap
20141224T000000,325000.0,2,1.0,960,4800,1.5,0,0,2,6,960,0,1912,0,98116,47.5752,-122.411,1440,4800,3840,3360,67.70833333333333,0.03278688524590164,Very Cheap
20141012T000000,475000.0,3,2.5,1630,7586,2.0,0,0,3,8,1630,0,1986,0,98029,47.5689,-122.023,2090,7330,5956,5240,62.61534405483786,0.05245901639344262,Very Cheap
20140730T000000,432100.0,3,1.75,1840,7350,1.0,0,0,3,8,1310,530,1976,0,98034,47.7089,-122.23,1860,7000,5510,5140,58.7891156462585,0.0468327868852459,Very Cheap
20150303T000000,359000.0,3,2.0,3085,7280,1.0,0,0,4,7,1560,1525,1959,0,98056,47.4956,-122.181,1480,7900,4195,6420,49.31318681318681,0.03724590163934426,Very Cheap
20150105T000000,490000.0,3,1.0,920,4800,1.0,0,0,4,6,780,140,1926,0,98117,47.6937,-122.362,1370,4800,3880,3430,102.08333333333333,0.05442622950819672,Very Cheap
20140522T000000,648360.0,4,1.75,2260,7005,1.0,0,1,4,7,1130,1130,1947,0,98033,47.6895,-122.207,2330,9180,4745,6850,92.55674518201285,0.07519475409836066,Very Cheap
20141007T000000,340000.0,3,1.75,1730,11986,1.0,0,3,5,6,1730,0,1918,0,98198,47.3595,-122.323,2490,9264,10256,6774,28.36642749874854,0.03475409836065574,Very Cheap
20150403T000000,545000.0,3,2.0,1610,8069,1.0,0,0,5,7,1090,520,1955,0,98006,47.5754,-122.15,1510,8803,6459,7293,67.5424463998017,0.06163934426229508,Very Cheap
20140715T000000,115000.0,2,0.75,550,7980,1.0,0,0,3,5,550,0,1952,0,98146,47.511,-122.348,1330,7980,7430,6650,14.411027568922306,0.005245901639344262,Very Cheap
20150219T000000,705640.0,3,2.25,2400,12350,1.0,0,0,4,8,1420,980,1968,0,98033,47.6533,-122.192,2615,12043,9950,9428,57.136842105263156,0.08270688524590164,Very Cheap
20140730T000000,300000.0,3,2.25,1960,1585,2.0,0,0,3,7,1750,210,2003,0,98118,47.5414,-122.288,1760,1958,-375,198,189.2744479495268,0.029508196721311476,Very Cheap
20140731T000000,1650000.0,4,2.75,3190,14904,1.0,0,3,4,9,1940,1250,1949,1992,98004,47.6178,-122.214,2600,11195,11714,8595,110.7085346215781,0.20655737704918034,Cheap
20150417T000000,1137500.0,4,3.5,3160,4200,2.0,0,4,3,8,2180,980,1999,0,98144,47.5963,-122.292,2180,5200,1040,3020,270.8333333333333,0.13934426229508196,Cheap
20140818T000000,280000.0,3,1.75,1550,7410,1.5,0,0,5,7,1550,0,1944,0,98178,47.4951,-122.237,1250,7467,5860,6217,37.78677462887989,0.026885245901639345,Very Cheap
20141219T000000,245000.0,4,1.75,1930,7650,1.0,0,0,4,8,1280,650,1981,0,98023,47.3078,-122.386,1860,8800,5720,6940,32.02614379084967,0.022295081967213116,Very Cheap
20141030T000000,564000.0,4,1.0,1170,4590,1.5,0,0,4,7,1170,0,1925,0,98115,47.6804,-122.311,1430,4080,3420,2650,122.87581699346406,0.0641311475409836,Very Cheap
20140919T000000,849000.0,3,1.75,2520,4534,1.0,0,0,5,9,1460,1060,1954,0,98199,47.6381,-122.401,1870,5023,2014,3153,187.25187472430525,0.10150819672131148,Cheap
20150409T000000,698000.0,3,1.75,1220,7447,1.0,0,0,4,7,1220,0,1964,0,98033,47.6886,-122.211,1340,7200,6227,5860,93.7290183966698,0.08170491803278689,Very Cheap
20140925T000000,319000.0,3,1.0,960,8556,1.0,0,0,3,7,960,0,1971,0,98034,47.7245,-122.22,1320,7528,7596,6208,37.283777466105654,0.032,Very Cheap
20150224T000000,1450000.0,3,3.5,4110,15720,1.0,0,1,3,10,2230,1880,2000,0,98034,47.6996,-122.229,2500,15400,11610,12900,92.23918575063614,0.18032786885245902,Cheap
20140710T000000,695000.0,4,3.5,3310,21050,2.0,0,0,5,9,2400,910,1992,0,98027,47.5197,-122.041,2260,23400,17740,21140,33.0166270783848,0.08131147540983606,Very Cheap
20150330T000000,680000.0,4,2.75,2220,5310,1.0,0,0,5,7,1170,1050,1951,0,98144,47.5801,-122.294,1540,4200,3090,2660,128.060263653484,0.07934426229508197,Very Cheap
20141027T000000,287500.0,4,2.25,2250,12000,2.0,0,0,3,8,2250,0,1985,0,98032,47.3715,-122.274,2140,11871,9750,9731,23.958333333333332,0.027868852459016394,Very Cheap
20141112T000000,465000.0,3,3.25,1510,1850,2.0,0,2,3,8,1230,280,2001,0,98107,47.6683,-122.362,1540,1840,340,300,251.35135135135135,0.051147540983606556,Very Cheap
20140925T000000,335000.0,3,1.0,1350,14212,1.0,0,0,4,6,1350,0,1981,0,98053,47.6606,-122.06,1520,14404,12862,12884,23.57162960878131,0.03409836065573771,Very Cheap
20140627T000000,602000.0,4,1.75,2420,37800,1.0,0,0,4,8,1880,540,1981,0,98053,47.6688,-122.024,2780,35532,35380,32752,15.925925925925926,0.06911475409836065,Very Cheap
20150225T000000,482000.0,3,2.5,2950,6545,2.0,0,0,3,8,2950,0,2003,0,98059,47.4828,-122.139,2400,6550,3595,4150,73.64400305576777,0.05337704918032787,Very Cheap
20140909T000000,220000.0,5,1.0,1260,8382,1.5,0,0,3,7,1260,0,1918,0,98146,47.5058,-122.355,910,8382,7122,7472,26.246719160104988,0.01901639344262295,Very Cheap
20140520T000000,206000.0,4,2.0,1700,6025,1.0,0,0,3,6,1700,0,1978,0,98002,47.3029,-122.221,1320,5956,4325,4636,34.190871369294605,0.017180327868852457,Very Cheap
20150324T000000,1100000.0,4,3.0,3320,5760,2.0,0,0,3,9,2120,1200,1954,2007,98199,47.6474,-122.389,2400,6144,2440,3744,190.97222222222223,0.13442622950819672,Cheap
20150320T000000,491150.0,3,2.5,1470,3971,2.0,0,0,3,7,1470,0,2003,0,98053,47.6816,-122.035,1650,3148,2501,1498,123.6842105263158,0.054577049180327866,Very Cheap
20140812T000000,390000.0,4,2.75,2500,12848,1.0,0,1,3,8,2120,380,1975,0,98003,47.3364,-122.321,2370,12497,10348,10127,30.35491905354919,0.04131147540983607,Very Cheap
20150507T000000,393000.0,4,2.5,2641,8091,2.0,0,0,3,7,2641,0,1998,0,98031,47.4043,-122.213,2641,8535,5450,5894,48.5724879495736,0.041704918032786885,Very Cheap
20140717T000000,635000.0,4,2.0,2260,8457,2.0,0,0,3,9,2260,0,1992,0,98074,47.6251,-122.03,2410,7713,6197,5303,75.08572779945607,0.07344262295081967,Very Cheap
20140516T000000,490000.0,2,1.0,1160,5000,1.0,0,0,4,8,1160,0,1937,0,98117,47.6865,-122.399,1750,5000,3840,3250,98.0,0.05442622950819672,Very Cheap
20140925T000000,770000.0,4,3.5,3680,2242,2.5,0,0,3,9,2670,1010,1930,2007,98112,47.6192,-122.307,1350,1288,-1438,-62,343.44335414808205,0.09114754098360656,Very Cheap
20141204T000000,665000.0,2,2.0,1615,4590,1.5,0,0,5,8,1615,0,1906,0,98103,47.6886,-122.348,1470,4590,2975,3120,144.880174291939,0.07737704918032787,Very Cheap
20141001T000000,287000.0,3,1.0,1250,26862,1.0,0,0,3,7,1250,0,1965,0,98058,47.426,-122.154,1530,24463,25612,22933,10.68423795696523,0.02780327868852459,Very Cheap
20141021T000000,410000.0,3,1.0,1230,7020,1.0,0,0,3,7,1090,140,1924,0,98116,47.5719,-122.39,1390,5850,5790,4460,58.40455840455841,0.043934426229508196,Very Cheap
20150225T000000,562000.0,3,2.0,2510,5200,1.0,0,0,5,8,1470,1040,1925,0,98106,47.5631,-122.366,990,5400,2690,4410,108.07692307692308,0.0638688524590164,Very Cheap
20140530T000000,475000.0,2,2.0,1540,54450,2.0,0,0,3,7,1540,0,1983,0,98053,47.638,-121.953,2280,29918,52910,27638,8.723599632690542,0.05245901639344262,Very Cheap
20141014T000000,387500.0,3,3.25,1860,2218,3.0,0,0,3,8,1860,0,2001,0,98125,47.7185,-122.313,1860,2218,358,358,174.70694319206493,0.040983606557377046,Very Cheap
20140617T000000,580000.0,5,2.0,2700,10875,1.0,0,0,4,7,1540,1160,1962,0,98007,47.6163,-122.138,2040,7464,8175,5424,53.333333333333336,0.06622950819672131,Very Cheap
20140621T000000,930000.0,3,2.5,3290,6830,2.0,0,0,3,10,3290,0,2000,0,98052,47.6702,-122.142,3200,6227,3540,3027,136.16398243045387,0.1121311475409836,Cheap
20150213T000000,625000.0,3,1.75,2700,18893,1.0,0,0,4,7,2110,590,1948,1983,98010,47.3397,-122.048,2260,17494,16193,15234,33.08103530408088,0.07213114754098361,Very Cheap
20141203T000000,325000.0,3,2.0,1570,5600,1.0,0,0,3,8,1570,0,1999,0,98058,47.4286,-122.185,2010,5600,4030,3590,58.035714285714285,0.03278688524590164,Very Cheap
20140627T000000,235000.0,3,1.75,1950,8712,1.0,0,0,3,7,1950,0,1960,0,98055,47.4391,-122.189,1820,11520,6762,9700,26.9742883379247,0.02098360655737705,Very Cheap
20140625T000000,450000.0,2,1.0,1380,4390,1.0,0,0,4,8,880,500,1931,0,98115,47.6947,-122.323,1390,5234,3010,3844,102.50569476082005,0.04918032786885246,Very Cheap
20150312T000000,745000.0,4,2.75,2410,5650,1.5,0,0,5,8,2070,340,1909,0,98116,47.5651,-122.391,1960,5650,3240,3690,131.858407079646,0.08786885245901639,Very Cheap
20140723T000000,223000.0,4,2.0,1200,8470,1.0,0,0,4,7,1200,0,1961,0,98023,47.3262,-122.338,1110,8400,7270,7290,26.328217237308145,0.019409836065573772,Very Cheap
20140728T000000,630000.0,4,1.75,1770,12278,1.0,0,0,3,7,1350,420,1937,0,98115,47.7004,-122.295,1670,9336,10508,7666,51.31128848346636,0.07278688524590164,Very Cheap
20140508T000000,413450.0,3,2.5,1540,1614,3.0,0,0,3,8,1470,70,2008,0,98103,47.6961,-122.341,1540,1418,74,-122,256.1648079306072,0.04438688524590164,Very Cheap
20140811T000000,720000.0,5,2.75,2860,5379,2.0,0,0,3,9,2860,0,2005,0,98052,47.7082,-122.104,2980,6018,2519,3038,133.85387618516452,0.08459016393442623,Very Cheap
20150416T000000,339000.0,3,1.5,1740,21980,1.0,0,0,4,7,1740,0,1973,0,98042,47.3644,-122.132,1400,16100,20240,14700,15.423111919927207,0.03462295081967213,Very Cheap
20150505T000000,1115500.0,4,3.5,2830,4000,1.5,0,0,3,7,1840,990,1919,2014,98144,47.5842,-122.292,2340,4000,1170,1660,278.875,0.13645901639344263,Cheap
20140811T000000,839000.0,5,4.0,4280,11307,2.0,0,0,3,10,2710,1570,1996,0,98027,47.5503,-122.081,3080,11307,7027,8227,74.20182188025117,0.1001967213114754,Cheap
20140902T000000,2950000.0,4,3.25,3890,25470,2.0,1,3,5,10,3030,860,1923,0,98105,47.6608,-122.269,4140,19281,21580,15141,115.82253631723596,0.3770491803278688,Medium
20140530T000000,568000.0,4,2.0,2340,50233,1.0,0,0,4,7,1170,1170,1966,0,98075,47.5905,-122.022,2470,62290,47893,59820,11.30730794497641,0.06465573770491803,Very Cheap
20150406T000000,269000.0,3,2.0,1410,10577,1.0,0,0,3,7,1410,0,1994,0,98030,47.3642,-122.187,1660,6757,9167,5097,25.43254230878321,0.02544262295081967,Very Cheap
20150406T000000,382000.0,2,2.0,1350,2560,1.0,0,0,4,8,1350,0,1974,0,98052,47.6338,-122.106,1800,2560,1210,760,149.21875,0.040262295081967214,Very Cheap
20150413T000000,574000.0,2,2.25,1100,1114,2.0,0,0,3,8,900,200,2009,0,98122,47.6199,-122.304,1230,1800,14,570,515.2603231597845,0.06544262295081968,Very Cheap
20140922T000000,405000.0,3,2.5,2070,4697,2.0,0,0,3,7,2070,0,2002,0,98065,47.5307,-121.875,2230,4437,2627,2207,86.22525015967639,0.043278688524590166,Very Cheap
20140728T000000,572000.0,3,2.5,2360,9938,1.0,0,0,3,8,1690,670,1987,0,98027,47.5374,-122.053,2280,9626,7578,7346,57.556852485409536,0.06518032786885246,Very Cheap
20141205T000000,675000.0,4,2.25,2760,12100,2.0,0,0,4,9,2760,0,1976,0,98074,47.6285,-122.058,2850,12410,9340,9560,55.78512396694215,0.07868852459016394,Very Cheap
20140902T000000,165000.0,4,1.0,1220,7980,1.5,0,0,3,6,1220,0,1944,0,98178,47.4924,-122.237,1210,7920,6760,6710,20.67669172932331,0.01180327868852459,Very Cheap
20150304T000000,260000.0,4,1.0,1220,7980,1.5,0,0,3,6,1220,0,1944,0,98178,47.4924,-122.237,1210,7920,6760,6710,32.581453634085214,0.024262295081967214,Very Cheap
20150304T000000,196000.0,3,1.0,1220,6719,1.0,0,0,3,6,1220,0,1953,0,98198,47.4187,-122.329,1580,7200,5499,5620,29.17100759041524,0.015868852459016394,Very Cheap
20150224T000000,515000.0,3,2.5,3020,12184,2.0,0,0,3,8,3020,0,2003,0,98019,47.744,-121.976,2980,10029,9164,7049,42.26854891661195,0.057704918032786885,Very Cheap
20141203T000000,810000.0,4,3.5,3470,7396,2.0,0,3,3,8,2520,950,1979,0,98125,47.7146,-122.279,2360,10541,3926,8181,109.51865873445105,0.09639344262295083,Very Cheap
20150311T000000,365650.0,4,2.25,2380,7700,2.0,0,0,4,8,2380,0,1977,0,98055,47.4391,-122.194,2100,7700,5320,5600,47.48701298701299,0.03811803278688525,Very Cheap
20140728T000000,651000.0,3,3.0,2260,1834,2.0,0,0,3,8,1660,600,2002,0,98122,47.6111,-122.308,2260,1834,-426,-426,354.9618320610687,0.07554098360655738,Very Cheap
20141009T000000,240000.0,2,1.0,720,6345,1.0,0,0,3,6,720,0,1943,0,98106,47.5201,-122.35,720,6345,5625,5625,37.825059101654844,0.021639344262295083,Very Cheap
20141029T000000,299000.0,3,2.0,1730,6007,1.0,0,0,3,8,1730,0,2004,0,98030,47.3573,-122.2,2000,6245,4277,4245,49.77526219410687,0.02937704918032787,Very Cheap
20140804T000000,768000.0,3,2.5,2660,10928,2.0,0,0,3,9,1830,830,1988,0,98006,47.5442,-122.141,2800,10025,8268,7225,70.27818448023426,0.09088524590163935,Very Cheap
20141028T000000,397380.0,2,1.0,1030,5072,1.0,0,0,3,6,1030,0,1924,1958,98115,47.6962,-122.294,1220,6781,4042,5561,78.34779179810725,0.042279344262295085,Very Cheap
20140701T000000,476000.0,4,3.0,2890,6885,1.0,0,0,3,7,1590,1300,1945,2015,98115,47.6763,-122.282,2180,6885,3995,4705,69.1358024691358,0.052590163934426226,Very Cheap
20150106T000000,315000.0,3,1.0,890,5200,1.0,0,0,3,7,890,0,1957,0,98118,47.559,-122.277,1420,6000,4310,4580,60.57692307692308,0.031475409836065574,Very Cheap
20140926T000000,240000.0,3,2.25,1410,7290,1.0,0,0,3,7,940,470,1980,0,98118,47.5396,-122.274,1550,7375,5880,5825,32.92181069958848,0.021639344262295083,Very Cheap
20140708T000000,325000.0,2,1.0,810,4080,1.0,0,0,4,6,810,0,1941,0,98126,47.5337,-122.379,1400,4080,3270,2680,79.65686274509804,0.03278688524590164,Very Cheap
20141008T000000,160000.0,3,1.75,1370,8006,2.0,0,0,3,7,1370,0,1990,0,98001,47.258,-122.252,1530,8006,6636,6476,19.985011241568824,0.011147540983606558,Very Cheap
20150109T000000,435000.0,3,2.5,2260,5100,2.0,0,0,3,8,2260,0,2007,0,98019,47.7341,-121.968,2260,5100,2840,2840,85.29411764705883,0.04721311475409836,Very Cheap
20150410T000000,427500.0,3,1.75,1430,16200,1.0,0,0,4,7,1430,0,1967,0,98027,47.5223,-122.043,1690,13125,14770,11435,26.38888888888889,0.04622950819672131,Very Cheap
20150417T000000,450000.0,5,2.5,2510,10240,1.0,0,0,4,8,1410,1100,1984,0,98059,47.4732,-122.141,2170,10500,7730,8330,43.9453125,0.04918032786885246,Very Cheap
20140919T000000,688000.0,3,1.5,1760,4880,1.5,0,3,3,8,1290,470,1928,0,98136,47.5334,-122.388,1840,4998,3120,3158,140.98360655737704,0.08039344262295083,Very Cheap
20150408T000000,285000.0,4,1.0,1430,3600,1.0,0,0,3,6,980,450,1947,0,98106,47.5343,-122.355,1170,4000,2170,2830,79.16666666666667,0.02754098360655738,Very Cheap
20140820T000000,530000.0,3,3.25,1510,1125,3.0,0,0,3,8,1510,0,2006,0,98107,47.6711,-122.39,1390,1174,-385,-216,471.1111111111111,0.05967213114754098,Very Cheap
20150402T000000,195000.0,4,1.75,1320,7694,1.0,0,0,3,7,1320,0,1928,1972,98148,47.4297,-122.325,1620,8468,6374,6848,25.34442422667013,0.015737704918032787,Very Cheap
20140828T000000,250200.0,3,1.5,1180,7384,1.0,0,0,5,7,1180,0,1959,0,98032,47.3838,-122.287,1150,7455,6204,6305,33.88407367280607,0.02297704918032787,Very Cheap
20150128T000000,1100000.0,3,2.25,1560,8570,1.0,0,0,5,7,1080,480,1977,0,98004,47.6155,-122.21,2660,9621,7010,6961,128.35472578763128,0.13442622950819672,Cheap
20141112T000000,732500.0,3,2.5,2470,10321,2.0,0,0,3,9,2470,0,1988,0,98052,47.6694,-122.141,2450,8440,7851,5990,70.97180505764945,0.08622950819672132,Very Cheap
20141030T000000,194250.0,3,2.25,2190,8834,1.0,0,0,3,7,1390,800,1987,0,98001,47.2633,-122.244,1490,8766,6644,7276,21.98890649762282,0.01563934426229508,Very Cheap
20150309T000000,526000.0,4,2.0,1610,8000,1.0,0,0,3,7,1190,420,1966,0,98008,47.6301,-122.118,1560,7896,6390,6336,65.75,0.059147540983606556,Very Cheap
20150504T000000,520000.0,4,2.75,2700,9882,2.0,0,0,3,7,2700,0,1958,1989,98155,47.7671,-122.291,2250,10797,7182,8547,52.62092693786683,0.058360655737704915,Very Cheap
20141113T000000,526000.0,3,1.75,1530,6125,1.0,0,0,3,7,1120,410,1958,0,98116,47.5687,-122.397,1360,6125,4595,4765,85.87755102040816,0.059147540983606556,Very Cheap
20140708T000000,1135250.0,5,4.0,7320,217800,2.0,0,0,3,11,7320,0,1992,0,98058,47.4473,-122.086,3270,34500,210480,31230,5.212350780532598,0.13904918032786887,Cheap
20140626T000000,202000.0,2,1.0,920,7569,1.0,0,0,4,6,920,0,1950,0,98168,47.4951,-122.302,1280,7627,6649,6347,26.687805522526094,0.016655737704918034,Very Cheap
20141112T000000,645500.0,4,2.5,2990,8622,2.0,0,0,3,9,2990,0,2000,0,98065,47.5394,-121.875,2980,8622,5632,5642,74.8666202737184,0.07481967213114754,Very Cheap
20150422T000000,570000.0,1,1.0,720,7540,1.0,1,4,4,6,720,0,1905,0,98198,47.3509,-122.323,1120,9736,6820,8616,75.59681697612731,0.06491803278688525,Very Cheap
20150320T000000,325000.0,3,2.0,1750,9000,1.5,0,0,4,5,1750,0,1936,0,98133,47.7489,-122.35,1830,8100,7250,6270,36.111111111111114,0.03278688524590164,Very Cheap
20141216T000000,725000.0,2,1.0,2410,5930,2.0,0,0,3,9,1930,480,2007,0,98116,47.5657,-122.395,1540,5892,3520,4352,122.25969645868466,0.08524590163934426,Very Cheap
20141126T000000,192000.0,3,1.75,1240,10361,1.0,0,0,3,6,1240,0,1987,0,98042,47.37,-122.151,1240,8834,9121,7594,18.531029823376123,0.015344262295081967,Very Cheap
20140709T000000,560000.0,2,1.0,1010,9219,1.0,0,0,4,7,1010,0,1960,0,98033,47.6886,-122.202,1610,9219,8209,7609,60.74411541381929,0.06360655737704918,Very Cheap
20141201T000000,283450.0,5,2.75,2770,6116,1.0,0,0,3,7,1490,1280,1979,0,98168,47.4847,-122.291,1920,6486,3346,4566,46.34565075212557,0.027337704918032786,Very Cheap
20140905T000000,863000.0,4,1.75,2800,5400,1.0,0,0,3,9,1400,1400,1924,2006,98115,47.6803,-122.313,1490,5400,2600,3910,159.8148148148148,0.10334426229508197,Cheap
20141028T000000,815000.0,4,2.0,1400,4800,2.0,0,0,3,7,1400,0,1986,0,98122,47.6168,-122.298,1620,2595,3400,975,169.79166666666666,0.09704918032786886,Very Cheap
20150416T000000,245000.0,2,1.0,1020,7679,1.0,0,0,5,6,1020,0,1942,0,98056,47.4915,-122.188,1280,6497,6659,5217,31.905195989061074,0.022295081967213116,Very Cheap
20141208T000000,1315000.0,4,3.0,2860,10292,1.0,0,0,4,8,2860,0,1953,1999,98004,47.6286,-122.206,1840,10273,7432,8433,127.76914108045084,0.16262295081967212,Cheap
20141107T000000,1156000.0,4,3.5,4270,12305,2.0,0,2,3,10,4270,0,1994,0,98006,47.5489,-122.118,4190,13137,8035,8947,93.94555058919138,0.1417704918032787,Cheap
20140903T000000,480000.0,3,2.5,2270,4488,2.0,0,0,3,7,2270,0,1999,0,98065,47.5329,-121.879,2360,4427,2218,2067,106.95187165775401,0.05311475409836065,Very Cheap
20140606T000000,600000.0,4,2.5,2560,5593,2.0,0,0,3,7,2560,0,2001,0,98053,47.6886,-122.037,2800,5890,3033,3090,107.2769533345253,0.06885245901639345,Very Cheap
20140624T000000,329950.0,2,1.0,900,5220,1.0,0,0,4,6,900,0,1956,0,98146,47.5105,-122.387,1480,6660,4320,5180,63.2088122605364,0.03343606557377049,Very Cheap
20140822T000000,299500.0,4,2.5,2010,12085,2.0,0,0,3,8,2010,0,1986,0,98042,47.3406,-122.057,1910,12133,10075,10223,24.782788580885395,0.02944262295081967,Very Cheap
20140918T000000,460000.0,3,2.5,1690,5131,1.0,0,0,3,7,1690,0,1941,1998,98126,47.5234,-122.38,860,5137,3441,4277,89.65114012862989,0.050491803278688525,Very Cheap
20150415T000000,515000.0,5,3.5,2310,5249,2.0,0,0,3,8,1560,750,2000,0,98118,47.5463,-122.272,1900,7296,2939,5396,98.11392646218327,0.057704918032786885,Very Cheap
20140623T000000,405000.0,3,2.25,1520,1245,3.0,0,0,3,8,1520,0,2004,0,98103,47.6907,-122.34,1520,1470,-275,-50,325.30120481927713,0.043278688524590166,Very Cheap
20141027T000000,483000.0,4,1.5,1220,3780,1.5,0,0,3,7,1220,0,1927,0,98107,47.6667,-122.36,1400,3185,2560,1785,127.77777777777777,0.05350819672131148,Very Cheap
20150203T000000,377000.0,4,2.5,2170,11511,2.0,0,0,3,8,2170,0,1992,0,98031,47.3886,-122.188,1900,8961,9341,7061,32.75128138302493,0.03960655737704918,Very Cheap
20140708T000000,568000.0,4,1.75,2790,17476,1.0,0,2,3,7,1450,1340,1956,0,98166,47.4556,-122.369,2790,16401,14686,13611,32.50171663996338,0.06465573770491803,Very Cheap
20141105T000000,355000.0,2,1.75,1760,4600,1.0,0,0,4,7,850,910,1926,0,98126,47.5654,-122.372,1150,4800,2840,3650,77.17391304347827,0.036721311475409836,Very Cheap
20140806T000000,640000.0,4,1.75,2100,3000,1.5,0,0,4,7,1500,600,1911,0,98103,47.6721,-122.329,1690,4000,900,2310,213.33333333333334,0.0740983606557377,Very Cheap
20150121T000000,270000.0,4,1.0,1430,5909,1.0,0,0,3,6,1070,360,1947,0,98155,47.7623,-122.313,1460,8433,4479,6973,45.69301066170249,0.025573770491803278,Very Cheap
20150114T000000,559950.0,5,3.5,2450,8193,2.0,0,0,3,9,2450,0,2005,0,98028,47.7721,-122.241,2310,8193,5743,5883,68.3449285975833,0.0636,Very Cheap
20141014T000000,515000.0,4,3.0,1820,8261,1.0,0,0,3,7,1420,400,1969,0,98034,47.7197,-122.219,1920,7961,6441,6041,62.34112092966953,0.057704918032786885,Very Cheap
20140826T000000,352000.0,4,1.75,1850,5712,1.0,0,0,3,7,1850,0,1954,0,98115,47.6966,-122.324,1510,6038,3862,4528,61.62464985994398,0.03632786885245902,Very Cheap
20140625T000000,595888.0,3,1.75,1870,9000,1.0,0,0,5,9,1870,0,1958,0,98177,47.7203,-122.361,2030,8160,7130,6130,66.20977777777777,0.06831318032786886,Very Cheap
20140722T000000,588000.0,4,2.25,2580,7344,2.0,0,0,3,8,2580,0,1977,0,98027,47.5647,-122.09,2390,7507,4764,5117,80.06535947712419,0.06727868852459017,Very Cheap
20150122T000000,1050000.0,4,3.25,3680,8580,1.0,0,3,5,10,1840,1840,1959,0,98136,47.5266,-122.387,2700,9100,4900,6400,122.37762237762237,0.12786885245901639,Cheap
20140908T000000,260000.0,3,1.5,1750,7000,2.0,0,0,3,8,1750,0,1983,0,98023,47.3108,-122.346,1840,9305,5250,7465,37.142857142857146,0.024262295081967214,Very Cheap
20150217T000000,1600000.0,4,3.5,3890,3600,2.0,0,0,3,9,2860,1030,2005,0,98112,47.6342,-122.282,2460,6050,-290,3590,444.44444444444446,0.2,Cheap
20150414T000000,380000.0,2,1.0,1000,4800,1.0,0,0,3,6,1000,0,1952,0,98117,47.6926,-122.362,1000,4800,3800,3800,79.16666666666667,0.04,Very Cheap
20140602T000000,802000.0,2,2.5,2210,6327,1.0,0,0,3,8,2210,0,2003,0,98053,47.7114,-122.03,2170,6327,4117,4157,126.75833728465308,0.09534426229508197,Very Cheap
20140811T000000,1325000.0,4,3.25,2850,4800,2.5,0,0,5,10,2700,150,1905,0,98112,47.6292,-122.312,2850,4800,1950,1950,276.0416666666667,0.16393442622950818,Cheap
20150416T000000,710000.0,4,2.75,2460,3600,2.0,0,0,3,8,1640,820,1907,2007,98122,47.6093,-122.297,1890,3600,1140,1710,197.22222222222223,0.08327868852459017,Very Cheap
20140609T000000,600000.0,3,2.5,2630,77972,2.0,0,0,3,9,2630,0,2004,0,98019,47.745,-121.916,2250,75794,75342,73544,7.695070025137229,0.06885245901639345,Very Cheap
20140902T000000,707900.0,3,1.0,1750,5355,2.0,0,0,4,7,1750,0,1929,0,98115,47.6792,-122.31,2240,4590,3605,2350,132.19421101774043,0.08300327868852458,Very Cheap
20141120T000000,179950.0,2,1.0,1100,7323,1.0,0,0,3,7,780,320,1982,0,98023,47.2874,-122.37,1410,7227,6223,5817,24.57326232418408,0.013763934426229509,Very Cheap
20140914T000000,683000.0,4,2.5,2620,10489,2.0,0,0,3,9,2620,0,1990,0,98052,47.6732,-122.143,2430,7701,7869,5271,65.11583563733436,0.07973770491803278,Very Cheap
20140603T000000,222400.0,3,2.0,1200,9566,1.0,0,0,3,7,1200,0,1995,0,98001,47.2649,-122.252,1590,9518,8366,7928,23.2490068994355,0.019331147540983605,Very Cheap
20140708T000000,517000.0,2,1.5,1920,3408,1.0,0,0,4,7,960,960,1912,0,98122,47.6118,-122.299,1130,3408,1488,2278,151.7018779342723,0.0579672131147541,Very Cheap
20141029T000000,410000.0,3,2.75,1690,5763,1.0,0,0,5,7,1180,510,1985,0,98011,47.7336,-122.202,1560,7518,4073,5958,71.14350164844699,0.043934426229508196,Very Cheap
20141006T000000,480000.0,3,1.75,1680,2552,1.0,0,0,4,7,840,840,1952,0,98117,47.6848,-122.391,1220,3880,872,2660,188.08777429467085,0.05311475409836065,Very Cheap
20150224T000000,430000.0,3,1.75,3440,10428,1.5,0,0,5,8,3440,0,1974,0,98058,47.449,-122.128,2160,8400,6988,6240,41.235136171845035,0.04655737704918033,Very Cheap
20150427T000000,439950.0,5,1.75,2190,7500,1.0,0,0,3,7,1290,900,1979,0,98133,47.7766,-122.355,1790,8820,5310,7030,58.66,0.04786229508196721,Very Cheap
20150421T000000,797500.0,4,2.5,3270,8223,2.0,0,0,3,10,3270,0,1998,0,98075,47.6018,-122.073,3460,8872,4953,5412,96.98406907454701,0.09475409836065574,Very Cheap
20140710T000000,379000.0,4,1.5,1280,5460,1.5,0,0,5,7,1080,200,1920,0,98118,47.5348,-122.268,1470,5934,4180,4464,69.41391941391942,0.03986885245901639,Very Cheap
20141216T000000,575000.0,1,1.0,1310,8667,1.5,0,0,1,6,1310,0,1918,0,98122,47.6059,-122.313,1130,4800,7357,3670,66.34360216914735,0.06557377049180328,Very Cheap
20150325T000000,247500.0,3,1.0,1660,11060,1.0,0,0,4,7,1110,550,1962,0,98003,47.3311,-122.326,1890,11060,9400,9170,22.377938517179025,0.02262295081967213,Very Cheap
20140623T000000,385000.0,4,2.75,2700,37011,2.0,0,0,3,9,2700,0,1984,0,98042,47.3496,-122.088,2700,37457,34311,34757,10.402312825916619,0.04065573770491803,Very Cheap
20140520T000000,423000.0,4,1.75,1940,6909,1.0,0,0,4,7,970,970,1941,0,98133,47.7108,-122.352,1460,6906,4969,5446,61.224489795918366,0.04563934426229508,Very Cheap
20141215T000000,550000.0,3,1.75,1520,5618,1.0,0,0,3,7,1170,350,1953,0,98115,47.68,-122.284,1550,5618,4098,4068,97.8996084015664,0.06229508196721312,Very Cheap
20140910T000000,415000.0,4,1.0,1620,4329,1.5,0,0,3,7,1620,0,1927,0,98116,47.5728,-122.388,1220,5520,2709,4300,95.86509586509587,0.04459016393442623,Very Cheap
20141010T000000,693000.0,3,2.25,2090,45535,1.0,0,2,5,8,1280,810,1952,0,98006,47.5538,-122.191,3090,12889,43445,9799,15.219062259800154,0.08104918032786886,Very Cheap
20150327T000000,543000.0,2,1.0,1070,4700,1.0,0,0,5,7,1070,0,1910,0,98117,47.6887,-122.368,1370,4700,3630,3330,115.53191489361703,0.06137704918032787,Very Cheap
20150327T000000,465000.0,5,1.75,2000,10246,1.0,0,2,3,7,1200,800,1953,0,98178,47.5084,-122.246,2340,9030,8246,6690,45.38356431778255,0.051147540983606556,Very Cheap
20150427T000000,280000.0,3,2.5,1020,2217,2.0,0,0,3,7,720,300,2004,0,98106,47.5343,-122.348,1060,1524,1197,464,126.29679747406405,0.026885245901639345,Very Cheap
20141118T000000,1388000.0,3,1.25,2400,6653,3.0,0,2,3,11,2400,0,1992,0,98122,47.6019,-122.29,1910,6653,4253,4743,208.6276867578536,0.1721967213114754,Cheap
20150130T000000,665000.0,6,3.0,2480,9720,2.0,0,0,3,8,2480,0,1972,0,98007,47.6127,-122.145,2480,9200,7240,6720,68.4156378600823,0.07737704918032787,Very Cheap
20150312T000000,237950.0,3,1.75,1310,7314,1.0,0,0,5,6,1310,0,1960,0,98002,47.2888,-122.221,1010,7314,6004,6304,32.533497402242276,0.02137049180327869,Very Cheap
20150102T000000,440000.0,4,2.75,2420,10200,1.0,0,0,3,8,1220,1200,1962,0,98034,47.72,-122.236,2240,9750,7780,7510,43.13725490196079,0.04786885245901639,Very Cheap
20150112T000000,618000.0,2,1.0,1890,4700,1.0,0,0,4,7,1030,860,1928,0,98107,47.6747,-122.391,2150,4700,2810,2550,131.48936170212767,0.07121311475409836,Very Cheap
20141113T000000,572000.0,3,2.25,1860,4000,1.5,0,0,5,7,1020,840,1920,0,98118,47.5539,-122.267,1180,4000,2140,2820,143.0,0.06518032786885246,Very Cheap
20140527T000000,725000.0,3,1.5,2500,4774,1.5,0,2,3,7,1450,1050,1940,0,98107,47.6567,-122.358,1300,4000,2274,2700,151.86426476749057,0.08524590163934426,Very Cheap
20140625T000000,454000.0,3,1.0,1970,22144,1.0,0,0,4,7,1970,0,1970,0,98065,47.5234,-121.841,1970,13500,20174,11530,20.502167630057805,0.049704918032786885,Very Cheap
20150122T000000,535000.0,4,1.0,1660,10656,1.5,0,0,4,7,1180,480,1920,0,98136,47.5391,-122.385,1120,8816,8996,7696,50.20645645645646,0.06032786885245902,Very Cheap
20141218T000000,249000.0,3,2.5,1850,7200,1.0,0,0,3,7,1500,350,1979,0,98023,47.3063,-122.384,2140,7500,5350,5360,34.583333333333336,0.02281967213114754,Very Cheap
20140709T000000,395000.0,4,2.75,1970,37026,1.0,0,0,4,8,1970,0,1961,0,98070,47.4375,-122.446,1970,51836,35056,49866,10.668179117376978,0.0419672131147541,Very Cheap
20141231T000000,690000.0,3,2.0,1890,6620,1.0,0,3,4,8,1890,0,1954,0,98125,47.7016,-122.274,2590,7188,4730,4598,104.2296072507553,0.08065573770491803,Very Cheap
20141003T000000,526500.0,3,1.5,1310,7236,1.0,0,0,4,7,1170,140,1928,0,98103,47.6944,-122.333,1680,8431,5926,6751,72.76119402985074,0.05921311475409836,Very Cheap
20140807T000000,325000.0,4,1.5,1870,7220,2.0,0,0,3,7,1870,0,1956,0,98155,47.77,-122.319,1550,7592,5350,6042,45.013850415512465,0.03278688524590164,Very Cheap
20150210T000000,495000.0,3,3.0,1520,4080,2.0,0,0,5,7,1520,0,1948,0,98144,47.572,-122.29,1320,4080,2560,2760,121.32352941176471,0.05508196721311476,Very Cheap
20141021T000000,825000.0,5,3.0,3070,8474,2.0,0,0,3,9,3070,0,2011,0,98033,47.6852,-122.184,3070,8527,5404,5457,97.35662025017702,0.09836065573770492,Very Cheap
20141223T000000,383000.0,3,1.5,1400,14850,1.5,0,0,4,7,1400,0,1910,0,98070,47.4471,-122.464,1350,14850,13450,13500,25.791245791245792,0.04039344262295082,Very Cheap
20150428T000000,320000.0,3,1.75,1960,11931,1.0,0,0,3,7,980,980,1954,0,98118,47.5432,-122.272,1460,4498,9971,3038,26.820886765568687,0.032131147540983604,Very Cheap
20141208T000000,475000.0,3,2.5,2680,87117,1.0,0,0,3,7,1340,1340,1989,0,98024,47.5646,-121.935,2580,87117,84437,84537,5.452437526544761,0.05245901639344262,Very Cheap
20140521T000000,275000.0,3,2.5,2030,6326,2.0,0,0,3,7,2030,0,1993,0,98038,47.3491,-122.029,1810,6825,4296,5015,43.47138792285805,0.02622950819672131,Very Cheap
20141015T000000,1150000.0,2,2.25,2320,9300,1.5,0,4,5,9,1920,400,1937,0,98115,47.681,-122.273,2790,9300,6980,6510,123.65591397849462,0.14098360655737704,Cheap
20141125T000000,455000.0,3,1.75,1760,11371,1.0,0,0,5,8,1760,0,1959,0,98155,47.7616,-122.273,2220,19884,9611,17664,40.01407088206842,0.049836065573770495,Very Cheap
20140702T000000,262000.0,5,1.0,1870,7800,1.0,0,0,3,7,1580,290,1962,0,98168,47.5127,-122.321,1740,7808,5930,6068,33.58974358974359,0.024524590163934427,Very Cheap
20140915T000000,390000.0,4,1.0,1280,4840,1.0,0,0,3,7,940,340,1950,0,98136,47.5477,-122.395,1360,4840,3560,3480,80.57851239669421,0.04131147540983607,Very Cheap
20141023T000000,300000.0,3,2.25,1730,10030,1.0,0,0,4,8,1730,0,1985,0,98023,47.3108,-122.345,2090,8823,8300,6733,29.91026919242273,0.029508196721311476,Very Cheap
20140820T000000,746300.0,3,1.75,2060,5721,1.0,0,2,3,9,1140,920,1964,0,98136,47.5268,-122.388,2060,8124,3661,6064,130.44922216395736,0.08803934426229508,Very Cheap
20140908T000000,267000.0,3,1.5,1030,8223,1.0,0,0,4,7,1030,0,1952,0,98148,47.4282,-122.331,1460,9463,7193,8003,32.46990149580445,0.025180327868852458,Very Cheap
20150402T000000,525000.0,3,2.5,1720,7950,1.5,0,0,4,7,1720,0,1972,0,98034,47.7178,-122.168,1790,7030,6230,5240,66.0377358490566,0.05901639344262295,Very Cheap
20150424T000000,570000.0,3,1.75,1210,7350,1.0,0,0,3,7,1210,0,1977,0,98033,47.7,-122.172,1610,7313,6140,5703,77.55102040816327,0.06491803278688525,Very Cheap
20141027T000000,360000.0,4,2.25,2620,8100,1.0,0,0,4,7,1550,1070,1964,0,98166,47.4564,-122.351,1650,8100,5480,6450,44.44444444444444,0.037377049180327866,Very Cheap
20150326T000000,1052000.0,3,1.0,1860,44431,1.0,0,0,4,6,1860,0,1947,0,98074,47.6057,-122.038,2000,44431,42571,42431,23.677162341608337,0.12813114754098362,Cheap
20141103T000000,699950.0,3,2.5,2510,4106,2.0,0,0,3,9,2510,0,2003,0,98029,47.5494,-121.994,2470,4106,1596,1636,170.47004383828545,0.08196065573770492,Very Cheap
20140616T000000,375000.0,4,2.5,2040,109336,1.5,0,0,4,8,2040,0,1973,0,98038,47.4193,-121.958,2370,133729,107296,131359,3.4297943952586523,0.03934426229508197,Very Cheap
20141215T000000,625000.0,4,1.75,2410,6770,1.0,0,0,4,7,1220,1190,1924,0,98103,47.6946,-122.336,1440,6770,4360,5330,92.31905465288035,0.07213114754098361,Very Cheap
20141016T000000,464050.0,2,1.0,780,2750,1.0,0,0,4,7,780,0,1928,0,98116,47.5842,-122.388,1320,4440,1970,3120,168.74545454545455,0.05102295081967213,Very Cheap
20140502T000000,470000.0,5,2.5,2210,9655,1.0,0,0,3,8,1460,750,1976,0,98011,47.7698,-122.222,2080,8633,7445,6553,48.679440704298294,0.05180327868852459,Very Cheap
20140909T000000,330000.0,4,2.0,1590,9100,1.0,0,0,3,7,1040,550,1967,2014,98058,47.4465,-122.156,1670,9100,7510,7430,36.26373626373626,0.03344262295081967,Very Cheap
20140915T000000,537000.0,4,1.75,2230,7957,1.0,0,0,4,7,2230,0,1967,0,98008,47.5859,-122.122,2230,8040,5727,5810,67.48774663818021,0.060590163934426226,Very Cheap
20150305T000000,250000.0,3,2.0,1560,32137,1.0,0,0,5,7,910,650,1976,0,98092,47.3197,-122.117,1470,29150,30577,27680,7.779195320036095,0.022950819672131147,Very Cheap
20150112T000000,835000.0,4,2.5,2950,48351,2.0,0,0,3,10,2950,0,1986,0,98075,47.5938,-122.048,2870,34417,45401,31547,17.269549750780747,0.09967213114754099,Very Cheap
20150316T000000,770000.0,4,1.0,1480,3750,1.5,0,0,4,7,1480,0,1912,0,98103,47.6737,-122.354,1570,3750,2270,2180,205.33333333333334,0.09114754098360656,Very Cheap
20141118T000000,650000.0,4,2.0,2850,4497,1.5,0,1,3,7,1730,1120,1910,0,98144,47.5876,-122.292,2450,6000,1647,3550,144.54080498109852,0.07540983606557378,Very Cheap
20141107T000000,335000.0,3,1.75,2390,30409,1.0,0,0,3,7,1560,830,1953,0,98168,47.4789,-122.296,1750,13500,28019,11750,11.016475385576639,0.03409836065573771,Very Cheap
20141202T000000,350000.0,3,1.75,1740,29597,1.0,0,0,4,7,1740,0,1965,0,98059,47.481,-122.115,1560,20741,27857,19181,11.825522857046323,0.036065573770491806,Very Cheap
20140724T000000,415000.0,5,2.75,2060,8906,1.0,0,0,4,7,1220,840,1978,0,98118,47.5358,-122.289,1840,8906,6846,7066,46.5977992364698,0.04459016393442623,Very Cheap
20141119T000000,788000.0,4,2.5,2680,8778,2.0,0,0,4,8,2680,0,1977,0,98006,47.5516,-122.161,2680,10020,6098,7340,89.76987924356345,0.09350819672131147,Very Cheap
20141014T000000,640000.0,4,2.75,3150,7379,1.5,0,0,4,7,2430,720,1915,0,98115,47.6968,-122.3,1990,7379,4229,5389,86.73261959615124,0.0740983606557377,Very Cheap
20140523T000000,388000.0,4,2.5,2440,7155,2.0,0,0,3,8,2440,0,1993,0,98058,47.4501,-122.126,2450,8109,4715,5659,54.22781271837876,0.041049180327868855,Very Cheap
20141125T000000,360000.0,6,1.75,2230,10080,1.0,0,0,3,7,1390,840,1969,0,98034,47.7089,-122.201,2110,8475,7850,6365,35.714285714285715,0.037377049180327866,Very Cheap
20150324T000000,692500.0,6,1.75,2230,10080,1.0,0,0,3,7,1390,840,1969,0,98034,47.7089,-122.201,2110,8475,7850,6365,68.70039682539682,0.08098360655737705,Very Cheap
20140624T000000,425000.0,4,1.5,1600,6180,1.5,0,0,3,6,1600,0,1946,0,98118,47.5681,-122.285,1410,6180,4580,4770,68.77022653721683,0.04590163934426229,Very Cheap
20150311T000000,645000.0,4,1.5,1600,6180,1.5,0,0,3,6,1600,0,1946,0,98118,47.5681,-122.285,1410,6180,4580,4770,104.36893203883496,0.07475409836065573,Very Cheap
20150114T000000,340000.0,3,1.0,1580,8308,1.5,0,0,3,7,1580,0,1948,0,98146,47.5075,-122.379,1200,8308,6728,7108,40.92441020702937,0.03475409836065574,Very Cheap
20150105T000000,713000.0,4,3.25,2840,54400,1.0,0,0,4,8,2840,0,1984,0,98053,47.6707,-122.045,2550,43560,51560,41010,13.106617647058824,0.08367213114754099,Very Cheap
20140521T000000,430000.0,3,2.75,2550,11160,2.0,0,0,3,8,2550,0,1994,0,98155,47.7351,-122.323,1020,7440,8610,6420,38.53046594982079,0.04655737704918033,Very Cheap
20150306T000000,280000.0,3,2.25,1700,7210,1.0,0,0,4,7,1250,450,1974,0,98003,47.3546,-122.318,2070,7300,5510,5230,38.83495145631068,0.026885245901639345,Very Cheap
20150226T000000,215000.0,3,2.0,1470,2052,1.5,0,0,3,7,1470,0,1986,0,98003,47.3084,-122.331,1390,2052,582,662,104.77582846003898,0.018360655737704918,Very Cheap
20140528T000000,306000.0,3,2.5,1680,11193,2.0,0,0,3,8,1680,0,1984,0,98058,47.4482,-122.125,2080,8084,9513,6004,27.33851514339319,0.030295081967213113,Very Cheap
20140625T000000,299900.0,3,1.0,1110,8593,1.0,0,0,3,7,1110,0,1979,0,98155,47.7595,-122.309,1780,8593,7483,6813,34.90050040730827,0.029495081967213115,Very Cheap
20140825T000000,534000.0,5,1.75,2120,8625,1.0,0,0,3,7,1200,920,1959,0,98008,47.6118,-122.131,1930,8625,6505,6695,61.91304347826087,0.06019672131147541,Very Cheap
20140728T000000,1160000.0,3,2.75,2380,5572,2.0,0,4,3,9,1930,450,1939,0,98105,47.6626,-122.271,3370,5500,3192,2130,208.183776022972,0.1422950819672131,Cheap
20140716T000000,1165000.0,3,2.5,2670,5000,2.0,0,3,5,9,2000,670,1942,1995,98144,47.5855,-122.292,2320,5000,2330,2680,233.0,0.14295081967213114,Cheap
20140711T000000,199990.0,2,1.0,890,6430,1.0,0,0,3,6,890,0,1935,1997,98022,47.2003,-121.996,1460,6430,5540,4970,31.102643856920686,0.016392131147540984,Very Cheap
20140812T000000,946000.0,4,3.0,3140,9058,1.0,0,0,3,9,2140,1000,1989,0,98006,47.5462,-122.154,2760,10018,5918,7258,104.43806579818944,0.11422950819672131,Cheap
20150220T000000,295000.0,4,1.0,1260,7800,1.5,0,0,3,7,1260,0,1947,2007,98125,47.7334,-122.307,1639,7492,6540,5853,37.82051282051282,0.028852459016393443,Very Cheap
20150218T000000,475000.0,2,1.0,920,5157,1.0,0,0,3,6,920,0,1909,0,98118,47.5499,-122.269,1700,5150,4237,3450,92.10781462090362,0.05245901639344262,Very Cheap
20150429T000000,750000.0,5,3.5,2990,212137,2.0,0,0,3,8,2450,540,1994,0,98024,47.5298,-121.887,1060,69260,209147,68200,3.535451147136049,0.08852459016393442,Very Cheap
20141028T000000,1225000.0,4,2.5,3120,49456,2.0,1,4,4,9,2590,530,1974,1989,98198,47.3535,-122.323,2030,32181,46336,30151,24.769492073762535,0.15081967213114755,Cheap
20150323T000000,183500.0,3,1.0,1010,7520,1.0,0,0,4,6,1010,0,1975,0,98001,47.2699,-122.255,1370,8469,6510,7099,24.40159574468085,0.014229508196721311,Very Cheap
20150327T000000,450000.0,2,1.0,1010,3627,1.0,0,2,4,6,1010,0,1924,0,98144,47.5873,-122.294,1630,4040,2617,2410,124.06947890818859,0.04918032786885246,Very Cheap
20150108T000000,180000.0,3,1.0,1020,5500,1.5,0,0,3,7,1020,0,1961,0,98118,47.5502,-122.286,1160,5500,4480,4340,32.72727272727273,0.01377049180327869,Very Cheap
20150105T000000,707000.0,5,4.5,3540,21217,2.0,0,0,4,8,2940,600,1926,0,98188,47.4274,-122.28,1290,12040,17677,10750,33.322335862751565,0.08288524590163934,Very Cheap
20150304T000000,230000.0,2,0.75,900,3527,1.0,0,0,3,6,900,0,1939,0,98146,47.5083,-122.336,1220,4080,2627,2860,65.2112276722427,0.020327868852459016,Very Cheap
20141209T000000,192500.0,3,1.0,1100,9750,1.0,0,0,4,7,1100,0,1966,0,98023,47.3248,-122.345,1190,9750,8650,8560,19.743589743589745,0.01540983606557377,Very Cheap
20141017T000000,309000.0,3,2.5,1990,3614,2.0,0,0,3,7,1990,0,2005,0,98038,47.36,-122.039,1980,3800,1624,1820,85.50083010514665,0.030688524590163933,Very Cheap
20141001T000000,759000.0,3,1.5,1980,5800,1.0,0,0,4,8,1520,460,1949,0,98199,47.6499,-122.413,2280,5800,3820,3520,130.86206896551724,0.08970491803278688,Very Cheap
20150427T000000,1115000.0,4,3.75,4040,14212,2.0,0,0,3,11,4040,0,2002,0,98059,47.5189,-122.147,3940,14212,10172,10272,78.45482690683929,0.13639344262295083,Cheap
20140519T000000,462000.0,5,1.75,1250,10530,1.0,0,0,4,7,1250,0,1966,0,98007,47.6101,-122.138,1560,8190,9280,6630,43.87464387464387,0.05075409836065574,Very Cheap
20141220T000000,229000.0,4,1.5,1820,22814,1.5,0,0,3,7,1820,0,1920,0,98125,47.7321,-122.296,1770,9150,20994,7380,10.03769615148593,0.02019672131147541,Very Cheap
20141020T000000,399950.0,2,2.25,1140,1184,2.0,0,0,3,8,1010,130,1999,0,98103,47.659,-122.346,1140,1339,44,199,337.7956081081081,0.04261639344262295,Very Cheap
20150403T000000,325000.0,5,2.0,1730,10532,1.0,0,0,4,5,1730,0,1943,0,98056,47.5076,-122.178,1940,8501,8802,6561,30.858336498290925,0.03278688524590164,Very Cheap
20140721T000000,512000.0,2,2.25,1170,1313,3.0,0,0,3,8,1170,0,2007,0,98107,47.6712,-122.378,1310,1304,143,-6,389.94668697638997,0.05731147540983607,Very Cheap
20140725T000000,410000.0,5,2.75,2910,5802,2.0,0,0,3,7,2910,0,2006,0,98038,47.3591,-122.036,2910,5000,2892,2090,70.66528783178214,0.043934426229508196,Very Cheap
20140624T000000,210000.0,2,1.0,970,5500,1.0,0,0,3,7,970,0,1956,0,98118,47.556,-122.291,1180,6000,4530,4820,38.18181818181818,0.017704918032786884,Very Cheap
20140925T000000,325000.0,4,2.25,2130,8499,1.0,0,0,4,7,1600,530,1975,0,98030,47.3657,-122.21,1890,11368,6369,9478,38.23979291681374,0.03278688524590164,Very Cheap
20150406T000000,685000.0,3,2.5,2520,10175,1.0,0,0,3,8,1630,890,1979,0,98027,47.5652,-122.089,2220,8388,7655,6168,67.32186732186732,0.08,Very Cheap
20140518T000000,488000.0,2,2.0,1360,4688,1.0,0,0,3,7,780,580,1944,0,98115,47.6874,-122.315,1340,4750,3328,3410,104.09556313993174,0.05416393442622951,Very Cheap
20150302T000000,247500.0,3,2.25,1620,6000,1.0,0,0,3,7,1280,340,1998,0,98002,47.2835,-122.2,1710,6318,4380,4608,41.25,0.02262295081967213,Very Cheap
20140620T000000,489000.0,4,2.0,2120,11479,1.0,0,0,4,7,1060,1060,1940,0,98125,47.7084,-122.303,1540,11000,9359,9460,42.59952957574701,0.05429508196721312,Very Cheap
20141125T000000,725000.0,4,1.75,2700,6000,1.0,0,0,4,8,1450,1250,1953,0,98199,47.6539,-122.395,2080,6000,3300,3920,120.83333333333333,0.08524590163934426,Very Cheap
20150409T000000,199950.0,3,1.5,1370,10317,1.5,0,0,3,6,1370,0,1958,0,98168,47.4731,-122.298,1370,9884,8947,8514,19.380633905205002,0.01638688524590164,Very Cheap
20150401T000000,670000.0,5,3.0,2520,13001,2.0,0,1,3,8,2010,510,1973,0,98008,47.6385,-122.114,2170,8215,10481,6045,51.53449734635797,0.0780327868852459,Very Cheap
20141229T000000,275000.0,3,2.0,1540,10410,1.0,0,0,4,7,1540,0,1967,0,98198,47.3662,-122.315,1590,7725,8870,6135,26.416906820365032,0.02622950819672131,Very Cheap
20150407T000000,1000000.0,3,1.75,2610,6360,2.0,0,2,3,8,2130,480,1924,0,98109,47.6287,-122.351,3010,6000,3750,2990,157.23270440251574,0.12131147540983607,Cheap
20140523T000000,255000.0,3,2.0,1490,8371,1.5,0,0,3,7,1490,0,1984,0,98031,47.3962,-122.189,1350,7846,6881,6496,30.462310357185522,0.02360655737704918,Very Cheap
20141113T000000,465000.0,3,1.75,2760,9137,1.0,0,0,3,7,1380,1380,1960,0,98007,47.6079,-122.132,1980,9137,6377,7157,50.89197767319689,0.051147540983606556,Very Cheap
20150211T000000,259000.0,3,1.75,1260,3604,1.0,0,0,3,7,1260,0,2012,0,98042,47.3612,-122.103,1430,3767,2344,2337,71.86459489456159,0.024131147540983607,Very Cheap
20141121T000000,695000.0,3,3.5,2630,4713,2.0,0,2,3,9,2030,600,2008,0,98027,47.5473,-122.016,2450,4187,2083,1737,147.4644600042436,0.08131147540983606,Very Cheap
20150501T000000,505000.0,3,1.75,1800,7210,1.0,0,0,3,7,1370,430,1976,0,98072,47.7346,-122.17,1820,8100,5410,6280,70.04160887656033,0.05639344262295082,Very Cheap
20140624T000000,631500.0,2,1.0,1130,2640,1.0,0,0,4,8,1130,0,1927,0,98109,47.6438,-122.357,1680,3200,1510,1520,239.20454545454547,0.07298360655737705,Very Cheap
20141016T000000,630500.0,3,1.0,1180,3600,1.5,0,0,3,7,1180,0,1926,0,98112,47.6337,-122.28,1900,3600,2420,1700,175.13888888888889,0.07285245901639344,Very Cheap
20140616T000000,999000.0,4,2.75,2800,19168,2.0,0,0,3,10,2800,0,1992,0,98075,47.5911,-122.037,2010,16020,16368,14010,52.11811352253756,0.12118032786885245,Cheap
20140710T000000,740000.0,3,1.5,1830,4000,1.0,0,0,4,7,1350,480,1910,0,98119,47.6453,-122.371,1570,3672,2170,2102,185.0,0.08721311475409836,Very Cheap
20140929T000000,650000.0,3,2.5,2220,6380,1.5,0,0,4,8,1660,560,1931,0,98115,47.6974,-122.313,950,6380,4160,5430,101.88087774294671,0.07540983606557378,Very Cheap
20140805T000000,554000.0,2,2.0,1870,5580,1.0,0,0,3,8,1870,0,2004,0,98053,47.7101,-122.031,1670,4500,3710,2830,99.2831541218638,0.06281967213114754,Very Cheap
20141201T000000,400000.0,3,2.5,2580,214315,1.5,0,0,3,8,2580,0,1946,1986,98053,47.6465,-122.024,2580,70131,211735,67551,1.8664115904159764,0.04262295081967213,Very Cheap
20150223T000000,529941.0,3,2.0,1660,10000,1.0,0,0,4,7,1010,650,1961,0,98005,47.5852,-122.174,2020,9720,8340,7700,52.9941,0.05966439344262295,Very Cheap
20141020T000000,310000.0,3,1.0,1330,3740,1.5,0,0,3,6,1330,0,1903,0,98118,47.5502,-122.274,1330,5053,2410,3723,82.88770053475936,0.03081967213114754,Very Cheap
20150422T000000,389000.0,3,1.0,1330,3740,1.5,0,0,3,6,1330,0,1903,0,98118,47.5502,-122.274,1330,5053,2410,3723,104.01069518716578,0.04118032786885246,Very Cheap
20140909T000000,731781.0,3,3.0,2630,4972,2.0,0,0,3,9,2630,0,2006,0,98052,47.693,-122.133,2880,4972,2342,2092,147.18041029766692,0.0861352131147541,Very Cheap
20150422T000000,502501.0,2,1.0,1100,4750,1.0,0,0,3,7,1100,0,1946,0,98116,47.5772,-122.381,1830,4750,3650,2920,105.78968421052632,0.05606570491803279,Very Cheap
20141117T000000,443000.0,3,1.75,1810,7950,1.0,0,0,4,7,1810,0,1968,0,98008,47.6236,-122.117,1680,7725,6140,6045,55.723270440251575,0.048262295081967214,Very Cheap
20140815T000000,607000.0,3,2.0,2060,4080,1.0,0,0,5,7,1060,1000,1921,0,98144,47.574,-122.289,1400,4080,2020,2680,148.77450980392157,0.06977049180327868,Very Cheap
20140702T000000,2147500.0,3,3.5,4660,5500,2.0,0,4,5,10,3040,1620,1909,0,98102,47.6465,-122.319,2980,5500,840,2520,390.45454545454544,0.2718032786885246,Cheap
20140910T000000,585000.0,4,2.5,2370,15200,1.0,0,0,3,8,1660,710,1975,0,98052,47.6295,-122.089,2360,13879,12830,11519,38.48684210526316,0.06688524590163934,Very Cheap
20140619T000000,1027000.0,3,2.5,2430,10500,2.0,0,1,3,9,2430,0,1989,0,98004,47.5818,-122.198,3440,12842,8070,9402,97.80952380952381,0.12485245901639344,Cheap
20140612T000000,315000.0,3,2.5,1880,7000,2.0,0,0,3,8,1880,0,1993,0,98031,47.4206,-122.184,1880,7000,5120,5120,45.0,0.031475409836065574,Very Cheap
20141021T000000,180000.0,2,1.0,1150,5695,1.0,0,0,4,6,1150,0,1958,0,98056,47.4989,-122.171,1150,5695,4545,4545,31.60667251975417,0.01377049180327869,Very Cheap
20140513T000000,322500.0,3,2.0,1350,14200,1.0,0,0,3,7,1350,0,1989,0,98019,47.7315,-121.972,2100,15101,12850,13001,22.711267605633804,0.032459016393442626,Very Cheap
20140602T000000,568500.0,3,2.75,2180,7519,1.0,0,0,4,7,1310,870,1981,0,98052,47.6959,-122.125,1510,7107,5339,5597,75.60845857161857,0.06472131147540984,Very Cheap
20140611T000000,813000.0,4,2.75,3370,6675,1.0,0,3,4,8,1920,1450,1948,0,98144,47.5887,-122.291,2250,5550,3305,3300,121.79775280898876,0.09678688524590164,Very Cheap
20150414T000000,1085000.0,5,2.25,3650,13068,1.0,0,0,4,10,1850,1800,1976,0,98040,47.5458,-122.231,2760,13927,9418,11167,83.02724211815121,0.13245901639344262,Cheap
20140626T000000,424000.0,4,2.0,2100,4857,2.0,0,0,3,8,2100,0,1965,1984,98155,47.7521,-122.279,1450,5965,2757,4515,87.29668519662343,0.04577049180327869,Very Cheap
20140717T000000,235000.0,2,1.0,670,5600,1.0,0,0,3,6,670,0,1903,0,98108,47.5498,-122.304,1960,7176,4930,5216,41.964285714285715,0.02098360655737705,Very Cheap
20140929T000000,740000.0,3,3.5,2420,4000,2.0,0,0,5,9,1820,600,1907,0,98122,47.6054,-122.295,2030,4550,1580,2520,185.0,0.08721311475409836,Very Cheap
20140813T000000,415000.0,1,1.0,760,3000,1.0,0,0,3,7,760,0,1900,0,98122,47.6059,-122.303,1270,3000,2240,1730,138.33333333333334,0.04459016393442623,Very Cheap
20140522T000000,432000.0,3,2.75,2200,14925,1.0,0,0,3,6,1100,1100,1982,0,98053,47.6606,-122.059,1520,14212,12725,12692,28.944723618090453,0.046819672131147544,Very Cheap
20150504T000000,1268890.0,5,3.25,4410,35192,2.0,0,2,3,12,3880,530,1990,0,98072,47.7522,-122.13,4410,59677,30782,55267,36.05620595589907,0.15657573770491803,Cheap
20140915T000000,676500.0,3,1.75,1300,2446,1.0,0,3,3,8,880,420,1961,0,98122,47.6071,-122.285,2440,5051,1146,2611,276.57399836467704,0.07888524590163934,Very Cheap
20141120T000000,419000.0,2,1.0,720,4592,1.0,0,0,4,6,720,0,1943,0,98199,47.6534,-122.404,1030,5816,3872,4786,91.24564459930313,0.04511475409836065,Very Cheap
20150320T000000,650000.0,3,2.5,2180,37042,2.0,0,0,3,9,2180,0,1998,0,98077,47.722,-122.026,2880,32688,34862,29808,17.547648615085578,0.07540983606557378,Very Cheap
20140822T000000,239000.0,2,1.0,1130,15190,1.0,0,0,4,7,1130,0,1954,0,98032,47.3902,-122.283,1490,16920,14060,15430,15.734035549703753,0.021508196721311476,Very Cheap
20140709T000000,900000.0,4,2.5,2230,4372,2.0,0,0,5,8,1540,690,1935,0,98103,47.6698,-122.334,2020,4372,2142,2352,205.85544373284537,0.10819672131147541,Cheap
20150428T000000,330000.0,5,1.75,2100,7347,1.0,0,0,3,7,1070,1030,1981,0,98028,47.7751,-122.268,2170,9418,5247,7248,44.9162923642303,0.03344262295081967,Very Cheap
20141204T000000,510000.0,3,1.75,2060,58341,1.0,0,4,3,8,1100,960,1982,0,98070,47.4193,-122.439,1230,14904,56281,13674,8.741708232632282,0.057049180327868855,Very Cheap
20140627T000000,465000.0,4,2.5,3060,6000,2.0,0,0,3,9,3060,0,2012,0,98038,47.3689,-122.058,3040,6000,2940,2960,77.5,0.051147540983606556,Very Cheap
20140623T000000,1700000.0,3,2.75,2810,18731,2.0,1,4,4,10,2810,0,1974,0,98052,47.6361,-122.093,3120,14810,15921,11690,90.75863541722279,0.21311475409836064,Cheap
20140827T000000,490000.0,3,2.25,2550,8588,1.0,0,4,3,9,2550,0,1989,0,98011,47.7711,-122.195,3050,8588,6038,5538,57.05635770843037,0.05442622950819672,Very Cheap
20140709T000000,2680000.0,5,3.0,4290,20445,2.0,0,0,4,11,4290,0,1985,0,98039,47.6217,-122.239,3620,22325,16155,18705,131.08339447297627,0.3416393442622951,Medium
20141130T000000,1000000.0,3,2.25,3040,52302,1.0,0,0,3,9,3040,0,2005,0,98072,47.7635,-122.112,2070,38600,49262,36530,19.119727735077053,0.12131147540983607,Cheap
20140708T000000,469950.0,4,2.75,2530,14178,2.0,0,0,3,8,2530,0,1997,0,98019,47.737,-121.955,2530,14055,11648,11525,33.1464240372408,0.05179672131147541,Very Cheap
20140509T000000,536000.0,3,1.75,1300,5413,1.5,0,0,3,7,1300,0,1925,1992,98115,47.6988,-122.32,1590,6380,4113,4790,99.02087566968409,0.06045901639344262,Very Cheap
20150305T000000,244950.0,4,2.5,1790,19177,1.0,0,0,4,7,1790,0,1966,0,98030,47.3617,-122.172,1760,11726,17387,9966,12.77311362569745,0.022288524590163936,Very Cheap
20150417T000000,575000.0,3,1.0,1530,2400,1.0,0,0,4,7,890,640,1928,0,98103,47.6543,-122.354,1240,2400,870,1160,239.58333333333334,0.06557377049180328,Very Cheap
20150325T000000,361000.0,5,2.75,2380,7500,1.0,0,0,3,7,1300,1080,1984,0,98178,47.5009,-122.235,2400,6000,5120,3600,48.13333333333333,0.037508196721311476,Very Cheap
20150327T000000,650000.0,5,2.25,2400,13450,1.0,0,0,5,7,1200,1200,1957,0,98008,47.6007,-122.117,1950,10361,11050,8411,48.3271375464684,0.07540983606557378,Very Cheap
20150323T000000,230005.0,2,1.0,1030,6000,1.0,0,0,2,7,830,200,1951,0,98118,47.5291,-122.268,1770,5000,4970,3230,38.33416666666667,0.020328524590163936,Very Cheap
20140527T000000,293000.0,4,2.5,3250,235063,1.0,0,2,3,9,3250,0,1973,0,98092,47.2582,-122.113,1600,44287,231813,42687,1.2464743494297275,0.02859016393442623,Very Cheap
20140516T000000,445000.0,3,3.0,1970,24318,1.0,0,0,3,8,1970,0,2010,0,98028,47.7651,-122.246,2150,14695,22348,12545,18.299202237026073,0.04852459016393443,Very Cheap
20140814T000000,280000.0,4,1.5,1940,6386,1.0,0,0,3,7,1140,800,1954,0,98118,47.5533,-122.285,1340,6165,4446,4825,43.845912934544316,0.026885245901639345,Very Cheap
20140716T000000,520000.0,3,2.25,1850,10855,1.0,0,0,3,8,1370,480,1985,0,98029,47.5696,-122.02,1850,8209,9005,6359,47.90419161676647,0.058360655737704915,Very Cheap
20140805T000000,780000.0,4,3.25,3900,40962,2.0,0,0,3,10,3900,0,1991,0,98053,47.683,-122.063,1730,11775,37062,10045,19.042038962941263,0.09245901639344262,Very Cheap
20140709T000000,625000.0,3,1.75,3160,76230,1.0,0,0,4,8,2160,1000,1978,0,98001,47.274,-122.287,1990,45789,73070,43799,8.198871835235472,0.07213114754098361,Very Cheap
20150410T000000,239950.0,3,1.75,1440,7200,1.0,0,0,3,7,1440,0,1986,0,98188,47.4473,-122.284,1640,9167,5760,7527,33.326388888888886,0.021632786885245902,Very Cheap
20140616T000000,335000.0,3,1.5,2040,6000,1.0,0,0,3,7,1340,700,1957,0,98118,47.5218,-122.286,1190,6000,3960,4810,55.833333333333336,0.03409836065573771,Very Cheap
20150417T000000,612000.0,3,2.5,2120,7401,2.0,0,0,3,8,2120,0,1989,0,98029,47.5781,-122.018,2010,7972,5281,5962,82.69152817186867,0.07042622950819673,Very Cheap
20140804T000000,200000.0,2,1.0,830,8000,1.0,0,0,3,6,830,0,1954,0,98198,47.4215,-122.318,1300,8000,7170,6700,25.0,0.01639344262295082,Very Cheap
20140710T000000,345000.0,3,1.75,3140,8571,1.0,0,0,4,8,1670,1470,1985,0,98023,47.3074,-122.337,2590,7949,5431,5359,40.25201260063003,0.03540983606557377,Very Cheap
20150128T000000,520000.0,4,2.5,2410,6440,1.0,0,0,3,8,1550,860,1974,0,98034,47.7153,-122.191,2330,6938,4030,4608,80.74534161490683,0.058360655737704915,Very Cheap
20140618T000000,855000.0,4,2.25,2190,4080,2.0,0,0,3,8,1800,390,1918,0,98119,47.6425,-122.358,2100,4080,1890,1980,209.55882352941177,0.10229508196721311,Cheap
20150507T000000,567500.0,4,1.75,2190,5060,1.0,0,0,3,7,1190,1000,1950,0,98116,47.5846,-122.387,1510,4600,2870,3090,112.15415019762845,0.06459016393442622,Very Cheap
20141110T000000,208000.0,3,1.5,1210,7247,1.0,0,0,4,7,1210,0,1967,0,98003,47.328,-122.321,1370,7869,6037,6499,28.701531668276527,0.01744262295081967,Very Cheap
20140821T000000,452000.0,3,1.75,1880,16239,1.0,0,0,3,7,880,1000,1922,0,98115,47.7004,-122.304,1260,7528,14359,6268,27.834226245458463,0.04944262295081967,Very Cheap
20140728T000000,555000.0,3,3.0,2410,12183,2.0,0,0,3,9,2410,0,1988,0,98011,47.747,-122.177,2540,9979,9773,7439,45.55528195025855,0.06295081967213115,Very Cheap
20140905T000000,519000.0,5,2.75,2620,8861,1.0,0,0,5,8,1350,1270,1979,0,98056,47.5226,-122.183,1940,10800,6241,8860,58.57126735131475,0.05822950819672131,Very Cheap
20141203T000000,474950.0,3,2.25,1850,2575,2.0,0,0,3,9,1850,0,2013,0,98118,47.5525,-122.273,1080,4120,725,3040,184.44660194174756,0.05245245901639344,Very Cheap
20150121T000000,419000.0,3,2.25,1760,16418,1.0,0,0,3,7,1190,570,1990,0,98053,47.6525,-121.985,2260,20747,14658,18487,25.520769886709708,0.04511475409836065,Very Cheap
20140911T000000,390000.0,2,1.0,860,1800,1.0,0,0,3,7,860,0,1909,0,98119,47.6334,-122.371,2160,3120,940,960,216.66666666666666,0.04131147540983607,Very Cheap
20141020T000000,539000.0,7,2.25,2620,6890,2.0,0,0,4,7,2620,0,1961,0,98007,47.6123,-122.134,2070,7910,4270,5840,78.22931785195937,0.06085245901639344,Very Cheap
20140801T000000,569000.0,4,1.75,2400,21196,1.0,0,0,5,8,1590,810,1956,0,98166,47.4282,-122.347,2200,19134,18796,16934,26.844687676920174,0.06478688524590163,Very Cheap
20141208T000000,611000.0,3,1.0,1850,5000,1.5,0,0,3,7,1850,0,1922,0,98103,47.6727,-122.351,1850,5000,3150,3150,122.2,0.07029508196721311,Very Cheap
20141028T000000,760000.0,3,2.5,4040,147856,2.0,0,0,3,9,4040,0,2004,0,98092,47.2711,-122.067,3000,125452,143816,122452,5.140136348879992,0.0898360655737705,Very Cheap
20140518T000000,732000.0,3,2.0,1940,55756,1.0,0,0,5,9,1940,0,1954,0,98007,47.5913,-122.149,2330,10018,53816,7688,13.128631896118803,0.08616393442622951,Very Cheap
20140708T000000,1675000.0,3,2.5,3490,8343,2.0,1,4,4,9,2150,1340,1939,1991,98125,47.7265,-122.281,2990,13104,4853,10114,200.7671101522234,0.2098360655737705,Cheap
20140903T000000,919950.0,5,2.75,3170,7062,2.0,0,0,3,9,3170,0,2014,0,98074,47.5937,-122.061,3210,6891,3892,3681,130.26762956669498,0.11081311475409836,Cheap
20140610T000000,400000.0,4,2.5,2530,7563,1.0,0,0,3,7,1440,1090,1978,0,98011,47.7762,-122.21,1960,7811,5033,5851,52.88906518577284,0.04262295081967213,Very Cheap
20140729T000000,785000.0,4,2.5,3230,21781,2.0,0,0,3,9,3230,0,1993,0,98053,47.6318,-122.01,3230,21780,18551,18550,36.04058583168817,0.09311475409836066,Very Cheap
20140629T000000,835000.0,3,2.25,2120,54014,2.0,0,0,4,9,2120,0,1964,0,98005,47.6482,-122.159,3280,50690,51894,47410,15.458955085718518,0.09967213114754099,Very Cheap
20150211T000000,640500.0,2,1.75,1640,6750,1.0,0,0,4,8,1340,300,1939,0,98125,47.7068,-122.308,1760,7490,5110,5730,94.88888888888889,0.07416393442622951,Very Cheap
20150316T000000,310000.0,4,2.5,2130,9013,2.0,0,0,3,8,2130,0,1988,0,98001,47.3208,-122.273,2350,8982,6883,6632,34.39476311993787,0.03081967213114754,Very Cheap
20141016T000000,355000.0,4,1.0,1440,7215,1.5,0,0,3,7,1440,0,1969,0,98034,47.7133,-122.212,1150,7215,5775,6065,49.203049203049204,0.036721311475409836,Very Cheap
20140529T000000,685000.0,3,1.75,1940,7313,1.0,0,1,4,8,1440,500,1960,0,98136,47.5239,-122.387,2160,7200,5373,5040,93.66880897032682,0.08,Very Cheap
20141017T000000,202500.0,3,1.0,1120,8576,1.0,0,0,3,6,1120,0,1943,0,98178,47.4896,-122.248,1050,8812,7456,7762,23.61240671641791,0.016721311475409836,Very Cheap
20150505T000000,540000.0,3,2.5,2400,5817,2.0,0,0,3,8,2400,0,1998,0,98065,47.5371,-121.87,2420,5817,3417,3397,92.83135636926251,0.06098360655737705,Very Cheap
20141117T000000,295000.0,4,2.5,1810,4871,2.0,0,0,3,8,1810,0,1999,0,98031,47.4088,-122.192,1850,5003,3061,3153,60.562512831040856,0.028852459016393443,Very Cheap
20150424T000000,518000.0,3,1.0,1270,6612,1.5,0,3,3,7,1270,0,1927,0,98118,47.5433,-122.264,2100,7680,5342,5580,78.34240774349668,0.0580983606557377,Very Cheap
20150501T000000,250000.0,2,1.75,1350,4023,1.0,0,0,3,7,1350,0,2005,0,98038,47.3493,-122.023,1370,3570,2673,2200,62.142679592344024,0.022950819672131147,Very Cheap
20140508T000000,330000.0,2,2.0,1550,435600,1.5,0,0,2,7,1550,0,1972,0,98065,47.5145,-121.853,1600,217800,434050,216200,0.7575757575757576,0.03344262295081967,Very Cheap
20141121T000000,481000.0,2,1.0,1620,3880,1.0,0,0,4,7,920,700,1924,0,98117,47.6855,-122.391,1330,3880,2260,2550,123.96907216494846,0.05324590163934426,Very Cheap
20141023T000000,898000.0,3,2.25,2650,12845,1.0,0,3,3,9,1770,880,1977,0,98034,47.7209,-122.256,2650,12902,10195,10252,69.91047100038925,0.10793442622950819,Cheap
20140804T000000,570000.0,5,1.75,2510,9750,1.5,0,0,3,8,2510,0,1969,0,98052,47.6635,-122.149,1900,9750,7240,7850,58.46153846153846,0.06491803278688525,Very Cheap
20150307T000000,475000.0,4,2.5,2040,16200,2.0,0,0,3,8,2040,0,1997,0,98019,47.7366,-121.958,2530,15389,14160,12859,29.320987654320987,0.05245901639344262,Very Cheap
20150209T000000,265000.0,3,2.5,1660,5250,2.0,0,0,4,8,1660,0,1988,0,98003,47.3541,-122.3,1630,5505,3590,3875,50.476190476190474,0.024918032786885248,Very Cheap
20140918T000000,380000.0,3,2.5,1980,17342,2.0,1,4,3,10,1580,400,1984,0,98166,47.4551,-122.373,2060,17313,15362,15253,21.9121208626456,0.04,Very Cheap
20140819T000000,790000.0,4,2.5,2690,8036,2.0,0,0,4,9,2690,0,1987,0,98007,47.6596,-122.144,2420,8087,5346,5667,98.30761572921851,0.09377049180327869,Very Cheap
20150312T000000,620000.0,2,2.25,2910,6110,2.0,0,2,4,9,2910,0,1985,0,98136,47.5279,-122.387,2090,5763,3200,3673,101.47299509001637,0.07147540983606557,Very Cheap
20140819T000000,709050.0,4,3.5,2720,9000,2.0,0,0,3,8,2670,50,1997,0,98125,47.7034,-122.297,1960,7772,6280,5812,78.78333333333333,0.08315409836065574,Very Cheap
20140806T000000,296500.0,3,1.0,1280,5100,1.0,0,0,3,7,1280,0,1948,0,98126,47.5259,-122.38,1380,7140,3820,5760,58.13725490196079,0.02904918032786885,Very Cheap
20140813T000000,475000.0,3,2.5,2160,35912,2.0,0,0,3,8,2160,0,1982,0,98077,47.7273,-122.083,2230,35244,33752,33014,13.226776564936511,0.05245901639344262,Very Cheap
20141022T000000,440000.0,3,2.25,1760,10835,1.0,0,0,4,8,1290,470,1976,0,98027,47.522,-122.048,2050,10488,9075,8438,40.609137055837564,0.04786885245901639,Very Cheap
20141208T000000,405000.0,2,1.0,800,6016,1.0,0,0,3,6,800,0,1942,0,98117,47.6913,-122.369,1470,3734,5216,2264,67.32047872340425,0.043278688524590166,Very Cheap
20150513T000000,269500.0,2,1.0,930,4000,1.0,0,0,3,6,730,200,1943,0,98108,47.5321,-122.323,1100,5000,3070,3900,67.375,0.025508196721311476,Very Cheap
20141119T000000,520000.0,5,1.75,2040,5280,1.0,0,0,4,7,1020,1020,1961,0,98007,47.5941,-122.144,1720,7344,3240,5624,98.48484848484848,0.058360655737704915,Very Cheap
20140804T000000,229500.0,1,1.0,1180,22000,1.0,0,2,3,6,1180,0,1948,0,98198,47.4007,-122.323,1890,11761,20820,9871,10.431818181818182,0.020262295081967214,Very Cheap
20141009T000000,335000.0,4,1.75,2000,10890,1.0,0,0,4,7,1390,610,1961,0,98003,47.3203,-122.321,1520,9250,8890,7730,30.76216712580349,0.03409836065573771,Very Cheap
20141021T000000,680000.0,4,2.75,3310,50951,2.0,0,0,3,9,3310,0,1998,0,98077,47.7249,-122.027,3230,39340,47641,36110,13.346156110773096,0.07934426229508197,Very Cheap
20150313T000000,1389000.0,4,3.5,3130,3900,2.0,0,0,3,9,2550,580,2008,0,98115,47.6849,-122.327,1830,3900,770,2070,356.15384615384613,0.17232786885245902,Cheap
20141215T000000,740000.0,4,2.5,2300,9900,1.0,0,2,3,8,1600,700,1961,0,98136,47.5256,-122.385,2510,7500,7600,4990,74.74747474747475,0.08721311475409836,Very Cheap
20150317T000000,270000.0,3,2.25,2140,9990,1.0,0,0,4,8,2140,0,1962,0,98003,47.3484,-122.298,2060,9990,7850,7930,27.027027027027028,0.025573770491803278,Very Cheap
20150504T000000,510000.0,4,2.0,2210,5572,1.5,0,3,3,7,1760,450,1911,0,98126,47.5727,-122.376,1760,4713,3362,2953,91.52907394113424,0.057049180327868855,Very Cheap
20140521T000000,300000.0,2,1.0,970,13700,1.0,0,0,3,6,970,0,1949,0,98106,47.515,-122.362,1570,10880,12730,9310,21.8978102189781,0.029508196721311476,Very Cheap
20150323T000000,1298890.0,5,2.25,2690,10800,1.0,0,3,4,8,2020,670,1956,0,98040,47.5821,-122.247,3380,9134,8110,5754,120.26759259259259,0.16051016393442624,Cheap
20140819T000000,675000.0,4,2.0,1890,5188,1.5,0,0,4,7,1670,220,1940,0,98105,47.6633,-122.287,1800,4848,3298,3048,130.10794140323824,0.07868852459016394,Very Cheap
20141104T000000,925850.0,6,3.25,3140,14923,2.0,0,0,3,10,3140,0,1991,0,98006,47.5411,-122.133,2980,10758,11783,7778,62.04181464852912,0.11158688524590164,Cheap
20140718T000000,255500.0,2,1.0,1440,43560,1.0,0,0,4,7,1150,290,1965,0,98027,47.4916,-122.082,1870,56628,42120,54758,5.865472910927457,0.023672131147540982,Very Cheap
20140514T000000,450000.0,3,2.5,2910,17172,2.0,0,0,3,10,2910,0,1989,0,98003,47.2789,-122.331,2910,20048,14262,17138,26.20545073375262,0.04918032786885246,Very Cheap
20141105T000000,280000.0,3,1.0,1310,22652,1.0,0,0,3,7,1310,0,1968,0,98092,47.2574,-122.072,1600,103672,21342,102072,12.360939431396787,0.026885245901639345,Very Cheap
20150105T000000,245000.0,4,2.25,2140,8800,2.0,0,0,4,7,2140,0,1963,0,98032,47.3655,-122.291,2060,9790,6660,7730,27.84090909090909,0.022295081967213116,Very Cheap
20150317T000000,344950.0,3,1.0,1090,6712,1.0,0,0,4,7,1090,0,1972,0,98034,47.7155,-122.211,1440,7350,5622,5910,51.3930274135876,0.03540327868852459,Very Cheap
20140811T000000,381000.0,3,1.75,1330,7216,1.0,0,0,3,7,1330,0,1969,0,98034,47.7199,-122.18,1500,8000,5886,6500,52.79933481152993,0.040131147540983604,Very Cheap
20141230T000000,1945000.0,4,4.0,4690,6900,2.0,0,0,3,11,3480,1210,2001,0,98004,47.6165,-122.216,2800,11240,2210,8440,281.8840579710145,0.24524590163934426,Cheap
20150211T000000,1500000.0,3,1.5,1910,21374,1.0,0,0,1,8,1910,0,1955,0,98004,47.6453,-122.214,2850,16167,19464,13317,70.17872181154674,0.18688524590163935,Cheap
20140619T000000,232603.0,3,1.75,1750,11461,2.0,0,0,4,7,1750,0,1976,0,98002,47.3173,-122.21,2140,11276,9711,9136,20.295174941104616,0.020669245901639346,Very Cheap
20141212T000000,220000.0,5,2.5,1760,10200,1.5,0,0,3,6,1760,0,1925,0,98106,47.5271,-122.351,1370,7620,8440,6250,21.568627450980394,0.01901639344262295,Very Cheap
20140811T000000,600000.0,4,1.75,1810,7700,1.0,0,0,5,8,1390,420,1977,0,98033,47.6976,-122.169,2080,7700,5890,5620,77.92207792207792,0.06885245901639345,Very Cheap
20141105T000000,239000.0,3,2.5,1360,5754,2.0,0,0,3,7,1360,0,1994,0,98030,47.3645,-122.183,1360,7050,4394,5690,41.53632255822037,0.021508196721311476,Very Cheap
20140826T000000,400000.0,3,1.75,1730,9211,1.0,0,0,3,8,1730,0,1961,0,98125,47.7149,-122.322,1440,9211,7481,7771,43.42633807404191,0.04262295081967213,Very Cheap
20140708T000000,2180000.0,6,2.75,4710,11000,2.0,0,3,3,10,3690,1020,1931,0,98105,47.6622,-122.272,2950,5300,6290,2350,198.1818181818182,0.2760655737704918,Cheap
20140908T000000,350000.0,3,1.0,1010,8551,1.0,0,0,5,7,1010,0,1953,0,98155,47.7351,-122.295,1310,8504,7541,7194,40.930885276575836,0.036065573770491806,Very Cheap
20140905T000000,562000.0,3,2.5,2400,97138,2.0,0,0,5,8,2400,0,1983,0,98077,47.7361,-122.046,2230,54450,94738,52220,5.785583396816899,0.0638688524590164,Very Cheap
20140910T000000,380000.0,3,1.5,1540,8400,1.0,0,0,5,7,1540,0,1968,0,98056,47.5237,-122.199,1690,7689,6860,5999,45.23809523809524,0.04,Very Cheap
20141015T000000,511200.0,4,1.75,1480,7875,1.0,0,0,3,7,740,740,1927,0,98199,47.643,-122.397,1680,5851,6395,4171,64.91428571428571,0.05720655737704918,Very Cheap
20141014T000000,680000.0,4,2.5,2520,5000,2.0,0,0,3,9,2520,0,2004,0,98029,47.5524,-121.992,2910,5001,2480,2091,136.0,0.07934426229508197,Very Cheap
20140726T000000,350000.0,3,3.25,1210,941,2.0,0,0,3,8,1000,210,2002,0,98133,47.7114,-122.356,1650,1493,-269,-157,371.9447396386823,0.036065573770491806,Very Cheap
20150219T000000,410000.0,5,2.5,2670,184140,1.0,0,0,3,8,1410,1260,1980,0,98042,47.3429,-122.097,1860,35719,181470,33859,2.226566742695775,0.043934426229508196,Very Cheap
20140522T000000,1050000.0,4,2.5,3030,12590,1.5,0,0,4,10,3030,0,1988,0,98004,47.5806,-122.193,2980,11635,9560,8655,83.39952343129468,0.12786885245901639,Cheap
20141028T000000,391265.0,3,2.0,1440,3900,1.0,0,0,3,8,1440,0,2002,0,98053,47.7022,-122.021,1350,3900,2460,2550,100.32435897435897,0.04147737704918033,Very Cheap
20140626T000000,1410000.0,4,2.25,3250,16684,2.0,0,0,3,9,3250,0,1979,0,98039,47.6334,-122.229,2890,16927,13434,14037,84.51210740829538,0.17508196721311475,Cheap
20150428T000000,575000.0,3,2.0,1750,5750,1.0,0,2,5,7,870,880,1956,0,98116,47.5579,-122.384,1750,5750,4000,4000,100.0,0.06557377049180328,Very Cheap
20150508T000000,316000.0,4,1.5,2120,46173,2.0,0,0,3,7,2120,0,1974,0,98053,47.6503,-121.968,2000,46173,44053,44173,6.843826478678015,0.03160655737704918,Very Cheap
20150416T000000,165000.0,3,1.0,1050,5156,1.5,0,0,3,7,1050,0,1919,0,98106,47.5169,-122.358,1050,5502,4106,4452,32.00155159038014,0.01180327868852459,Very Cheap
20140812T000000,850000.0,3,2.25,1950,3600,1.5,0,0,5,8,1430,520,1911,0,98119,47.637,-122.363,1950,3600,1650,1650,236.11111111111111,0.10163934426229508,Cheap
20140804T000000,210000.0,3,1.0,1020,6000,1.0,0,0,3,5,1020,0,1900,0,98027,47.5281,-122.031,2070,7200,4980,5130,35.0,0.017704918032786884,Very Cheap
20140824T000000,325000.0,4,2.5,1820,9161,1.0,0,0,4,7,1220,600,1975,0,98058,47.4333,-122.168,1860,7650,7341,5790,35.47647636720882,0.03278688524590164,Very Cheap
20150407T000000,682000.0,4,2.5,2390,53941,2.0,0,0,3,8,2390,0,1989,0,98053,47.7066,-122.08,2610,104108,51551,101498,12.64344376262954,0.07960655737704918,Very Cheap
20140718T000000,430000.0,3,2.5,1400,7508,2.0,0,0,4,7,1400,0,1987,0,98034,47.7233,-122.167,1710,7700,6108,5990,57.27224294086308,0.04655737704918033,Very Cheap
20141125T000000,325500.0,3,1.5,1540,8110,1.0,0,0,4,7,1190,350,1959,0,98125,47.7329,-122.291,1290,8110,6570,6820,40.135635018495684,0.03285245901639344,Very Cheap
20140720T000000,385000.0,3,1.75,2370,6360,1.0,0,3,3,7,1280,1090,1954,0,98178,47.5039,-122.24,1990,6360,3990,4370,60.534591194968556,0.04065573770491803,Very Cheap
20150323T000000,435000.0,1,1.0,670,1800,1.0,0,0,5,6,670,0,1905,0,98103,47.654,-122.35,1330,3360,1130,2030,241.66666666666666,0.04721311475409836,Very Cheap
20140721T000000,550000.0,4,1.0,2420,15520,2.0,0,0,4,7,2420,0,1945,0,98006,47.5744,-122.137,1630,9965,13100,8335,35.43814432989691,0.06229508196721312,Very Cheap
20141009T000000,400000.0,3,1.0,1000,7800,1.0,0,0,4,6,860,140,1930,0,98125,47.7098,-122.283,1700,7800,6800,6100,51.282051282051285,0.04262295081967213,Very Cheap
20140721T000000,503000.0,4,2.75,2100,7350,1.0,0,0,5,7,1240,860,1978,0,98034,47.7194,-122.172,2490,7350,5250,4860,68.43537414965986,0.056131147540983604,Very Cheap
20140819T000000,676000.0,4,2.5,2800,5368,2.0,0,0,3,8,2800,0,2003,0,98074,47.6076,-122.053,2790,5368,2568,2578,125.93144560357675,0.07881967213114754,Very Cheap
20141113T000000,180000.0,3,1.0,940,11055,1.5,0,0,4,7,940,0,1959,0,98032,47.3732,-122.295,1420,9100,10115,7680,16.28222523744912,0.01377049180327869,Very Cheap
20140611T000000,234000.0,3,2.0,1640,5280,1.5,0,0,5,6,1640,0,1910,0,98002,47.3089,-122.213,1160,7875,3640,6715,44.31818181818182,0.020852459016393442,Very Cheap
20140512T000000,734200.0,4,2.5,2760,5000,1.5,0,0,5,7,1680,1080,1928,0,98107,47.6726,-122.371,1850,5000,2240,3150,146.84,0.08645245901639344,Very Cheap
20140729T000000,920000.0,3,3.25,3660,66211,2.0,0,0,3,10,3660,0,2003,0,98038,47.4087,-122.062,3660,107153,62551,103493,13.894972134539579,0.11081967213114755,Cheap
20140616T000000,1920000.0,4,2.5,3070,34412,1.0,0,3,4,9,2070,1000,1950,0,98039,47.64,-122.24,3780,27940,31342,24160,55.79449029408346,0.2419672131147541,Cheap
20141209T000000,224000.0,3,1.75,1100,10125,1.0,0,0,4,7,1100,0,1969,0,98092,47.3232,-122.103,1520,10125,9025,8605,22.123456790123456,0.01954098360655738,Very Cheap
20150408T000000,1400000.0,3,2.75,3130,19530,1.0,1,4,3,8,1690,1440,1947,1984,98008,47.5895,-122.111,2980,18782,16400,15802,71.68458781362007,0.1737704918032787,Cheap
20140919T000000,185000.0,3,1.0,1320,7155,1.0,0,0,4,6,1320,0,1961,0,98002,47.2857,-122.22,1070,8100,5835,7030,25.85604472396925,0.014426229508196721,Very Cheap
20140818T000000,554600.0,3,1.75,1470,5000,1.5,0,0,5,7,1470,0,1900,0,98107,47.6755,-122.369,1530,5000,3530,3470,110.92,0.0628983606557377,Very Cheap
20140825T000000,268000.0,3,1.75,1480,8009,1.0,0,0,3,7,980,500,1980,0,98032,47.3657,-122.28,1790,7678,6529,5888,33.462354850792856,0.025311475409836064,Very Cheap
20140915T000000,675000.0,4,2.25,2260,8715,1.0,0,0,4,8,1530,730,1976,0,98008,47.6237,-122.106,2220,8650,6455,6430,77.4526678141136,0.07868852459016394,Very Cheap
20140711T000000,620000.0,4,2.25,2210,10039,1.0,0,0,4,8,1710,500,1967,0,98052,47.634,-122.101,2070,10965,7829,8895,61.759139356509614,0.07147540983606557,Very Cheap
20140521T000000,396450.0,3,1.75,1540,12446,1.0,0,0,5,8,1540,0,1967,0,98027,47.5172,-122.027,1330,11508,10906,10178,31.85360758476619,0.04215737704918033,Very Cheap
20140820T000000,565000.0,5,1.75,1910,9720,1.0,0,0,4,7,1390,520,1955,0,98006,47.5772,-122.159,1750,9720,7810,7970,58.1275720164609,0.06426229508196721,Very Cheap
20140824T000000,410000.0,3,1.75,1760,3520,1.0,0,0,3,7,1160,600,1966,0,98144,47.5773,-122.303,1840,5000,1760,3160,116.47727272727273,0.043934426229508196,Very Cheap
20140519T000000,1190000.0,4,3.0,2240,6000,1.5,0,0,4,8,1270,970,1914,0,98109,47.6369,-122.35,2240,4250,3760,2010,198.33333333333334,0.14622950819672131,Cheap
20140821T000000,716125.0,3,2.25,2110,7279,1.0,0,0,4,9,2110,0,1984,0,98033,47.6669,-122.17,2130,7279,5169,5149,98.38233273801346,0.08408196721311476,Very Cheap
20140521T000000,225000.0,2,1.0,1396,111949,1.0,0,0,3,7,1396,0,1940,1997,98053,47.6374,-122.007,2020,111949,110553,109929,2.009843768144423,0.019672131147540985,Very Cheap
20140711T000000,640000.0,4,2.75,3040,7274,2.0,0,3,3,9,2320,720,1986,0,98125,47.7184,-122.28,2830,10080,4234,7250,87.98460269452846,0.0740983606557377,Very Cheap
20140910T000000,374000.0,2,1.0,1140,5650,1.0,0,1,3,6,980,160,1920,0,98116,47.5634,-122.391,1220,5700,4510,4480,66.19469026548673,0.03921311475409836,Very Cheap
20150415T000000,415000.0,4,2.0,1780,12161,1.0,0,0,5,7,1160,620,1950,0,98155,47.7746,-122.323,1780,8170,10381,6390,34.12548310171861,0.04459016393442623,Very Cheap
20140819T000000,592500.0,4,2.5,3370,35150,1.0,0,0,5,8,1770,1600,1993,0,98027,47.461,-122.002,2920,41241,31780,38321,16.856330014224753,0.06786885245901639,Very Cheap
20140904T000000,365000.0,3,2.5,1484,1761,3.0,0,0,3,7,1484,0,2003,0,98115,47.6844,-122.317,1484,4320,277,2836,207.26859738784782,0.0380327868852459,Very Cheap
20140914T000000,600000.0,4,2.5,2230,12753,1.0,0,0,4,7,1180,1050,1981,0,98074,47.6297,-122.033,1860,12753,10523,10893,47.04775346977182,0.06885245901639345,Very Cheap
20141216T000000,465000.0,4,2.5,2820,39413,2.0,0,0,4,9,2820,0,1989,0,98092,47.3064,-122.1,2910,39413,36593,36503,11.798137670311826,0.051147540983606556,Very Cheap
20150422T000000,254999.0,3,1.0,1580,7560,1.0,0,0,4,7,1000,580,1976,0,98001,47.3318,-122.277,1580,7560,5980,5980,33.730026455026454,0.023606426229508197,Very Cheap
20140916T000000,279000.0,4,2.5,2040,8076,2.0,0,0,3,7,2040,0,1994,0,98042,47.3691,-122.074,2040,8408,6036,6368,34.54680534918276,0.02675409836065574,Very Cheap
20141231T000000,460000.0,3,2.5,2720,40813,2.0,0,0,3,8,2720,0,2001,0,98001,47.2619,-122.271,2250,40511,38093,38261,11.27091857986426,0.050491803278688525,Very Cheap
20140728T000000,507000.0,4,2.25,1490,956,2.0,0,0,3,7,1020,470,2005,0,98122,47.6184,-122.301,1510,1350,-534,-160,530.3347280334729,0.05665573770491803,Very Cheap
20140520T000000,291000.0,3,1.75,1560,9788,1.0,0,0,3,7,1560,0,1964,0,98178,47.4876,-122.226,1840,11180,8228,9340,29.73028197793216,0.028327868852459016,Very Cheap
20141202T000000,350000.0,2,1.5,830,1077,2.0,0,0,3,7,830,0,2006,0,98122,47.6058,-122.319,830,1366,247,536,324.97678737233053,0.036065573770491806,Very Cheap
20141129T000000,90000.0,3,1.0,980,2490,2.0,0,0,4,6,980,0,1969,0,98092,47.317,-122.182,980,3154,1510,2174,36.144578313253014,0.0019672131147540984,Very Cheap
20140806T000000,329000.0,3,1.75,1980,7000,1.0,0,0,4,8,1360,620,1977,0,98058,47.4442,-122.129,1880,7200,5020,5320,47.0,0.03331147540983607,Very Cheap
20140814T000000,909000.0,4,2.5,3680,11648,2.0,0,0,3,10,3680,0,1986,0,98006,47.5604,-122.107,2830,11251,7968,8421,78.03914835164835,0.10937704918032787,Cheap
20141015T000000,187000.0,2,1.0,860,5400,1.0,0,0,4,5,860,0,1953,0,98056,47.492,-122.171,960,5400,4540,4440,34.629629629629626,0.014688524590163935,Very Cheap
20140709T000000,580000.0,3,1.75,1850,5100,1.0,0,0,3,7,1020,830,1909,0,98105,47.6605,-122.326,1850,5100,3250,3250,113.72549019607843,0.06622950819672131,Very Cheap
20140903T000000,345000.0,3,2.5,1620,5992,2.0,0,0,3,7,1620,0,2001,0,98019,47.736,-121.965,1620,4644,4372,3024,57.576769025367156,0.03540983606557377,Very Cheap
20140515T000000,497000.0,4,2.5,2240,7200,2.0,0,0,3,8,2240,0,1995,0,98118,47.5636,-122.275,1860,6600,4960,4740,69.02777777777777,0.055344262295081964,Very Cheap
20140815T000000,345000.0,3,1.0,1010,3060,1.5,0,0,3,6,1010,0,1904,0,98118,47.5657,-122.285,1330,4590,2050,3260,112.74509803921569,0.03540983606557377,Very Cheap
20141119T000000,313500.0,3,1.75,1610,7350,1.0,0,0,3,8,1610,0,1974,0,98058,47.4503,-122.131,2120,7350,5740,5230,42.6530612244898,0.03127868852459016,Very Cheap
20150402T000000,910000.0,3,2.5,2720,7250,2.0,0,0,3,9,2720,0,1990,0,98033,47.6894,-122.195,2870,7250,4530,4380,125.51724137931035,0.10950819672131147,Cheap
20140604T000000,399950.0,3,1.5,2080,5244,1.0,0,0,3,7,1190,890,1959,0,98125,47.7144,-122.293,1850,6982,3164,5132,76.26811594202898,0.04261639344262295,Very Cheap
20140527T000000,268000.0,4,2.0,1930,6600,1.0,0,0,4,7,1030,900,1967,0,98168,47.482,-122.332,1220,6600,4670,5380,40.60606060606061,0.025311475409836064,Very Cheap
20141229T000000,559000.0,4,1.75,2250,8458,1.0,0,0,3,8,1450,800,1954,0,98136,47.5235,-122.383,1950,7198,6208,5248,66.09127453298652,0.06347540983606557,Very Cheap
20140709T000000,309000.0,3,2.25,1980,8755,1.0,0,0,4,7,1300,680,1963,0,98198,47.3922,-122.321,2030,8671,6775,6641,35.294117647058826,0.030688524590163933,Very Cheap
20140609T000000,410000.0,3,2.5,1960,4400,2.0,0,0,3,7,1960,0,2006,0,98065,47.5384,-121.889,2060,4400,2440,2340,93.18181818181819,0.043934426229508196,Very Cheap
20140520T000000,259000.0,3,1.0,1320,8625,1.0,0,0,4,7,1320,0,1957,0,98056,47.4902,-122.179,1370,8295,7305,6925,30.028985507246375,0.024131147540983607,Very Cheap
20141124T000000,950000.0,5,2.0,2940,5500,2.0,0,0,4,9,2340,600,1909,0,98102,47.6466,-122.321,2940,5500,2560,2560,172.72727272727272,0.11475409836065574,Cheap
20141202T000000,320000.0,4,1.0,1460,7200,1.5,0,0,4,7,1460,0,1955,0,98155,47.7602,-122.306,1690,7357,5740,5667,44.44444444444444,0.032131147540983604,Very Cheap
20150413T000000,1150000.0,4,2.5,2330,30122,1.0,0,1,3,8,1490,840,1951,0,98115,47.6843,-122.267,2430,6726,27792,4296,38.17807582497842,0.14098360655737704,Cheap
20141124T000000,394250.0,3,2.0,2620,10107,1.0,0,3,3,7,2620,0,1982,0,98198,47.4096,-122.329,1730,7812,7487,6082,39.007618482240034,0.04186885245901639,Very Cheap
20141106T000000,315000.0,1,1.0,700,3876,1.0,0,0,3,6,700,0,1910,0,98103,47.6886,-122.352,1150,3952,3176,2802,81.26934984520123,0.031475409836065574,Very Cheap
20141224T000000,480000.0,2,2.0,1140,12000,1.0,0,0,3,6,1140,0,1943,0,98027,47.5277,-122.031,1880,6125,10860,4245,40.0,0.05311475409836065,Very Cheap
20140804T000000,556000.0,3,2.5,2750,35440,2.0,0,0,3,9,2750,0,1994,0,98045,47.4745,-121.723,2710,35440,32690,32730,15.688487584650114,0.06308196721311475,Very Cheap
20141027T000000,450000.0,3,2.5,2480,5647,2.0,0,0,3,7,2480,0,2002,0,98065,47.5355,-121.88,2510,5018,3167,2508,79.68833008677174,0.04918032786885246,Very Cheap
20141001T000000,420000.0,3,1.5,1130,5413,1.0,0,0,3,7,940,190,1946,0,98125,47.7021,-122.32,1400,7168,4283,5768,77.5909846665435,0.04524590163934426,Very Cheap
20150317T000000,890000.0,6,3.75,2770,5000,1.0,0,0,3,8,1870,900,1969,0,98107,47.669,-122.365,1570,2108,2230,538,178.0,0.10688524590163935,Cheap
20141006T000000,295000.0,4,2.0,1710,8814,1.0,0,0,5,7,1030,680,1975,0,98031,47.395,-122.174,1710,7272,7104,5562,33.46948037213524,0.028852459016393443,Very Cheap
20140911T000000,410000.0,4,2.25,2150,27345,2.0,0,0,5,8,2150,0,1976,0,98059,47.469,-122.121,2200,11923,25195,9723,14.993600292558055,0.043934426229508196,Very Cheap
20140611T000000,308900.0,3,2.5,2250,7294,2.0,0,0,3,8,2250,0,1994,0,98092,47.2636,-122.212,2140,7363,5044,5223,42.34987661091308,0.030675409836065575,Very Cheap
20141022T000000,1161000.0,4,2.5,2960,26742,1.0,0,3,3,8,1480,1480,1949,1996,98115,47.6846,-122.268,2500,9460,23782,6960,43.414853040161546,0.14242622950819672,Cheap
20150128T000000,665000.0,2,2.5,2300,6984,1.0,0,0,3,8,2300,0,2006,0,98053,47.7087,-122.015,1820,4950,4684,3130,95.21764032073311,0.07737704918032787,Very Cheap
20140903T000000,577000.0,3,1.75,1740,5500,1.0,0,0,5,7,970,770,1953,0,98116,47.577,-122.395,1740,7250,3760,5510,104.9090909090909,0.06583606557377049,Very Cheap
20140917T000000,959000.0,3,2.5,2830,3750,3.0,0,0,3,10,2830,0,2014,0,98117,47.6799,-122.385,1780,5000,920,3220,255.73333333333332,0.1159344262295082,Cheap
20140626T000000,471000.0,2,1.75,1240,6417,1.0,0,0,5,7,1240,0,1924,0,98126,47.5439,-122.379,1800,6417,5177,4617,73.39878447872837,0.051934426229508196,Very Cheap
20150421T000000,560000.0,3,2.5,2180,7169,2.0,0,0,3,8,2180,0,1990,0,98029,47.5714,-122.002,2150,5914,4989,3764,78.11410238526992,0.06360655737704918,Very Cheap
20140514T000000,955000.0,5,2.25,2510,9887,2.0,0,0,3,8,2510,0,1972,0,98040,47.5339,-122.223,2510,10006,7377,7496,96.59148376656215,0.11540983606557377,Cheap
20140620T000000,1240000.0,7,5.5,6630,13782,2.0,0,0,3,10,4930,1700,2004,0,98006,47.5399,-122.118,4470,8639,7152,4169,89.97242780438253,0.15278688524590164,Cheap
20141231T000000,579000.0,3,2.5,2300,18540,1.0,0,0,3,8,1800,500,1961,0,98177,47.7767,-122.369,2460,18540,16240,16080,31.22977346278317,0.06609836065573771,Very Cheap
20150428T000000,335000.0,4,2.25,3220,7889,2.0,0,0,3,8,3220,0,1978,0,98023,47.3112,-122.339,2120,7651,4669,5531,42.46419064520218,0.03409836065573771,Very Cheap
20140915T000000,485000.0,3,2.5,2270,7887,2.0,0,2,3,8,2270,0,2004,0,98065,47.5326,-121.855,2550,7133,5617,4583,61.49359705845062,0.05377049180327869,Very Cheap
20140702T000000,552000.0,3,2.5,1840,9900,1.0,0,0,3,9,1840,0,1978,0,98007,47.6131,-122.151,2730,9900,8060,7170,55.75757575757576,0.06255737704918032,Very Cheap
20140714T000000,950000.0,4,3.25,3820,15293,2.0,0,0,3,10,3820,0,2003,0,98074,47.6097,-122.017,2790,7142,11473,4352,62.11992414830315,0.11475409836065574,Cheap
20150316T000000,203700.0,3,2.0,1660,7958,1.0,0,0,3,7,1130,530,1983,0,98092,47.3187,-122.171,1550,7647,6298,6097,25.596883639105304,0.016878688524590162,Very Cheap
20140709T000000,412000.0,4,3.5,3360,9767,2.0,0,0,3,9,2450,910,1990,0,98023,47.3047,-122.347,2580,8757,6407,6177,42.182860653220025,0.04419672131147541,Very Cheap
20150106T000000,237500.0,3,2.0,1350,8960,1.0,0,0,4,7,1350,0,1986,0,98038,47.3614,-122.045,1470,8288,7610,6818,26.506696428571427,0.021311475409836064,Very Cheap
20140815T000000,866800.0,4,3.5,2970,5000,2.0,0,2,3,9,2200,770,2001,0,98117,47.6772,-122.399,1470,4560,2030,3090,173.36,0.10384262295081967,Cheap
20150310T000000,425000.0,3,1.0,1000,5100,1.0,0,0,3,7,860,140,1946,0,98115,47.6857,-122.293,1000,5100,4100,4100,83.33333333333333,0.04590163934426229,Very Cheap
20140625T000000,200000.0,3,2.0,1190,6833,1.0,0,0,3,7,1190,0,1995,0,98092,47.3191,-122.18,1540,8000,5643,6460,29.26972047416947,0.01639344262295082,Very Cheap
20140929T000000,280000.0,3,1.75,1670,6034,1.0,0,0,3,7,990,680,1957,0,98118,47.5209,-122.286,1230,6034,4364,4804,46.403712296983755,0.026885245901639345,Very Cheap
20141126T000000,140000.0,3,1.5,1200,2002,2.0,0,0,3,8,1200,0,1966,0,98055,47.4659,-122.189,1270,1848,802,578,69.93006993006993,0.008524590163934427,Very Cheap
20141114T000000,370000.0,5,2.5,2250,10400,1.0,0,0,3,8,1280,970,1973,0,98058,47.4501,-122.139,2140,9592,8150,7452,35.57692307692308,0.038688524590163934,Very Cheap
20140916T000000,550000.0,2,0.75,1040,4000,1.0,0,0,3,7,930,110,1909,0,98119,47.6489,-122.372,1700,4800,2960,3100,137.5,0.06229508196721312,Very Cheap
20140702T000000,1411600.0,2,2.5,3180,9400,2.0,0,4,5,10,2610,570,1985,0,98006,47.5617,-122.158,3760,9450,6220,5690,150.17021276595744,0.1752918032786885,Cheap
20150322T000000,1505000.0,2,2.5,3180,9400,2.0,0,4,5,10,2610,570,1985,0,98006,47.5617,-122.158,3760,9450,6220,5690,160.10638297872342,0.18754098360655738,Cheap
20140528T000000,510000.0,4,1.5,2040,8800,1.0,0,0,4,7,1020,1020,1961,0,98007,47.5965,-122.139,1490,8800,6760,7310,57.95454545454545,0.057049180327868855,Very Cheap
20140716T000000,351000.0,3,1.0,1160,10518,1.0,0,0,3,7,1160,0,1960,0,98028,47.7343,-122.22,1670,9380,9358,7710,33.37136337706789,0.03619672131147541,Very Cheap
20150325T000000,210000.0,3,1.0,880,10800,1.0,0,0,3,6,880,0,1942,0,98146,47.4949,-122.338,1100,8820,9920,7720,19.444444444444443,0.017704918032786884,Very Cheap
20150507T000000,449999.0,4,1.75,2290,36900,1.5,0,2,5,7,1690,600,1938,0,98022,47.2034,-122.003,2170,12434,34610,10264,12.195094850948509,0.04918019672131148,Very Cheap
20140519T000000,137000.0,3,1.0,950,7620,1.0,0,0,3,6,950,0,1954,0,98106,47.5178,-122.346,1260,7620,6670,6360,17.979002624671917,0.008131147540983607,Very Cheap
20141217T000000,270000.0,3,1.0,1010,14510,1.0,0,0,5,7,1010,0,1974,0,98042,47.3437,-122.078,2020,44866,13500,42846,18.607856650585802,0.025573770491803278,Very Cheap
20141229T000000,540000.0,3,2.5,3100,100188,1.0,0,0,4,7,1820,1280,1981,0,98038,47.3928,-122.066,2430,104979,97088,102549,5.389867049946101,0.06098360655737705,Very Cheap
20141205T000000,565000.0,5,3.0,2560,12480,1.0,0,0,3,8,1590,970,2012,0,98155,47.7657,-122.284,2500,17299,9920,14799,45.2724358974359,0.06426229508196721,Very Cheap
20150409T000000,940000.0,4,1.5,2430,3600,2.5,0,0,3,8,2430,0,1980,0,98112,47.6351,-122.285,2020,4800,1170,2780,261.1111111111111,0.11344262295081967,Cheap
20140616T000000,385000.0,2,1.0,830,26329,1.0,1,3,4,6,830,0,1928,0,98070,47.4012,-122.425,2030,27338,25499,25308,14.622659424968665,0.04065573770491803,Very Cheap
20140822T000000,400000.0,3,3.0,2090,7634,1.0,0,0,3,8,1450,640,2001,0,98019,47.7408,-121.974,2090,9600,5544,7510,52.39717055279015,0.04262295081967213,Very Cheap
20150321T000000,365000.0,3,2.0,2030,8649,1.0,0,0,3,7,2030,0,1998,0,98056,47.5082,-122.166,1760,7200,6619,5440,42.20141056769569,0.0380327868852459,Very Cheap
20140522T000000,353250.0,2,1.0,1060,1600,2.0,0,0,3,7,1060,0,1979,0,98144,47.5888,-122.294,1360,3360,540,2000,220.78125,0.03649180327868853,Very Cheap
20150429T000000,455000.0,2,1.5,1090,6750,1.0,0,0,3,7,950,140,1942,0,98117,47.6836,-122.397,1640,6750,5660,5110,67.4074074074074,0.049836065573770495,Very Cheap
20140527T000000,475000.0,4,3.5,3400,234352,2.0,0,0,3,8,2500,900,1991,0,98070,47.4335,-122.449,1300,39639,230952,38339,2.026865569741244,0.05245901639344262,Very Cheap
20141124T000000,571500.0,4,1.75,1920,7455,1.0,0,0,4,7,960,960,1939,1964,98125,47.7106,-122.286,1920,7455,5535,5535,76.65995975855131,0.06511475409836065,Very Cheap
20150328T000000,441000.0,2,1.0,1150,3000,1.0,0,0,3,6,780,370,1915,0,98118,47.5624,-122.291,1150,5000,1850,3850,147.0,0.048,Very Cheap
20150213T000000,810000.0,6,2.75,3970,9500,1.0,0,0,4,10,2180,1790,1970,0,98005,47.5956,-122.178,2490,9775,5530,7285,85.26315789473684,0.09639344262295083,Very Cheap
20150409T000000,550000.0,3,2.25,1880,11556,2.0,0,0,3,8,1880,0,1987,0,98074,47.6283,-122.032,1880,12000,9676,10120,47.59432329525787,0.06229508196721312,Very Cheap
20140702T000000,736000.0,2,1.0,1500,4000,1.0,0,0,3,8,1100,400,1933,0,98109,47.6409,-122.353,1980,4000,2500,2020,184.0,0.08668852459016393,Very Cheap
20150224T000000,375000.0,3,1.75,2190,17550,1.0,0,0,3,7,2190,0,1989,0,98014,47.6984,-121.912,1700,17550,15360,15850,21.367521367521366,0.03934426229508197,Very Cheap
20150205T000000,717500.0,3,2.5,2530,9932,2.0,0,0,3,8,2530,0,1995,0,98052,47.6853,-122.16,2140,7950,7402,5810,72.24124043495772,0.08426229508196721,Very Cheap
20141121T000000,581000.0,2,1.75,1930,11200,1.0,0,2,3,8,1430,500,1951,0,98177,47.7576,-122.37,2840,12408,9270,9568,51.875,0.06636065573770492,Very Cheap
20140725T000000,629000.0,3,2.0,1510,4560,2.0,0,0,4,7,1510,0,1909,1995,98116,47.5689,-122.408,1990,5000,3050,3010,137.93859649122808,0.07265573770491804,Very Cheap
20140911T000000,3800000.0,3,4.25,5510,35000,2.0,0,4,3,13,4910,600,1997,0,98177,47.7296,-122.37,3430,45302,29490,41872,108.57142857142857,0.4885245901639344,High
20141208T000000,225000.0,3,2.0,1100,5200,1.0,0,0,3,6,1100,0,1969,2014,98042,47.3606,-122.083,1050,5330,4100,4280,43.26923076923077,0.019672131147540985,Very Cheap
20140618T000000,315000.0,3,2.5,1730,6368,2.0,0,0,3,7,1730,0,1993,0,98038,47.3505,-122.032,1780,6597,4638,4817,49.46608040201005,0.031475409836065574,Very Cheap
20150310T000000,425000.0,3,2.5,1480,1386,3.0,0,0,3,8,1480,0,2005,0,98029,47.5468,-121.998,1470,1593,-94,123,306.63780663780665,0.04590163934426229,Very Cheap
20140625T000000,346500.0,3,1.0,1150,11802,1.0,0,0,4,7,1150,0,1932,1958,98106,47.5624,-122.361,1880,6082,10652,4202,29.359430604982208,0.03560655737704918,Very Cheap
20150105T000000,550000.0,3,2.25,1950,26500,1.0,0,0,4,8,1570,380,1965,0,98006,47.5784,-122.179,2160,12751,24550,10591,20.754716981132077,0.06229508196721312,Very Cheap
20150209T000000,565000.0,3,1.75,2380,10450,1.0,0,0,3,8,1400,980,1977,0,98052,47.6409,-122.111,2150,9600,8070,7450,54.066985645933016,0.06426229508196721,Very Cheap
20141224T000000,1001000.0,4,2.0,3100,8000,1.5,0,0,5,7,2040,1060,1939,0,98103,47.6852,-122.329,1650,4000,4900,2350,125.125,0.12144262295081967,Cheap
20140805T000000,400000.0,2,2.0,2010,3797,1.5,0,0,3,7,1450,560,1922,2004,98108,47.5596,-122.315,1660,4650,1787,2990,105.34632604687911,0.04262295081967213,Very Cheap
20141121T000000,724950.0,4,2.0,2270,5760,2.0,0,0,4,8,2270,0,1909,0,98116,47.5809,-122.39,1420,5760,3490,4340,125.859375,0.08523934426229508,Very Cheap
20140708T000000,623000.0,3,1.75,2050,16313,1.0,0,0,2,8,2050,0,1973,0,98040,47.5743,-122.212,3180,10264,14263,7084,38.19040029424386,0.07186885245901639,Very Cheap
20140624T000000,295000.0,2,1.0,650,5400,1.0,0,0,3,6,650,0,1950,0,98122,47.6185,-122.295,1310,4906,4750,3596,54.629629629629626,0.028852459016393443,Very Cheap
20140521T000000,700000.0,4,3.25,2780,7875,2.0,0,0,3,9,2780,0,2006,0,98133,47.7294,-122.352,1000,7500,5095,6500,88.88888888888889,0.08196721311475409,Very Cheap
20150408T000000,482000.0,2,1.5,1300,1229,2.0,0,0,3,8,1160,140,2000,0,98107,47.6727,-122.375,1430,1255,-71,-175,392.1887713588283,0.05337704918032787,Very Cheap
20140821T000000,770000.0,3,2.5,2730,11380,2.0,0,0,3,10,2730,0,1995,0,98075,47.58,-122.057,2800,10070,8650,7270,67.66256590509666,0.09114754098360656,Very Cheap
20141017T000000,310000.0,4,2.5,3140,22100,1.0,0,0,4,8,1820,1320,1960,0,98023,47.319,-122.362,2700,25500,18960,22800,14.027149321266968,0.03081967213114754,Very Cheap
20140708T000000,720000.0,4,2.25,2410,8400,2.0,0,0,5,8,2410,0,1965,0,98008,47.626,-122.119,1910,8056,5990,6146,85.71428571428571,0.08459016393442623,Very Cheap
20150319T000000,355000.0,3,1.0,1180,5965,1.5,0,0,4,6,1180,0,1928,0,98125,47.7281,-122.299,1270,7710,4785,6440,59.5138306789606,0.036721311475409836,Very Cheap
20140729T000000,512000.0,4,2.5,2600,4506,2.0,0,0,3,9,2600,0,2005,0,98056,47.5146,-122.188,2470,6041,1906,3571,113.62627607634265,0.05731147540983607,Very Cheap
20141216T000000,303000.0,2,1.5,1400,1650,3.0,0,0,3,7,1400,0,1999,0,98125,47.7222,-122.29,1430,1650,250,220,183.63636363636363,0.029901639344262296,Very Cheap
20140618T000000,299000.0,5,2.5,2220,9360,1.0,0,0,4,7,1110,1110,1968,0,98058,47.4341,-122.169,1780,7704,7140,5924,31.944444444444443,0.02937704918032787,Very Cheap
20140623T000000,285000.0,3,2.5,1660,6263,2.0,0,0,3,8,1660,0,2003,0,98042,47.3507,-122.141,2190,6192,4603,4002,45.50534887434137,0.02754098360655738,Very Cheap
20140924T000000,680000.0,3,1.75,2330,9652,1.0,0,0,4,8,1590,740,1968,0,98040,47.5714,-122.211,2420,9631,7322,7211,70.45171985080812,0.07934426229508197,Very Cheap
20140902T000000,285000.0,4,1.75,1440,6720,1.0,0,0,5,6,720,720,1954,0,98166,47.4571,-122.345,1820,6784,5280,4964,42.410714285714285,0.02754098360655738,Very Cheap
20141125T000000,707000.0,4,2.25,2920,17023,1.0,0,0,4,9,1690,1230,1977,0,98006,47.5585,-122.134,2710,10681,14103,7971,41.53204488045586,0.08288524590163934,Very Cheap
20140507T000000,690000.0,3,2.0,1760,6428,1.0,0,0,4,7,980,780,1942,0,98199,47.6388,-122.397,1760,6004,4668,4244,107.3428749222153,0.08065573770491803,Very Cheap
20150422T000000,872000.0,4,2.25,2860,40284,2.0,0,0,3,10,2860,0,1983,0,98072,47.7308,-122.115,2670,92782,37424,90112,21.646311190547117,0.10452459016393442,Cheap
20141104T000000,290000.0,4,1.75,2090,12750,1.0,0,0,3,8,1360,730,1967,0,98166,47.4792,-122.357,2040,12300,10660,10260,22.745098039215687,0.02819672131147541,Very Cheap
20150417T000000,425000.0,4,1.75,1910,16785,1.0,0,0,4,7,1110,800,1981,0,98028,47.7474,-122.235,1590,9900,14875,8310,25.32022639261245,0.04590163934426229,Very Cheap
20150126T000000,925000.0,3,2.75,3280,10558,1.0,0,2,4,9,2040,1240,1979,0,98006,47.5606,-122.133,3150,9998,7278,6848,87.61129001704869,0.11147540983606558,Cheap
20141219T000000,340500.0,3,1.0,1770,12458,1.0,0,0,3,7,1770,0,1957,0,98155,47.7715,-122.27,2000,8225,10688,6225,27.331834965484028,0.03481967213114754,Very Cheap
20141121T000000,365000.0,2,1.0,920,6600,1.0,0,0,4,6,920,0,1910,0,98118,47.5572,-122.282,1370,5500,5680,4130,55.303030303030305,0.0380327868852459,Very Cheap
20140710T000000,725000.0,3,1.75,1690,8489,1.0,0,0,4,7,1690,0,1959,0,98004,47.6079,-122.192,1850,8536,6799,6686,85.40464130050654,0.08524590163934426,Very Cheap
20140702T000000,811000.0,3,3.0,2470,7410,2.0,0,0,5,8,1860,610,1977,0,98117,47.6937,-122.392,2390,7800,4940,5410,109.44669365721997,0.09652459016393443,Very Cheap
20141210T000000,299000.0,3,1.0,1040,9514,1.0,0,0,4,7,1040,0,1969,0,98059,47.4936,-122.102,1040,9514,8474,8474,31.427370191297037,0.02937704918032787,Very Cheap
20150421T000000,287500.0,4,2.0,1220,9147,1.0,0,0,5,7,1220,0,1953,0,98146,47.5011,-122.336,1220,8576,7927,7356,31.431070296272,0.027868852459016394,Very Cheap
20140520T000000,879950.0,4,2.25,3500,13875,1.0,0,4,4,9,1830,1670,1938,0,98146,47.5083,-122.388,2960,15000,10375,12040,63.41981981981982,0.1055672131147541,Cheap
20141110T000000,135900.0,2,1.0,760,3800,1.0,0,0,3,6,760,0,1950,0,98178,47.5019,-122.269,1220,7410,3040,6190,35.76315789473684,0.00798688524590164,Very Cheap
20140512T000000,1225000.0,4,2.25,3070,16028,1.0,0,3,3,9,1870,1200,1976,0,98040,47.5271,-122.228,3070,19822,12958,16752,76.42874968804593,0.15081967213114755,Cheap
20141017T000000,522500.0,4,1.75,2100,6480,1.0,0,0,5,7,1300,800,1947,0,98177,47.7049,-122.359,1840,7500,4380,5660,80.63271604938272,0.05868852459016394,Very Cheap
20150312T000000,399500.0,4,1.5,1660,6617,1.0,0,0,5,7,1660,0,1947,0,98155,47.739,-122.323,950,7440,4957,6490,60.374792201904185,0.04255737704918033,Very Cheap
20150504T000000,450000.0,3,1.0,1430,5960,1.5,0,0,4,7,1430,0,1917,0,98118,47.562,-122.289,1140,3960,4530,2820,75.50335570469798,0.04918032786885246,Very Cheap
20141027T000000,218000.0,4,1.0,1620,17500,1.0,0,0,3,7,1620,0,1962,0,98023,47.3021,-122.388,2400,17394,15880,14994,12.457142857142857,0.018754098360655738,Very Cheap
20150327T000000,289999.0,3,2.0,1490,9285,1.0,0,0,3,8,1490,0,1995,0,98092,47.3248,-122.169,2040,6681,7795,4641,31.23306408185245,0.028196590163934426,Very Cheap
20150224T000000,540000.0,2,1.0,1170,4750,1.0,0,0,3,6,1170,0,1903,0,98107,47.6729,-122.378,1170,2023,3580,853,113.6842105263158,0.06098360655737705,Very Cheap
20140725T000000,324950.0,3,1.0,1240,7500,1.0,0,0,4,7,1240,0,1976,0,98074,47.6199,-122.062,1240,9750,6260,8510,43.32666666666667,0.03278032786885246,Very Cheap
20140613T000000,718500.0,3,2.0,2910,6600,2.0,0,0,4,7,1920,990,1900,1988,98118,47.5576,-122.281,1370,5500,3690,4130,108.86363636363636,0.08439344262295082,Very Cheap
20140709T000000,495000.0,3,2.0,2660,192099,1.0,0,0,4,9,2660,0,1964,0,98022,47.2098,-122.016,2570,43561,189439,40991,2.5767963393875033,0.05508196721311476,Very Cheap
20140521T000000,260000.0,6,2.0,2220,8797,1.0,0,0,3,7,2220,0,1977,0,98002,47.2977,-122.227,1170,5123,6577,3953,29.555530294418553,0.024262295081967214,Very Cheap
20140502T000000,430000.0,4,1.5,1920,10000,1.0,0,0,4,7,1070,850,1954,0,98006,47.5725,-122.133,1450,10836,8080,9386,43.0,0.04655737704918033,Very Cheap
20140603T000000,402500.0,3,3.25,2780,4002,2.0,0,0,3,8,2780,0,2009,0,98019,47.7348,-121.966,1890,4090,1222,2200,100.57471264367815,0.04295081967213115,Very Cheap
20140811T000000,1415000.0,4,3.0,3110,4408,2.5,0,3,4,10,2510,600,1931,0,98105,47.6583,-122.27,3250,5669,1298,2419,321.00725952813065,0.17573770491803278,Cheap
20141028T000000,275000.0,3,2.25,1820,9766,1.0,0,0,4,7,1450,370,1987,0,98031,47.397,-122.203,1860,8236,7946,6376,28.158918697522015,0.02622950819672131,Very Cheap
20140603T000000,250000.0,3,2.25,1765,7652,2.0,0,0,3,7,1765,0,1996,0,98003,47.3072,-122.328,1765,7719,5887,5954,32.67119707266074,0.022950819672131147,Very Cheap
20140523T000000,665000.0,3,2.75,1800,9550,1.0,0,0,4,7,1320,480,1966,0,98006,47.5679,-122.178,1890,9902,7750,8012,69.63350785340315,0.07737704918032787,Very Cheap
20150203T000000,425000.0,3,2.5,2650,144183,1.0,0,0,3,8,2650,0,1967,0,98042,47.4212,-122.144,1940,41210,141533,39270,2.947642926003759,0.04590163934426229,Very Cheap
20140722T000000,760000.0,2,1.0,1410,3600,1.5,0,0,4,7,1310,100,1925,0,98103,47.6695,-122.338,1740,4200,2190,2460,211.11111111111111,0.0898360655737705,Very Cheap
20140814T000000,447000.0,3,2.5,1650,3076,2.0,0,0,3,7,1650,0,2003,0,98053,47.682,-122.035,1560,3064,1426,1504,145.3185955786736,0.04878688524590164,Very Cheap
20140708T000000,205000.0,3,1.0,1180,8240,1.0,0,0,4,7,1180,0,1967,0,98003,47.3325,-122.321,1180,7840,7060,6660,24.87864077669903,0.017049180327868854,Very Cheap
20140506T000000,191000.0,3,1.5,800,8850,1.0,0,0,4,6,800,0,1959,0,98023,47.3266,-122.348,820,8775,8050,7955,21.581920903954803,0.01521311475409836,Very Cheap
20150316T000000,350000.0,2,1.75,1430,7921,1.0,0,0,3,7,1430,0,1983,0,98146,47.5088,-122.371,1290,8040,6491,6750,44.18634010857215,0.036065573770491806,Very Cheap
20150330T000000,789888.0,5,3.5,3300,7860,2.0,0,0,3,9,2410,890,2001,0,98006,47.5463,-122.192,2540,9920,4560,7380,100.49465648854962,0.09375580327868853,Very Cheap
20150323T000000,443000.0,2,1.0,1220,10170,1.0,0,0,3,7,980,240,1948,0,98125,47.7297,-122.327,1990,9064,8950,7074,43.55948869223206,0.048262295081967214,Very Cheap
20140929T000000,695000.0,4,3.5,3530,7202,2.0,0,0,3,9,2660,870,2000,0,98177,47.7339,-122.36,2810,8100,3672,5290,96.50097195223549,0.08131147540983606,Very Cheap
20150213T000000,560000.0,4,2.0,1380,4048,1.5,0,0,4,7,1380,0,1906,0,98103,47.6583,-122.344,1440,3956,2668,2516,138.3399209486166,0.06360655737704918,Very Cheap
20140714T000000,550000.0,3,1.75,1410,5000,1.0,0,0,4,7,810,600,1923,0,98107,47.6727,-122.395,1760,5000,3590,3240,110.0,0.06229508196721312,Very Cheap
20140724T000000,850000.0,2,2.5,3360,6750,2.0,0,0,3,9,3360,0,2004,0,98053,47.7112,-122.033,2510,6750,3390,4240,125.92592592592592,0.10163934426229508,Cheap
20150420T000000,352750.0,4,2.75,2270,24237,1.0,0,0,4,7,1360,910,1977,0,98058,47.4672,-122.175,2050,8016,21967,5966,14.554194000907703,0.03642622950819672,Very Cheap
20140818T000000,550000.0,4,2.5,2890,9045,2.0,0,0,3,8,2890,0,2001,0,98019,47.7385,-121.965,2840,10114,6155,7274,60.807075732448865,0.06229508196721312,Very Cheap
20141118T000000,774900.0,5,1.0,1750,3861,1.5,0,0,3,7,1750,0,1903,0,98122,47.6075,-122.295,1700,4255,2111,2555,200.6993006993007,0.09179016393442622,Very Cheap
20140710T000000,250000.0,3,1.0,1010,8711,1.0,0,0,5,6,1010,0,1944,0,98056,47.4914,-122.186,1250,8053,7701,6803,28.699345654919068,0.022950819672131147,Very Cheap
20140825T000000,962800.0,4,2.5,3780,23623,2.0,0,0,3,9,3780,0,1997,0,98006,47.559,-122.118,3370,10210,19843,6840,40.75688947212463,0.1164327868852459,Cheap
20141104T000000,299500.0,3,1.75,1880,11700,1.0,0,0,4,7,1880,0,1968,0,98092,47.3213,-122.187,2230,35200,9820,32970,25.5982905982906,0.02944262295081967,Very Cheap
20141103T000000,250000.0,2,1.0,800,5220,1.0,0,0,3,6,800,0,1943,0,98125,47.7037,-122.32,1910,5376,4420,3466,47.89272030651341,0.022950819672131147,Very Cheap
20150116T000000,745000.0,5,4.0,4720,493534,2.0,0,0,5,9,3960,760,1975,0,98027,47.4536,-122.009,2160,219542,488814,217382,1.5095211272171725,0.08786885245901639,Very Cheap
20150217T000000,279475.0,2,1.0,1060,10600,1.5,0,0,3,6,1060,0,1968,0,98065,47.5375,-121.742,1560,21344,9540,19784,26.36556603773585,0.02681639344262295,Very Cheap
20141202T000000,450000.0,3,2.25,2530,27227,2.0,0,0,3,8,2530,0,1987,0,98056,47.527,-122.193,2160,30192,24697,28032,16.527711462886106,0.04918032786885246,Very Cheap
20140826T000000,307700.0,5,2.25,1980,13132,1.0,0,0,4,7,1260,720,1962,0,98198,47.3984,-122.301,1880,11325,11152,9445,23.43131282363692,0.030518032786885245,Very Cheap
20141211T000000,665000.0,3,1.0,1650,5102,1.0,0,0,4,8,1300,350,1953,0,98199,47.6524,-122.404,1440,5102,3452,3662,130.34104272834182,0.07737704918032787,Very Cheap
20140724T000000,375000.0,3,2.75,1890,3930,2.0,0,0,3,8,1890,0,1999,0,98065,47.5337,-121.867,2100,4259,2040,2159,95.41984732824427,0.03934426229508197,Very Cheap
20150303T000000,420000.0,4,2.5,3360,11637,2.0,0,0,3,11,3360,0,1990,0,98023,47.3018,-122.342,3530,11205,8277,7675,36.09177623098737,0.04524590163934426,Very Cheap
20140708T000000,148000.0,2,1.0,630,4200,1.0,0,0,3,6,630,0,1930,0,98106,47.5329,-122.348,970,4200,3570,3230,35.23809523809524,0.00957377049180328,Very Cheap
20140729T000000,707000.0,3,1.5,1980,4000,2.0,0,0,3,8,1980,0,1919,0,98109,47.6364,-122.351,1980,3600,2020,1620,176.75,0.08288524590163934,Very Cheap
20141112T000000,399000.0,3,1.0,990,4250,1.0,0,0,4,7,840,150,1924,0,98136,47.5392,-122.39,990,4500,3260,3510,93.88235294117646,0.042491803278688525,Very Cheap
20141022T000000,570000.0,4,2.5,3420,115434,2.0,0,0,3,9,3420,0,1989,0,98038,47.3932,-121.988,3250,111513,112014,108263,4.9378865845418165,0.06491803278688525,Very Cheap
20150323T000000,853000.0,4,2.25,3440,35025,2.0,0,0,3,10,3440,0,1988,0,98053,47.6674,-122.055,3210,35005,31585,31795,24.354032833690223,0.1020327868852459,Cheap
20141222T000000,400000.0,3,1.0,1300,14138,1.0,0,0,4,7,1300,0,1943,0,98005,47.593,-122.165,2440,12196,12838,9756,28.292544914415053,0.04262295081967213,Very Cheap
20140512T000000,615000.0,2,1.75,2040,28593,1.5,1,3,4,7,2040,0,1919,1990,98070,47.3979,-122.465,2040,35124,26553,33084,21.508760885531423,0.07081967213114754,Very Cheap
20150106T000000,463000.0,3,1.0,1250,7700,1.0,0,0,4,7,1250,0,1955,0,98007,47.5974,-122.149,1520,7700,6450,6180,60.12987012987013,0.05088524590163934,Very Cheap
20140603T000000,600000.0,4,2.5,1960,14242,1.0,0,1,4,8,1290,670,1958,0,98146,47.4947,-122.369,2490,10907,12282,8417,42.12891447830361,0.06885245901639345,Very Cheap
20141028T000000,429000.0,5,2.5,2720,8120,1.0,0,0,3,7,1360,1360,1970,0,98108,47.557,-122.308,2020,8120,5400,6100,52.83251231527094,0.04642622950819672,Very Cheap
20140904T000000,980000.0,4,4.25,3250,11780,2.0,0,0,3,8,2360,890,1944,2001,98004,47.6322,-122.203,1800,9000,8530,7200,83.1918505942275,0.11868852459016394,Cheap
20150421T000000,359500.0,6,3.75,3190,4700,2.0,0,0,3,8,3190,0,2003,0,98042,47.3724,-122.105,2680,5640,1510,2960,76.48936170212765,0.037311475409836065,Very Cheap
20141107T000000,715000.0,4,2.5,2570,7980,2.0,0,0,3,9,2570,0,1998,0,98074,47.6378,-122.065,2760,6866,5410,4106,89.59899749373433,0.0839344262295082,Very Cheap
20150325T000000,240000.0,3,1.75,1420,6984,1.0,0,0,4,7,980,440,1980,0,98030,47.3748,-122.18,1430,7875,5564,6445,34.36426116838488,0.021639344262295083,Very Cheap
20141215T000000,455000.0,4,2.0,2120,9442,1.0,0,0,5,7,1060,1060,1968,0,98011,47.7675,-122.226,1290,9600,7322,8310,48.188943020546496,0.049836065573770495,Very Cheap
20141017T000000,610000.0,3,2.5,2080,167270,1.0,0,0,3,7,2080,0,2000,0,98038,47.4032,-121.963,2080,55321,165190,53241,3.6467985891074313,0.07016393442622951,Very Cheap
20150311T000000,675000.0,3,2.75,2740,5735,2.0,0,0,3,9,2740,0,2004,0,98052,47.6862,-122.093,2210,5026,2995,2816,117.69834350479512,0.07868852459016394,Very Cheap
20150129T000000,283500.0,3,1.75,1250,5375,1.0,0,0,3,7,1250,0,1985,0,98198,47.3787,-122.323,1320,6258,4125,4938,52.74418604651163,0.027344262295081967,Very Cheap
20140826T000000,235000.0,2,1.0,2150,4500,1.5,0,0,3,7,1260,890,1917,0,98118,47.5158,-122.267,1590,5010,2350,3420,52.22222222222222,0.02098360655737705,Very Cheap
20140626T000000,827000.0,4,2.5,3230,12100,1.0,0,0,3,9,1870,1360,1977,0,98006,47.562,-122.146,2670,10200,8870,7530,68.34710743801652,0.09862295081967214,Very Cheap
20140910T000000,353000.0,2,1.0,860,8511,1.0,0,0,3,7,860,0,1949,0,98125,47.7312,-122.3,1554,8499,7651,6945,41.47573728116555,0.03645901639344262,Very Cheap
20140923T000000,747500.0,4,2.5,2810,11902,2.0,0,0,4,9,2810,0,1993,0,98059,47.5303,-122.143,2990,10754,9092,7764,62.80457066039321,0.0881967213114754,Very Cheap
20150412T000000,341000.0,2,1.0,1040,4000,1.0,0,0,3,6,1040,0,1914,0,98144,47.5753,-122.303,1740,4000,2960,2260,85.25,0.03488524590163934,Very Cheap
20141124T000000,182000.0,3,1.0,1160,18055,1.0,0,0,2,5,1160,0,1950,0,98168,47.4772,-122.269,1340,10324,16895,8984,10.080310163389642,0.014032786885245901,Very Cheap
20141202T000000,250000.0,3,2.0,1470,2781,2.0,0,0,3,6,1470,0,2003,0,98038,47.349,-122.024,1360,3008,1311,1648,89.89572096368212,0.022950819672131147,Very Cheap
20140521T000000,655000.0,4,3.5,2350,13402,2.0,0,3,3,8,1670,680,1994,0,98033,47.6947,-122.19,2250,9474,11052,7224,48.87330249216535,0.0760655737704918,Very Cheap
20140507T000000,405000.0,3,2.25,1660,8307,1.0,0,0,4,8,1660,0,1961,0,98133,47.7575,-122.352,2510,7800,6647,5290,48.75406283856988,0.043278688524590166,Very Cheap
20140818T000000,390000.0,4,1.75,2020,9750,1.0,0,0,3,7,1100,920,1975,0,98074,47.6192,-122.055,1670,9600,7730,7930,40.0,0.04131147540983607,Very Cheap
20141008T000000,275400.0,2,1.0,890,8180,1.0,0,0,3,7,890,0,1947,0,98155,47.737,-122.3,1130,8180,7290,7050,33.66748166259169,0.026281967213114755,Very Cheap
20140604T000000,791000.0,3,2.25,2430,5500,2.0,0,0,3,8,1810,620,1989,0,98033,47.6812,-122.196,2040,5500,3070,3460,143.8181818181818,0.0939016393442623,Very Cheap
20140508T000000,424500.0,3,1.75,1460,7700,1.0,0,0,3,7,1460,0,1979,0,98052,47.6981,-122.127,1720,7280,6240,5560,55.12987012987013,0.04583606557377049,Very Cheap
20140617T000000,430000.0,3,1.0,980,7200,1.0,0,0,4,7,980,0,1950,0,98116,47.5718,-122.395,1180,6572,6220,5392,59.72222222222222,0.04655737704918033,Very Cheap
20150505T000000,865000.0,4,2.5,2580,10631,2.0,0,2,4,9,2580,0,1992,0,98033,47.6993,-122.206,4220,10631,8051,6411,81.365816950428,0.10360655737704919,Cheap
20150304T000000,163000.0,2,2.0,1250,7543,1.0,0,0,3,7,1250,0,1962,0,98198,47.4051,-122.296,1250,7506,6293,6256,21.60943921516638,0.011540983606557377,Very Cheap
20140908T000000,920000.0,4,2.75,3140,9085,1.0,0,2,5,8,1570,1570,1961,0,98006,47.5675,-122.16,2430,9350,5945,6920,101.26582278481013,0.11081967213114755,Cheap
20141211T000000,1028950.0,5,3.25,2680,3011,2.0,0,0,3,9,1870,810,1910,2014,98122,47.6115,-122.287,3440,5165,331,1725,341.73032215210895,0.1251081967213115,Cheap
20140724T000000,325000.0,3,1.75,1810,8048,1.0,0,0,4,7,1290,520,1983,0,98055,47.4484,-122.194,1550,9081,6238,7531,40.38270377733598,0.03278688524590164,Very Cheap
20140603T000000,315000.0,5,2.5,2090,4698,2.0,0,0,3,7,2090,0,1998,0,98038,47.3538,-122.025,2070,4698,2608,2628,67.04980842911877,0.031475409836065574,Very Cheap
20140911T000000,227000.0,4,1.0,1120,8763,1.0,0,0,3,6,1120,0,1971,0,98146,47.508,-122.358,1120,8636,7643,7516,25.90437064932101,0.019934426229508195,Very Cheap
20140729T000000,179000.0,4,1.75,1790,7175,1.5,0,0,3,6,1410,380,1900,0,98168,47.4963,-122.318,1790,8417,5385,6627,24.94773519163763,0.013639344262295083,Very Cheap
20141009T000000,276000.0,2,1.0,870,2676,1.0,0,0,3,7,820,50,2004,0,98144,47.5702,-122.287,1500,1719,1806,219,103.1390134529148,0.026360655737704918,Very Cheap
20150303T000000,335000.0,4,1.5,3160,19745,1.5,0,0,4,6,1840,1320,1968,0,98010,47.3103,-122.006,1540,8611,16585,7071,16.966320587490504,0.03409836065573771,Very Cheap
20141114T000000,430000.0,3,2.0,2350,12480,1.0,0,0,3,7,1600,750,1981,0,98028,47.7661,-122.262,2160,12000,10130,9840,34.455128205128204,0.04655737704918033,Very Cheap
20141118T000000,266490.0,3,2.5,1810,4113,2.0,0,0,3,7,1810,0,2004,0,98042,47.3715,-122.126,1880,4465,2303,2585,64.79212253829321,0.02511344262295082,Very Cheap
20140806T000000,655000.0,4,2.75,3160,8197,1.0,0,0,3,8,1580,1580,1962,0,98115,47.7004,-122.287,2050,8197,5037,6147,79.90728315237281,0.0760655737704918,Very Cheap
20141114T000000,635500.0,3,2.0,1660,3600,1.0,0,0,3,7,1000,660,1939,2006,98103,47.6789,-122.351,1700,4356,1940,2656,176.52777777777777,0.07350819672131148,Very Cheap
20140626T000000,235000.0,5,2.5,2500,9583,1.0,0,0,3,7,1300,1200,1979,0,98198,47.3946,-122.312,2120,19352,7083,17232,24.52259209015966,0.02098360655737705,Very Cheap
20150427T000000,885000.0,3,2.5,2880,11443,2.0,0,0,4,9,2880,0,1986,0,98006,47.5633,-122.111,2840,12530,8563,9690,77.33985842873372,0.1062295081967213,Cheap
20140818T000000,352500.0,3,1.0,1470,8400,1.0,0,0,4,7,1470,0,1953,0,98133,47.7628,-122.354,1470,8400,6930,6930,41.964285714285715,0.03639344262295082,Very Cheap
20140709T000000,450000.0,3,2.5,1460,7573,2.0,0,0,3,8,1460,0,1983,0,98007,47.6012,-122.141,1910,7668,6113,5758,59.42162947312822,0.04918032786885246,Very Cheap
20141011T000000,3635000.0,5,6.0,5490,19897,2.0,0,0,3,12,5490,0,2005,0,98039,47.6165,-122.236,2910,17600,14407,14690,182.69085791827914,0.4668852459016393,High
20140919T000000,1050000.0,3,2.25,2480,15022,1.0,0,4,3,9,1330,1150,1967,2003,98136,47.5497,-122.396,2500,8178,12542,5678,69.89748369058714,0.12786885245901639,Cheap
20141121T000000,476000.0,2,2.25,1140,1332,3.0,0,0,3,8,1140,0,1999,0,98103,47.6543,-122.356,1140,1267,192,127,357.35735735735733,0.052590163934426226,Very Cheap
20140507T000000,375000.0,3,2.5,1830,13042,2.0,0,0,3,8,1830,0,1990,0,98038,47.3738,-122.042,1940,6996,11212,5056,28.753258702652968,0.03934426229508197,Very Cheap
20140909T000000,600600.0,4,3.5,3110,6829,2.0,0,0,3,8,3110,0,2014,0,98148,47.4349,-122.328,2910,7425,3719,4515,87.94845511787963,0.0689311475409836,Very Cheap
20141117T000000,567000.0,4,1.75,2630,11213,1.0,0,2,4,8,1430,1200,1948,0,98177,47.7158,-122.366,2240,15186,8583,12946,50.56630696512976,0.06452459016393443,Very Cheap
20140725T000000,650000.0,4,1.75,2390,12000,1.0,0,0,3,8,1470,920,1979,0,98052,47.7061,-122.163,2110,12000,9610,9890,54.166666666666664,0.07540983606557378,Very Cheap
20140604T000000,190000.0,5,2.0,1750,10284,1.0,0,0,4,5,1750,0,1943,0,98056,47.5094,-122.182,1560,9010,8534,7450,18.475301439128742,0.015081967213114755,Very Cheap
20141001T000000,858000.0,4,3.5,4370,422967,1.0,0,2,4,10,2580,1790,1978,0,98022,47.2332,-122.029,3260,422967,418597,419707,2.0285270482094346,0.10268852459016393,Cheap
20150115T000000,435500.0,1,1.75,1020,4512,1.0,0,0,3,7,770,250,1937,0,98115,47.6724,-122.266,1230,5029,3492,3799,96.52039007092199,0.04727868852459016,Very Cheap
20150311T000000,685000.0,3,2.0,2500,6733,1.0,0,0,3,8,1770,730,1979,0,98107,47.6691,-122.36,1770,6343,4233,4573,101.73770978761326,0.08,Very Cheap
20141119T000000,252000.0,3,2.0,1540,7210,2.0,0,0,4,7,1540,0,1984,0,98023,47.3128,-122.351,1500,7210,5670,5710,34.95145631067961,0.02321311475409836,Very Cheap
20140912T000000,512500.0,4,2.25,2200,6900,2.0,0,0,4,8,2200,0,1975,0,98028,47.7682,-122.261,2400,6900,4700,4500,74.27536231884058,0.05737704918032787,Very Cheap
20140801T000000,423800.0,3,2.5,1940,7415,2.0,0,0,3,8,1940,0,1965,0,98006,47.542,-122.176,1940,8425,5475,6485,57.15441672285907,0.04574426229508197,Very Cheap
20150504T000000,460000.0,3,2.25,1453,2225,2.0,0,0,4,8,1453,0,1986,0,98006,47.5429,-122.188,1860,2526,772,666,206.74157303370785,0.050491803278688525,Very Cheap
20140722T000000,434000.0,3,2.75,1830,3200,2.0,0,0,3,8,1830,0,1991,0,98034,47.7155,-122.218,2030,3331,1370,1301,135.625,0.04708196721311476,Very Cheap
20150414T000000,244000.0,3,1.0,2000,15900,1.0,0,0,3,6,1000,1000,1948,0,98178,47.4816,-122.233,1760,10500,13900,8740,15.345911949685535,0.02216393442622951,Very Cheap
20150217T000000,348125.0,3,1.0,1400,8451,1.5,0,0,3,7,1400,0,1953,0,98133,47.7719,-122.337,1590,8433,7051,6843,41.193349899420184,0.03581967213114754,Very Cheap
20140509T000000,585000.0,4,3.25,2400,29252,2.0,0,0,4,8,2400,0,1982,0,98072,47.743,-122.131,2280,45000,26852,42720,19.99863257213182,0.06688524590163934,Very Cheap
20140508T000000,230000.0,3,1.0,1390,16000,1.0,0,0,4,6,1390,0,1960,0,98001,47.2898,-122.251,1420,10000,14610,8580,14.375,0.020327868852459016,Very Cheap
20140805T000000,450000.0,3,2.0,1680,11250,1.0,0,0,4,8,1680,0,1967,0,98045,47.4861,-121.786,1760,12160,9570,10400,40.0,0.04918032786885246,Very Cheap
20150323T000000,393000.0,5,2.0,1820,5054,1.0,0,0,4,7,910,910,1970,0,98108,47.5547,-122.299,1180,5628,3234,4448,77.7601899485556,0.041704918032786885,Very Cheap
20141221T000000,517000.0,2,1.0,1140,3750,1.0,0,0,4,7,1140,0,1925,0,98103,47.6619,-122.343,1660,4000,2610,2340,137.86666666666667,0.0579672131147541,Very Cheap
20140915T000000,400000.0,3,1.0,1060,12690,1.0,0,0,3,7,1060,0,1969,0,98033,47.6736,-122.167,1920,10200,11630,8280,31.52088258471237,0.04262295081967213,Very Cheap
20150304T000000,890000.0,2,1.75,3050,50965,2.0,0,0,3,10,3050,0,1991,0,98053,47.6744,-122.05,3050,40107,47915,37057,17.46296477975081,0.10688524590163935,Cheap
20150310T000000,205950.0,3,1.0,970,11963,1.0,0,0,4,6,970,0,1970,0,98198,47.3776,-122.315,1210,11963,10993,10753,17.215581375909053,0.01717377049180328,Very Cheap
20141203T000000,209000.0,3,1.0,1320,3954,1.5,0,0,3,6,1320,0,1912,2014,98022,47.202,-121.994,1270,5184,2634,3914,52.85786545270612,0.017573770491803278,Very Cheap
20140612T000000,430000.0,4,1.75,1890,6000,1.0,0,0,4,6,1110,780,1947,0,98125,47.7274,-122.305,1560,6356,4110,4796,71.66666666666667,0.04655737704918033,Very Cheap
20150301T000000,534000.0,4,1.75,2040,2750,1.5,0,0,4,6,1260,780,1926,0,98105,47.6698,-122.3,1940,3750,710,1810,194.1818181818182,0.06019672131147541,Very Cheap
20140627T000000,735000.0,4,3.0,2370,3672,1.5,0,0,5,7,1650,720,1916,0,98115,47.678,-122.311,2140,4182,1302,2042,200.16339869281046,0.08655737704918033,Very Cheap
20150224T000000,873000.0,3,2.25,2720,54450,2.0,0,0,3,11,2720,0,1997,0,98027,47.5473,-122.092,3170,60548,51730,57378,16.03305785123967,0.10465573770491804,Cheap
20141118T000000,475000.0,4,2.25,1970,7532,1.0,0,0,3,8,1390,580,1983,0,98052,47.7219,-122.109,1970,8248,5562,6278,63.06425916091344,0.05245901639344262,Very Cheap
20140530T000000,325000.0,3,1.75,2180,10230,1.0,0,0,4,7,1090,1090,1961,0,98118,47.5158,-122.281,2130,7200,8050,5070,31.76930596285435,0.03278688524590164,Very Cheap
20140814T000000,500000.0,3,2.25,2990,216057,2.0,0,0,3,9,2990,0,1994,0,98019,47.754,-121.942,2840,215622,213067,212782,2.3142041220603824,0.05573770491803279,Very Cheap
20150120T000000,279000.0,4,2.75,2180,8475,1.0,0,0,4,7,1330,850,1987,0,98031,47.4045,-122.174,1500,7140,6295,5640,32.92035398230089,0.02675409836065574,Very Cheap
20150414T000000,350000.0,3,2.0,1440,5469,1.0,0,0,3,8,1440,0,1988,0,98029,47.5753,-122.017,1980,6198,4029,4218,63.99707441945511,0.036065573770491806,Very Cheap
20150421T000000,660000.0,4,2.25,3180,13653,2.0,0,0,3,9,3180,0,1978,0,98074,47.6316,-122.05,2910,12350,10473,9440,48.34102395078005,0.07672131147540984,Very Cheap
20150218T000000,324950.0,2,1.5,1643,14616,1.0,0,1,4,7,1643,0,1954,0,98198,47.3973,-122.312,2270,9940,12973,7670,22.232484948002188,0.03278032786885246,Very Cheap
20150127T000000,500000.0,4,2.0,1530,7816,1.0,0,0,3,7,1530,0,1955,0,98133,47.7309,-122.332,1480,7816,6286,6336,63.97134083930399,0.05573770491803279,Very Cheap
20140718T000000,187300.0,2,1.0,1310,7697,1.0,0,0,3,6,850,460,1950,0,98146,47.4982,-122.348,1270,6410,6387,5140,24.334156164739507,0.014727868852459016,Very Cheap
20140520T000000,345600.0,5,3.5,2800,5120,2.5,0,0,3,9,2800,0,1903,2005,98122,47.6059,-122.31,1780,5120,2320,3340,67.5,0.03548852459016393,Very Cheap
20141124T000000,400000.0,3,1.5,1510,7642,1.0,0,0,3,7,1510,0,1959,0,98008,47.5978,-122.116,2180,8357,6132,6177,52.34231876472128,0.04262295081967213,Very Cheap
20150122T000000,935000.0,5,3.0,2700,5001,2.0,0,0,3,10,2700,0,2009,0,98115,47.6811,-122.288,1610,5191,2301,3581,186.9626074785043,0.11278688524590164,Cheap
20140715T000000,374000.0,4,1.75,2220,15600,1.0,0,0,5,7,1140,1080,1963,0,98056,47.492,-122.166,1670,4800,13380,3130,23.974358974358974,0.03921311475409836,Very Cheap
20140609T000000,328000.0,3,1.75,1440,45302,2.0,0,0,3,7,1440,0,1977,0,98019,47.7078,-121.915,2080,49658,43862,47578,7.240298441569909,0.03318032786885246,Very Cheap
20140826T000000,257500.0,3,2.0,1300,9334,1.0,0,0,5,7,1300,0,1981,0,98178,47.4865,-122.238,2210,9636,8034,7426,27.587315191772017,0.023934426229508195,Very Cheap
20140908T000000,1003000.0,4,2.5,2230,3600,2.0,0,0,5,8,1630,600,1906,0,98112,47.6304,-122.309,2410,4800,1370,2390,278.6111111111111,0.12170491803278688,Cheap
20140626T000000,216500.0,2,1.75,1390,4482,1.0,0,0,4,8,1390,0,1980,0,98198,47.3785,-122.32,1390,4680,3092,3290,48.30432842481035,0.018557377049180326,Very Cheap
20140521T000000,1185000.0,3,2.25,2760,40946,2.0,0,0,5,10,2760,0,1978,0,98005,47.6501,-122.164,3030,42253,38186,39223,28.940555854051677,0.14557377049180328,Cheap
20140730T000000,360000.0,4,2.5,3200,7282,2.0,0,0,3,9,3200,0,2007,0,98188,47.4318,-122.286,3030,7290,4082,4260,49.436967865970885,0.037377049180327866,Very Cheap
20150122T000000,699999.0,3,0.75,1240,4000,1.0,0,0,4,7,1240,0,1968,0,98112,47.6239,-122.297,1460,4000,2760,2540,174.99975,0.08196708196721311,Very Cheap
20141002T000000,535000.0,3,2.5,1960,47044,2.0,0,0,4,8,1960,0,1978,0,98077,47.7573,-122.07,2020,29004,45084,26984,11.372332284669671,0.06032786885245902,Very Cheap
20150319T000000,464950.0,3,2.0,2190,19800,1.0,0,0,3,7,2190,0,1994,0,98146,47.5106,-122.365,1640,9719,17610,8079,23.482323232323232,0.051140983606557375,Very Cheap
20141202T000000,925000.0,4,2.5,3540,18168,2.0,0,0,3,10,3540,0,1996,0,98006,47.5441,-122.131,4130,11180,14628,7050,50.91369440774989,0.11147540983606558,Cheap
20140508T000000,930000.0,3,3.25,2640,4080,2.0,0,0,3,9,1840,800,1912,2000,98105,47.6636,-122.326,1990,4080,1440,2090,227.94117647058823,0.1121311475409836,Cheap
20140922T000000,727500.0,3,2.0,2660,5000,1.5,0,3,3,8,1940,720,1910,0,98116,47.5829,-122.382,2270,5000,2340,2730,145.5,0.08557377049180327,Very Cheap
20150312T000000,325000.0,4,1.75,1670,9500,1.0,0,0,3,7,1670,0,1976,0,98125,47.7254,-122.31,1620,9500,7830,7880,34.21052631578947,0.03278688524590164,Very Cheap
20140905T000000,695000.0,3,3.25,3080,12100,2.0,0,0,3,8,2080,1000,1984,0,98117,47.695,-122.399,2100,6581,9020,4481,57.43801652892562,0.08131147540983606,Very Cheap
20140625T000000,585000.0,4,2.75,2890,6825,1.0,0,0,3,8,1560,1330,1973,0,98034,47.734,-122.182,1900,10120,3935,8220,85.71428571428571,0.06688524590163934,Very Cheap
20140926T000000,319000.0,3,2.25,1800,9597,1.0,0,2,3,7,1200,600,1963,0,98188,47.4516,-122.267,1700,13502,7797,11802,33.2395540273002,0.032,Very Cheap
20150106T000000,265000.0,6,2.5,2000,7650,1.5,0,0,4,7,1790,210,1960,0,98032,47.3841,-122.288,1710,7650,5650,5940,34.64052287581699,0.024918032786885248,Very Cheap
20140626T000000,359000.0,5,1.75,1940,6654,1.5,0,0,4,7,1940,0,1953,0,98166,47.4663,-122.359,2300,9500,4714,7200,53.95250976856026,0.03724590163934426,Very Cheap
20150426T000000,390000.0,5,1.75,1940,6654,1.5,0,0,4,7,1940,0,1953,0,98166,47.4663,-122.359,2300,9500,4714,7200,58.61136158701533,0.04131147540983607,Very Cheap
20150128T000000,374500.0,3,1.0,960,9531,1.0,0,0,5,7,960,0,1969,0,98072,47.7619,-122.162,1670,9250,8571,7580,39.29283391039765,0.03927868852459016,Very Cheap
20140822T000000,661000.0,2,1.5,1750,46173,2.0,0,0,4,8,1750,0,1964,0,98072,47.7397,-122.126,2220,42224,44423,40004,14.315725640525848,0.07685245901639344,Very Cheap
20141203T000000,900000.0,3,2.5,2320,5000,2.0,0,0,3,8,1620,700,1907,1993,98112,47.6278,-122.292,2160,5000,2680,2840,180.0,0.10819672131147541,Cheap
20150413T000000,600000.0,5,2.5,2380,8204,1.0,0,0,3,8,1540,840,1957,0,98115,47.7,-122.287,2270,8204,5824,5934,73.13505607020966,0.06885245901639345,Very Cheap
20140516T000000,2000000.0,5,4.25,6490,10862,2.0,0,3,4,11,3940,2550,1991,0,98040,47.5728,-122.205,3290,14080,4372,10790,184.12815319462345,0.25245901639344265,Cheap
20150508T000000,512500.0,4,1.75,1620,4240,1.5,0,0,5,7,1620,0,1916,0,98144,47.5746,-122.311,1450,4240,2620,2790,120.87264150943396,0.05737704918032787,Very Cheap
20140604T000000,229500.0,3,1.75,1770,33224,1.0,0,0,4,8,1770,0,1968,0,98092,47.3377,-122.194,1690,22069,31454,20379,6.90765711533831,0.020262295081967214,Very Cheap
20140731T000000,589000.0,3,2.5,2320,5663,2.0,0,0,3,8,2320,0,2003,0,98027,47.539,-122.07,2500,4500,3343,2000,104.00847607275296,0.06740983606557377,Very Cheap
20150323T000000,539950.0,3,2.5,1330,2183,3.0,0,0,3,8,1330,0,2014,0,98117,47.6987,-122.365,1310,5000,853,3690,247.3431058176821,0.06097704918032787,Very Cheap
20141020T000000,640000.0,4,2.5,3420,21344,2.0,0,0,3,9,3420,0,2002,0,98166,47.45,-122.334,2110,21344,17924,19234,29.985007496251875,0.0740983606557377,Very Cheap
20150108T000000,218250.0,3,1.0,1270,7344,1.0,0,0,3,7,970,300,1967,0,98023,47.305,-122.371,1290,7300,6074,6010,29.71813725490196,0.01878688524590164,Very Cheap
20150225T000000,675000.0,4,3.5,2550,3600,2.0,0,2,3,8,1880,670,1997,0,98177,47.7709,-122.39,2090,6000,1050,3910,187.5,0.07868852459016394,Very Cheap
20140717T000000,338000.0,5,2.0,1860,9000,2.0,0,0,3,7,1860,0,1980,0,98045,47.4484,-121.772,1390,9752,7140,8362,37.55555555555556,0.034491803278688525,Very Cheap
20150331T000000,231750.0,3,1.0,1020,7615,1.0,0,0,3,7,1020,0,1981,0,98058,47.4292,-122.152,1470,9515,6595,8045,30.433355219960603,0.020557377049180328,Very Cheap
20141114T000000,199900.0,1,1.0,720,7140,1.0,0,0,3,6,720,0,1930,0,98146,47.5119,-122.339,1140,7577,6420,6437,27.99719887955182,0.01638032786885246,Very Cheap
20141001T000000,1059000.0,4,3.5,4460,16271,2.0,0,2,3,11,4460,0,2001,0,98075,47.5862,-121.97,4540,17122,11811,12582,65.08512076700879,0.12904918032786886,Cheap
20141002T000000,263000.0,4,2.75,1830,7315,1.0,0,0,5,7,1250,580,1979,0,98023,47.2989,-122.38,1730,7208,5485,5478,35.95352016404648,0.024655737704918034,Very Cheap
20140820T000000,279950.0,3,1.5,1520,7200,1.0,0,0,4,7,1160,360,1990,0,98198,47.3855,-122.302,1460,7200,5680,5740,38.88194444444444,0.026878688524590164,Very Cheap
20140520T000000,395000.0,3,1.5,1080,2940,1.5,0,0,4,7,1080,0,1920,0,98115,47.6832,-122.304,1400,4930,1860,3530,134.35374149659864,0.0419672131147541,Very Cheap
20140626T000000,252500.0,3,2.0,1900,8002,1.0,0,0,3,7,1900,0,1991,0,98023,47.2909,-122.352,1900,6086,6102,4186,31.55461134716321,0.023278688524590165,Very Cheap
20150312T000000,1150000.0,4,3.75,5300,37034,2.0,0,0,3,11,5300,0,1989,0,98077,47.7283,-122.076,3730,37034,31734,33304,31.05254630879732,0.14098360655737704,Cheap
20140826T000000,205000.0,3,1.0,1370,10708,1.0,0,0,3,7,1370,0,1969,0,98001,47.2769,-122.264,1770,14482,9338,12712,19.144564811355995,0.017049180327868854,Very Cheap
20140828T000000,654000.0,5,2.5,2960,8968,1.0,0,0,4,8,1640,1320,1965,0,98008,47.6233,-122.102,1890,9077,6008,7187,72.92595896520963,0.0759344262295082,Very Cheap
20150317T000000,200000.0,3,1.0,960,213008,1.0,0,0,2,6,960,0,1933,0,98024,47.5621,-121.862,1520,57499,212048,55979,0.9389318711034327,0.01639344262295082,Very Cheap
20140722T000000,700000.0,3,2.5,2190,7982,2.0,0,0,3,8,2190,0,2004,0,98033,47.6869,-122.187,2090,8888,5792,6798,87.69731896767728,0.08196721311475409,Very Cheap
20141003T000000,2720000.0,4,3.25,3990,18115,2.0,0,0,4,11,3990,0,1989,0,98039,47.6177,-122.229,3450,16087,14125,12637,150.1518078940105,0.3468852459016393,Medium
20141209T000000,306000.0,2,1.75,1200,2622,1.0,0,0,5,7,800,400,1956,0,98125,47.7175,-122.292,1310,1926,1422,616,116.70480549199085,0.030295081967213113,Very Cheap
20150406T000000,270000.0,3,2.5,1780,5015,2.0,0,0,3,7,1780,0,2010,0,98042,47.3352,-122.052,2010,5250,3235,3240,53.83848454636092,0.025573770491803278,Very Cheap
20141029T000000,340000.0,3,2.25,2630,9916,2.0,0,0,4,9,2630,0,1988,0,98092,47.3314,-122.202,2470,10810,7286,8340,34.28801936264623,0.03475409836065574,Very Cheap
20140611T000000,450000.0,4,2.5,2300,19250,1.0,0,0,4,7,2300,0,1955,0,98045,47.4793,-121.776,1460,19250,16950,17790,23.376623376623378,0.04918032786885246,Very Cheap
20140724T000000,580000.0,4,2.75,3210,6825,1.0,0,0,5,7,1810,1400,1975,0,98034,47.7338,-122.169,1840,8000,3615,6160,84.98168498168498,0.06622950819672131,Very Cheap
20141103T000000,435000.0,4,1.75,2290,4400,1.0,0,3,3,7,1290,1000,1959,0,98126,47.5698,-122.375,1820,4000,2110,2180,98.86363636363636,0.04721311475409836,Very Cheap
20140818T000000,690000.0,4,2.5,2780,4688,2.0,0,0,3,9,2780,0,2003,0,98059,47.5225,-122.156,3000,6029,1908,3029,147.18430034129693,0.08065573770491803,Very Cheap
20140617T000000,720000.0,4,2.5,2650,11520,2.0,0,0,3,8,2110,540,1988,0,98033,47.683,-122.187,2000,7680,8870,5680,62.5,0.08459016393442623,Very Cheap
20150217T000000,403000.0,3,2.25,1840,13020,1.0,0,0,3,8,1390,450,1980,0,98052,47.6923,-122.095,2210,13020,11180,10810,30.952380952380953,0.04301639344262295,Very Cheap
20140612T000000,440000.0,3,2.75,1560,7392,1.0,0,0,5,7,1030,530,1972,0,98011,47.7382,-122.182,1870,7520,5832,5650,59.523809523809526,0.04786885245901639,Very Cheap
20141023T000000,178500.0,3,1.0,1200,8470,1.0,0,0,5,7,1200,0,1961,0,98032,47.3864,-122.287,1200,7952,7270,6752,21.074380165289256,0.01357377049180328,Very Cheap
20141002T000000,270000.0,4,2.5,1900,8282,1.0,0,0,3,7,1900,0,1968,1997,98022,47.2089,-122.003,1420,8350,6382,6930,32.60082105771553,0.025573770491803278,Very Cheap
20141112T000000,129888.0,2,1.0,710,9900,1.0,0,0,3,6,710,0,1943,0,98166,47.479,-122.339,1070,9900,9190,8830,13.12,0.007198426229508197,Very Cheap
20150218T000000,260000.0,3,1.75,1360,15210,1.0,0,0,3,7,1360,0,1987,0,98038,47.3657,-122.047,1610,7800,13850,6190,17.094017094017094,0.024262295081967214,Very Cheap
20140829T000000,339950.0,5,2.5,2990,7292,2.0,0,0,4,8,2990,0,1990,0,98042,47.3604,-122.091,2150,8190,4302,6040,46.61958310477235,0.03474754098360656,Very Cheap
20140822T000000,250000.0,3,1.0,1640,26127,2.0,0,0,3,6,1640,0,1975,0,98019,47.7656,-121.905,1620,25788,24487,24168,9.568645462548321,0.022950819672131147,Very Cheap
20150114T000000,680000.0,3,3.5,3650,103672,1.0,0,0,3,10,2050,1600,2011,0,98031,47.4002,-122.217,2550,16140,100022,13590,6.559148082413767,0.07934426229508197,Very Cheap
20141229T000000,660000.0,10,3.0,2920,3745,2.0,0,0,4,7,1860,1060,1913,0,98105,47.6635,-122.32,1810,3745,825,1935,176.23497997329773,0.07672131147540984,Very Cheap
20140716T000000,1225000.0,3,3.5,3680,11491,2.0,0,2,3,11,3680,0,1999,0,98007,47.5647,-122.128,3710,10030,7811,6320,106.6051692629014,0.15081967213114755,Cheap
20140523T000000,550000.0,3,2.0,1830,9152,1.0,0,0,5,8,1830,0,1959,0,98006,47.5531,-122.181,1770,9220,7322,7450,60.09615384615385,0.06229508196721312,Very Cheap
20150102T000000,675000.0,5,2.75,2570,12906,2.0,0,0,3,8,2570,0,1987,0,98075,47.5814,-122.05,2580,12927,10336,10347,52.30125523012552,0.07868852459016394,Very Cheap
20150410T000000,981000.0,3,3.25,2730,9588,2.0,0,1,3,10,1900,830,1984,0,98052,47.6339,-122.09,2730,12736,6858,10006,102.3153942428035,0.11881967213114754,Cheap
20150325T000000,168000.0,3,1.0,1150,8000,1.5,0,0,4,6,1150,0,1913,1957,98001,47.2749,-122.252,1170,9600,6850,8430,21.0,0.01219672131147541,Very Cheap
20140522T000000,1000000.0,4,3.0,4260,18687,2.0,0,0,3,11,4260,0,1996,0,98075,47.5874,-121.982,3490,16772,14427,13282,53.513137475250176,0.12131147540983607,Cheap
20150401T000000,320000.0,3,1.0,1260,9600,1.0,0,0,3,7,1260,0,1970,1995,98045,47.4444,-121.762,1530,9790,8340,8260,33.333333333333336,0.032131147540983604,Very Cheap
20150204T000000,959000.0,6,3.25,4440,17424,1.0,0,1,4,9,2220,2220,1959,0,98040,47.5791,-122.23,2660,10768,12984,8108,55.03902662993572,0.1159344262295082,Cheap
20150409T000000,372000.0,4,1.0,2300,7680,1.0,0,0,3,7,1270,1030,1959,0,98106,47.524,-122.359,1840,5120,5380,3280,48.4375,0.03895081967213115,Very Cheap
20140707T000000,391500.0,3,2.5,1920,9625,2.0,0,0,3,8,1920,0,1993,0,98045,47.4876,-121.8,1920,10343,7705,8423,40.675324675324674,0.04150819672131147,Very Cheap
20150327T000000,390000.0,2,1.0,1080,4725,1.5,0,0,3,7,1080,0,1944,0,98126,47.5275,-122.381,1520,4961,3645,3441,82.53968253968254,0.04131147540983607,Very Cheap
20141106T000000,302000.0,2,1.0,890,5000,1.0,0,0,4,6,890,0,1947,0,98118,47.5526,-122.287,1160,5000,4110,3840,60.4,0.02977049180327869,Very Cheap
20141103T000000,495000.0,3,3.5,1650,1577,2.0,0,0,3,7,1100,550,2012,0,98109,47.6302,-122.344,1580,1280,-73,-300,313.8871274571972,0.05508196721311476,Very Cheap
20140904T000000,504500.0,3,2.5,1820,1545,3.0,0,2,3,8,1640,180,1998,0,98103,47.6523,-122.346,1440,1290,-275,-150,326.53721682847896,0.056327868852459016,Very Cheap
20150318T000000,555000.0,4,1.75,2320,4800,1.5,0,0,3,7,2170,150,1918,0,98117,47.6893,-122.365,1390,4800,2480,3410,115.625,0.06295081967213115,Very Cheap
20150317T000000,1550000.0,4,3.5,3260,5000,2.0,0,0,5,9,2630,630,1937,0,98105,47.6598,-122.273,2600,5000,1740,2400,310.0,0.19344262295081968,Cheap
20140909T000000,550000.0,3,1.5,1730,5750,1.0,0,0,3,7,1250,480,1947,0,98116,47.5645,-122.397,1370,5750,4020,4380,95.65217391304348,0.06229508196721312,Very Cheap
20140721T000000,1800000.0,4,2.5,3320,8325,2.5,0,0,5,10,3320,0,1905,0,98112,47.6263,-122.314,3680,6050,5005,2370,216.21621621621622,0.2262295081967213,Cheap
20150429T000000,655000.0,1,1.0,1660,5422,1.0,0,0,4,7,830,830,1908,0,98117,47.6821,-122.388,1100,5356,3762,4256,120.80413131685725,0.0760655737704918,Very Cheap
20150213T000000,685000.0,3,2.5,3290,90796,2.0,0,0,4,10,3290,0,1992,0,98042,47.3154,-122.079,2700,55023,87506,52323,7.544385215207718,0.08,Very Cheap
20150501T000000,721000.0,4,2.0,2280,8339,1.0,0,0,4,7,1220,1060,1954,0,98115,47.6986,-122.297,1970,8340,6059,6370,86.46120637966183,0.08472131147540983,Very Cheap
20140714T000000,1518630.0,4,4.25,3650,5328,1.5,0,0,3,9,2330,1320,1907,2014,98119,47.638,-122.362,1710,3600,1678,1890,285.02815315315314,0.18932852459016394,Cheap
20150223T000000,365000.0,4,2.5,1620,219542,2.0,0,0,3,7,1620,0,1980,0,98038,47.4014,-122.069,2240,217800,217922,215560,1.6625520401563254,0.0380327868852459,Very Cheap
20140613T000000,458000.0,3,2.0,2020,8555,1.0,0,0,4,7,1220,800,1957,0,98125,47.7278,-122.287,1600,8148,6535,6548,53.53594389246055,0.05022950819672131,Very Cheap
20150409T000000,280000.0,2,1.0,1150,12861,1.0,0,0,3,6,1150,0,1959,0,98058,47.4493,-122.171,1170,7574,11711,6404,21.771246403856622,0.026885245901639345,Very Cheap
20150409T000000,628000.0,4,1.75,1940,3060,1.0,0,0,4,7,1000,940,1911,0,98115,47.6786,-122.317,1320,3060,1120,1740,205.22875816993465,0.07252459016393442,Very Cheap
20150218T000000,781500.0,4,2.5,3440,6332,2.0,0,0,3,10,3440,0,2001,0,98059,47.5347,-122.155,3310,6528,2892,3218,123.42072015161087,0.09265573770491803,Very Cheap
20140624T000000,295000.0,3,1.75,2000,7560,1.0,0,0,4,7,1300,700,1968,0,98058,47.4346,-122.171,1900,8301,5560,6401,39.02116402116402,0.028852459016393443,Very Cheap
20150403T000000,435000.0,2,1.0,750,2786,1.0,0,0,5,7,750,0,1947,0,98117,47.6892,-122.393,1700,4653,2036,2953,156.13783201722902,0.04721311475409836,Very Cheap
20150322T000000,300000.0,3,1.75,1420,7200,1.0,0,0,3,7,1000,420,1979,0,98146,47.5069,-122.367,1550,8640,5780,7090,41.666666666666664,0.029508196721311476,Very Cheap
20150326T000000,208500.0,2,1.0,880,4814,1.0,0,0,4,5,880,0,1906,0,98010,47.3107,-121.999,1010,6160,3934,5150,43.311175737432485,0.017508196721311476,Very Cheap
20140603T000000,930000.0,2,2.5,2680,11214,1.0,0,0,3,9,2680,0,2006,0,98053,47.7078,-122.019,2305,6908,8534,4603,82.93204922418406,0.1121311475409836,Cheap
20150211T000000,316000.0,2,2.0,860,3000,1.0,0,0,3,6,860,0,1906,0,98118,47.5633,-122.288,1290,3500,2140,2210,105.33333333333333,0.03160655737704918,Very Cheap
20140623T000000,249900.0,3,2.0,1310,6738,1.0,0,0,4,7,1310,0,1990,0,98042,47.3694,-122.083,1290,8067,5428,6777,37.08815672306322,0.02293770491803279,Very Cheap
20140731T000000,675000.0,3,2.25,1780,4252,2.0,0,0,4,8,1540,240,1989,0,98144,47.6004,-122.292,2220,4000,2472,1780,158.74882408278458,0.07868852459016394,Very Cheap
20141030T000000,447000.0,3,2.25,1440,4667,2.0,0,0,3,7,1440,0,1985,0,98029,47.5662,-122.017,1610,4756,3227,3146,95.77887293764731,0.04878688524590164,Very Cheap
20150417T000000,675000.0,3,2.0,1510,3817,1.5,0,0,3,8,1510,0,1905,1994,98122,47.6088,-122.294,1510,3817,2307,2307,176.84045061566675,0.07868852459016394,Very Cheap
20150421T000000,546000.0,4,2.5,2100,1397,3.0,0,0,3,8,1580,520,2008,0,98144,47.5928,-122.295,1490,1201,-703,-289,390.83750894774516,0.06177049180327869,Very Cheap
20141231T000000,310000.0,3,2.0,1310,1361,3.0,0,0,3,7,1310,0,2003,0,98133,47.7337,-122.343,1370,1608,51,238,227.77369581190302,0.03081967213114754,Very Cheap
20150106T000000,190000.0,3,1.0,1280,5100,1.0,0,0,3,7,880,400,1961,0,98178,47.5035,-122.259,1360,6120,3820,4760,37.254901960784316,0.015081967213114755,Very Cheap
20140618T000000,650000.0,3,1.5,1320,8114,1.0,0,0,3,8,1320,0,1951,0,98004,47.5827,-122.195,2110,8114,6794,6004,80.10845452304659,0.07540983606557378,Very Cheap
20141002T000000,585000.0,3,2.5,1740,2350,2.0,0,0,3,8,1130,610,1995,0,98112,47.6207,-122.297,1740,3201,610,1461,248.93617021276594,0.06688524590163934,Very Cheap
20141106T000000,1430800.0,4,2.5,2910,7364,2.0,0,0,3,10,2910,0,2003,0,98033,47.6906,-122.213,2480,8400,4454,5920,194.29657794676805,0.17780983606557377,Cheap
20150112T000000,565000.0,4,2.5,2500,12090,1.0,0,0,3,9,2500,0,1983,0,98074,47.6346,-122.045,3380,12760,9590,9380,46.7328370554177,0.06426229508196721,Very Cheap
20141111T000000,174900.0,3,1.0,1100,6000,1.5,0,0,2,6,1100,0,1926,0,98108,47.5279,-122.318,960,5880,4900,4920,29.15,0.013101639344262296,Very Cheap
20140924T000000,360000.0,3,2.25,1381,1180,3.0,0,0,3,8,1381,0,2007,0,98125,47.711,-122.32,1381,1180,-201,-201,305.08474576271186,0.037377049180327866,Very Cheap
20150429T000000,234000.0,3,1.0,960,9624,1.0,0,0,3,7,960,0,1953,0,98155,47.7758,-122.301,1540,9624,8664,8084,24.3142144638404,0.020852459016393442,Very Cheap
20141125T000000,575000.0,8,3.0,3840,15990,1.0,0,0,3,7,2530,1310,1961,0,98034,47.7111,-122.211,1380,8172,12150,6792,35.959974984365225,0.06557377049180328,Very Cheap
20150303T000000,315000.0,3,2.5,2200,5954,2.0,0,0,3,7,2200,0,2004,0,98042,47.3709,-122.125,2200,5046,3754,2846,52.90560967416862,0.031475409836065574,Very Cheap
20150325T000000,225000.0,3,1.0,1250,7820,1.0,0,0,3,7,1250,0,1967,0,98001,47.3397,-122.291,1300,7920,6570,6620,28.77237851662404,0.019672131147540985,Very Cheap
20140626T000000,370000.0,3,1.5,2380,14500,1.0,0,0,4,7,1850,530,1961,0,98028,47.7714,-122.256,1830,13600,12120,11770,25.517241379310345,0.038688524590163934,Very Cheap
20140523T000000,606000.0,3,1.0,1500,3920,1.0,0,0,3,7,1000,500,1947,0,98107,47.6718,-122.359,1640,4017,2420,2377,154.59183673469389,0.06963934426229508,Very Cheap
20140603T000000,272500.0,3,2.0,1410,7622,1.0,0,0,4,7,1410,0,1983,0,98058,47.4273,-122.147,1830,8330,6212,6500,35.75177118866439,0.025901639344262296,Very Cheap
20150323T000000,475000.0,3,1.75,1680,3420,1.0,0,0,3,7,960,720,1992,0,98115,47.6855,-122.291,1680,4080,1740,2400,138.88888888888889,0.05245901639344262,Very Cheap
20140605T000000,270000.0,3,1.0,1500,13500,1.0,0,0,4,7,1500,0,1968,0,98059,47.4666,-122.072,1350,13680,12000,12330,20.0,0.025573770491803278,Very Cheap
20140818T000000,624000.0,4,1.75,2710,9216,1.0,0,0,3,8,1440,1270,1961,0,98126,47.5523,-122.379,1960,6350,6506,4390,67.70833333333333,0.072,Very Cheap
20140702T000000,355000.0,3,1.75,1730,7416,1.5,0,0,3,7,1730,0,1954,0,98133,47.76,-122.349,1390,6490,5686,5100,47.86947141316073,0.036721311475409836,Very Cheap
20141104T000000,345000.0,3,1.0,960,3844,1.0,0,0,3,7,960,0,1972,0,98133,47.7027,-122.346,1020,3844,2884,2824,89.75026014568158,0.03540983606557377,Very Cheap
20141120T000000,342000.0,4,2.5,2380,7792,2.0,0,0,3,8,2380,0,1993,0,98092,47.3273,-122.173,2260,7378,5412,5118,43.8911704312115,0.03501639344262295,Very Cheap
20141103T000000,316000.0,3,1.75,1120,98445,1.5,0,2,4,7,1120,0,1917,0,98022,47.1853,-122.017,1620,34200,97325,32580,3.209914165269948,0.03160655737704918,Very Cheap
20140731T000000,539950.0,4,2.5,2960,37430,2.0,0,0,3,9,2960,0,1990,0,98038,47.3988,-122.023,2800,36384,34470,33584,14.425594442960193,0.06097704918032787,Very Cheap
20150218T000000,221347.0,3,2.0,1580,6655,1.0,0,0,3,6,790,790,1944,0,98178,47.4927,-122.248,1090,6655,5075,5565,33.26025544703231,0.019193049180327867,Very Cheap
20140718T000000,330000.0,3,2.5,1870,4657,2.0,0,0,3,8,1870,0,2000,0,98055,47.4615,-122.214,2290,4795,2787,2505,70.86106935795577,0.03344262295081967,Very Cheap
20140718T000000,279000.0,4,2.5,1810,13000,1.0,0,0,4,8,1470,340,1977,0,98022,47.2202,-121.993,1850,13000,11190,11150,21.46153846153846,0.02675409836065574,Very Cheap
20141014T000000,850000.0,4,3.0,2550,3784,1.5,0,0,4,8,1750,800,1900,0,98103,47.6559,-122.338,2100,4560,1234,2460,224.63002114164905,0.10163934426229508,Cheap
20150212T000000,746000.0,3,1.75,1910,12321,1.0,0,0,4,7,1100,810,1952,0,98004,47.5995,-122.198,1910,11761,10411,9851,60.547033520006494,0.088,Very Cheap
20141001T000000,478000.0,2,2.0,1200,1867,1.0,0,0,3,7,600,600,1924,1998,98109,47.627,-122.345,1790,2221,667,431,256.02570969469735,0.05285245901639344,Very Cheap
20150116T000000,820000.0,4,2.75,2420,4635,1.5,0,0,5,7,2420,0,1905,0,98103,47.682,-122.347,1590,3150,2215,1560,176.91477885652642,0.09770491803278689,Very Cheap
20140820T000000,2160000.0,3,3.5,3080,6495,2.0,0,3,3,11,2530,550,1996,2006,98199,47.6321,-122.393,4120,8620,3415,4500,332.5635103926097,0.27344262295081967,Cheap
20141023T000000,820000.0,3,3.0,3850,38830,2.0,0,1,3,10,3850,0,2000,0,98006,47.5535,-122.191,2970,14050,34980,11080,21.117692505794487,0.09770491803278689,Very Cheap
20150418T000000,887000.0,3,2.0,3000,22040,2.0,0,2,4,8,2470,530,1942,0,98177,47.7745,-122.368,2600,7947,19040,5347,40.24500907441016,0.10649180327868853,Cheap
20140724T000000,159000.0,3,1.0,1360,20000,1.0,0,0,4,7,1360,0,1953,0,98001,47.2861,-122.253,1530,9997,18640,8467,7.95,0.011016393442622952,Very Cheap
20140617T000000,824000.0,7,4.25,3670,4000,2.0,0,1,3,8,2800,870,1964,0,98199,47.6375,-122.388,2010,4000,330,1990,206.0,0.09822950819672131,Very Cheap
20140925T000000,812000.0,4,2.5,2270,5000,2.0,0,0,3,9,2270,0,2014,0,98117,47.6916,-122.37,1210,5000,2730,3790,162.4,0.09665573770491803,Very Cheap
20141215T000000,242000.0,4,2.5,1750,11400,2.0,0,0,4,7,1750,0,1975,0,98023,47.3149,-122.386,1890,9024,9650,7134,21.228070175438596,0.021901639344262296,Very Cheap
20140520T000000,625000.0,4,2.5,3550,8048,2.0,0,0,3,9,3550,0,2007,0,98065,47.5422,-121.888,3920,7871,4498,3951,77.65904572564612,0.07213114754098361,Very Cheap
20141212T000000,399888.0,4,1.0,2370,30200,1.5,0,0,4,7,1570,800,1948,0,98146,47.5108,-122.366,1640,9719,27830,8079,13.241324503311258,0.04260826229508197,Very Cheap
20140922T000000,289000.0,3,2.25,1670,6600,2.0,0,0,4,7,1670,0,1990,0,98042,47.3604,-122.089,1670,6801,4930,5131,43.78787878787879,0.028065573770491802,Very Cheap
20140804T000000,400000.0,3,2.0,1860,12944,1.0,0,0,3,9,1860,0,2002,0,98058,47.4298,-122.102,2500,29279,11084,26779,30.902348578491967,0.04262295081967213,Very Cheap
20140521T000000,1550000.0,3,2.5,4460,26027,2.0,0,0,3,12,4460,0,1992,0,98033,47.6573,-122.173,3770,26027,21567,22257,59.55354055404003,0.19344262295081968,Cheap
20140528T000000,345000.0,2,1.0,1080,4000,1.0,0,0,3,7,1080,0,1940,0,98117,47.6902,-122.387,1530,4240,2920,2710,86.25,0.03540983606557377,Very Cheap
20150407T000000,874950.0,2,1.0,1080,4000,1.0,0,0,3,7,1080,0,1940,0,98117,47.6902,-122.387,1530,4240,2920,2710,218.7375,0.10491147540983607,Cheap
20140528T000000,875000.0,3,2.75,2280,4280,1.0,0,0,5,7,1280,1000,1917,0,98103,47.6685,-122.335,1650,4280,2000,2630,204.4392523364486,0.10491803278688525,Cheap
20150310T000000,628990.0,4,2.5,2540,32647,2.0,0,0,3,9,2540,0,1996,0,98053,47.6324,-121.988,2740,32647,30107,29907,19.26639507458572,0.0726544262295082,Very Cheap
20140723T000000,535000.0,2,3.5,2560,5000,1.0,0,0,4,6,1280,1280,1944,0,98107,47.6681,-122.368,1390,4000,2440,2610,107.0,0.06032786885245902,Very Cheap
20141007T000000,770126.0,4,2.75,2390,9300,1.0,0,0,3,8,1430,960,1979,0,98004,47.6035,-122.206,1910,9348,6910,7438,82.80924731182796,0.09116406557377049,Very Cheap
20140710T000000,710000.0,4,2.5,2870,8995,1.0,0,0,5,8,1870,1000,1968,0,98006,47.5678,-122.128,2670,9672,6125,7002,78.93274041133964,0.08327868852459017,Very Cheap
20140618T000000,465000.0,3,1.75,1510,4800,1.0,0,2,3,7,860,650,1925,2011,98126,47.5667,-122.372,1510,4800,3290,3290,96.875,0.051147540983606556,Very Cheap
20140814T000000,359000.0,3,1.75,2200,11520,1.0,0,0,4,7,2200,0,1952,0,98133,47.7659,-122.341,1690,8038,9320,6348,31.163194444444443,0.03724590163934426,Very Cheap
20150301T000000,151000.0,2,0.75,720,5040,1.0,0,0,3,4,720,0,1949,0,98106,47.5323,-122.347,1290,4120,4320,2830,29.96031746031746,0.009967213114754098,Very Cheap
20140815T000000,820000.0,3,2.5,2970,9600,2.0,0,0,3,9,2970,0,1994,0,98006,47.5422,-122.132,2970,9707,6630,6737,85.41666666666667,0.09770491803278689,Very Cheap
20150326T000000,160000.0,3,1.5,960,6497,1.0,0,0,4,7,960,0,1970,0,98023,47.3018,-122.378,1160,7080,5537,5920,24.62675080806526,0.011147540983606558,Very Cheap
20140701T000000,535000.0,4,1.75,1420,5000,1.5,0,0,4,7,1420,0,1945,0,98117,47.6771,-122.397,1490,5000,3580,3510,107.0,0.06032786885245902,Very Cheap
20150423T000000,365000.0,3,2.25,1800,9010,1.0,0,0,3,7,1300,500,1975,0,98155,47.7722,-122.312,1950,10240,7210,8290,40.51054384017758,0.0380327868852459,Very Cheap
20150220T000000,708000.0,4,2.5,3090,5600,2.0,0,0,3,9,3090,0,2005,0,98075,47.597,-121.979,3080,5788,2510,2708,126.42857142857143,0.08301639344262295,Very Cheap
20140709T000000,215000.0,3,1.0,1200,7280,1.0,0,0,4,7,1200,0,1967,0,98032,47.3724,-122.277,1200,8400,6080,7200,29.532967032967033,0.018360655737704918,Very Cheap
20140725T000000,1950000.0,4,3.5,4065,18713,2.0,0,0,4,10,4065,0,1987,0,98039,47.6209,-122.237,3070,18713,14648,15643,104.20563244803078,0.2459016393442623,Cheap
20140926T000000,390000.0,4,2.5,2570,22215,2.0,0,0,5,7,2570,0,1958,0,98059,47.4833,-122.157,2460,6533,19645,4073,17.555705604321403,0.04131147540983607,Very Cheap
20140513T000000,570000.0,3,2.0,1530,5401,1.0,0,0,4,7,1530,0,1937,0,98115,47.686,-122.304,1640,5467,3871,3827,105.53601184965747,0.06491803278688525,Very Cheap
20140625T000000,383000.0,3,1.75,1500,13430,1.0,0,0,3,7,1500,0,1977,0,98072,47.7527,-122.082,1500,13430,11930,11930,28.518242740134028,0.04039344262295082,Very Cheap
20150409T000000,370000.0,4,3.0,2490,5706,2.0,0,0,3,9,2490,0,2005,0,98042,47.3509,-122.165,2650,5880,3216,3230,64.84402383456012,0.038688524590163934,Very Cheap
20150211T000000,454000.0,4,2.5,3040,12522,2.0,0,0,3,7,3040,0,2000,0,98019,47.7247,-121.959,2490,9742,9482,7252,36.25618910717138,0.049704918032786885,Very Cheap
20150324T000000,1400000.0,5,3.25,4140,32700,1.0,0,4,3,10,2190,1950,1973,0,98177,47.7633,-122.369,3220,22077,28560,18857,42.813455657492355,0.1737704918032787,Cheap
20140728T000000,371000.0,4,1.75,1690,10854,1.0,0,0,3,7,1690,0,1977,0,98056,47.5241,-122.199,2390,7000,9164,4610,34.1809471162705,0.038819672131147544,Very Cheap
20150505T000000,530000.0,3,1.75,1430,10350,1.0,0,0,3,7,1430,0,1959,0,98008,47.6353,-122.123,1890,10350,8920,8460,51.207729468599034,0.05967213114754098,Very Cheap
20140610T000000,608000.0,4,2.75,2490,9714,1.0,0,0,4,8,1400,1090,1983,0,98011,47.7496,-122.201,2060,15300,7224,13240,62.590076178711136,0.0699016393442623,Very Cheap
20141111T000000,450000.0,3,1.75,1350,7200,1.0,0,0,5,7,1350,0,1954,0,98125,47.713,-122.284,1100,7200,5850,6100,62.5,0.04918032786885246,Very Cheap
20140730T000000,780000.0,4,2.5,3140,14421,2.0,0,0,3,10,3140,0,1994,0,98075,47.5943,-122.018,3140,17417,11281,14277,54.08778864156439,0.09245901639344262,Very Cheap
20140829T000000,290000.0,4,2.5,2340,52272,2.0,0,0,2,8,2340,0,1978,0,98042,47.3468,-122.091,2480,40500,49932,38020,5.547903275176003,0.02819672131147541,Very Cheap
20140916T000000,225000.0,3,1.75,1610,14182,1.0,0,0,4,7,1100,510,1978,0,98092,47.3174,-122.18,1510,8400,12572,6890,15.86518121562544,0.019672131147540985,Very Cheap
20140911T000000,805000.0,4,2.5,3320,38032,2.0,0,0,4,10,3320,0,1991,0,98077,47.7478,-122.036,3270,37804,34712,34534,21.166386201093815,0.09573770491803278,Very Cheap
20150407T000000,660000.0,3,2.5,2390,15669,2.0,0,0,3,9,2390,0,1991,0,98011,47.7446,-122.193,2640,12500,13279,9860,42.1213861765269,0.07672131147540984,Very Cheap
20140613T000000,299000.0,3,1.75,1180,13927,1.0,0,0,5,7,1180,0,1962,0,98059,47.4818,-122.094,1400,13173,12747,11773,21.46908882027716,0.02937704918032787,Very Cheap
20140919T000000,530000.0,2,2.25,1260,1312,3.0,0,0,3,8,1260,0,2007,0,98103,47.6538,-122.356,1300,1312,52,12,403.9634146341463,0.05967213114754098,Very Cheap
20141017T000000,680000.0,3,2.5,1800,4400,1.0,0,0,5,7,1350,450,1970,0,98199,47.6599,-122.396,1920,4400,2600,2480,154.54545454545453,0.07934426229508197,Very Cheap
20150216T000000,199900.0,4,1.75,1790,12000,1.0,0,0,5,6,1790,0,1944,0,98001,47.2664,-122.256,1550,9840,10210,8290,16.658333333333335,0.01638032786885246,Very Cheap
20150108T000000,224000.0,3,1.75,1760,6300,1.0,0,0,3,7,1060,700,1963,0,98178,47.5003,-122.26,1340,7300,4540,5960,35.55555555555556,0.01954098360655738,Very Cheap
20140829T000000,244000.0,3,1.75,1540,8885,1.0,0,0,4,7,1440,100,1980,0,98031,47.4031,-122.201,1540,12734,7345,11194,27.46201463140124,0.02216393442622951,Very Cheap
20150408T000000,485000.0,4,1.75,1260,3880,1.0,0,0,5,7,860,400,1918,0,98117,47.687,-122.391,1000,3880,2620,2880,125.0,0.05377049180327869,Very Cheap
20150112T000000,330000.0,4,2.5,2240,7589,2.0,0,0,3,8,2240,0,1994,0,98030,47.3824,-122.207,2250,7300,5349,5050,43.48398998550534,0.03344262295081967,Very Cheap
20141231T000000,509000.0,4,2.0,1630,1724,1.5,0,0,3,6,1030,600,1915,1970,98119,47.6472,-122.362,1780,3810,94,2030,295.24361948955914,0.056918032786885245,Very Cheap
20141117T000000,440000.0,4,2.5,2350,7203,2.0,0,0,3,8,2350,0,1989,0,98059,47.5123,-122.151,2260,7274,4853,5014,61.08565875329724,0.04786885245901639,Very Cheap
20141210T000000,244000.0,3,2.0,1350,8587,1.0,0,0,3,7,1350,0,1998,0,98022,47.2073,-122.012,1350,8587,7237,7237,28.41504599976709,0.02216393442622951,Very Cheap
20140717T000000,399700.0,4,1.75,1320,4800,1.0,0,0,4,7,870,450,1930,0,98106,47.5534,-122.365,940,4800,3480,3860,83.27083333333333,0.04258360655737705,Very Cheap
20140625T000000,519000.0,4,2.5,1950,2617,1.5,0,0,4,7,1250,700,1910,0,98107,47.6696,-122.372,1520,1438,667,-82,198.31868551776844,0.05822950819672131,Very Cheap
20140508T000000,211000.0,4,1.0,2100,9200,1.0,0,0,3,7,1050,1050,1959,0,98168,47.476,-122.292,1540,10033,7100,8493,22.934782608695652,0.01783606557377049,Very Cheap
20140708T000000,950000.0,3,2.5,3480,7800,1.0,0,0,4,7,1750,1730,1941,1998,98177,47.7047,-122.378,3010,9918,4320,6908,121.7948717948718,0.11475409836065574,Cheap
20140902T000000,410000.0,3,2.5,1830,2839,2.0,0,0,3,8,1830,0,1999,0,98074,47.6022,-122.021,1830,3011,1009,1181,144.41704825642833,0.043934426229508196,Very Cheap
20150325T000000,750000.0,4,2.0,2640,5000,2.0,0,0,3,7,2040,600,1949,0,98117,47.678,-122.375,1330,5000,2360,3670,150.0,0.08852459016393442,Very Cheap
20140910T000000,133400.0,3,1.0,900,2550,1.0,0,0,4,6,900,0,1978,0,98023,47.3036,-122.363,1120,2550,1650,1430,52.31372549019608,0.007659016393442623,Very Cheap
20150424T000000,240000.0,3,2.0,1553,6550,1.0,0,0,3,7,1553,0,1900,2001,98022,47.2056,-121.994,1010,10546,4997,9536,36.6412213740458,0.021639344262295083,Very Cheap
20140604T000000,539000.0,3,2.5,1710,2300,2.0,0,0,3,8,1570,140,2005,0,98052,47.6743,-122.142,2120,2856,590,736,234.34782608695653,0.06085245901639344,Very Cheap
20140814T000000,688000.0,4,3.0,3400,292723,2.0,0,0,3,10,3400,0,1998,0,98045,47.4883,-121.725,1760,69696,289323,67936,2.350344865282195,0.08039344262295083,Very Cheap
20140513T000000,465000.0,3,1.5,1270,5112,1.0,0,0,3,7,1270,0,1950,0,98115,47.676,-122.288,1580,5080,3842,3500,90.96244131455398,0.051147540983606556,Very Cheap
20140617T000000,936000.0,3,1.75,2960,12420,1.0,0,2,4,8,1480,1480,1952,0,98116,47.5739,-122.406,2700,9106,9460,6406,75.3623188405797,0.11291803278688524,Cheap
20141230T000000,620000.0,4,2.5,3040,9606,2.0,0,0,3,7,3040,0,2003,0,98053,47.6884,-122.044,1690,3849,6566,2159,64.54299396210702,0.07147540983606557,Very Cheap
20141020T000000,429950.0,3,1.75,1430,9750,1.0,0,0,5,7,1430,0,1962,0,98133,47.7441,-122.357,1630,9282,8320,7652,44.0974358974359,0.04655081967213115,Very Cheap
20140707T000000,296475.0,3,2.5,1520,4170,2.0,0,0,3,7,1520,0,2004,0,98038,47.3842,-122.04,1560,4237,2650,2677,71.09712230215827,0.029045901639344264,Very Cheap
20150427T000000,330000.0,4,2.0,1820,9450,1.0,0,0,3,7,1100,720,1962,0,98155,47.7607,-122.329,1540,9450,7630,7910,34.92063492063492,0.03344262295081967,Very Cheap
20140730T000000,445000.0,3,2.25,1800,11200,1.0,0,0,3,8,1270,530,1979,0,98052,47.7072,-122.164,1940,11250,9400,9310,39.732142857142854,0.04852459016393443,Very Cheap
20140801T000000,846000.0,4,3.25,2720,4000,2.0,0,1,3,10,2070,650,2014,0,98118,47.5554,-122.267,1450,4000,1280,2550,211.5,0.10111475409836065,Cheap
20150514T000000,725000.0,4,1.75,1980,5850,1.0,0,1,4,8,1380,600,1960,0,98116,47.5607,-122.391,1810,5850,3870,4040,123.93162393162393,0.08524590163934426,Very Cheap
20150504T000000,369000.0,4,2.5,2550,7349,2.0,0,0,3,9,2550,0,1989,0,98023,47.3059,-122.349,2400,8508,4799,6108,50.21091304939448,0.03855737704918033,Very Cheap
20140609T000000,625000.0,3,1.75,2210,16200,1.0,0,0,3,8,1390,820,1958,0,98005,47.5924,-122.175,2050,16200,13990,14150,38.58024691358025,0.07213114754098361,Very Cheap
20140618T000000,535000.0,3,2.0,2120,4080,2.0,0,0,3,7,2120,0,2003,0,98053,47.682,-122.037,2280,4080,1960,1800,131.12745098039215,0.06032786885245902,Very Cheap
20141218T000000,229950.0,4,1.5,1570,6717,1.0,0,0,5,6,1570,0,1911,0,98002,47.307,-122.217,1140,6716,5147,5576,34.23403305046896,0.020321311475409835,Very Cheap
20150423T000000,229999.0,3,1.75,1310,6960,1.0,0,0,4,7,1310,0,1974,0,98092,47.2761,-122.153,1580,7200,5650,5620,33.045833333333334,0.020327737704918032,Very Cheap
20140825T000000,850000.0,5,3.5,3150,4120,2.0,0,0,3,8,2460,690,1911,2007,98115,47.6754,-122.315,2080,4160,970,2080,206.3106796116505,0.10163934426229508,Cheap
20140610T000000,589900.0,4,4.5,3870,35889,2.0,0,0,3,10,2530,1340,2001,0,98027,47.4677,-122.01,3020,35366,32019,32346,16.436791217364654,0.06752786885245901,Very Cheap
20141030T000000,513000.0,2,1.0,1840,4322,1.0,0,0,4,7,1160,680,1914,0,98144,47.5764,-122.289,1750,4322,2482,2572,118.69504858861639,0.05744262295081967,Very Cheap
20140926T000000,401000.0,3,1.0,1120,8321,1.0,0,0,4,6,1120,0,1941,1987,98027,47.5631,-122.091,1980,8671,7201,6691,48.191323158274244,0.04275409836065574,Very Cheap
20140905T000000,260000.0,3,2.5,1440,2500,2.0,0,0,3,7,1440,0,2006,0,98146,47.511,-122.359,1440,5000,1060,3560,104.0,0.024262295081967214,Very Cheap
20150508T000000,525000.0,4,2.75,2300,26650,1.0,0,0,4,8,2300,0,1950,0,98177,47.7771,-122.362,2000,9879,24350,7879,19.69981238273921,0.05901639344262295,Very Cheap
20150320T000000,470000.0,3,3.5,2070,11658,1.0,0,0,4,8,1370,700,1977,0,98056,47.537,-122.178,1930,8744,9588,6814,40.31566306399039,0.05180327868852459,Very Cheap
20150121T000000,205000.0,4,1.5,1420,8063,1.0,0,0,3,7,940,480,1962,0,98198,47.4174,-122.316,1330,7515,6643,6185,25.42477985861342,0.017049180327868854,Very Cheap
20150210T000000,620000.0,3,2.25,2010,7495,1.0,0,0,4,8,1570,440,1979,0,98027,47.5613,-122.083,2050,8402,5485,6352,82.72181454302869,0.07147540983606557,Very Cheap
20140811T000000,229000.0,3,1.5,1200,5000,1.0,0,0,3,6,1200,0,1979,0,98146,47.5122,-122.357,1440,2500,3800,1060,45.8,0.02019672131147541,Very Cheap
20140509T000000,445000.0,2,2.0,1150,6634,1.0,0,0,3,7,860,290,1940,0,98115,47.7001,-122.309,1680,6892,5484,5212,67.07868555924028,0.04852459016393443,Very Cheap
20140514T000000,215000.0,2,1.0,1240,7200,1.0,0,0,3,7,1240,0,1967,0,98168,47.4971,-122.282,1130,9200,5960,8070,29.86111111111111,0.018360655737704918,Very Cheap
20140729T000000,504975.0,2,2.5,1900,4871,2.0,0,0,3,8,1900,0,2005,0,98053,47.7132,-122.034,1640,4780,2971,3140,103.66967768425374,0.05639016393442623,Very Cheap
20140801T000000,495000.0,4,2.25,2350,10072,2.0,0,0,3,8,2350,0,1980,0,98011,47.7628,-122.168,2210,9687,7722,7477,49.14614773629865,0.05508196721311476,Very Cheap
20150311T000000,205000.0,3,1.0,1120,8342,1.0,0,0,4,7,1120,0,1976,0,98042,47.3732,-122.116,1190,6660,7222,5470,24.574442579717093,0.017049180327868854,Very Cheap
20140730T000000,152275.0,1,1.0,1020,6871,1.0,0,0,3,6,1020,0,1937,1946,98146,47.5051,-122.338,1260,6933,5851,5673,22.16198515499927,0.010134426229508197,Very Cheap
20150325T000000,586000.0,4,2.25,1930,8338,1.0,0,0,3,8,1930,0,1968,0,98125,47.7026,-122.285,2280,7616,6408,5336,70.28064284000959,0.06701639344262295,Very Cheap
20141017T000000,779950.0,2,2.5,2680,7625,1.0,0,0,3,9,2680,0,2002,0,98053,47.7094,-122.024,2310,7395,4945,5085,102.28852459016393,0.09245245901639344,Very Cheap
20141218T000000,557000.0,4,1.75,2660,11315,2.0,0,0,4,8,2660,0,1983,0,98074,47.6204,-122.044,1980,11315,8655,9335,49.22669023420239,0.06321311475409835,Very Cheap
20141029T000000,610000.0,4,2.25,2200,7200,1.0,0,2,4,8,1220,980,1958,0,98144,47.5818,-122.296,1940,6000,5000,4060,84.72222222222223,0.07016393442622951,Very Cheap
20140708T000000,405000.0,3,1.5,1010,7683,1.5,0,0,5,7,1010,0,1953,0,98125,47.72,-122.318,1550,7271,6673,5721,52.713783678250685,0.043278688524590166,Very Cheap
20140509T000000,320000.0,4,2.25,2310,7490,2.0,0,0,3,8,2310,0,1980,0,98055,47.4379,-122.192,2310,8480,5180,6170,42.72363150867824,0.032131147540983604,Very Cheap
20140919T000000,356000.0,3,1.0,920,3863,1.0,0,0,3,6,920,0,1970,0,98118,47.5524,-122.27,1080,5150,2943,4070,92.15635516438002,0.03685245901639344,Very Cheap
20150226T000000,794500.0,5,3.0,3030,4120,1.5,0,0,4,7,1930,1100,1913,0,98115,47.6771,-122.319,1280,3090,1090,1810,192.8398058252427,0.09436065573770491,Very Cheap
20140508T000000,349000.0,3,1.75,1590,9620,1.0,0,0,3,7,1590,0,1988,0,98059,47.4815,-122.152,2980,9398,8030,6418,36.27858627858628,0.035934426229508196,Very Cheap
20140604T000000,549000.0,4,2.25,2740,88426,2.0,0,0,3,7,2740,0,1991,0,98027,47.4734,-122.006,2740,62726,85686,59986,6.208581186528849,0.06216393442622951,Very Cheap
20140718T000000,193000.0,3,1.0,960,10761,1.0,0,0,4,6,960,0,1962,0,98002,47.2819,-122.224,960,10761,9801,9801,17.935136139763962,0.015475409836065573,Very Cheap
20141016T000000,700000.0,3,1.5,2240,7227,2.0,0,1,3,9,1440,800,1977,0,98008,47.6208,-122.093,3150,16150,4987,13000,96.85900096859001,0.08196721311475409,Very Cheap
20150324T000000,523000.0,3,2.5,2400,6182,2.0,0,0,3,8,2400,0,1998,0,98065,47.5363,-121.87,2420,5829,3782,3409,84.60045292785506,0.05875409836065574,Very Cheap
20141118T000000,565000.0,5,3.25,2860,20790,1.0,0,0,4,7,1800,1060,1965,0,98155,47.7757,-122.295,1920,9612,17930,7692,27.176527176527177,0.06426229508196721,Very Cheap
20150505T000000,500000.0,4,2.5,2960,5027,2.0,0,0,3,7,2960,0,2000,0,98065,47.5328,-121.881,2760,5500,2067,2740,99.46290033817387,0.05573770491803279,Very Cheap
20140707T000000,1450000.0,4,3.25,3770,4103,2.0,0,0,5,9,2710,1060,1925,0,98109,47.641,-122.349,2560,4160,333,1600,353.39995125517913,0.18032786885245902,Cheap
20150219T000000,710000.0,6,3.5,3830,68825,2.0,0,0,3,9,3830,0,1995,0,98027,47.4574,-122.003,2410,68825,64995,66415,10.316018888485289,0.08327868852459017,Very Cheap
20141015T000000,333000.0,4,2.0,2750,9001,1.0,0,0,3,8,2750,0,2008,0,98055,47.457,-122.189,1340,11050,6251,9710,36.995889345628264,0.033836065573770495,Very Cheap
20140717T000000,580000.0,3,1.75,2100,6874,1.0,0,0,3,7,1300,800,1943,0,98115,47.6724,-122.279,2220,5912,4774,3692,84.37590922315974,0.06622950819672131,Very Cheap
20140801T000000,289950.0,4,1.75,1500,8400,1.0,0,0,3,7,1200,300,1956,0,98188,47.4531,-122.273,1780,9913,6900,8133,34.517857142857146,0.028190163934426228,Very Cheap
20150219T000000,375000.0,2,1.0,710,4618,1.0,0,1,3,5,710,0,1925,0,98199,47.64,-122.394,1810,4988,3908,3178,81.203984408835,0.03934426229508197,Very Cheap
20140926T000000,505000.0,2,3.0,2770,10800,1.5,0,0,5,8,1910,860,1984,0,98074,47.6082,-122.057,2140,10800,8030,8660,46.75925925925926,0.05639344262295082,Very Cheap
20140721T000000,324950.0,3,1.75,2050,6720,1.0,0,2,3,7,1050,1000,1939,0,98178,47.5058,-122.235,2380,7260,4670,4880,48.35565476190476,0.03278032786885246,Very Cheap
20140714T000000,490000.0,4,2.25,1960,10275,2.0,0,0,3,7,1960,0,1965,0,98052,47.6887,-122.124,1560,10275,8315,8715,47.688564476885645,0.05442622950819672,Very Cheap
20140512T000000,630000.0,4,2.0,1770,6000,2.0,0,0,5,7,1770,0,1911,1981,98199,47.6493,-122.401,1340,6000,4230,4660,105.0,0.07278688524590164,Very Cheap
20140620T000000,595000.0,3,2.75,3290,22649,2.0,0,0,4,8,3290,0,1993,0,98056,47.5241,-122.193,2750,6119,19359,3369,26.2704755176829,0.06819672131147542,Very Cheap
20150501T000000,872500.0,4,2.0,1990,6000,1.0,0,0,3,9,1260,730,1956,2015,98199,47.6515,-122.397,1770,6000,4010,4230,145.41666666666666,0.10459016393442623,Cheap
20150222T000000,490000.0,2,1.0,1760,5250,1.0,0,2,4,7,1000,760,1951,0,98126,47.5577,-122.379,1760,5400,3490,3640,93.33333333333333,0.05442622950819672,Very Cheap
20141216T000000,1900000.0,4,3.25,5080,27755,2.0,0,0,3,11,5080,0,2001,0,98006,47.5423,-122.111,4730,22326,22675,17596,68.45613402990452,0.23934426229508196,Cheap
20150505T000000,310000.0,2,1.0,1020,8102,1.0,0,0,3,7,1020,0,1956,0,98056,47.5135,-122.193,1770,7291,7082,5521,38.26215749197729,0.03081967213114754,Very Cheap
20150504T000000,450000.0,3,1.0,1350,92721,1.0,0,0,2,6,1200,150,1946,0,98055,47.4657,-122.198,1860,8096,91371,6236,4.853269485876986,0.04918032786885246,Very Cheap
20141023T000000,539000.0,3,1.5,1740,12000,2.0,0,0,3,9,1740,0,1974,0,98074,47.6276,-122.053,2580,12224,10260,9644,44.916666666666664,0.06085245901639344,Very Cheap
20140707T000000,888550.0,3,2.5,3540,38322,2.0,0,0,3,10,3540,0,1989,0,98053,47.6892,-122.048,3540,35926,34782,32386,23.18642033296801,0.10669508196721311,Cheap
20140714T000000,269950.0,3,2.5,1520,8720,1.0,0,0,3,7,1080,440,1981,0,98058,47.4267,-122.157,1720,7551,7200,5831,30.95756880733945,0.025567213114754097,Very Cheap
20140926T000000,142000.0,0,0.0,290,20875,1.0,0,0,1,1,290,0,1963,0,98024,47.5308,-121.888,1620,22850,20585,21230,6.802395209580839,0.008786885245901639,Very Cheap
20140819T000000,300000.0,3,1.75,1310,9761,1.0,0,0,3,7,1310,0,1967,0,98034,47.721,-122.228,1490,9600,8451,8110,30.73455588566745,0.029508196721311476,Very Cheap
20140922T000000,780000.0,2,3.25,3000,24004,1.0,0,0,3,10,2410,590,1952,0,98005,47.611,-122.157,4270,24506,21004,20236,32.49458423596067,0.09245901639344262,Very Cheap
20140715T000000,545000.0,3,2.5,2660,20369,2.0,0,0,3,8,2660,0,1992,0,98027,47.5234,-122.055,2720,12927,17709,10207,26.756345426874173,0.06163934426229508,Very Cheap
20150415T000000,278000.0,3,2.25,2120,9804,2.0,0,0,3,7,2120,0,1994,0,98042,47.3596,-122.16,2120,7200,7684,5080,28.35577315381477,0.02662295081967213,Very Cheap
20141201T000000,342000.0,3,2.25,1200,2845,2.0,0,0,3,7,1200,0,1986,0,98034,47.7151,-122.203,1220,2140,1645,920,120.21089630931459,0.03501639344262295,Very Cheap
20150506T000000,190000.0,4,1.75,1900,9861,1.0,0,0,4,7,1900,0,1967,0,98038,47.3615,-122.057,1720,7967,7961,6247,19.26782273603083,0.015081967213114755,Very Cheap
20141121T000000,387000.0,2,1.5,1010,948,3.0,0,0,3,8,1010,0,1999,0,98103,47.6529,-122.355,1330,1318,-62,-12,408.2278481012658,0.040918032786885244,Very Cheap
20150304T000000,279950.0,3,2.25,1850,7480,2.0,0,0,3,7,1850,0,1978,0,98058,47.452,-122.159,1870,7480,5630,5610,37.4264705882353,0.026878688524590164,Very Cheap
20150318T000000,550000.0,6,4.5,4520,40164,2.0,0,0,3,9,3580,940,1953,2008,98031,47.407,-122.216,2870,13068,35644,10198,13.693855193705806,0.06229508196721312,Very Cheap
20140520T000000,439000.0,3,2.0,2010,251341,2.0,0,0,3,8,1510,500,2003,0,98019,47.7416,-121.91,1780,108900,249331,107120,1.746631070935502,0.04773770491803279,Very Cheap
20141010T000000,774888.0,3,2.25,2420,23507,1.0,0,0,4,8,2420,0,1969,0,98027,47.5107,-122.027,2540,22257,21087,19717,32.964138341770536,0.09178859016393442,Very Cheap
20140610T000000,480000.0,5,2.5,2732,9500,1.0,0,2,4,8,1870,862,1975,0,98003,47.3436,-122.323,2720,10000,6768,7280,50.526315789473685,0.05311475409836065,Very Cheap
20140508T000000,835000.0,4,2.0,1910,6960,1.5,0,0,5,8,1910,0,1941,0,98103,47.6893,-122.348,1360,3300,5050,1940,119.97126436781609,0.09967213114754099,Very Cheap
20150303T000000,1500000.0,5,3.5,3520,5400,2.0,0,0,3,9,2400,1120,2008,0,98119,47.6364,-122.363,1360,3600,1880,2240,277.77777777777777,0.18688524590163935,Cheap
20150326T000000,771000.0,4,2.0,2220,3760,1.5,0,0,4,7,1370,850,1929,0,98117,47.6876,-122.368,1620,3760,1540,2140,205.0531914893617,0.09127868852459016,Very Cheap
20140807T000000,1225000.0,4,2.25,2020,5800,1.0,0,3,4,9,1760,260,1941,0,98199,47.6471,-122.412,3100,5800,3780,2700,211.20689655172413,0.15081967213114755,Cheap
20141017T000000,600000.0,4,2.5,2090,7290,1.0,0,0,5,8,1420,670,1966,0,98007,47.624,-122.142,2110,8436,5200,6326,82.3045267489712,0.06885245901639345,Very Cheap
20140702T000000,305000.0,3,1.0,1580,7424,1.0,0,0,3,7,1010,570,1962,0,98058,47.4607,-122.171,1710,7772,5844,6062,41.08297413793103,0.03016393442622951,Very Cheap
20150327T000000,1388000.0,5,1.75,2650,11340,1.0,0,0,3,8,2650,0,1955,0,98004,47.626,-122.213,2780,13204,8690,10424,122.39858906525573,0.1721967213114754,Cheap
20140910T000000,216500.0,3,1.0,1020,11652,1.0,0,0,4,6,1020,0,1971,0,98188,47.4459,-122.278,1690,11652,10632,9962,18.58050120151047,0.018557377049180326,Very Cheap
20150122T000000,370000.0,3,2.5,1070,1219,2.0,0,0,3,7,720,350,2004,0,98116,47.5618,-122.384,1070,1254,149,184,303.52748154224776,0.038688524590163934,Very Cheap
20140630T000000,492650.0,4,1.75,2120,9786,1.0,0,0,3,8,1640,480,1967,0,98177,47.7753,-122.365,2310,8787,7666,6477,50.34232577151032,0.05477377049180328,Very Cheap
20140725T000000,431200.0,5,1.75,1360,10609,1.0,0,0,3,7,1060,300,1966,0,98034,47.7203,-122.229,1490,9935,9249,8445,40.644735601847486,0.04671475409836066,Very Cheap
20150409T000000,277500.0,4,2.0,1700,12048,2.0,0,0,3,7,1700,0,1990,0,98030,47.3748,-122.186,1960,7650,10348,5690,23.032868525896415,0.026557377049180327,Very Cheap
20150317T000000,278000.0,5,1.5,1820,8712,1.0,0,0,5,7,1090,730,1960,0,98032,47.3712,-122.289,1820,8712,6892,6892,31.910009182736456,0.02662295081967213,Very Cheap
20140902T000000,351000.0,4,1.0,1430,8400,1.0,0,0,3,6,730,700,1969,0,98072,47.7417,-122.172,1310,8240,6970,6930,41.785714285714285,0.03619672131147541,Very Cheap
20140616T000000,850000.0,4,3.5,4140,7089,2.0,0,0,3,10,3160,980,2003,0,98034,47.7059,-122.2,2640,8896,2949,6256,119.9040767386091,0.10163934426229508,Cheap
20140811T000000,885000.0,2,2.0,1313,3600,1.0,0,0,3,8,1313,0,1904,2012,98119,47.6369,-122.365,1080,3600,2287,2520,245.83333333333334,0.1062295081967213,Cheap
20140715T000000,399950.0,3,2.0,1590,87120,1.0,0,3,3,8,1590,0,1998,0,98022,47.2241,-122.072,2780,183161,85530,180381,4.590794306703398,0.04261639344262295,Very Cheap
20140805T000000,185000.0,3,1.75,1080,9262,1.0,0,0,3,7,1080,0,1968,0,98178,47.4883,-122.248,1090,9262,8182,8172,19.974087670049666,0.014426229508196721,Very Cheap
20140925T000000,440000.0,5,3.0,2730,6000,1.0,0,0,3,8,1470,1260,1979,0,98178,47.4994,-122.234,2590,6000,3270,3410,73.33333333333333,0.04786885245901639,Very Cheap
20140813T000000,2395000.0,4,3.25,3800,19798,2.0,0,0,3,10,3800,0,1969,2009,98006,47.5684,-122.19,3940,18975,15998,15035,120.97181533488231,0.3042622950819672,Medium
20140821T000000,299000.0,3,2.25,2540,9961,1.0,0,0,4,8,1320,1220,1969,0,98031,47.41,-122.208,1870,10251,7421,8381,30.01706655958237,0.02937704918032787,Very Cheap
20140828T000000,299500.0,3,1.75,1810,34500,1.0,0,0,3,8,1230,580,1980,0,98032,47.3707,-122.275,2090,9735,32690,7645,8.681159420289855,0.02944262295081967,Very Cheap
20150317T000000,420000.0,3,1.5,1540,7506,1.0,0,0,5,7,1540,0,1961,0,98155,47.7565,-122.325,2180,7653,5966,5473,55.95523581135092,0.04524590163934426,Very Cheap
20140627T000000,234000.0,4,1.0,1390,18000,1.0,0,0,3,7,1390,0,1955,2013,98032,47.3885,-122.284,1390,18000,16610,16610,13.0,0.020852459016393442,Very Cheap
20140714T000000,540000.0,2,1.75,1460,4800,1.0,0,0,5,7,850,610,1950,0,98103,47.6928,-122.339,2050,5592,3340,3542,112.5,0.06098360655737705,Very Cheap
20140609T000000,649950.0,4,2.5,2350,63162,2.0,0,0,4,8,2350,0,1994,0,98077,47.7545,-122.047,2370,63162,60812,60792,10.290206136601121,0.07540327868852459,Very Cheap
20150108T000000,330000.0,3,1.0,1160,7912,1.0,0,0,4,7,1160,0,1956,0,98125,47.7336,-122.306,1190,7482,6752,6292,41.7087967644085,0.03344262295081967,Very Cheap
20150427T000000,840000.0,4,3.25,3500,5960,2.0,0,0,3,9,3500,0,2010,0,98053,47.6944,-122.022,3390,6856,2460,3466,140.93959731543623,0.10032786885245902,Cheap
20141107T000000,370000.0,3,2.5,1980,6922,2.0,0,0,5,8,1980,0,1991,0,98031,47.396,-122.184,2090,7697,4942,5607,53.45275931811615,0.038688524590163934,Very Cheap
20140625T000000,410000.0,3,1.5,1250,7700,1.0,0,0,5,7,1250,0,1968,0,98056,47.5383,-122.178,1430,7700,6450,6270,53.246753246753244,0.043934426229508196,Very Cheap
20141209T000000,257000.0,2,1.0,770,7200,1.0,0,0,3,7,770,0,1951,0,98125,47.7143,-122.325,1320,7139,6430,5819,35.69444444444444,0.023868852459016394,Very Cheap
20141230T000000,350000.0,3,1.0,1920,6710,1.0,0,0,3,7,1320,600,1959,0,98118,47.5346,-122.286,1810,5600,4790,3790,52.16095380029806,0.036065573770491806,Very Cheap
20140825T000000,380000.0,2,1.0,1120,7560,1.0,0,1,3,6,1120,0,1947,0,98177,47.77,-122.39,1120,7200,6440,6080,50.264550264550266,0.04,Very Cheap
20150310T000000,344000.0,3,1.0,1150,12402,1.0,0,0,4,6,1150,0,1969,0,98072,47.7422,-122.099,1400,13600,11252,12200,27.737461699725852,0.035278688524590165,Very Cheap
20140527T000000,488000.0,3,2.5,1590,2550,3.0,0,0,3,7,1590,0,1985,0,98117,47.6772,-122.393,1260,5100,960,3840,191.37254901960785,0.05416393442622951,Very Cheap
20141008T000000,465000.0,3,1.0,910,3880,1.0,0,0,3,7,780,130,1942,0,98117,47.6862,-122.392,1220,3880,2970,2660,119.84536082474227,0.051147540983606556,Very Cheap
20150504T000000,229500.0,2,1.75,1870,6625,1.0,0,0,3,7,960,910,1948,0,98178,47.5071,-122.249,1680,6000,4755,4320,34.64150943396226,0.020262295081967214,Very Cheap
20141112T000000,445000.0,5,3.0,2420,11250,2.0,0,0,3,8,2420,0,2013,0,98146,47.5082,-122.362,1510,9950,8830,8440,39.55555555555556,0.04852459016393443,Very Cheap
20150317T000000,246000.0,4,1.5,2120,7110,1.5,0,0,3,6,2120,0,1919,0,98030,47.3846,-122.227,1540,7110,4990,5570,34.59915611814346,0.02242622950819672,Very Cheap
20140604T000000,545000.0,5,2.5,2730,17240,1.0,0,0,5,7,1660,1070,1958,0,98028,47.7646,-122.267,2250,13200,14510,10950,31.612529002320187,0.06163934426229508,Very Cheap
20140813T000000,518000.0,4,2.5,2560,5672,2.0,0,1,3,8,2560,0,2005,0,98056,47.5222,-122.201,2190,6788,3112,4598,91.32581100141044,0.0580983606557377,Very Cheap
20141031T000000,565000.0,4,2.5,2620,10016,2.0,0,0,3,8,2620,0,1996,0,98056,47.5295,-122.179,2620,10016,7396,7396,56.409744408945684,0.06426229508196721,Very Cheap
20150410T000000,445000.0,4,2.5,2760,8558,2.0,0,0,3,7,2760,0,2001,0,98056,47.4802,-122.189,2760,7703,5798,4943,51.99813040430007,0.04852459016393443,Very Cheap
20140717T000000,968000.0,5,2.5,2900,9799,1.0,0,0,3,8,1450,1450,1959,0,98004,47.6255,-122.208,2810,9687,6899,6877,98.78559036636392,0.11711475409836065,Cheap
20150331T000000,725000.0,3,2.0,1820,6324,1.0,0,0,5,7,910,910,1945,0,98115,47.6823,-122.27,1850,6440,4504,4590,114.6426312460468,0.08524590163934426,Very Cheap
20140826T000000,315500.0,3,1.75,1870,8400,1.0,0,0,3,7,990,880,1977,0,98058,47.454,-122.164,1750,8400,6530,6650,37.55952380952381,0.031540983606557375,Very Cheap
20140505T000000,487585.0,4,1.75,2010,9211,1.0,0,0,3,7,1470,540,1977,0,98034,47.7206,-122.171,1840,8500,7201,6660,52.93507762457931,0.05410950819672131,Very Cheap
20150323T000000,246500.0,2,1.0,940,6000,1.0,0,0,2,7,940,0,1954,0,98148,47.4631,-122.329,1890,8547,5060,6657,41.083333333333336,0.022491803278688525,Very Cheap
20140814T000000,819000.0,3,1.75,1850,6000,1.5,0,0,3,8,1650,200,1913,1999,98199,47.6528,-122.401,1540,6000,4150,4460,136.5,0.09757377049180328,Very Cheap
20141218T000000,349900.0,5,2.5,2530,4229,2.0,0,0,3,7,2530,0,2004,0,98038,47.3531,-122.021,2070,4879,1699,2809,82.73823598959565,0.036052459016393444,Very Cheap
20140822T000000,267000.0,3,1.0,940,4700,1.0,0,0,4,6,940,0,1942,0,98146,47.5117,-122.378,1020,5700,3760,4680,56.808510638297875,0.025180327868852458,Very Cheap
20150513T000000,480000.0,3,2.25,1820,15000,1.0,0,0,3,7,1480,340,1978,0,98028,47.7401,-122.249,1930,13600,13180,11670,32.0,0.05311475409836065,Very Cheap
20140910T000000,525000.0,2,1.0,1510,3360,1.0,0,0,3,7,880,630,1924,0,98122,47.6135,-122.297,1330,3360,1850,2030,156.25,0.05901639344262295,Very Cheap
20140625T000000,578000.0,4,2.5,2070,5415,2.0,0,0,3,8,2070,0,1996,0,98029,47.5706,-122.006,2120,5331,3345,3211,106.74053554939981,0.06596721311475409,Very Cheap
20150506T000000,345000.0,3,2.5,1380,1547,3.0,0,0,3,8,1380,0,2000,0,98103,47.6908,-122.341,1380,1465,167,85,223.01228183581125,0.03540983606557377,Very Cheap
20150326T000000,499000.0,3,1.0,1270,6250,1.0,0,0,3,7,910,360,1955,0,98116,47.5694,-122.397,2000,6250,4980,4250,79.84,0.05560655737704918,Very Cheap
20140826T000000,425000.0,3,1.5,1390,9680,1.0,0,0,4,7,1390,0,1956,0,98008,47.634,-122.125,1460,10050,8290,8590,43.90495867768595,0.04590163934426229,Very Cheap
20141027T000000,268000.0,4,3.0,1840,7510,2.0,0,0,5,8,1840,0,1988,2013,98092,47.2595,-122.218,1650,7957,5670,6307,35.685752330226364,0.025311475409836064,Very Cheap
20141204T000000,240000.0,3,1.0,1600,12566,1.0,0,0,4,7,1600,0,1971,0,98045,47.4431,-121.765,1600,10650,10966,9050,19.099156453923285,0.021639344262295083,Very Cheap
20150303T000000,147000.0,3,1.5,1480,9606,1.0,0,0,4,7,1100,380,1964,0,98023,47.2978,-122.363,1600,9619,8126,8019,15.302935665209244,0.009442622950819672,Very Cheap
20150306T000000,500000.0,4,2.0,2120,7806,1.0,0,0,4,6,1770,350,1949,0,98033,47.6859,-122.166,1560,9920,5686,8360,64.05329233922623,0.05573770491803279,Very Cheap
20141028T000000,1010000.0,4,2.75,2940,5400,1.5,0,2,5,8,1940,1000,1910,0,98119,47.6366,-122.369,1970,2008,2460,38,187.03703703703704,0.12262295081967213,Cheap
20150309T000000,991500.0,4,3.0,3820,26895,2.0,0,2,3,11,3820,0,1995,0,98072,47.7253,-122.092,3820,24751,23075,20931,36.86558839933073,0.12019672131147541,Cheap
20141118T000000,510000.0,5,2.0,2740,3838,1.0,0,0,4,7,1370,1370,1959,0,98117,47.6819,-122.393,1660,4040,1098,2380,132.88170922355394,0.057049180327868855,Very Cheap
20140801T000000,1980000.0,4,4.0,4360,12081,2.0,0,0,3,10,4360,0,2007,0,98004,47.6377,-122.219,2180,10800,7721,8620,163.89371740749937,0.2498360655737705,Cheap
20140702T000000,484998.0,4,2.5,1540,1870,2.0,0,0,3,8,1540,0,2014,0,98029,47.5524,-121.999,1540,1619,330,79,259.3572192513369,0.053770229508196724,Very Cheap
20140625T000000,1280000.0,4,3.5,4660,17398,2.0,0,2,3,11,4660,0,2003,0,98006,47.5422,-122.112,5080,24913,12738,19833,73.57167490516152,0.1580327868852459,Cheap
20140529T000000,210000.0,3,1.75,1590,7617,2.0,0,0,3,7,1590,0,1986,0,98198,47.3819,-122.312,1490,7450,6027,5960,27.569909413154786,0.017704918032786884,Very Cheap
20140804T000000,450000.0,2,1.0,1180,10720,1.0,0,0,4,7,1180,0,1955,0,98007,47.5893,-122.135,1420,10750,9540,9330,41.97761194029851,0.04918032786885246,Very Cheap
20150402T000000,875000.0,4,1.75,2360,8286,1.0,0,0,3,7,1320,1040,1952,0,98004,47.6226,-122.205,1680,7630,5926,5950,105.59980690321024,0.10491803278688525,Cheap
20150428T000000,529950.0,4,2.75,1860,7500,1.0,0,0,5,8,1220,640,1967,0,98056,47.5398,-122.173,2020,8137,5640,6117,70.66,0.0596655737704918,Very Cheap
20140723T000000,415000.0,3,1.75,1470,4000,1.0,0,0,3,7,1070,400,1979,0,98122,47.6067,-122.298,1280,3500,2530,2220,103.75,0.04459016393442623,Very Cheap
20150220T000000,590000.0,4,2.0,2990,12970,1.5,0,2,4,7,1960,1030,1948,0,98028,47.7605,-122.258,2500,10680,9980,8180,45.48959136468774,0.06754098360655737,Very Cheap
20140526T000000,379950.0,3,1.5,1690,9144,1.0,0,0,4,7,1140,550,1956,0,98028,47.739,-122.253,1840,10600,7454,8760,41.55183727034121,0.03999344262295082,Very Cheap
20150410T000000,385000.0,1,1.0,660,3570,1.0,0,0,3,6,660,0,1906,0,98118,47.5659,-122.284,1520,4080,2910,2560,107.84313725490196,0.04065573770491803,Very Cheap
20141029T000000,588000.0,3,1.75,2310,7620,2.0,0,0,3,8,2310,0,1942,1988,98177,47.7266,-122.363,2200,7672,5310,5472,77.16535433070867,0.06727868852459017,Very Cheap
20140811T000000,252500.0,2,1.0,770,2191,1.0,0,0,3,6,770,0,1937,0,98108,47.5512,-122.323,940,5000,1421,4060,115.24418073938841,0.023278688524590165,Very Cheap
20140519T000000,530000.0,3,3.5,2320,3174,2.0,0,0,3,9,2060,260,1997,0,98033,47.6897,-122.175,2320,3187,854,867,166.98172652804033,0.05967213114754098,Very Cheap
20150105T000000,385000.0,2,1.5,1370,159865,1.0,0,0,3,7,1370,0,1960,0,98072,47.7592,-122.092,1370,16217,158495,14847,2.408281987927314,0.04065573770491803,Very Cheap
20140829T000000,419000.0,3,2.25,1700,7650,1.0,0,0,4,7,1340,360,1975,0,98034,47.7214,-122.166,1980,7200,5950,5220,54.77124183006536,0.04511475409836065,Very Cheap
20141017T000000,175000.0,2,1.0,960,5508,1.0,0,0,3,6,770,190,1951,0,98118,47.5307,-122.277,1280,5304,4548,4024,31.771968046477852,0.013114754098360656,Very Cheap
20150331T000000,515000.0,2,1.0,1150,5664,1.0,0,0,3,7,870,280,1948,0,98115,47.6894,-122.284,1380,5664,4514,4284,90.92514124293785,0.057704918032786885,Very Cheap
20150218T000000,945000.0,4,2.5,2910,4680,1.5,0,0,5,9,1850,1060,1937,0,98115,47.6745,-122.31,1960,4120,1770,2160,201.92307692307693,0.11409836065573771,Cheap
20140620T000000,359900.0,5,2.25,2290,7420,1.0,0,0,3,7,1290,1000,1973,0,98058,47.4375,-122.166,1660,7526,5130,5866,48.504043126684635,0.03736393442622951,Very Cheap
20140807T000000,419950.0,4,2.5,2260,5164,2.0,0,0,3,8,2260,0,1996,0,98056,47.509,-122.166,2260,5866,2904,3606,81.32261812548413,0.04523934426229508,Very Cheap
20140926T000000,460000.0,3,1.75,1300,4000,1.0,0,0,3,7,900,400,1953,0,98199,47.6368,-122.388,1750,4000,2700,2250,115.0,0.050491803278688525,Very Cheap
20150305T000000,255000.0,3,2.25,1850,7151,2.0,0,0,3,7,1850,0,1989,0,98023,47.2843,-122.352,1710,6827,5301,5117,35.6593483428891,0.02360655737704918,Very Cheap
20141104T000000,481000.0,4,1.75,1920,9500,1.0,0,0,4,7,1470,450,1966,0,98006,47.5683,-122.177,1820,10091,7580,8271,50.63157894736842,0.05324590163934426,Very Cheap
20150313T000000,719521.0,4,1.75,1920,9500,1.0,0,0,4,7,1470,450,1966,0,98006,47.5683,-122.177,1820,10091,7580,8271,75.73905263157894,0.08452734426229508,Very Cheap
20140620T000000,1080000.0,3,3.0,4910,43560,2.0,0,0,4,10,4000,910,1989,0,98007,47.5911,-122.131,3540,12288,38650,8748,24.793388429752067,0.1318032786885246,Cheap
20140523T000000,334000.0,4,2.5,2210,6080,1.0,0,2,4,8,1410,800,1965,0,98178,47.4915,-122.228,2210,6175,3870,3965,54.93421052631579,0.0339672131147541,Very Cheap
20140912T000000,675000.0,4,2.75,2280,3200,1.5,0,0,5,8,1520,760,1931,0,98105,47.6709,-122.282,1970,4687,920,2717,210.9375,0.07868852459016394,Very Cheap
20140613T000000,556000.0,3,1.75,1640,7437,1.0,0,0,3,7,1090,550,1948,0,98126,47.5324,-122.38,1640,7436,5797,5796,74.76132849267178,0.06308196721311475,Very Cheap
20140815T000000,900000.0,4,2.0,1980,7200,2.0,0,3,3,8,1700,280,1910,0,98119,47.6318,-122.369,2490,4200,5220,1710,125.0,0.10819672131147541,Cheap
20141002T000000,400000.0,3,1.0,900,4084,1.5,0,0,3,7,900,0,1910,0,98117,47.684,-122.393,1280,4080,3184,2800,97.94319294809011,0.04262295081967213,Very Cheap
20150324T000000,724950.0,4,1.75,1960,4340,1.0,0,0,5,8,980,980,1912,0,98117,47.6847,-122.37,1630,4360,2380,2730,167.03917050691246,0.08523934426229508,Very Cheap
20140903T000000,321000.0,4,2.25,1800,4500,2.0,0,0,4,8,1800,0,2004,0,98031,47.394,-122.183,2010,5050,2700,3040,71.33333333333333,0.032262295081967214,Very Cheap
20140701T000000,1356920.0,4,3.5,4270,5800,2.0,0,3,5,10,3170,1100,1937,0,98199,47.6474,-122.411,3100,5800,1530,2700,233.95172413793102,0.1681206557377049,Cheap
20140613T000000,171000.0,4,2.0,1520,19672,1.0,0,0,3,6,1020,500,1920,0,98188,47.4683,-122.281,1810,7840,18152,6030,8.692557950386336,0.012590163934426229,Very Cheap
20140707T000000,1360000.0,4,3.0,5430,108900,2.0,0,0,4,10,5430,0,1987,0,98053,47.6582,-122.038,3170,107076,103470,103906,12.488521579430671,0.16852459016393442,Cheap
20150224T000000,323000.0,3,1.75,1950,15037,1.0,0,0,3,7,1950,0,1989,0,98014,47.6892,-121.913,1760,15181,13087,13421,21.480348473764714,0.03252459016393443,Very Cheap
20140502T000000,491500.0,4,1.75,2190,125452,1.0,0,2,3,9,2190,0,1968,0,98092,47.2703,-122.069,3000,125017,123262,122017,3.9178331154545165,0.05462295081967213,Very Cheap
20140721T000000,226000.0,4,1.5,1200,10890,1.0,0,0,5,7,1200,0,1972,0,98042,47.3423,-122.088,1250,10139,9690,8889,20.752984389348025,0.01980327868852459,Very Cheap
20141009T000000,580000.0,6,1.75,2180,4000,1.5,0,0,4,7,1380,800,1926,0,98105,47.6643,-122.29,1720,4000,1820,2280,145.0,0.06622950819672131,Very Cheap
20140822T000000,640000.0,4,2.5,2320,11259,2.0,0,0,3,9,2320,0,1982,0,98004,47.6443,-122.194,2820,11770,8939,8950,56.84341415756284,0.0740983606557377,Very Cheap
20140820T000000,619790.0,3,1.75,1040,5097,1.0,0,0,4,7,800,240,1944,0,98199,47.6385,-122.401,1630,5097,4057,3467,121.59897979203453,0.07144786885245902,Very Cheap
20140630T000000,383962.0,4,2.5,2700,6998,2.0,0,0,3,8,2700,0,2001,0,98188,47.4694,-122.263,2350,10550,4298,8200,54.8673906830523,0.04051960655737705,Very Cheap
20140815T000000,373000.0,3,2.0,1400,2445,1.0,0,0,3,7,840,560,2002,0,98144,47.5926,-122.299,1400,3200,1045,1800,152.55623721881392,0.03908196721311476,Very Cheap
20141210T000000,541338.0,3,2.5,2060,8123,2.0,0,0,3,8,1010,1050,1977,0,98052,47.6642,-122.13,1760,6170,6063,4410,66.64261972177766,0.06115908196721311,Very Cheap
20141003T000000,254922.0,2,1.0,780,8160,1.0,0,0,4,6,780,0,1953,0,98133,47.7356,-122.34,1310,8160,7380,6850,31.24044117647059,0.02359632786885246,Very Cheap
20140624T000000,575000.0,3,2.25,2400,5000,1.5,0,0,4,7,1440,960,1926,0,98117,47.6897,-122.393,1630,5000,2600,3370,115.0,0.06557377049180328,Very Cheap
20140902T000000,650000.0,4,3.0,2900,15535,1.0,0,2,4,7,1870,1030,1961,0,98008,47.612,-122.119,2330,10217,12635,7887,41.84100418410042,0.07540983606557378,Very Cheap
20140813T000000,269950.0,3,1.5,1740,9547,1.0,0,0,4,7,1740,0,1962,0,98055,47.4475,-122.213,1780,9936,7807,8156,28.275898187912432,0.025567213114754097,Very Cheap
20150430T000000,270950.0,2,1.0,780,6250,1.0,0,0,3,6,780,0,1942,0,98168,47.5099,-122.33,1280,7100,5470,5820,43.352,0.025698360655737704,Very Cheap
20141229T000000,495000.0,3,2.75,2430,14861,1.0,0,0,3,9,1530,900,1988,0,98028,47.7461,-122.247,2230,10300,12431,8070,33.30866025166543,0.05508196721311476,Very Cheap
20140507T000000,794154.0,4,2.0,2210,8556,1.0,0,1,4,8,1210,1000,1954,0,98199,47.6498,-122.396,2190,7975,6346,5785,92.81837307152875,0.09431527868852459,Very Cheap
20141219T000000,340768.0,3,1.5,1510,11200,1.0,0,0,4,8,1510,0,1960,0,98003,47.3347,-122.325,2110,12070,9690,9960,30.425714285714285,0.034854819672131145,Very Cheap
20140801T000000,375000.0,2,1.0,900,5413,1.0,0,0,3,7,900,0,1947,0,98125,47.7047,-122.307,1280,6380,4513,5100,69.27766488084242,0.03934426229508197,Very Cheap
20140524T000000,820000.0,4,2.5,3670,7000,2.0,0,0,3,10,3670,0,2005,0,98075,47.5854,-122.08,3680,7437,3330,3757,117.14285714285714,0.09770491803278689,Very Cheap
20140930T000000,555000.0,2,2.25,1160,954,2.0,0,0,3,8,960,200,2014,0,98105,47.6647,-122.284,1160,1327,-206,167,581.7610062893082,0.06295081967213115,Very Cheap
20140612T000000,312500.0,2,1.5,1070,1200,2.0,0,0,3,7,1070,0,1999,0,98103,47.697,-122.347,1070,1200,130,130,260.4166666666667,0.03114754098360656,Very Cheap
20141202T000000,450000.0,2,1.0,950,4560,1.5,0,0,3,7,950,0,1925,0,98112,47.6288,-122.3,2040,4560,3610,2520,98.6842105263158,0.04918032786885246,Very Cheap
20150105T000000,739000.0,3,2.75,2950,6667,2.0,0,0,3,9,2950,0,2003,0,98029,47.5577,-122.026,3340,6667,3717,3327,110.84445777711115,0.08708196721311476,Very Cheap
20150413T000000,320000.0,3,2.0,1420,1716,2.0,0,0,3,7,1050,370,2003,0,98155,47.7364,-122.295,1420,8150,296,6730,186.4801864801865,0.032131147540983604,Very Cheap
20140609T000000,235000.0,3,1.0,1590,13000,1.5,0,0,3,6,1590,0,1944,0,98166,47.4789,-122.346,1460,8400,11410,6940,18.076923076923077,0.02098360655737705,Very Cheap
20150323T000000,275500.0,4,1.0,1290,5000,1.5,0,0,3,7,1290,0,1957,0,98146,47.5128,-122.358,1440,2500,3710,1060,55.1,0.026295081967213113,Very Cheap
20140618T000000,564000.0,2,2.0,1690,4500,1.0,0,0,3,8,1690,0,2004,0,98053,47.7133,-122.031,1640,4500,2810,2860,125.33333333333333,0.0641311475409836,Very Cheap
20150501T000000,263000.0,4,1.75,1340,8700,1.5,0,0,3,6,1340,0,1958,0,98188,47.4514,-122.287,1240,8700,7360,7460,30.229885057471265,0.024655737704918034,Very Cheap
20141104T000000,257000.0,3,1.75,1397,18000,1.0,0,0,3,7,1397,0,1965,2014,98092,47.3388,-122.166,1950,31294,16603,29344,14.277777777777779,0.023868852459016394,Very Cheap
20150319T000000,725000.0,4,2.5,3750,218506,2.0,0,0,3,10,3750,0,1991,0,98092,47.3045,-122.103,2540,39413,214756,36873,3.3179866914409675,0.08524590163934426,Very Cheap
20141211T000000,300000.0,3,2.25,2000,7560,1.0,0,0,3,7,1400,600,1979,0,98055,47.4798,-122.228,2040,6949,5560,4909,39.682539682539684,0.029508196721311476,Very Cheap
20140707T000000,328000.0,3,2.0,2250,7904,1.5,0,0,3,8,2250,0,1998,0,98001,47.3165,-122.252,2460,8622,5654,6162,41.497975708502025,0.03318032786885246,Very Cheap
20140728T000000,187500.0,3,1.0,840,8400,1.0,0,0,3,6,840,0,1959,0,98023,47.3281,-122.344,1030,8640,7560,7610,22.321428571428573,0.014754098360655738,Very Cheap
20150223T000000,400000.0,3,1.0,1100,5100,2.0,0,0,4,7,1100,0,1900,0,98117,47.679,-122.386,1540,5100,4000,3560,78.43137254901961,0.04262295081967213,Very Cheap
20150302T000000,515000.0,3,1.5,1660,5100,1.0,0,0,4,7,1210,450,1954,0,98136,47.5345,-122.383,1440,5100,3440,3660,100.98039215686275,0.057704918032786885,Very Cheap
20150420T000000,1410000.0,2,2.0,2180,18525,1.0,1,4,5,9,1580,600,1952,0,98146,47.5036,-122.387,2480,21503,16345,19023,76.11336032388664,0.17508196721311475,Cheap
20150417T000000,235000.0,3,1.0,1460,8400,1.0,0,0,3,7,1460,0,1958,0,98055,47.4243,-122.198,1460,9600,6940,8140,27.976190476190474,0.02098360655737705,Very Cheap
20140717T000000,669000.0,4,2.5,2470,4945,2.0,0,0,3,8,2470,0,2012,0,98053,47.6898,-122.015,2510,4988,2475,2478,135.2881698685541,0.0779016393442623,Very Cheap
20150424T000000,282000.0,3,1.0,1250,13503,1.5,0,0,4,6,1250,0,1931,0,98065,47.526,-121.829,1450,13503,12253,12053,20.884247944901134,0.02714754098360656,Very Cheap
20140626T000000,663000.0,3,2.0,1480,3876,1.0,0,0,5,7,860,620,1928,0,98117,47.6808,-122.382,1660,3774,2396,2114,171.05263157894737,0.07711475409836066,Very Cheap
20150424T000000,279900.0,3,3.25,2240,5000,2.0,0,0,3,9,1540,700,1989,0,98198,47.4114,-122.334,1800,7500,2760,5700,55.98,0.026872131147540983,Very Cheap
20140507T000000,335000.0,3,2.0,1570,7200,1.0,0,0,4,7,1570,0,1952,0,98155,47.7501,-122.314,1410,7434,5630,6024,46.52777777777778,0.03409836065573771,Very Cheap
20141231T000000,689000.0,4,2.75,3250,10000,2.0,0,0,3,9,3250,0,2014,0,98155,47.7557,-122.309,1620,10089,6750,8469,68.9,0.08052459016393443,Very Cheap
20150421T000000,413100.0,3,2.25,1790,231303,1.0,0,0,3,7,1250,540,1980,0,98077,47.7558,-122.027,2090,93654,229513,91564,1.7859690535790715,0.044340983606557374,Very Cheap
20150327T000000,506950.0,3,2.5,2080,4931,2.0,0,0,3,8,2080,0,2000,0,98065,47.5342,-121.868,1890,4229,2851,2339,102.80876090042588,0.05664918032786885,Very Cheap
20140506T000000,500000.0,3,2.5,1480,1171,3.0,0,0,3,8,1480,0,2006,0,98112,47.62,-122.3,1480,1231,-309,-249,426.9854824935952,0.05573770491803279,Very Cheap
20140613T000000,540000.0,5,3.0,3610,9775,2.0,0,0,3,8,3610,0,2003,0,98038,47.3545,-122.011,2800,8582,6165,5782,55.24296675191816,0.06098360655737705,Very Cheap
20140822T000000,812000.0,3,2.5,2040,4559,2.0,0,0,3,9,2040,0,1998,0,98122,47.6156,-122.295,1500,4500,2519,3000,178.1092344812459,0.09665573770491803,Very Cheap
20140828T000000,1200000.0,4,3.25,3850,19842,2.0,0,3,3,11,3180,670,1989,0,98074,47.6239,-122.065,4320,19500,15992,15180,60.47777441790142,0.14754098360655737,Cheap
20141215T000000,370000.0,3,2.25,3230,35306,2.0,0,0,3,9,3230,0,1987,0,98092,47.3065,-122.113,2760,35285,32076,32525,10.479805132272135,0.038688524590163934,Very Cheap
20140825T000000,338000.0,3,2.0,2440,23512,1.0,0,0,3,6,1640,800,1933,0,98148,47.4594,-122.326,1630,19613,21072,17983,14.375637972099353,0.034491803278688525,Very Cheap
20140507T000000,185000.0,4,1.0,1490,6600,1.0,0,0,3,7,1490,0,1969,0,98168,47.4835,-122.332,1280,6600,5110,5320,28.03030303030303,0.014426229508196721,Very Cheap
20141219T000000,450000.0,3,1.0,1150,35415,1.0,0,0,4,7,1010,140,1950,0,98008,47.5974,-122.129,2460,11781,34265,9321,12.706480304955527,0.04918032786885246,Very Cheap
20140712T000000,451000.0,2,1.0,900,6000,1.0,0,0,3,7,900,0,1944,2004,98115,47.6855,-122.289,1460,4800,5100,3340,75.16666666666667,0.04931147540983607,Very Cheap
20150421T000000,785000.0,4,2.5,3210,24527,1.5,0,0,3,11,3210,0,1984,0,98074,47.6399,-122.052,3280,24527,21317,21247,32.00554490969136,0.09311475409836066,Very Cheap
20140728T000000,850000.0,5,3.0,3900,5250,1.5,0,1,5,8,2620,1280,1931,0,98116,47.5577,-122.389,1950,5700,1350,3750,161.9047619047619,0.10163934426229508,Cheap
20141223T000000,235000.0,3,1.0,1240,18000,1.0,0,0,2,7,1240,0,1943,0,98198,47.3514,-122.315,1240,18000,16760,16760,13.055555555555555,0.02098360655737705,Very Cheap
20150114T000000,1150000.0,3,1.75,1760,6788,2.0,1,4,3,7,1760,0,1940,1960,98125,47.7336,-122.284,1630,7588,5028,5958,169.4166175604007,0.14098360655737704,Cheap
20140516T000000,377500.0,3,2.25,1410,1377,2.0,0,0,3,7,1290,120,2005,0,98027,47.5342,-122.067,1445,1370,-33,-75,274.1466957153232,0.039672131147540986,Very Cheap
20140530T000000,825500.0,3,2.5,2780,11964,2.0,0,0,3,9,2780,0,2009,0,98034,47.7127,-122.216,1760,9640,9184,7880,68.99866265463056,0.09842622950819672,Very Cheap
20140610T000000,1059500.0,5,3.25,3230,3825,2.0,0,0,3,9,2480,750,2014,0,98117,47.6785,-122.392,1480,5100,595,3620,276.9934640522876,0.12911475409836065,Cheap
20141120T000000,880000.0,5,3.5,4600,8764,2.0,0,0,3,10,3180,1420,2007,0,98006,47.5491,-122.19,3210,9431,4164,6221,100.4107713372889,0.10557377049180328,Cheap
20140521T000000,413800.0,3,2.0,1440,4421,1.0,0,0,3,8,1440,0,2007,0,98053,47.7188,-122.024,1440,4157,2981,2717,93.59873331825379,0.0444327868852459,Very Cheap
20140627T000000,504200.0,2,1.5,1200,1687,3.0,0,0,3,8,1200,0,2008,0,98103,47.6491,-122.334,1240,1296,487,56,298.8737403675163,0.05628852459016393,Very Cheap
20150422T000000,421500.0,4,3.0,2793,5703,2.0,0,0,3,9,2793,0,2009,0,98030,47.3682,-122.178,2793,5704,2910,2911,73.90846922672277,0.045442622950819675,Very Cheap
20150305T000000,855169.0,4,2.5,2970,5050,2.0,0,0,3,8,2970,0,2014,0,98052,47.7043,-122.122,2810,4998,2080,2188,169.34039603960397,0.10231724590163935,Cheap
20150207T000000,380000.0,3,2.0,1440,3218,1.0,0,0,3,7,850,590,2008,0,98106,47.5655,-122.36,1170,5000,1778,3830,118.08576755748912,0.04,Very Cheap
20140804T000000,580000.0,3,2.25,1480,1026,3.0,0,0,3,8,1480,0,2014,0,98103,47.6536,-122.354,1570,1283,-454,-287,565.3021442495127,0.06622950819672131,Very Cheap
20150409T000000,377000.0,3,2.5,1870,5333,2.0,0,0,3,8,1870,0,2012,0,98019,47.7447,-121.984,2100,3730,3463,1630,70.6919182448903,0.03960655737704918,Very Cheap
20140930T000000,329900.0,4,2.75,2475,4000,2.0,0,0,3,7,2475,0,2014,0,98002,47.3452,-122.209,2475,4000,1525,1525,82.475,0.03342950819672131,Very Cheap
20140828T000000,921800.0,4,2.5,2950,7024,2.0,0,0,3,10,2950,0,2012,0,98199,47.6651,-122.403,2950,6339,4074,3389,131.2357630979499,0.11105573770491803,Cheap
20150304T000000,529500.0,3,2.25,1410,905,3.0,0,0,3,9,1410,0,2014,0,98116,47.5818,-122.402,1510,1352,-505,-158,585.0828729281768,0.05960655737704918,Very Cheap
20140603T000000,363990.0,4,2.5,2240,3712,2.0,0,0,3,8,2240,0,2014,0,98038,47.3551,-122.061,2530,4315,1472,1785,98.05765086206897,0.03790032786885246,Very Cheap
20150115T000000,834950.0,5,2.75,3230,6500,2.0,0,0,3,9,3230,0,2014,0,98074,47.6237,-122.023,3180,7624,3270,4444,128.45384615384614,0.0996655737704918,Very Cheap
20140819T000000,399000.0,3,2.0,2100,31550,1.0,0,0,3,8,2100,0,2010,0,98014,47.6907,-121.917,1860,18452,29450,16592,12.646592709984152,0.042491803278688525,Very Cheap
20141114T000000,338900.0,3,2.25,1936,9495,1.0,0,0,3,8,1936,0,2013,0,98030,47.3714,-122.197,1410,12770,7559,11360,35.69246972090574,0.034609836065573774,Very Cheap
20150311T000000,419950.0,3,2.5,3120,6000,2.0,0,0,3,9,3120,0,2007,0,98038,47.3473,-122.03,2670,6000,2880,3330,69.99166666666666,0.04523934426229508,Very Cheap
20150413T000000,493000.0,4,2.5,2070,4270,2.0,0,0,3,8,2070,0,2010,0,98028,47.773,-122.265,2070,4610,2200,2540,115.45667447306792,0.054819672131147544,Very Cheap
20141211T000000,650000.0,4,2.5,3700,4500,2.0,0,0,3,9,3700,0,2007,0,98028,47.7473,-122.23,3050,5047,800,1997,144.44444444444446,0.07540983606557378,Very Cheap
20140909T000000,456000.0,3,2.5,2130,5205,2.0,0,0,3,8,2130,0,2013,0,98045,47.4832,-121.774,2250,5462,3075,3212,87.60806916426513,0.0499672131147541,Very Cheap
20140918T000000,425000.0,3,2.25,1620,997,2.5,0,0,3,8,1540,80,2010,0,98027,47.54,-122.026,1620,1068,-623,-552,426.27883650952856,0.04590163934426229,Very Cheap
20150209T000000,348000.0,3,2.5,1490,2478,3.0,0,0,3,8,1490,0,2009,0,98133,47.7236,-122.353,1270,1156,988,-114,140.4358353510896,0.03580327868852459,Very Cheap
20141029T000000,1040890.0,5,4.0,4180,7232,2.0,0,0,3,9,4180,0,2014,0,98052,47.7049,-122.125,3570,6054,3052,2484,143.92837389380531,0.12667409836065574,Cheap
20141118T000000,299000.0,2,2.5,1400,1262,2.0,0,0,3,8,1160,240,2008,0,98106,47.5342,-122.349,1060,1524,-138,464,236.9255150554675,0.02937704918032787,Very Cheap
20140512T000000,1264000.0,4,3.75,3490,9170,2.0,0,0,3,9,3490,0,2012,0,98004,47.5991,-122.2,1810,8470,5680,6660,137.84078516902943,0.1559344262295082,Cheap
20141112T000000,155000.0,3,1.0,1300,6098,1.0,0,0,3,7,1300,0,2013,0,98014,47.7074,-121.364,1300,6849,4798,5549,25.418169891767793,0.010491803278688525,Very Cheap
20150225T000000,319500.0,4,2.5,2730,4962,2.0,0,0,3,8,2730,0,2006,0,98002,47.3363,-122.216,2150,3802,2232,1652,64.38935912938331,0.0320655737704918,Very Cheap
20141222T000000,274000.0,3,2.5,1830,2517,2.0,0,0,3,8,1830,0,2005,0,98055,47.4496,-122.189,1610,2762,687,1152,108.85975367500993,0.026098360655737705,Very Cheap
20140616T000000,429000.0,5,2.5,2340,4500,2.0,0,0,3,7,2340,0,2009,0,98059,47.4911,-122.154,2190,4500,2160,2310,95.33333333333333,0.04642622950819672,Very Cheap
20141202T000000,267800.0,3,1.75,1410,1899,2.0,0,0,3,8,1410,0,2014,0,98106,47.5171,-122.347,1410,1811,489,401,141.02159031068985,0.025285245901639344,Very Cheap
20150408T000000,369950.0,3,2.5,1930,8254,2.0,0,0,3,7,1930,0,2014,0,98146,47.4973,-122.346,1540,8849,6324,7309,44.820692997334625,0.03868196721311475,Very Cheap
20150109T000000,480000.0,6,5.0,3028,18055,2.0,0,0,3,7,3028,0,2005,0,98030,47.3651,-122.197,1400,34575,15027,33175,26.585433397950705,0.05311475409836065,Very Cheap
20140915T000000,440000.0,4,3.5,3180,4869,2.0,0,0,3,8,2390,790,2007,0,98055,47.4482,-122.206,2850,4500,1689,1650,90.36763195728075,0.04786885245901639,Very Cheap
20150324T000000,839704.0,4,3.25,2950,4161,2.0,0,0,3,10,2210,740,2014,0,98027,47.5297,-122.073,2790,3693,1211,903,201.803412641192,0.10028904918032787,Cheap
20150129T000000,535000.0,3,3.25,1430,1276,3.0,0,0,3,8,1430,0,2007,0,98107,47.6712,-122.38,1430,1243,-154,-187,419.27899686520374,0.06032786885245902,Very Cheap
20140825T000000,290000.0,2,1.5,1020,1275,3.0,0,0,3,8,1020,0,2008,0,98103,47.7003,-122.346,980,1415,255,435,227.45098039215685,0.02819672131147541,Very Cheap
20140721T000000,370000.0,3,2.5,1650,1793,3.0,0,0,3,8,1650,0,2007,0,98133,47.7107,-122.332,1650,1863,143,213,206.35805911879532,0.038688524590163934,Very Cheap
20150303T000000,405000.0,3,2.0,1060,651,3.0,0,0,3,7,1060,0,2007,0,98103,47.6828,-122.345,1440,1501,-409,61,622.1198156682028,0.043278688524590166,Very Cheap
20140530T000000,499431.0,4,2.75,2620,6019,2.0,0,0,3,8,2620,0,2013,0,98045,47.484,-121.771,2790,6716,3399,3926,82.97574347898322,0.05566308196721311,Very Cheap
20140710T000000,275000.0,4,2.5,1830,3868,2.0,0,0,3,7,1830,0,2007,0,98118,47.5186,-122.276,2330,3868,2038,1538,71.09617373319546,0.02622950819672131,Very Cheap
20140522T000000,320000.0,3,2.25,998,844,2.0,0,0,3,7,798,200,2007,0,98117,47.6983,-122.367,998,1110,-154,112,379.1469194312796,0.032131147540983604,Very Cheap
20140805T000000,425000.0,4,2.5,2070,4427,2.0,0,0,3,7,2070,0,2007,0,98065,47.5208,-121.869,2070,4556,2357,2486,96.0018070928394,0.04590163934426229,Very Cheap
20150227T000000,1450000.0,4,3.5,2860,2199,3.0,0,0,3,10,2860,0,2013,0,98102,47.6262,-122.323,1990,1378,-661,-612,659.3906321055025,0.18032786885245902,Cheap
20150210T000000,340000.0,3,2.0,1920,5688,1.0,0,3,3,9,1920,0,2007,0,98022,47.1952,-121.976,2384,4802,3768,2418,59.774964838255976,0.03475409836065574,Very Cheap
20141001T000000,299900.0,3,2.5,1210,2046,2.0,0,0,3,9,920,290,2008,0,98106,47.5212,-122.357,1070,651,836,-419,146.57869012707724,0.029495081967213115,Very Cheap
20141226T000000,865950.0,5,3.5,4890,12039,2.0,0,0,3,9,3590,1300,2014,0,98011,47.7338,-122.208,4590,10079,7149,5489,71.92873162222776,0.1037311475409836,Cheap
20140815T000000,720000.0,4,2.5,3420,17038,2.0,0,0,3,9,3420,0,2007,0,98034,47.718,-122.241,2520,14190,13618,11670,42.25848104237586,0.08459016393442623,Very Cheap
20141002T000000,460000.0,4,3.5,2870,3225,2.0,0,3,3,9,2070,800,2006,0,98178,47.5009,-122.225,1770,6450,355,4680,142.63565891472868,0.050491803278688525,Very Cheap
20141119T000000,375000.0,3,2.5,1600,2042,2.0,0,0,3,8,1600,0,2005,0,98027,47.5341,-122.067,1445,1370,442,-75,183.64348677766895,0.03934426229508197,Very Cheap
20150511T000000,386180.0,2,1.5,960,1829,2.0,0,0,3,7,960,0,2005,0,98122,47.6032,-122.308,1470,1829,869,359,211.14270092946967,0.04081049180327869,Very Cheap
20150114T000000,280000.0,3,2.75,1740,5639,1.0,0,3,3,7,1740,0,2010,0,98022,47.1942,-121.977,2380,5331,3899,2951,49.654194006029435,0.026885245901639345,Very Cheap
20140808T000000,359000.0,4,2.5,2575,4725,2.0,0,0,3,8,2575,0,2011,0,98001,47.3058,-122.277,2575,5323,2150,2748,75.97883597883597,0.03724590163934426,Very Cheap
20140502T000000,785000.0,5,3.25,3660,11995,2.0,0,2,3,10,3660,0,2006,0,98065,47.5337,-121.86,3320,11241,8335,7921,65.44393497290538,0.09311475409836066,Very Cheap
20150206T000000,425000.0,3,2.25,1420,1230,2.0,0,0,3,8,940,480,2009,0,98144,47.5703,-122.288,1400,1230,-190,-170,345.5284552845528,0.04590163934426229,Very Cheap
20150504T000000,575000.0,5,2.5,3070,7200,2.0,0,0,3,8,3070,0,2005,0,98059,47.4939,-122.137,2590,7200,4130,4610,79.86111111111111,0.06557377049180328,Very Cheap
20150303T000000,465000.0,3,2.5,1920,144619,1.0,0,0,3,8,1920,0,2014,0,98022,47.2683,-121.946,2010,48787,142699,46777,3.2153451482861866,0.051147540983606556,Very Cheap
20150506T000000,1850000.0,4,3.25,4160,10335,2.0,0,0,3,10,4160,0,2014,0,98004,47.6235,-122.192,1840,10333,6175,8493,179.00338655055637,0.23278688524590163,Cheap
20150218T000000,720000.0,4,3.25,3276,10801,2.0,0,0,3,9,3276,0,2008,0,98166,47.4585,-122.361,2010,11656,7525,9646,66.66049439866678,0.08459016393442623,Very Cheap
20140506T000000,390000.0,5,3.75,2890,5000,1.0,0,0,3,7,1310,1580,2006,0,98108,47.5701,-122.296,1930,5117,2110,3187,78.0,0.04131147540983607,Very Cheap
20150429T000000,2205000.0,3,2.5,3430,10177,2.0,0,0,3,10,3430,0,2014,0,98034,47.7159,-122.251,3110,12339,6747,9229,216.6650289869313,0.27934426229508197,Cheap
20140702T000000,1054690.0,4,3.5,3390,3979,2.0,0,0,3,9,2610,780,2014,0,98199,47.6482,-122.408,3350,4165,589,815,265.0640864538829,0.12848393442622952,Cheap
20140610T000000,915000.0,6,3.75,2930,14980,2.0,0,3,3,9,2930,0,2013,0,98006,47.5441,-122.117,3210,10787,12050,7577,61.08144192256342,0.11016393442622952,Cheap
20150422T000000,562000.0,2,2.25,1300,1314,3.0,0,0,3,8,1300,0,2008,0,98103,47.6536,-122.356,1300,1312,14,12,427.70167427701676,0.0638688524590164,Very Cheap
20141120T000000,349000.0,2,1.75,1250,1208,2.0,0,0,3,7,1040,210,2007,0,98144,47.6004,-122.299,1250,1656,-42,406,288.9072847682119,0.035934426229508196,Very Cheap
20140814T000000,375000.0,4,2.5,2310,7800,2.0,0,0,3,8,2310,0,2011,0,98042,47.3737,-122.164,2310,7140,5490,4830,48.07692307692308,0.03934426229508197,Very Cheap
20141212T000000,479950.0,2,2.25,1360,1336,3.0,0,0,3,8,1360,0,2008,0,98107,47.6714,-122.392,1280,1295,-24,15,359.2440119760479,0.05310819672131147,Very Cheap
20150109T000000,319000.0,4,2.5,2020,5100,2.0,0,0,3,7,2020,0,2010,0,98023,47.2822,-122.357,2300,5685,3080,3385,62.549019607843135,0.032,Very Cheap
20141003T000000,325000.0,3,1.5,1270,1067,3.0,0,0,3,8,1270,0,2009,0,98133,47.7236,-122.353,1090,1118,-203,28,304.5923149015932,0.03278688524590164,Very Cheap
20140821T000000,505657.0,4,2.75,2790,8092,2.0,0,0,3,8,2790,0,2013,0,98045,47.4834,-121.773,2790,6154,5302,3364,62.48850716757291,0.05647960655737705,Very Cheap
20150305T000000,340000.0,4,2.5,2320,4142,2.0,0,0,3,7,2320,0,2010,0,98038,47.3662,-122.019,2150,4140,1822,1990,82.08594881699662,0.03475409836065574,Very Cheap
20150123T000000,250000.0,3,2.5,1750,6351,2.0,0,0,3,7,1750,0,2012,0,98001,47.2589,-122.256,1398,6092,4601,4694,39.36387970398363,0.022950819672131147,Very Cheap
20140926T000000,349500.0,4,2.5,2030,4596,2.0,0,0,3,8,2030,0,2014,0,98001,47.3515,-122.275,2040,4705,2566,2665,76.0443864229765,0.036,Very Cheap
20150424T000000,290750.0,3,2.5,1270,865,2.0,0,0,3,7,1080,190,2008,0,98118,47.5351,-122.279,1630,7752,-405,6122,336.1271676300578,0.028295081967213115,Very Cheap
20150505T000000,715000.0,5,3.25,2710,2356,2.0,0,0,3,8,2230,480,2013,0,98027,47.5394,-122.028,2160,2108,-354,-52,303.4804753820034,0.0839344262295082,Very Cheap
20140811T000000,689950.0,4,2.75,2520,8433,2.0,0,0,3,8,2520,0,2014,0,98125,47.7214,-122.289,1890,7772,5913,5882,81.81548677813352,0.08064918032786886,Very Cheap
20140924T000000,425000.0,2,2.5,1340,1263,3.0,0,0,3,8,1340,0,2008,0,98117,47.6788,-122.388,1510,1260,-77,-250,336.5003958828187,0.04590163934426229,Very Cheap
20150119T000000,657000.0,2,3.0,1570,1281,3.0,0,0,3,8,1570,0,2014,0,98107,47.6741,-122.384,1570,2500,-289,930,512.8805620608899,0.07632786885245901,Very Cheap
20141120T000000,359950.0,4,3.5,2690,5564,2.0,0,0,3,7,2690,0,2007,0,98038,47.3537,-122.018,2210,4046,2874,1836,64.69266714593817,0.037370491803278685,Very Cheap
20140731T000000,319900.0,4,2.75,2475,4276,2.0,0,0,3,7,2475,0,2014,0,98002,47.345,-122.21,2475,4000,1801,1525,74.81290926099157,0.03211803278688525,Very Cheap
20150416T000000,532000.0,3,3.75,2260,2050,2.0,0,0,3,9,1170,1090,2010,0,98118,47.566,-122.29,2130,3082,-210,952,259.5121951219512,0.059934426229508196,Very Cheap
20150330T000000,291000.0,2,1.0,840,863,3.0,0,0,3,8,840,0,2008,0,98103,47.6974,-122.349,1110,1190,23,80,337.19582850521437,0.028327868852459016,Very Cheap
20140721T000000,675000.0,3,3.25,1720,1330,2.0,0,0,3,8,1030,690,2004,0,98112,47.62,-122.309,1720,1520,-390,-200,507.5187969924812,0.07868852459016394,Very Cheap
20150121T000000,885000.0,3,2.25,2940,6500,3.0,0,0,3,9,2940,0,2014,0,98136,47.5482,-122.388,1680,6500,3560,4820,136.15384615384616,0.1062295081967213,Cheap
20141021T000000,1450000.0,5,3.5,4170,9090,2.0,0,0,3,10,4170,0,2008,0,98004,47.5918,-122.196,1930,13635,4920,11705,159.51595159515952,0.18032786885245902,Cheap
20141016T000000,780000.0,6,4.25,4310,10000,2.0,0,0,3,8,2950,1360,2008,0,98074,47.6214,-122.062,2100,10000,5690,7900,78.0,0.09245901639344262,Very Cheap
20140712T000000,839950.0,4,2.75,3010,7200,2.0,0,0,3,9,3010,0,2014,0,98033,47.6948,-122.179,3010,7203,4190,4193,116.65972222222223,0.10032131147540983,Cheap
20150424T000000,645000.0,3,2.5,2170,1984,2.5,0,0,3,8,2170,0,2008,0,98027,47.5401,-122.027,2150,1984,-186,-166,325.1008064516129,0.07475409836065573,Very Cheap
20141223T000000,263000.0,3,2.5,1584,3200,2.0,0,0,3,7,1584,0,2011,0,98002,47.3451,-122.215,1584,2800,1616,1216,82.1875,0.024655737704918034,Very Cheap
20141030T000000,345000.0,2,2.25,1110,1290,3.0,0,0,3,8,1110,0,2006,0,98103,47.6968,-122.34,1360,1251,180,-109,267.4418604651163,0.03540983606557377,Very Cheap
20141125T000000,505000.0,4,2.5,2420,5006,2.0,0,0,3,8,2420,0,2013,0,98059,47.4795,-122.126,2750,5471,2586,2721,100.87894526568118,0.05639344262295082,Very Cheap
20140903T000000,522500.0,2,2.25,1430,1210,2.0,0,0,3,8,1340,90,2005,0,98115,47.6765,-122.301,1430,1016,-220,-414,431.8181818181818,0.05868852459016394,Very Cheap
20140811T000000,400000.0,3,2.5,2393,4788,2.0,0,0,3,8,2393,0,2012,0,98055,47.4517,-122.204,2439,5477,2395,3038,83.5421888053467,0.04262295081967213,Very Cheap
20140619T000000,543000.0,3,2.25,1240,949,3.0,0,0,3,8,1240,0,2008,0,98103,47.6488,-122.334,1310,1140,-291,-170,572.1812434141201,0.06137704918032787,Very Cheap
20141013T000000,495000.0,4,2.5,2980,12075,1.0,0,0,3,8,1910,1070,2007,0,98056,47.5074,-122.172,2240,12075,9095,9835,40.993788819875775,0.05508196721311476,Very Cheap
20140911T000000,549995.0,4,3.5,2970,6587,2.0,0,0,3,8,2260,710,2014,0,98059,47.4776,-122.122,2970,5690,3617,2720,83.49703962350084,0.0622944262295082,Very Cheap
20150211T000000,327555.0,3,2.5,2329,5720,2.0,0,0,3,8,2329,0,2010,0,98030,47.362,-122.2,2197,5720,3391,3523,57.26486013986014,0.03312196721311476,Very Cheap
20150409T000000,690000.0,5,3.25,3340,9075,2.0,0,0,3,8,2600,740,2005,0,98065,47.5446,-121.88,2770,6646,5735,3876,76.03305785123968,0.08065573770491803,Very Cheap
20150318T000000,673000.0,4,2.25,2580,2875,2.0,0,0,3,9,2580,0,2015,0,98116,47.5674,-122.392,1290,5750,295,4460,234.08695652173913,0.07842622950819672,Very Cheap
20140721T000000,384435.0,3,2.5,2029,3906,2.0,0,0,3,9,2029,0,2014,0,98003,47.341,-122.18,2029,3920,1877,1891,98.42165898617512,0.040581639344262295,Very Cheap
20140815T000000,780000.0,4,2.75,3430,6500,2.0,0,0,3,9,3050,380,2006,0,98052,47.7079,-122.106,3070,6802,3070,3732,120.0,0.09245901639344262,Very Cheap
20141029T000000,1375000.0,5,3.75,3330,5042,2.0,0,2,3,9,2470,860,2014,0,98103,47.6497,-122.339,1780,3990,1712,2210,272.70924236414123,0.17049180327868851,Cheap
20150324T000000,950968.0,5,3.5,3220,5081,2.0,0,0,3,8,3220,0,2013,0,98052,47.7048,-122.111,2970,5753,1861,2783,187.16158236567605,0.11488104918032786,Cheap
20150329T000000,334950.0,2,2.25,1240,750,2.0,0,0,3,7,1150,90,2008,0,98027,47.5322,-122.073,1240,750,-490,-490,446.6,0.03409180327868853,Very Cheap
20140609T000000,489000.0,3,3.5,1500,1249,2.0,0,0,3,8,1240,260,2004,0,98107,47.6727,-122.373,1440,1850,-251,410,391.5132105684548,0.05429508196721312,Very Cheap
20150420T000000,600000.0,3,3.0,3530,8345,2.0,0,0,3,10,3530,0,2006,0,98028,47.7338,-122.234,1940,9600,4815,7660,71.8993409227082,0.06885245901639345,Very Cheap
20140822T000000,282000.0,3,2.25,1260,915,2.0,0,0,3,8,1020,240,2007,0,98106,47.555,-122.363,1260,1056,-345,-204,308.1967213114754,0.02714754098360656,Very Cheap
20140801T000000,442000.0,4,4.0,4168,8485,2.0,0,0,3,10,3222,946,2007,0,98023,47.3029,-122.387,4362,8100,4317,3738,52.09192692987625,0.048131147540983604,Very Cheap
20150512T000000,220000.0,2,1.5,1030,2850,2.0,0,0,3,7,1030,0,1995,0,98038,47.3845,-122.039,1030,3000,1820,1970,77.19298245614036,0.01901639344262295,Very Cheap
20150218T000000,489000.0,3,2.5,3080,5598,2.0,0,0,3,8,3080,0,2006,0,98055,47.4372,-122.206,3080,5303,2518,2223,87.35262593783494,0.05429508196721312,Very Cheap
20141223T000000,250000.0,3,1.5,1072,4339,2.0,0,0,3,7,1072,0,2009,0,98042,47.386,-122.162,1443,4341,3267,2898,57.61696243374049,0.022950819672131147,Very Cheap
20140724T000000,484259.0,4,2.75,2790,5000,2.0,0,0,3,8,2790,0,2014,0,98045,47.4831,-121.773,2620,5527,2210,2907,96.8518,0.05367331147540984,Very Cheap
20150302T000000,1680000.0,3,2.5,4090,16972,2.0,0,2,3,11,3590,500,2007,0,98177,47.7258,-122.37,3740,16972,12882,13232,98.98656610888523,0.21049180327868852,Cheap
20150424T000000,450000.0,3,2.5,1800,4357,2.0,0,0,3,8,1800,0,2013,0,98065,47.5337,-121.841,1800,3663,2557,1863,103.28207482212531,0.04918032786885246,Very Cheap
20141114T000000,299000.0,2,1.5,830,1276,2.0,0,0,3,7,830,0,2005,0,98122,47.6175,-122.297,1540,1484,446,-56,234.32601880877743,0.02937704918032787,Very Cheap
20141029T000000,450000.0,3,2.5,2280,4557,2.0,0,0,3,8,2280,0,2010,0,98028,47.7733,-122.266,2070,4610,2277,2540,98.74917709019091,0.04918032786885246,Very Cheap
20150123T000000,585000.0,4,3.0,2110,1286,2.0,0,0,3,9,1710,400,2007,0,98029,47.5444,-122.014,2000,1286,-824,-714,454.89891135303264,0.06688524590163934,Very Cheap
20141103T000000,660000.0,3,2.25,1570,1680,3.0,0,0,3,8,1570,0,2014,0,98103,47.6585,-122.348,1290,1870,110,580,392.85714285714283,0.07672131147540984,Very Cheap
20140512T000000,301500.0,2,1.5,830,1333,2.0,0,0,3,7,830,0,2005,0,98136,47.5506,-122.381,1120,4822,503,3702,226.18154538634658,0.029704918032786885,Very Cheap
20140915T000000,949950.0,4,3.75,4120,8258,2.0,0,0,3,10,4120,0,2012,0,98075,47.5872,-122.055,3730,8332,4138,4602,115.03390651489465,0.11474754098360655,Cheap
20141030T000000,759990.0,4,2.5,2540,5760,2.0,0,0,3,9,2540,0,2009,0,98029,47.5405,-121.993,2580,3600,3220,1020,131.94270833333334,0.08983475409836066,Very Cheap
20150316T000000,355000.0,4,2.75,2050,4000,2.0,0,0,3,8,2050,0,2014,0,98001,47.3522,-122.275,2050,4000,1950,1950,88.75,0.036721311475409836,Very Cheap
20140723T000000,889950.0,4,2.75,3080,7242,2.0,0,0,3,9,3080,0,2014,0,98033,47.6948,-122.178,3010,7205,4162,4195,122.88732394366197,0.10687868852459016,Cheap
20140701T000000,629800.0,3,2.5,2390,1984,2.0,0,0,3,8,2220,170,2008,0,98027,47.5405,-122.027,2150,1984,-406,-166,317.43951612903226,0.07276065573770492,Very Cheap
20150424T000000,745000.0,4,2.5,3170,5100,2.0,0,0,3,9,3170,0,2012,0,98056,47.5187,-122.208,1580,5100,1930,3520,146.07843137254903,0.08786885245901639,Very Cheap
20141103T000000,379900.0,2,1.5,1240,1331,2.0,0,0,3,7,1050,190,2007,0,98144,47.5959,-122.298,1250,1431,91,181,285.4244928625094,0.03998688524590164,Very Cheap
20141114T000000,335000.0,3,2.5,1090,1139,2.0,0,0,3,8,960,130,2009,0,98126,47.5664,-122.369,1400,1348,49,-52,294.11764705882354,0.03409836065573771,Very Cheap
20140512T000000,809000.0,5,4.5,4630,6324,2.0,0,0,3,9,3210,1420,2006,0,98065,47.5382,-121.86,4420,6790,1694,2370,127.92536369386464,0.09626229508196721,Very Cheap
20140826T000000,569950.0,4,2.5,3230,5899,2.0,0,0,3,8,3230,0,2012,0,98065,47.515,-121.869,2720,5899,2669,3179,96.61807085946771,0.06491147540983606,Very Cheap
20140808T000000,723000.0,4,3.5,3510,9263,2.0,0,0,3,10,3510,0,2001,0,98065,47.5413,-121.877,3690,10417,5753,6727,78.05246680341142,0.08498360655737705,Very Cheap
20141110T000000,282000.0,4,2.5,1785,2552,2.0,0,0,3,8,1785,0,2009,0,98030,47.3582,-122.2,1691,2700,767,1009,110.50156739811912,0.02714754098360656,Very Cheap
20141030T000000,569900.0,5,3.25,2360,3873,2.0,0,0,3,8,1990,370,2006,0,98108,47.5635,-122.299,1720,3071,1513,1351,147.14691453653498,0.06490491803278689,Very Cheap
20150121T000000,385000.0,4,2.0,2340,9716,1.0,0,0,3,7,2340,0,2009,0,98146,47.4842,-122.347,1180,13500,7376,12320,39.62536023054755,0.04065573770491803,Very Cheap
20140707T000000,420000.0,3,2.25,1620,1075,3.0,0,0,3,8,1540,80,2009,0,98027,47.5405,-122.026,1620,1237,-545,-383,390.69767441860466,0.04524590163934426,Very Cheap
20140806T000000,2250000.0,3,3.25,3890,3452,2.0,0,0,3,12,2890,1000,2006,0,98102,47.626,-122.323,2860,2199,-438,-661,651.7960602549247,0.28524590163934427,Cheap
20140915T000000,1205000.0,4,3.5,3590,5335,2.0,0,2,3,9,3140,450,2006,0,98115,47.6762,-122.267,2100,6250,1745,4150,225.86691658856608,0.1481967213114754,Cheap
20141208T000000,292000.0,4,3.0,1984,4460,2.0,0,0,3,7,1984,0,2012,0,98002,47.3532,-122.211,2095,3402,2476,1307,65.47085201793722,0.028459016393442622,Very Cheap
20150316T000000,645000.0,3,2.25,1640,1023,3.0,0,0,3,8,1640,0,2014,0,98105,47.6636,-122.319,1720,1960,-617,240,630.4985337243402,0.07475409836065573,Very Cheap
20150319T000000,304500.0,4,2.0,1350,942,3.0,0,0,3,7,1350,0,2008,0,98027,47.5394,-122.026,1390,942,-408,-448,323.2484076433121,0.030098360655737705,Very Cheap
20150507T000000,489500.0,4,3.5,2730,5707,2.0,0,0,3,8,2000,730,2011,0,98019,47.7327,-121.965,2430,5899,2977,3469,85.77185912037848,0.05436065573770492,Very Cheap
20150424T000000,1583000.0,4,4.0,5610,11063,3.0,0,0,3,11,4750,860,2006,0,98074,47.65,-122.065,4560,11063,5453,6503,143.08957787218657,0.1977704918032787,Cheap
20150106T000000,390000.0,2,1.0,962,1992,2.0,0,0,3,7,962,0,2012,0,98115,47.6911,-122.313,1130,1992,1030,862,195.78313253012047,0.04131147540983607,Very Cheap
20141002T000000,815000.0,4,3.5,3040,4006,2.0,0,0,3,8,2350,690,2013,0,98029,47.5439,-122.011,2050,4000,966,1950,203.4448327508737,0.09704918032786886,Very Cheap
20150403T000000,719000.0,3,3.5,2540,10578,2.0,0,1,3,9,2010,530,2014,0,98006,47.547,-122.192,3240,9831,8038,6591,67.97126110795992,0.08445901639344262,Very Cheap
20150403T000000,331210.0,4,2.5,2240,4800,2.0,0,0,3,8,2240,0,2014,0,98001,47.2911,-122.266,2240,5040,2560,2800,69.00208333333333,0.03360131147540984,Very Cheap
20140507T000000,245000.0,3,1.5,1260,1270,2.0,0,0,3,7,1040,220,2005,0,98133,47.7111,-122.331,1260,1472,10,212,192.91338582677164,0.022295081967213116,Very Cheap
20140909T000000,465000.0,5,4.0,3210,7200,2.0,0,0,3,8,2410,800,2011,0,98019,47.7329,-121.966,2750,7200,3990,4450,64.58333333333333,0.051147540983606556,Very Cheap
20140930T000000,580000.0,3,2.5,1620,1171,3.0,0,4,3,8,1470,150,2008,0,98103,47.6681,-122.355,1620,1505,-449,-115,495.30315969257043,0.06622950819672131,Very Cheap
20150414T000000,540000.0,3,2.0,1580,1972,2.5,0,2,3,8,1180,400,2007,0,98116,47.5903,-122.386,1500,1908,392,408,273.8336713995943,0.06098360655737705,Very Cheap
20141118T000000,399000.0,3,2.5,1430,1250,3.0,0,0,3,7,1430,0,2007,0,98103,47.6904,-122.342,1360,1269,-180,-91,319.2,0.042491803278688525,Very Cheap
20140804T000000,328000.0,4,2.5,1850,5388,2.0,0,0,3,8,1850,0,2009,0,98038,47.3494,-122.041,2140,5086,3538,2946,60.87602078693393,0.03318032786885246,Very Cheap
20150511T000000,701000.0,4,2.5,3340,5314,2.0,0,0,3,10,3340,0,2010,0,98065,47.5167,-121.885,3220,5500,1974,2280,131.91569439217162,0.08209836065573771,Very Cheap
20141022T000000,408000.0,3,2.75,2670,4800,2.0,0,0,3,8,2670,0,2014,0,98038,47.3483,-122.042,2340,5000,2130,2660,85.0,0.04367213114754098,Very Cheap
20150212T000000,2641100.0,5,4.25,4660,16200,2.0,0,2,3,11,4660,0,2005,0,98004,47.6326,-122.216,3340,16200,11540,12860,163.03086419753086,0.3365377049180328,Medium
20140814T000000,445000.0,3,2.5,1550,930,2.0,0,0,3,8,1060,490,2006,0,98144,47.5857,-122.314,1550,1301,-620,-249,478.494623655914,0.04852459016393443,Very Cheap
20141021T000000,672500.0,4,2.5,3470,6651,2.0,0,0,3,9,3470,0,2005,0,98065,47.5426,-121.879,2730,6179,3181,3449,101.11261464441438,0.07836065573770491,Very Cheap
20140709T000000,538000.0,3,2.5,3010,7014,2.0,0,0,3,8,3010,0,2009,0,98059,47.4949,-122.149,3030,6180,4004,3150,76.70373538637011,0.06072131147540984,Very Cheap
20140904T000000,450000.0,5,3.5,3931,9497,2.0,0,0,3,10,2650,1281,2014,0,98023,47.3008,-122.386,3510,9497,5566,5987,47.383384226597876,0.04918032786885246,Very Cheap
20140619T000000,362500.0,3,2.5,1800,2700,2.0,0,0,3,8,1800,0,2011,0,98126,47.5458,-122.369,1380,1200,900,-180,134.25925925925927,0.03770491803278689,Very Cheap
20141015T000000,414950.0,3,2.5,1570,1551,3.0,0,0,3,8,1570,0,2008,0,98103,47.6961,-122.341,1570,1705,-19,135,267.5370728562218,0.04458360655737705,Very Cheap
20150127T000000,679950.0,3,2.5,2230,3939,2.0,0,0,3,8,2230,0,2014,0,98133,47.73,-122.335,2230,4200,1709,1970,172.61995430312263,0.07933770491803278,Very Cheap
20141112T000000,290000.0,4,2.5,2423,7292,2.0,0,0,3,8,2423,0,2005,0,98023,47.3227,-122.37,2495,7489,4869,4994,39.76961053208996,0.02819672131147541,Very Cheap
20141023T000000,230000.0,3,2.0,1160,1174,2.0,0,0,3,7,790,370,2007,0,98106,47.5225,-122.357,1160,994,14,-166,195.9114139693356,0.020327868852459016,Very Cheap
20150220T000000,439950.0,2,2.0,1440,4666,1.0,0,0,3,8,1440,0,2010,0,98053,47.709,-122.019,1510,4595,3226,3085,94.28846978139734,0.04786229508196721,Very Cheap
20140522T000000,349900.0,4,2.5,2052,3723,2.0,0,0,3,8,2052,0,2014,0,98003,47.2824,-122.295,2052,5250,1671,3198,93.98334676336287,0.036052459016393444,Very Cheap
20141222T000000,550000.0,5,2.5,2780,9272,2.0,0,0,3,8,2780,0,2014,0,98126,47.5168,-122.378,1150,8460,6492,7310,59.318377911993096,0.06229508196721312,Very Cheap
20150430T000000,1050000.0,4,4.25,3720,5750,2.0,0,2,3,9,2960,760,2006,0,98116,47.5632,-122.399,2550,5750,2030,3200,182.6086956521739,0.12786885245901639,Cheap
20150319T000000,655000.0,2,2.25,1460,1851,2.0,0,0,3,9,1180,280,2014,0,98119,47.6461,-122.362,1800,4269,391,2469,353.8627768773636,0.0760655737704918,Very Cheap
20141110T000000,385000.0,3,3.5,1370,1540,2.0,0,0,3,8,1100,270,2006,0,98116,47.5638,-122.388,1370,915,170,-455,250.0,0.04065573770491803,Very Cheap
20150410T000000,729999.0,6,4.5,3600,6110,2.0,0,0,3,9,2510,1090,2012,0,98118,47.5687,-122.291,1360,5800,2510,4440,119.47610474631752,0.08590150819672131,Very Cheap
20140616T000000,523950.0,3,2.25,1420,1282,3.0,0,0,3,8,1420,0,2006,0,98103,47.6533,-122.346,1530,1280,-138,-250,408.6973478939158,0.05887868852459016,Very Cheap
20140512T000000,369000.0,2,2.5,980,895,2.0,0,0,3,8,670,310,2009,0,98116,47.5874,-122.386,980,899,-85,-81,412.29050279329607,0.03855737704918033,Very Cheap
20140505T000000,509900.0,3,2.5,1790,2700,2.0,0,0,3,8,1790,0,2010,0,98027,47.564,-122.093,1890,3078,910,1188,188.85185185185185,0.05703606557377049,Very Cheap
20140715T000000,282000.0,3,2.5,2010,5399,2.0,0,0,3,7,2010,0,2006,0,98042,47.3338,-122.052,2280,5141,3389,2861,52.23189479533247,0.02714754098360656,Very Cheap
20140827T000000,387865.0,3,2.5,2370,4200,2.0,0,0,3,8,2370,0,2014,0,98038,47.3696,-122.018,2370,4200,1830,1830,92.34880952380952,0.041031475409836066,Very Cheap
20141120T000000,385000.0,4,2.5,2560,6238,2.0,0,0,3,8,2560,0,2007,0,98178,47.4899,-122.255,2560,6240,3678,3680,61.71849951907663,0.04065573770491803,Very Cheap
20140609T000000,536000.0,3,2.5,1900,6224,2.0,0,0,3,7,1900,0,2005,0,98075,47.5941,-122.004,2260,5450,4324,3190,86.11825192802057,0.06045901639344262,Very Cheap
20140625T000000,395000.0,2,2.25,1350,1493,2.0,0,0,3,8,1050,300,2007,0,98136,47.5421,-122.388,1250,1202,143,-48,264.56798392498325,0.0419672131147541,Very Cheap
20141117T000000,545000.0,4,2.75,2650,6717,2.0,0,0,3,10,2650,0,2014,0,98056,47.4947,-122.171,2740,7923,4067,5183,81.13741253535805,0.06163934426229508,Very Cheap
20150413T000000,715000.0,4,2.5,3020,7035,2.0,0,4,3,9,3020,0,2001,0,98065,47.5344,-121.874,3020,6771,4015,3751,101.63468372423597,0.0839344262295082,Very Cheap
20140710T000000,348000.0,3,2.5,1500,2255,2.0,0,0,3,7,1500,0,2005,0,98029,47.5538,-121.997,1440,2040,755,600,154.32372505543236,0.03580327868852459,Very Cheap
20140801T000000,455000.0,3,1.75,1320,1014,3.0,0,0,3,9,1320,0,2015,0,98122,47.6047,-122.305,1380,1495,-306,115,448.71794871794873,0.049836065573770495,Very Cheap
20140603T000000,575000.0,4,2.75,3120,7644,2.0,0,0,3,10,3120,0,2010,0,98065,47.5156,-121.884,2980,6050,4524,3070,75.22239665096808,0.06557377049180328,Very Cheap
20141007T000000,449950.0,3,2.25,1540,1270,3.0,0,0,3,7,1540,0,2014,0,98103,47.6935,-122.341,1230,1454,-270,224,354.29133858267716,0.04917377049180328,Very Cheap
20140625T000000,364000.0,3,2.5,1800,2790,2.0,0,0,3,8,1800,0,2011,0,98126,47.5455,-122.371,1580,2036,990,456,130.46594982078852,0.03790163934426229,Very Cheap
20141201T000000,932990.0,4,2.5,3640,6389,2.0,0,0,3,9,3640,0,2014,0,98052,47.7049,-122.123,3570,6303,2749,2733,146.03067772734389,0.11252327868852459,Cheap
20140627T000000,710000.0,3,2.5,2440,4153,2.0,0,0,3,9,2440,0,2003,0,98052,47.665,-122.087,2030,4143,1713,2113,170.9607512641464,0.08327868852459017,Very Cheap
20150213T000000,949990.0,4,4.0,3970,7314,2.0,0,0,3,9,3970,0,2014,0,98074,47.6173,-122.056,3560,5258,3344,1698,129.88651900464862,0.1147527868852459,Cheap
20140731T000000,326989.0,3,2.5,2060,4200,2.0,0,0,3,8,2060,0,2014,0,98038,47.3706,-122.017,2370,4200,2140,1830,77.85452380952381,0.033047737704918034,Very Cheap
20140708T000000,335606.0,3,2.5,2538,4600,2.0,0,0,3,8,2538,0,2013,0,98092,47.2584,-122.196,2570,4800,2062,2230,72.95782608695652,0.03417783606557377,Very Cheap
20140507T000000,1532500.0,5,4.5,4270,8076,2.0,0,0,3,11,3400,870,2007,0,98033,47.699,-122.206,4100,10631,3806,6531,189.75978207033185,0.19114754098360656,Cheap
20141126T000000,299950.0,3,2.5,1320,3150,2.0,0,0,3,7,1320,0,2005,0,98118,47.5328,-122.282,1390,1725,1830,335,95.22222222222223,0.029501639344262295,Very Cheap
20141014T000000,962000.0,4,2.75,3340,5700,2.0,0,0,3,11,3340,0,2013,0,98059,47.5059,-122.146,3340,6940,2360,3600,168.7719298245614,0.11632786885245902,Cheap
20140813T000000,395825.0,2,2.5,1590,1679,2.0,0,0,3,8,1590,0,2012,0,98029,47.5449,-122.011,1590,1680,89,90,235.75044669446098,0.04207540983606557,Very Cheap
20141014T000000,419354.0,5,2.75,2710,4500,2.0,0,0,3,8,2710,0,2014,0,98038,47.3547,-122.062,2710,4626,1790,1916,93.18977777777778,0.04516118032786885,Very Cheap
20140826T000000,920000.0,4,2.75,3140,7258,2.0,0,1,3,10,3140,0,2006,0,98034,47.7064,-122.232,2990,13600,4118,10610,126.75668228162029,0.11081967213114755,Cheap
20140829T000000,366000.0,3,2.25,1445,1028,2.0,0,0,3,7,1300,145,2005,0,98027,47.5339,-122.067,1445,1377,-417,-68,356.0311284046693,0.03816393442622951,Very Cheap
20140516T000000,480000.0,4,2.5,2430,5000,2.0,0,0,3,7,2430,0,2009,0,98065,47.515,-121.873,2430,5441,2570,3011,96.0,0.05311475409836065,Very Cheap
20141120T000000,388000.0,3,3.25,1370,915,2.0,0,0,3,8,1100,270,2006,0,98116,47.5639,-122.388,1370,1146,-455,-224,424.04371584699453,0.041049180327868855,Very Cheap
20150421T000000,2320000.0,4,3.5,5050,9520,2.0,0,0,3,11,3610,1440,2007,0,98004,47.6364,-122.209,2430,9248,4470,6818,243.69747899159663,0.29442622950819675,Cheap
20150121T000000,730000.0,3,2.5,1860,1290,2.0,0,0,3,9,1240,620,2010,0,98122,47.6179,-122.301,1710,1525,-570,-185,565.8914728682171,0.0859016393442623,Very Cheap
20140521T000000,950000.0,5,3.75,5330,6000,2.0,0,2,3,10,3570,1760,2006,0,98027,47.5401,-122.073,4420,5797,670,1377,158.33333333333334,0.11475409836065574,Cheap
20140728T000000,358990.0,3,3.25,1710,2171,2.0,0,0,3,7,1400,310,2014,0,98106,47.5434,-122.368,1380,1300,461,-80,165.35697835099032,0.03724459016393443,Very Cheap
20141016T000000,398651.0,4,2.5,2650,4120,2.0,0,0,3,8,2650,0,2014,0,98146,47.5019,-122.34,2030,3768,1470,1738,96.75995145631067,0.042446032786885246,Very Cheap
20141114T000000,530000.0,4,2.5,2590,7891,2.0,0,0,3,9,2590,0,2006,0,98056,47.5055,-122.194,1400,7891,5301,6491,67.16512482575085,0.05967213114754098,Very Cheap
20140723T000000,610360.0,4,2.5,2610,5562,2.0,0,0,3,9,2610,0,2013,0,98056,47.5137,-122.169,2720,7400,2952,4680,109.73750449478605,0.0702111475409836,Very Cheap
20140502T000000,436110.0,3,2.5,1770,1235,3.0,0,0,3,8,1600,170,2007,0,98103,47.6965,-122.342,1680,1203,-535,-477,353.1255060728745,0.047358688524590166,Very Cheap
20140620T000000,925000.0,4,2.75,3730,8014,2.0,0,0,3,10,3730,0,2012,0,98074,47.6036,-122.059,3670,8279,4284,4609,115.4230097329673,0.11147540983606558,Cheap
20150313T000000,449950.0,4,2.5,2420,5244,2.0,0,0,3,9,2420,0,2007,0,98166,47.4729,-122.35,1400,5250,2824,3850,85.80282227307399,0.04917377049180328,Very Cheap
20140527T000000,760000.0,4,2.5,3330,7399,2.0,0,0,3,9,3330,0,2009,0,98052,47.679,-122.153,2640,8601,4069,5961,102.71658332207055,0.0898360655737705,Very Cheap
20140708T000000,293000.0,3,2.25,1910,3481,2.0,0,0,3,8,1910,0,2009,0,98055,47.4293,-122.188,1714,3177,1571,1463,84.17121516805516,0.02859016393442623,Very Cheap
20150212T000000,695000.0,2,2.5,2170,7665,1.0,0,2,3,8,2170,0,2013,0,98053,47.7112,-122.019,2300,7100,5495,4800,90.67188519243314,0.08131147540983606,Very Cheap
20140604T000000,285000.0,3,2.5,2437,5136,2.0,0,0,3,7,2437,0,2011,0,98002,47.3517,-122.21,2437,4614,2699,2177,55.49065420560748,0.02754098360655738,Very Cheap
20141230T000000,1255780.0,5,4.0,4180,12042,2.0,0,0,3,10,4180,0,2014,0,98075,47.5959,-122.014,1800,6052,7862,4252,104.28334163760172,0.15485639344262295,Cheap
20140714T000000,379900.0,3,2.5,1800,2791,2.0,0,0,3,8,1800,0,2011,0,98126,47.5442,-122.371,1580,2617,991,1037,136.1160874238624,0.03998688524590164,Very Cheap
20150427T000000,472000.0,5,2.5,2570,7412,2.0,0,0,3,8,2570,0,2006,0,98019,47.7265,-121.957,2890,8056,4842,5166,63.68051807879115,0.052065573770491806,Very Cheap
20140707T000000,300000.0,4,2.5,2090,5195,2.0,0,0,3,7,2090,0,2007,0,98031,47.3986,-122.166,2090,5236,3105,3146,57.74783445620789,0.029508196721311476,Very Cheap
20141120T000000,272000.0,4,2.5,2789,3960,2.0,0,0,3,7,2789,0,2007,0,98001,47.3059,-122.28,2547,3960,1171,1413,68.68686868686869,0.02583606557377049,Very Cheap
20141120T000000,418395.0,4,2.5,2906,5893,2.0,0,0,3,9,2906,0,2014,0,98092,47.2599,-122.192,2680,4950,2987,2270,70.99864245715256,0.045035409836065576,Very Cheap
20141222T000000,465000.0,5,2.5,2550,6405,2.0,0,0,3,7,2550,0,2008,0,98065,47.5191,-121.869,2190,5900,3855,3710,72.59953161592506,0.051147540983606556,Very Cheap
20140716T000000,659950.0,4,2.75,3550,9400,2.0,0,0,3,9,3550,0,2014,0,98059,47.4827,-122.131,3550,9421,5850,5871,70.20744680851064,0.07671475409836065,Very Cheap
20150107T000000,484950.0,3,2.25,1590,926,3.0,0,0,3,8,1590,0,2014,0,98136,47.5402,-122.387,1640,1321,-664,-319,523.7041036717062,0.05376393442622951,Very Cheap
20150426T000000,359000.0,3,2.25,1950,1968,2.0,0,0,4,7,1160,790,1979,0,98056,47.5179,-122.195,1950,1968,18,18,182.41869918699186,0.03724590163934426,Very Cheap
20140617T000000,519000.0,4,2.5,3250,4500,2.0,0,0,3,8,3250,0,2009,0,98059,47.4944,-122.149,3030,4518,1250,1488,115.33333333333333,0.05822950819672131,Very Cheap
20140527T000000,1710000.0,5,4.5,4590,14685,2.0,0,0,3,10,4590,0,2009,0,98033,47.664,-122.2,3030,9486,10095,6456,116.44535240040858,0.21442622950819673,Cheap
20140617T000000,535000.0,4,2.75,3070,7201,2.0,0,0,3,9,3070,0,2006,0,98059,47.4897,-122.147,2880,8364,4131,5484,74.29523677267046,0.06032786885245902,Very Cheap
20150409T000000,622950.0,4,3.25,3030,7644,2.0,0,0,3,8,2830,200,2006,0,98065,47.5457,-121.881,3400,6908,4614,3508,81.49529042386185,0.07186229508196722,Very Cheap
20140811T000000,515000.0,3,2.5,2610,5845,2.0,0,0,3,8,2610,0,2005,0,98059,47.4821,-122.142,2810,5000,3235,2190,88.10949529512403,0.057704918032786885,Very Cheap
20140522T000000,330000.0,4,3.5,3150,6202,2.0,0,0,3,7,3150,0,2005,0,98042,47.3993,-122.162,2950,5940,3052,2990,53.20864237342793,0.03344262295081967,Very Cheap
20150213T000000,318000.0,3,1.5,1240,983,3.0,0,0,3,8,1240,0,2009,0,98133,47.7235,-122.353,1240,1026,-257,-214,323.499491353001,0.03186885245901639,Very Cheap
20141007T000000,439000.0,3,2.5,1680,2801,2.0,0,0,3,7,1680,0,2011,0,98011,47.745,-122.181,1920,2723,1121,803,156.72973937879328,0.04773770491803279,Very Cheap
20150324T000000,540000.0,3,2.5,2220,5279,2.0,0,0,3,8,2220,0,2006,0,98146,47.5132,-122.387,1610,5297,3059,3687,102.29210077666225,0.06098360655737705,Very Cheap
20140717T000000,1079000.0,4,3.25,4800,12727,2.0,0,0,3,10,4800,0,2011,0,98059,47.5311,-122.134,4750,13602,7927,8852,84.78038815117466,0.13167213114754098,Cheap
20150326T000000,435000.0,4,2.5,3100,4699,2.0,0,0,3,9,3100,0,2010,0,98038,47.3785,-122.023,2450,5130,1599,2680,92.5728878484784,0.04721311475409836,Very Cheap
20150122T000000,2700000.0,4,4.0,7850,89651,2.0,0,0,3,12,7850,0,2006,0,98027,47.5406,-121.982,6210,95832,81801,89622,30.116786204281045,0.3442622950819672,Medium
20141017T000000,1100000.0,4,2.75,3590,5625,2.0,0,0,3,10,3590,0,2012,0,98052,47.6959,-122.133,3590,5625,2035,2035,195.55555555555554,0.13442622950819672,Cheap
20150206T000000,293467.0,4,2.0,1590,942,3.0,0,0,3,7,1590,0,2008,0,98027,47.54,-122.026,1390,942,-648,-448,311.53609341825904,0.028651409836065574,Very Cheap
20150512T000000,328000.0,3,2.5,2242,4800,2.0,0,0,3,8,2242,0,2013,0,98092,47.2581,-122.2,2009,4800,2558,2791,68.33333333333333,0.03318032786885246,Very Cheap
20140708T000000,550000.0,3,3.5,2490,3582,2.0,0,0,3,8,1720,770,2005,0,98027,47.5338,-122.067,1445,1590,1092,145,153.54550530429927,0.06229508196721312,Very Cheap
20150402T000000,649000.0,3,2.0,1530,1442,3.0,0,0,3,9,1530,0,2015,0,98107,47.6692,-122.372,1620,1456,-88,-164,450.06934812760056,0.07527868852459016,Very Cheap
20140708T000000,435000.0,4,2.5,2150,3143,2.0,0,0,3,7,2150,0,2010,0,98059,47.5048,-122.154,2640,3200,993,560,138.40279987273306,0.04721311475409836,Very Cheap
20140620T000000,625000.0,3,2.5,2440,4800,2.0,0,0,3,10,2440,0,2014,0,98106,47.5595,-122.365,1180,5480,2360,4300,130.20833333333334,0.07213114754098361,Very Cheap
20150429T000000,415000.0,3,1.5,1270,1483,3.0,0,0,3,8,1270,0,2007,0,98115,47.6987,-122.317,1270,1413,213,143,279.838165879973,0.04459016393442623,Very Cheap
20140603T000000,400000.0,3,2.25,1450,4706,2.0,0,0,3,7,1450,0,2009,0,98028,47.761,-122.232,1490,4667,3256,3177,84.99787505312368,0.04262295081967213,Very Cheap
20140506T000000,979000.0,3,2.5,2690,4047,3.0,0,0,3,10,2690,0,2014,0,98117,47.6797,-122.385,2040,5000,1357,2960,241.90758586607365,0.11855737704918033,Cheap
20150220T000000,625250.0,4,2.5,2755,4831,2.0,0,0,3,7,2755,0,2003,0,98053,47.685,-122.039,2510,4831,2076,2321,129.42454978265368,0.07216393442622951,Very Cheap
20140909T000000,665000.0,4,3.5,2650,3474,2.0,0,0,3,8,2230,420,2011,0,98027,47.5377,-122.046,2330,3474,824,1144,191.42199194012665,0.07737704918032787,Very Cheap
20140627T000000,589500.0,3,3.25,2310,3075,2.0,0,0,3,8,1730,580,2005,0,98116,47.5644,-122.383,2310,3075,765,765,191.70731707317074,0.06747540983606558,Very Cheap
20150309T000000,437000.0,2,3.0,1460,1452,2.0,0,0,3,8,1140,320,2007,0,98136,47.5224,-122.39,1460,1452,-8,-8,300.9641873278237,0.047475409836065574,Very Cheap
20141001T000000,320000.0,3,1.0,1400,9000,1.0,0,0,5,7,1400,0,1959,0,98059,47.5022,-122.145,1440,8400,7600,6960,35.55555555555556,0.032131147540983604,Very Cheap
20150114T000000,333500.0,3,2.5,2196,7475,2.0,0,0,3,8,2196,0,2006,0,98030,47.3803,-122.204,1860,6755,5279,4895,44.61538461538461,0.033901639344262297,Very Cheap
20141124T000000,430000.0,3,2.25,2020,2750,2.0,0,0,3,8,1680,340,2008,0,98108,47.5633,-122.297,1720,1546,730,-174,156.36363636363637,0.04655737704918033,Very Cheap
20140805T000000,995500.0,5,4.5,4280,8465,2.0,0,0,3,10,4280,0,2014,0,98034,47.7325,-122.165,2990,11067,4185,8077,117.60189013585351,0.12072131147540983,Cheap
20140603T000000,427874.0,3,3.0,2340,5002,2.0,0,0,3,8,2340,0,2013,0,98045,47.4831,-121.773,2790,5375,2662,2585,85.5405837664934,0.04627855737704918,Very Cheap
20140521T000000,334990.0,4,2.5,2220,4228,2.0,0,0,3,8,2220,0,2014,0,98146,47.5014,-122.341,2220,4157,2008,1937,79.23131504257331,0.03409704918032787,Very Cheap
20150211T000000,909500.0,4,4.0,4420,5940,2.0,0,0,3,10,3410,1010,2006,0,98027,47.5397,-122.072,4510,5797,1520,1287,153.11447811447812,0.10944262295081968,Cheap
20150319T000000,210000.0,3,2.0,1580,4961,2.0,0,0,3,7,1580,0,2006,0,98042,47.3338,-122.053,2280,5000,3381,2720,42.33017536786938,0.017704918032786884,Very Cheap
20150123T000000,952990.0,4,2.75,3550,6558,2.0,0,0,3,9,3550,0,2013,0,98052,47.7076,-122.115,3140,5617,3008,2477,145.31716986886246,0.11514622950819672,Cheap
20150218T000000,622500.0,2,1.75,1510,851,3.0,0,0,3,8,1420,90,2013,0,98107,47.6536,-122.358,1300,1338,-659,38,731.4923619271445,0.0718032786885246,Very Cheap
20140618T000000,515000.0,3,3.5,1360,1419,2.0,0,0,3,8,1040,320,2007,0,98107,47.6697,-122.371,1560,1977,59,417,362.93164200140944,0.057704918032786885,Very Cheap
20150126T000000,350000.0,3,2.5,2040,13590,2.0,0,0,3,8,2040,0,2009,0,98042,47.3122,-122.04,1850,12485,11550,10635,25.754231052244297,0.036065573770491806,Very Cheap
20141016T000000,310000.0,1,1.5,1120,912,3.0,0,0,3,7,1120,0,2011,0,98144,47.5924,-122.299,1380,3200,-208,1820,339.9122807017544,0.03081967213114754,Very Cheap
20140528T000000,700000.0,4,3.5,4490,5099,2.0,0,0,3,9,3390,1100,2006,0,98065,47.5394,-121.861,4290,5537,609,1247,137.28181996469897,0.08196721311475409,Very Cheap
20140715T000000,907687.0,4,2.5,3560,6786,2.0,0,0,3,9,2930,630,2014,0,98075,47.5756,-122.071,3560,5886,3226,2326,133.7587680518715,0.1092048524590164,Cheap
20140709T000000,741500.0,2,2.5,2150,5760,1.0,0,0,3,8,2150,0,2010,0,98053,47.7094,-122.018,1640,4680,3610,3040,128.73263888888889,0.08740983606557377,Very Cheap
20140724T000000,395000.0,3,2.5,2130,5088,2.0,0,0,3,8,1840,290,2011,0,98019,47.7329,-121.976,2130,5762,2958,3632,77.63364779874213,0.0419672131147541,Very Cheap
20150223T000000,559950.0,5,2.75,2990,6370,2.0,0,0,3,8,2990,0,2014,0,98059,47.4853,-122.154,2730,5740,3380,3010,87.90423861852433,0.0636,Very Cheap
20140725T000000,215000.0,4,2.5,1847,8000,2.0,0,0,3,7,1847,0,2008,0,98001,47.2872,-122.257,1847,8000,6153,6153,26.875,0.018360655737704918,Very Cheap
20150222T000000,390000.0,4,2.5,2610,7227,2.0,0,0,3,9,2610,0,2011,0,98010,47.314,-122.023,2630,7421,4617,4791,53.964300539643006,0.04131147540983607,Very Cheap
20150303T000000,425000.0,3,2.25,1670,107157,1.0,0,0,3,7,1670,0,2007,0,98022,47.2743,-122.009,3310,108900,105487,105590,3.966143135772745,0.04590163934426229,Very Cheap
20150507T000000,472000.0,3,2.5,1860,415126,2.0,0,0,3,7,1860,0,2006,0,98038,47.3974,-122.005,2070,54014,413266,51944,1.1370041866806704,0.052065573770491806,Very Cheap
20150407T000000,1330000.0,4,3.5,3440,9776,2.0,0,0,3,10,3440,0,2006,0,98040,47.5374,-122.216,2400,11000,6336,8600,136.04746317512274,0.16459016393442624,Cheap
20140610T000000,695000.0,4,3.5,3510,9364,2.0,0,0,3,10,3510,0,2001,0,98065,47.54,-121.876,3510,9161,5854,5651,74.22041862451944,0.08131147540983606,Very Cheap
20150120T000000,545000.0,3,2.5,1740,1279,3.0,0,0,3,8,1740,0,2008,0,98116,47.589,-122.387,1740,1280,-461,-460,426.1141516810008,0.06163934426229508,Very Cheap
20140711T000000,389950.0,4,2.5,2240,5500,2.0,0,0,3,8,2240,0,2013,0,98056,47.496,-122.169,700,5500,3260,4800,70.9,0.04130491803278689,Very Cheap
20150330T000000,380000.0,3,2.25,1550,1485,3.0,0,0,3,8,1550,0,2011,0,98103,47.6989,-122.346,1550,1480,-65,-70,255.8922558922559,0.04,Very Cheap
20141117T000000,288790.0,4,2.0,1390,745,3.0,0,0,3,7,1390,0,2008,0,98027,47.5401,-122.026,1390,942,-645,-448,387.63758389261744,0.028038032786885245,Very Cheap
20150401T000000,432500.0,3,3.0,2500,6000,2.0,0,0,3,8,2500,0,2012,0,98058,47.4408,-122.161,2130,6000,3500,3870,72.08333333333333,0.046885245901639346,Very Cheap
20141206T000000,615000.0,3,3.5,2710,3326,2.0,0,0,3,8,1650,1060,2005,0,98027,47.5371,-122.073,2280,2738,616,458,184.90679494888755,0.07081967213114754,Very Cheap
20140707T000000,500000.0,3,2.5,1720,3012,2.0,0,0,3,9,1720,0,2011,0,98133,47.7312,-122.334,1720,7658,1292,5938,166.00265604249668,0.05573770491803279,Very Cheap
20140531T000000,615000.0,3,2.25,1760,1146,3.0,0,0,3,9,1760,0,2014,0,98122,47.6073,-122.304,1346,3472,-614,2126,536.6492146596859,0.07081967213114754,Very Cheap
20140926T000000,500000.0,4,2.25,2270,8196,1.0,0,0,5,7,1150,1120,1963,0,98034,47.7214,-122.227,1920,10122,5926,8202,61.00536847242557,0.05573770491803279,Very Cheap
20141015T000000,622000.0,3,3.5,1690,1765,2.0,0,0,3,8,1370,320,2006,0,98103,47.6536,-122.34,1690,1694,75,4,352.40793201133147,0.07173770491803279,Very Cheap
20150409T000000,802945.0,5,3.5,4000,9234,2.0,0,0,3,9,4000,0,2015,0,98024,47.5265,-121.887,3690,6600,5234,2910,86.95527398743774,0.09546819672131147,Very Cheap
20140731T000000,1260000.0,4,2.5,2880,9003,2.0,0,0,3,10,2880,0,2008,0,98033,47.6844,-122.199,2640,8126,6123,5486,139.95334888370544,0.15540983606557376,Cheap
20150224T000000,598950.0,3,2.5,1480,1531,3.0,0,0,3,8,1480,0,2014,0,98107,47.669,-122.402,1530,1321,51,-209,391.2148922273024,0.06871475409836066,Very Cheap
20150102T000000,430000.0,3,2.5,1950,4949,2.0,0,0,3,7,1950,0,2009,0,98065,47.5155,-121.87,2200,5740,2999,3540,86.8862396443726,0.04655737704918033,Very Cheap
20141124T000000,515000.0,4,2.75,2700,5150,2.0,0,0,3,9,2700,0,2009,0,98065,47.5209,-121.874,2700,5747,2450,3047,100.0,0.057704918032786885,Very Cheap
20140717T000000,1262000.0,2,3.0,2210,3917,2.0,0,0,3,10,1500,710,2008,0,98122,47.6166,-122.291,1720,3933,1707,2213,322.18534592800614,0.15567213114754097,Cheap
20140609T000000,400000.0,4,3.5,2370,3692,2.5,0,0,3,8,2370,0,2013,0,98056,47.5044,-122.17,2520,5425,1322,2905,108.34236186348862,0.04262295081967213,Very Cheap
20150422T000000,390000.0,3,2.5,1310,1254,2.0,0,0,3,7,850,460,2007,0,98116,47.5622,-122.384,1310,1372,-56,62,311.0047846889952,0.04131147540983607,Very Cheap
20141001T000000,450000.0,3,2.5,2410,4293,2.0,0,0,3,7,2410,0,2007,0,98065,47.5196,-121.869,2190,5900,1883,3710,104.82180293501048,0.04918032786885246,Very Cheap
20140516T000000,804995.0,5,1.5,3360,5402,2.0,0,0,3,9,3360,0,2014,0,98074,47.6067,-122.053,3360,5415,2042,2055,149.01795631247685,0.09573704918032787,Very Cheap
20150326T000000,825000.0,4,3.25,3040,4155,2.0,0,0,3,8,2350,690,2013,0,98029,47.5429,-122.012,2680,4000,1115,1320,198.55595667870037,0.09836065573770492,Very Cheap
20140513T000000,435000.0,4,2.25,2140,6355,2.0,0,0,3,7,2140,0,2002,0,98065,47.5367,-121.88,2480,5746,4215,3266,68.45003933910307,0.04721311475409836,Very Cheap
20140609T000000,398000.0,3,2.5,1720,1715,2.0,0,0,3,7,1240,480,2004,0,98136,47.5481,-122.384,1610,1626,-5,16,232.06997084548104,0.042360655737704915,Very Cheap
20140605T000000,411605.0,4,2.5,2658,3960,2.0,0,0,3,9,2658,0,2014,0,98092,47.2603,-122.194,2578,4200,1302,1622,103.94065656565657,0.04414491803278688,Very Cheap
20141208T000000,315000.0,3,3.25,1480,983,2.0,0,0,3,8,1180,300,2013,0,98106,47.5555,-122.363,1330,1062,-497,-268,320.4476093591048,0.031475409836065574,Very Cheap
20141120T000000,455000.0,2,2.0,1350,1209,3.0,0,0,3,8,1350,0,2013,0,98199,47.649,-122.383,1310,982,-141,-328,376.3440860215054,0.049836065573770495,Very Cheap
20150501T000000,452950.0,3,2.5,1150,1194,2.0,0,0,3,8,1020,130,2006,0,98107,47.6684,-122.365,1450,1714,44,264,379.35510887772193,0.0495672131147541,Very Cheap
20140520T000000,380000.0,3,1.75,1690,1468,2.0,0,0,3,8,1380,310,2008,0,98108,47.563,-122.297,1690,1936,-222,246,258.8555858310627,0.04,Very Cheap
20141124T000000,340000.0,2,1.75,1270,1916,2.0,0,0,3,8,1270,0,2012,0,98108,47.5648,-122.294,1140,1916,646,776,177.45302713987473,0.03475409836065574,Very Cheap
20141103T000000,409950.0,3,2.5,2655,5080,2.0,0,0,3,8,2655,0,2013,0,98023,47.2972,-122.348,2879,5232,2425,2353,80.69881889763779,0.043927868852459015,Very Cheap
20150504T000000,360000.0,2,1.0,880,1165,2.0,0,0,3,8,880,0,2005,0,98122,47.6192,-122.297,1640,3825,285,2185,309.0128755364807,0.037377049180327866,Very Cheap
20150403T000000,1595000.0,4,4.25,4645,7757,2.0,0,0,3,10,3855,790,2006,0,98112,47.6248,-122.29,2150,6970,3112,4820,205.62072966352972,0.19934426229508198,Cheap
20140520T000000,440000.0,3,1.5,1270,1443,3.0,0,0,3,8,1270,0,2007,0,98115,47.699,-122.317,1270,1413,173,143,304.92030492030494,0.04786885245901639,Very Cheap
20140910T000000,730000.0,2,1.75,1728,95950,1.0,0,3,3,9,1728,0,2012,0,98070,47.4579,-122.443,1720,35735,94222,34015,7.60812923397603,0.0859016393442623,Very Cheap
20140522T000000,408000.0,3,2.25,1950,7221,1.0,0,0,4,8,1950,0,2006,0,98188,47.431,-122.285,2310,8125,5271,5815,56.501869547154136,0.04367213114754098,Very Cheap
20140825T000000,820000.0,4,2.5,3170,3862,3.0,0,0,3,8,3170,0,2008,0,98034,47.6705,-122.145,2840,4181,692,1341,212.32522009321596,0.09770491803278689,Very Cheap
20140731T000000,360000.0,2,2.5,1233,1244,2.0,0,0,3,7,963,270,2007,0,98136,47.5533,-122.381,1230,1300,11,70,289.3890675241158,0.037377049180327866,Very Cheap
20140620T000000,339990.0,3,2.5,2570,4600,2.0,0,0,3,8,2570,0,2014,0,98092,47.2582,-122.196,2570,5000,2030,2430,73.9108695652174,0.0347527868852459,Very Cheap
20141008T000000,515000.0,3,2.0,1560,1020,3.0,0,0,3,8,1560,0,2014,0,98122,47.605,-122.304,1560,1728,-540,168,504.9019607843137,0.057704918032786885,Very Cheap
20150121T000000,541000.0,3,1.75,1630,1166,2.0,0,0,3,8,1020,610,2013,0,98107,47.6646,-122.367,1420,1670,-464,250,463.9794168096055,0.06111475409836065,Very Cheap
20150406T000000,375000.0,4,2.5,2510,7245,2.0,0,0,3,9,2510,0,2007,0,98146,47.5096,-122.363,1830,8900,4735,7070,51.75983436853002,0.03934426229508197,Very Cheap
20141020T000000,320000.0,4,2.5,2223,5780,2.0,0,0,3,8,2223,0,2010,0,98042,47.3586,-122.157,1690,7766,3557,6076,55.36332179930796,0.032131147540983604,Very Cheap
20150227T000000,325000.0,2,2.25,1230,1058,2.0,0,0,3,7,1160,70,2008,0,98027,47.5325,-122.073,1240,817,-172,-423,307.1833648393195,0.03278688524590164,Very Cheap
20150318T000000,740000.0,5,2.75,3050,7520,2.0,0,0,3,8,3050,0,2014,0,98056,47.5245,-122.184,2180,10800,4470,8620,98.40425531914893,0.08721311475409836,Very Cheap
20141030T000000,450000.0,5,2.75,2710,6220,2.0,0,0,3,8,2710,0,2014,0,98038,47.3555,-122.061,2530,4759,3510,2229,72.34726688102894,0.04918032786885246,Very Cheap
20140723T000000,455000.0,4,2.5,2090,4400,2.0,0,0,3,8,2090,0,2011,0,98118,47.5403,-122.286,2090,3430,2310,1340,103.4090909090909,0.049836065573770495,Very Cheap
20150203T000000,292500.0,3,2.5,1440,1068,2.0,0,0,3,8,1160,280,2006,0,98106,47.5393,-122.361,1580,1483,-372,-97,273.87640449438203,0.028524590163934428,Very Cheap
20140806T000000,650000.0,3,2.5,2500,51836,1.0,0,0,3,9,1510,990,2013,0,98027,47.4694,-121.989,2270,54450,49336,52180,12.539547804614553,0.07540983606557378,Very Cheap
20150306T000000,530000.0,4,2.75,2740,7872,2.0,0,0,3,10,2740,0,2015,0,98056,47.4954,-122.172,1220,6300,5132,5080,67.32723577235772,0.05967213114754098,Very Cheap
20140804T000000,829995.0,5,3.25,3360,6120,2.0,0,0,3,9,3360,0,2014,0,98074,47.607,-122.053,3230,5398,2760,2168,135.6200980392157,0.09901573770491803,Very Cheap
20141223T000000,395000.0,4,2.75,2280,5013,2.0,0,0,3,8,2280,0,2009,0,98019,47.7333,-121.976,2130,5121,2733,2991,78.79513265509675,0.0419672131147541,Very Cheap
20140711T000000,859990.0,4,2.75,3520,5500,2.0,0,0,3,9,3520,0,2014,0,98074,47.6181,-122.056,3340,5500,1980,2160,156.3618181818182,0.10294950819672131,Cheap
20140710T000000,342500.0,2,1.5,1320,826,2.0,0,0,3,8,1100,220,2008,0,98144,47.5879,-122.304,1340,1213,-494,-127,414.6489104116223,0.035081967213114754,Very Cheap
20141205T000000,743000.0,4,2.75,3410,5838,2.0,0,0,3,9,3410,0,2012,0,98053,47.6931,-122.022,3420,7048,2428,3628,127.26961288112368,0.08760655737704919,Very Cheap
20141215T000000,345000.0,3,2.25,2730,9388,1.0,0,0,3,7,1390,1340,1975,0,98030,47.3785,-122.185,2255,5701,6658,3446,36.74904132935662,0.03540983606557377,Very Cheap
20141231T000000,443000.0,3,2.5,1780,2778,2.0,0,0,3,8,1530,250,2007,0,98126,47.5487,-122.372,1380,1998,998,618,159.46724262059035,0.048262295081967214,Very Cheap
20140929T000000,260000.0,3,2.5,1427,4337,2.0,0,0,3,7,1427,0,2009,0,98042,47.3857,-122.162,1443,4347,2910,2904,59.94927369149181,0.024262295081967214,Very Cheap
20140722T000000,810000.0,4,2.5,2910,6555,2.0,0,0,3,9,2910,0,2005,0,98033,47.6659,-122.172,2910,10419,3645,7509,123.56979405034325,0.09639344262295083,Very Cheap
20141222T000000,570000.0,4,2.75,3250,5600,2.0,0,0,3,8,3250,0,2011,0,98059,47.4806,-122.125,2730,5667,2350,2937,101.78571428571429,0.06491803278688525,Very Cheap
20150303T000000,1563100.0,5,3.5,3630,8100,2.0,0,0,3,10,3630,0,2008,0,98004,47.5951,-122.2,1730,8246,4470,6516,192.97530864197532,0.1951606557377049,Cheap
20141113T000000,840000.0,2,2.5,1680,975,3.0,0,0,3,9,1680,0,2009,0,98119,47.6321,-122.361,1680,977,-705,-703,861.5384615384615,0.10032786885245902,Cheap
20150414T000000,950000.0,3,2.5,2280,2296,3.0,0,0,3,9,1890,390,2013,0,98112,47.6256,-122.299,1390,4000,16,2610,413.7630662020906,0.11475409836065574,Cheap
20150127T000000,572800.0,3,2.5,3310,4682,2.0,0,0,3,9,2380,930,2015,0,98065,47.5201,-121.885,2660,5166,1372,2506,122.34087996582657,0.06528524590163934,Very Cheap
20141001T000000,305000.0,3,3.0,1290,1112,3.0,0,0,3,7,1290,0,2008,0,98125,47.7282,-122.296,1230,9000,-178,7770,274.28057553956836,0.03016393442622951,Very Cheap
20140730T000000,1695000.0,5,4.75,3940,7067,2.0,0,0,3,10,3230,710,2008,0,98004,47.6232,-122.205,1910,7735,3127,5825,239.84717701995189,0.2124590163934426,Cheap
20140827T000000,445000.0,4,2.5,2170,6000,2.0,0,0,3,7,1630,540,2008,0,98106,47.5589,-122.365,1720,5668,3830,3948,74.16666666666667,0.04852459016393443,Very Cheap
20140902T000000,801000.0,4,3.5,3290,8059,2.0,0,0,3,9,3290,0,2012,0,98029,47.5573,-122.02,3290,10758,4769,7468,99.39198411713612,0.09521311475409835,Very Cheap
20140714T000000,711000.0,3,2.5,2550,5376,2.0,0,0,3,9,2550,0,2004,0,98052,47.6647,-122.083,2250,4050,2826,1800,132.25446428571428,0.08340983606557377,Very Cheap
20140827T000000,268500.0,3,2.25,1140,977,2.0,0,0,3,7,850,290,2008,0,98126,47.5439,-122.375,1140,976,-163,-164,274.82088024564996,0.02537704918032787,Very Cheap
20141006T000000,320000.0,4,2.5,2300,3825,2.0,0,0,3,7,2300,0,2012,0,98042,47.3594,-122.082,2110,3825,1525,1715,83.66013071895425,0.032131147540983604,Very Cheap
20140921T000000,500000.0,4,3.25,2670,5001,1.0,0,0,3,9,1640,1030,2013,0,98108,47.5666,-122.293,1610,5001,2331,3391,99.98000399920016,0.05573770491803279,Very Cheap
20140505T000000,631625.0,4,2.5,2440,6651,2.0,0,0,3,9,2440,0,2014,0,98117,47.6971,-122.371,1350,7653,4211,6303,94.96692226732821,0.073,Very Cheap
20150127T000000,850000.0,2,2.5,1611,2210,2.0,0,2,3,10,1611,0,2005,0,98109,47.6291,-122.347,2070,2182,599,112,384.61538461538464,0.10163934426229508,Cheap
20141027T000000,600000.0,3,3.5,2710,3290,2.0,0,0,3,8,1650,1060,2006,0,98027,47.5367,-122.072,2440,3290,580,850,182.370820668693,0.06885245901639345,Very Cheap
20140508T000000,988500.0,3,2.75,2015,16807,2.0,1,4,3,9,2015,0,2007,0,98166,47.45,-122.377,1780,12310,14792,10530,58.814779556137324,0.11980327868852458,Cheap
20150327T000000,430236.0,4,3.25,3444,5166,2.0,0,0,3,8,2714,730,2014,0,98023,47.2966,-122.348,2848,5182,1722,2334,83.28222996515679,0.04658832786885246,Very Cheap
20140915T000000,1266520.0,3,2.5,3060,9576,2.0,0,0,3,10,3060,0,2005,0,98004,47.5928,-122.199,3060,9579,6516,6519,132.25981620718463,0.1562649180327869,Cheap
20150428T000000,689500.0,4,2.5,2050,2772,2.0,0,0,3,8,2050,0,2013,0,98029,47.5431,-122.011,1800,2886,722,1086,248.73737373737373,0.08059016393442622,Very Cheap
20141201T000000,175003.0,3,1.5,1390,1882,2.0,0,0,3,7,1390,0,2014,0,98108,47.5667,-122.297,1490,2175,492,685,92.98777895855473,0.013115147540983606,Very Cheap
20140915T000000,459000.0,2,2.5,1240,1249,3.0,0,0,3,8,1240,0,2006,0,98107,47.6718,-122.386,1240,2500,9,1260,367.4939951961569,0.050360655737704915,Very Cheap
20150424T000000,1180000.0,4,3.25,3750,74052,2.0,0,0,3,10,3750,0,2013,0,98053,47.658,-122.006,4920,74052,70302,69132,15.93474855506941,0.14491803278688525,Cheap
20140902T000000,358000.0,3,3.25,1410,1442,3.0,0,0,3,8,1360,50,2006,0,98125,47.7183,-122.317,1500,1200,32,-300,248.26629680998613,0.03711475409836065,Very Cheap
20140714T000000,447055.0,4,2.5,2448,4949,2.0,0,0,3,9,2448,0,2014,0,98030,47.3428,-122.179,2815,5446,2501,2631,90.33239038189534,0.048794098360655735,Very Cheap
20140627T000000,415000.0,3,2.75,2600,64626,1.5,0,0,3,8,2600,0,2009,0,98014,47.7185,-121.405,1740,64626,62026,62886,6.421564076377928,0.04459016393442623,Very Cheap
20141013T000000,1210000.0,4,3.25,3330,9000,2.0,0,0,3,9,2870,460,2004,0,98033,47.6836,-122.208,2550,6349,5670,3799,134.44444444444446,0.14885245901639343,Cheap
20141021T000000,495000.0,2,2.25,1160,1010,2.0,0,0,3,8,1000,160,2006,0,98112,47.6207,-122.301,1200,1170,-150,-30,490.0990099009901,0.05508196721311476,Very Cheap
20141120T000000,479000.0,2,2.25,1330,1380,2.0,0,0,3,8,1060,270,2005,0,98116,47.577,-122.41,1580,4802,50,3222,347.1014492753623,0.05298360655737705,Very Cheap
20150317T000000,1898000.0,3,2.5,2830,4334,3.0,1,4,3,10,2830,0,2006,0,98074,47.6318,-122.071,2830,38211,1504,35381,437.9326257498846,0.23908196721311475,Cheap
20141016T000000,249900.0,3,2.5,1610,3517,2.0,0,0,3,8,1610,0,2005,0,98055,47.4496,-122.189,1830,2889,1907,1059,71.05487631504123,0.02293770491803279,Very Cheap
20141030T000000,1465000.0,4,2.5,2800,4000,2.0,0,0,3,9,2800,0,2011,0,98103,47.6695,-122.339,1770,4200,1200,2430,366.25,0.1822950819672131,Cheap
20150410T000000,1037000.0,5,3.75,4570,10194,2.0,0,0,3,11,4570,0,2006,0,98034,47.718,-122.161,2040,7560,5624,5520,101.72650578771827,0.1261639344262295,Cheap
20141020T000000,897000.0,4,2.5,2820,6120,2.0,0,0,3,9,2820,0,2014,0,98115,47.6911,-122.293,1510,6120,3300,4610,146.5686274509804,0.10780327868852459,Cheap
20150327T000000,1100000.0,4,2.5,2570,9470,2.0,0,0,3,9,2570,0,2006,0,98033,47.6548,-122.19,2570,10663,6900,8093,116.15628299894404,0.13442622950819672,Cheap
20141113T000000,685000.0,3,2.25,1710,1193,2.0,0,0,3,9,1140,570,2014,0,98122,47.6173,-122.31,1510,1193,-517,-317,574.1827326068734,0.08,Very Cheap
20140930T000000,295000.0,3,1.5,1220,3286,2.0,0,0,3,7,1220,0,1982,0,98033,47.7168,-122.189,1220,2640,2066,1420,89.77480219111382,0.028852459016393443,Very Cheap
20140804T000000,619000.0,3,2.25,1650,946,3.0,0,0,3,8,1650,0,2014,0,98103,47.6536,-122.354,1570,1283,-704,-287,654.3340380549682,0.07134426229508196,Very Cheap
20141125T000000,439108.0,2,1.5,1130,1340,2.0,0,0,3,8,910,220,2008,0,98116,47.5761,-122.41,1310,1340,210,30,327.6925373134328,0.047751868852459016,Very Cheap
20150220T000000,260000.0,3,2.25,1489,2800,2.0,0,0,3,7,1489,0,2011,0,98002,47.3452,-122.215,1584,3200,1311,1616,92.85714285714286,0.024262295081967214,Very Cheap
20140606T000000,279000.0,5,2.5,2690,5557,2.0,0,0,3,7,2690,0,2012,0,98178,47.4914,-122.253,2090,10500,2867,8410,50.206946193989566,0.02675409836065574,Very Cheap
20150330T000000,380000.0,3,2.25,1530,1305,2.0,0,0,3,7,1116,414,2007,0,98177,47.7034,-122.357,1320,1427,-225,107,291.18773946360153,0.04,Very Cheap
20141107T000000,287000.0,3,2.5,1600,6315,2.0,0,0,3,8,1600,0,2013,0,98092,47.2611,-122.198,1608,4300,4715,2692,45.447347585114805,0.02780327868852459,Very Cheap
20141211T000000,377000.0,2,1.5,1000,1251,2.0,0,0,3,7,930,70,2006,0,98199,47.6529,-122.384,1420,1187,251,-233,301.3589128697042,0.03960655737704918,Very Cheap
20150223T000000,649950.0,4,3.5,2440,3012,3.0,0,1,3,8,2440,0,2005,0,98117,47.6923,-122.392,1860,4650,572,2790,215.78685258964143,0.07540327868852459,Very Cheap
20141024T000000,445000.0,3,2.5,1260,1102,3.0,0,0,3,8,1260,0,2007,0,98107,47.675,-122.387,1320,2500,-158,1180,403.8112522686025,0.04852459016393443,Very Cheap
20150504T000000,605000.0,3,2.5,1660,1692,3.0,0,0,3,7,1610,50,2005,0,98115,47.6801,-122.322,1210,1230,32,20,357.565011820331,0.06950819672131148,Very Cheap
20140923T000000,475000.0,3,2.25,1190,1137,2.0,0,0,3,7,960,230,1999,0,98115,47.677,-122.325,1190,1080,-53,-110,417.7660510114336,0.05245901639344262,Very Cheap
20140828T000000,399000.0,3,3.0,1520,1884,3.0,0,0,3,8,1520,0,2009,0,98125,47.7176,-122.284,1360,1939,364,579,211.78343949044586,0.042491803278688525,Very Cheap
20150420T000000,718000.0,5,2.75,3250,8100,2.0,0,0,3,8,3250,0,2014,0,98125,47.7133,-122.311,1270,8100,4850,6830,88.64197530864197,0.08432786885245902,Very Cheap
20140528T000000,1400000.0,4,3.25,4700,9160,1.0,0,4,3,11,2520,2180,2005,0,98116,47.5744,-122.406,2240,8700,4460,6460,152.83842794759826,0.1737704918032787,Cheap
20140516T000000,341000.0,3,2.5,1480,1663,2.0,0,0,3,9,1180,300,2012,0,98126,47.5443,-122.375,1380,1537,183,157,205.05111244738424,0.03488524590163934,Very Cheap
20140519T000000,818000.0,2,2.5,2380,9374,1.0,0,2,3,8,2380,0,2011,0,98053,47.7095,-122.019,1610,5000,6994,3390,87.2626413484105,0.09744262295081967,Very Cheap
20141202T000000,759000.0,3,2.25,1640,1873,3.0,0,0,3,8,1640,0,2014,0,98112,47.6196,-122.297,1640,3920,233,2280,405.232247730913,0.08970491803278688,Very Cheap
20140611T000000,547500.0,3,3.5,1650,2262,3.0,0,0,3,8,1650,0,2010,0,98103,47.6823,-122.347,1620,3166,612,1546,242.0424403183024,0.061967213114754095,Very Cheap
20140521T000000,2700000.0,5,4.75,5305,8401,2.0,0,2,3,11,3745,1560,2005,0,98033,47.6864,-122.215,2960,7200,3096,4240,321.3903106773003,0.3442622950819672,Medium
20140722T000000,358000.0,2,2.5,1278,987,2.0,0,0,3,7,1002,276,2007,0,98136,47.5532,-122.381,1220,1287,-291,67,362.71529888551163,0.03711475409836065,Very Cheap
20141001T000000,412000.0,3,2.5,1200,813,3.0,0,0,3,9,1200,0,2010,0,98144,47.5894,-122.315,1750,4365,-387,2615,506.7650676506765,0.04419672131147541,Very Cheap
20150130T000000,245000.0,2,1.5,690,1058,2.0,0,0,3,7,690,0,2005,0,98103,47.6951,-122.343,690,1058,368,368,231.56899810964083,0.022295081967213116,Very Cheap
20141007T000000,460940.0,4,2.5,3202,4964,2.0,0,0,3,9,3202,0,2014,0,98030,47.3412,-122.179,2425,4886,1762,2461,92.85656728444802,0.050615081967213114,Very Cheap
20140522T000000,321000.0,3,2.25,1347,1292,3.0,0,0,3,7,1347,0,2010,0,98125,47.7306,-122.291,1480,1865,-55,385,248.45201238390092,0.032262295081967214,Very Cheap
20140623T000000,633634.0,4,3.5,2960,6000,2.0,0,0,3,9,2960,0,2014,0,98065,47.5183,-121.886,2960,6000,3040,3040,105.60566666666666,0.07326347540983606,Very Cheap
20140923T000000,290000.0,1,0.75,740,1284,1.0,0,0,4,6,740,0,1928,0,98107,47.6741,-122.406,1430,3988,544,2558,225.85669781931463,0.02819672131147541,Very Cheap
20150401T000000,445000.0,2,2.25,1200,1137,3.0,0,0,3,7,1200,0,2007,0,98107,47.6715,-122.392,1280,1295,-63,15,391.3808267370273,0.04852459016393443,Very Cheap
20150407T000000,887250.0,5,3.5,4320,7502,2.0,0,0,3,9,3500,820,2012,0,98056,47.5235,-122.168,3250,7538,3182,4288,118.26846174353506,0.10652459016393442,Cheap
20140911T000000,739000.0,3,2.5,2310,7348,1.0,0,3,3,8,2310,0,2010,0,98053,47.7116,-122.019,2310,7153,5038,4843,100.57158410451824,0.08708196721311476,Very Cheap
20141216T000000,429900.0,3,2.0,1490,1286,3.0,0,0,3,8,1490,0,2014,0,98144,47.57,-122.288,1420,1230,-204,-190,334.2923794712286,0.04654426229508197,Very Cheap
20150106T000000,459000.0,3,2.0,1480,800,2.0,0,0,3,8,1000,480,2014,0,98136,47.5492,-122.387,1480,886,-680,-594,573.75,0.050360655737704915,Very Cheap
20140625T000000,240000.0,3,2.25,1481,2820,2.0,0,0,3,7,1481,0,2012,0,98002,47.3457,-122.217,1481,3028,1339,1547,85.1063829787234,0.021639344262295083,Very Cheap
20140910T000000,566950.0,3,3.0,1730,1902,3.0,0,0,3,8,1730,0,2014,0,98117,47.6944,-122.377,1830,1804,172,-26,298.08096740273396,0.06451803278688524,Very Cheap
20140507T000000,1040000.0,4,3.5,3900,8391,2.0,0,0,3,10,3900,0,2006,0,98033,47.6979,-122.205,3820,12268,4491,8448,123.94231915147182,0.12655737704918033,Cheap
20150310T000000,343000.0,3,3.5,1130,1449,3.0,0,0,3,7,1130,0,2005,0,98103,47.6968,-122.348,1130,1200,319,70,236.71497584541063,0.035147540983606555,Very Cheap
20141111T000000,572115.0,4,3.25,3230,4838,2.0,0,0,3,9,3230,0,2014,0,98038,47.3559,-122.023,2980,5094,1608,2114,118.25444398511782,0.06519540983606557,Very Cheap
20150108T000000,918000.0,5,3.5,3920,5150,2.0,0,0,3,9,2820,1100,2004,0,98052,47.6638,-122.084,3170,5530,1230,2360,178.25242718446603,0.11055737704918032,Cheap
20150505T000000,555000.0,2,1.5,1190,1361,2.0,0,0,3,8,1190,0,2007,0,98122,47.6161,-122.302,1280,3360,171,2080,407.78839088905215,0.06295081967213115,Very Cheap
20140716T000000,399440.0,4,2.5,2311,4396,2.0,0,0,3,9,2311,0,2014,0,98092,47.3276,-122.163,2458,4616,2085,2158,90.86442220200182,0.04254950819672131,Very Cheap
20140711T000000,450000.0,3,2.5,1810,914,3.0,0,0,3,8,1380,430,2008,0,98116,47.5732,-122.387,1810,914,-896,-896,492.3413566739606,0.04918032786885246,Very Cheap
20140604T000000,648000.0,4,2.5,3290,6203,2.0,0,0,3,9,3290,0,2008,0,98065,47.5441,-121.86,2990,6835,2913,3845,104.46558117040142,0.07514754098360656,Very Cheap
20140618T000000,580000.0,4,2.5,3250,5000,2.0,0,0,3,8,3250,0,2008,0,98059,47.4988,-122.148,3230,5507,1750,2277,116.0,0.06622950819672131,Very Cheap
20150331T000000,415000.0,4,2.5,2544,4071,2.0,0,0,3,9,2544,0,2013,0,98030,47.341,-122.179,2358,4179,1527,1821,101.94055514615573,0.04459016393442623,Very Cheap
20141021T000000,527500.0,3,2.5,1380,1389,3.0,0,0,3,8,1380,0,2008,0,98102,47.6427,-122.327,1380,1249,9,-131,379.76961843052555,0.05934426229508197,Very Cheap
20140730T000000,384000.0,3,2.25,1430,800,2.0,0,0,3,8,1140,290,2011,0,98136,47.5477,-122.388,1430,1387,-630,-43,480.0,0.04052459016393443,Very Cheap
20140820T000000,692000.0,3,2.5,3490,28213,1.5,0,2,3,9,2242,1248,2009,0,98070,47.365,-122.456,2120,56628,24723,54508,24.527699996455535,0.08091803278688525,Very Cheap
20140822T000000,455000.0,2,1.5,910,966,2.0,0,0,3,8,820,90,2006,0,98119,47.627,-122.361,2740,6400,56,3660,471.0144927536232,0.049836065573770495,Very Cheap
20150403T000000,1280000.0,4,3.25,3080,4120,2.0,0,0,3,9,2380,700,2014,0,98117,47.6845,-122.359,1410,4120,1040,2710,310.6796116504854,0.1580327868852459,Cheap
20140624T000000,415000.0,3,2.5,2280,6031,2.0,0,0,3,8,2280,0,2011,0,98019,47.7322,-121.966,2430,7200,3751,4770,68.81114243077434,0.04459016393442623,Very Cheap
20141222T000000,975000.0,3,2.5,1660,1344,3.0,0,0,3,8,1660,0,2008,0,98102,47.644,-122.327,1750,2040,-316,290,725.4464285714286,0.1180327868852459,Cheap
20141006T000000,799950.0,4,2.5,3320,7429,2.0,0,0,3,9,3320,0,2014,0,98034,47.7189,-122.225,1840,7429,4109,5589,107.67936465203931,0.09507540983606558,Very Cheap
20150405T000000,545000.0,5,4.0,1680,7268,1.0,0,0,3,8,1370,310,2008,0,98106,47.5571,-122.356,2040,8259,5588,6219,74.98624105668685,0.06163934426229508,Very Cheap
20141003T000000,429900.0,4,3.5,2584,5005,2.0,0,0,3,8,2584,0,2014,0,98023,47.296,-122.35,2767,5201,2421,2434,85.89410589410589,0.04654426229508197,Very Cheap
20140729T000000,275000.0,3,2.5,2217,8019,2.0,0,0,3,7,2217,0,2009,0,98001,47.2776,-122.251,1470,8037,5802,6567,34.29355281207133,0.02622950819672131,Very Cheap
20140718T000000,498000.0,3,2.5,2480,4136,2.0,0,0,3,8,2480,0,2009,0,98059,47.493,-122.147,2510,4314,1656,1804,120.40618955512572,0.055475409836065574,Very Cheap
20140527T000000,754950.0,3,2.5,2610,7256,2.0,0,0,3,9,2610,0,2014,0,98033,47.695,-122.18,2610,7206,4646,4596,104.0449283351709,0.08917377049180328,Very Cheap
20140606T000000,895000.0,4,3.0,3240,5562,2.0,0,0,3,10,3240,0,2013,0,98075,47.5919,-121.975,3380,5562,2322,2182,160.913340524991,0.10754098360655738,Cheap
20140506T000000,580000.0,4,3.25,3569,8327,2.0,0,0,3,10,3569,0,2013,0,98055,47.4595,-122.208,2550,5251,4758,2701,69.65293623153596,0.06622950819672131,Very Cheap
20150222T000000,379900.0,4,2.5,3181,5831,2.0,0,0,3,8,3181,0,2014,0,98003,47.2716,-122.297,2056,24393,2650,22337,65.15177499571257,0.03998688524590164,Very Cheap
20150310T000000,245000.0,4,2.5,1921,4888,2.0,0,0,3,7,1921,0,2009,0,98001,47.2689,-122.24,1921,9140,2967,7219,50.122749590834694,0.022295081967213116,Very Cheap
20140826T000000,417000.0,3,2.5,1570,4926,2.0,0,0,3,8,1570,0,2014,0,98065,47.5342,-121.842,1800,3202,3356,1402,84.65286236297199,0.04485245901639344,Very Cheap
20140505T000000,555000.0,3,2.5,1940,3211,2.0,0,0,3,8,1940,0,2009,0,98027,47.5644,-122.093,1880,3078,1271,1198,172.8433509810028,0.06295081967213115,Very Cheap
20140826T000000,555000.0,3,2.5,1940,3211,2.0,0,0,3,8,1940,0,2009,0,98027,47.5644,-122.093,1880,3078,1271,1198,172.8433509810028,0.06295081967213115,Very Cheap
20140910T000000,353000.0,4,2.5,2210,13721,2.0,0,0,3,8,2210,0,2009,0,98042,47.3122,-122.039,1850,12951,11511,11101,25.726987828875448,0.03645901639344262,Very Cheap
20150425T000000,539000.0,3,2.25,1280,1187,2.0,0,0,3,8,1080,200,2008,0,98107,47.6651,-122.368,1280,1681,-93,401,454.0859309182814,0.06085245901639344,Very Cheap
20140904T000000,434900.0,3,2.0,1520,5040,2.0,0,0,3,7,1520,0,1977,2006,98177,47.777,-122.362,1860,8710,3520,6850,86.28968253968254,0.0472,Very Cheap
20141202T000000,325000.0,2,2.25,1230,1078,2.0,0,0,3,7,1160,70,2008,0,98027,47.5324,-122.073,1240,817,-152,-423,301.4842300556586,0.03278688524590164,Very Cheap
20150409T000000,650000.0,3,2.5,1480,2159,3.0,0,0,3,8,1480,0,2007,0,98103,47.6533,-122.341,1480,1554,679,74,301.06530801296896,0.07540983606557378,Very Cheap
20150225T000000,379950.0,4,2.5,2612,5850,2.0,0,0,3,8,2612,0,2014,0,98030,47.3751,-122.189,2419,8984,3238,6565,64.94871794871794,0.03999344262295082,Very Cheap
20141119T000000,700000.0,3,2.5,2350,4975,2.0,0,0,3,8,2350,0,2012,0,98029,47.5418,-122.01,2350,3951,2625,1601,140.7035175879397,0.08196721311475409,Very Cheap
20141215T000000,675000.0,3,2.5,1300,1590,2.0,0,0,3,8,1100,200,2014,0,98109,47.6384,-122.343,1070,1223,290,153,424.52830188679246,0.07868852459016394,Very Cheap
20140609T000000,379000.0,4,1.5,2020,7560,1.0,0,0,4,7,2020,0,1960,0,98059,47.502,-122.146,1410,8080,5540,6670,50.13227513227513,0.03986885245901639,Very Cheap
20150330T000000,571000.0,3,2.5,2140,2867,2.0,0,0,3,8,1960,180,2005,0,98027,47.5357,-122.073,2280,2836,727,556,199.16288803627486,0.06504918032786886,Very Cheap
20141024T000000,475000.0,3,2.25,1380,1621,2.0,0,0,3,8,1140,240,2007,0,98117,47.678,-122.375,1460,1403,241,-57,293.0289944478717,0.05245901639344262,Very Cheap
20140509T000000,769900.0,4,3.5,2730,3047,2.0,0,0,3,8,2400,330,2006,0,98116,47.5797,-122.391,1980,4600,317,2620,252.67476206104365,0.0911344262295082,Very Cheap
20141222T000000,633000.0,4,3.5,4220,5817,2.0,0,0,3,9,2910,1310,2006,0,98065,47.5392,-121.862,4290,6637,1597,2347,108.81897885507993,0.07318032786885247,Very Cheap
20140512T000000,635000.0,3,2.5,1570,1433,3.0,0,0,3,8,1570,0,2010,0,98103,47.6858,-122.336,1570,2652,-137,1082,443.12630844382414,0.07344262295081967,Very Cheap
20140725T000000,1238000.0,4,3.5,4670,6000,2.0,0,3,3,11,3820,850,2007,0,98027,47.5414,-121.994,4310,6000,1330,1690,206.33333333333334,0.15252459016393444,Cheap
20150108T000000,524000.0,3,2.25,1370,1007,3.0,0,0,3,8,1330,40,2009,0,98107,47.6682,-122.361,1570,1635,-363,65,520.3574975173783,0.05888524590163934,Very Cheap
20141126T000000,485000.0,4,3.5,3273,5115,2.0,0,0,3,8,2671,602,2014,0,98055,47.4477,-122.204,2996,5100,1842,2104,94.81915933528836,0.05377049180327869,Very Cheap
20140521T000000,1030000.0,3,4.0,3880,13095,2.0,0,3,3,11,3700,180,2009,0,98034,47.6996,-122.233,3880,10830,9215,6950,78.65597556319206,0.12524590163934426,Cheap
20141024T000000,650000.0,3,3.5,1494,1262,3.0,0,0,3,8,1494,0,2011,0,98115,47.6826,-122.324,1494,1264,-232,-230,515.0554675118859,0.07540983606557378,Very Cheap
20141001T000000,754842.0,3,2.5,2930,5641,2.0,0,0,3,8,2930,0,2013,0,98052,47.71,-122.113,3300,5641,2711,2341,133.81350824321927,0.08915960655737705,Very Cheap
20140924T000000,428900.0,4,2.5,2598,5553,2.0,0,0,3,9,2598,0,2014,0,98092,47.3412,-122.178,2502,4900,2955,2398,77.2375292634612,0.04641311475409836,Very Cheap
20140623T000000,329900.0,3,2.5,2242,4995,2.0,0,0,3,8,2242,0,2011,0,98092,47.2595,-122.202,1798,4942,2753,3144,66.04604604604604,0.03342950819672131,Very Cheap
20141218T000000,1035290.0,4,2.5,2830,5932,2.0,0,0,3,9,2830,0,2014,0,98199,47.6479,-122.408,2840,5593,3102,2753,174.5262980445044,0.12593967213114754,Cheap
20140909T000000,544999.0,4,2.5,2710,6937,2.0,0,0,3,7,2710,0,2009,0,98065,47.5153,-121.871,2380,5866,4227,3486,78.5640766902119,0.0616392131147541,Very Cheap
20140529T000000,449950.0,4,2.75,2320,4344,2.0,0,0,3,8,2320,0,2012,0,98059,47.4862,-122.163,2310,3770,2024,1460,103.57965009208102,0.04917377049180328,Very Cheap
20150113T000000,635000.0,4,2.5,2720,7991,2.0,0,0,3,9,2720,0,2006,0,98133,47.7168,-122.331,1590,8611,5271,7021,79.46439744712802,0.07344262295081967,Very Cheap
20141103T000000,599000.0,3,1.75,1650,1180,3.0,0,0,3,8,1650,0,2014,0,98105,47.6638,-122.319,1650,1960,-470,310,507.6271186440678,0.06872131147540983,Very Cheap
20141103T000000,478000.0,3,3.25,1430,1348,2.0,0,0,3,8,1160,270,2008,0,98107,47.6743,-122.374,1160,1265,-82,105,354.5994065281899,0.05285245901639344,Very Cheap
20140929T000000,388000.0,4,2.5,2090,5040,2.0,0,0,3,9,2090,0,2014,0,98055,47.4797,-122.23,1430,12000,2950,10570,76.98412698412699,0.041049180327868855,Very Cheap
20140804T000000,809950.0,4,3.5,3660,4903,2.0,0,0,3,9,2760,900,2014,0,98034,47.7184,-122.156,3630,4992,1243,1362,165.19477870691412,0.09638688524590164,Very Cheap
20150415T000000,1060000.0,4,3.5,4220,8417,3.0,0,0,3,10,4220,0,2012,0,98075,47.5869,-122.054,3730,8435,4197,4705,125.93560651063324,0.12918032786885245,Cheap
20150422T000000,659000.0,2,2.5,1450,1213,2.0,0,0,3,9,1110,340,2015,0,98107,47.6692,-122.372,1620,1456,-237,-164,543.2811211871393,0.07659016393442623,Very Cheap
20140626T000000,971971.0,4,3.75,3460,6738,2.0,0,0,3,11,3460,0,2013,0,98059,47.506,-122.145,3340,6120,3278,2780,144.25215197387948,0.11763554098360655,Cheap
20150115T000000,389000.0,3,2.5,1350,874,3.0,0,0,3,8,1270,80,2006,0,98136,47.5491,-122.387,1350,886,-476,-464,445.0800915331808,0.04118032786885246,Very Cheap
20140708T000000,355000.0,4,2.75,3000,5470,2.0,0,0,3,8,3000,0,2005,0,98038,47.3613,-122.038,2420,4891,2470,2471,64.89945155393053,0.036721311475409836,Very Cheap
20141208T000000,551500.0,4,2.5,2950,10003,2.0,0,0,3,9,2950,0,2006,0,98059,47.489,-122.14,2790,9323,7053,6533,55.13345996201139,0.06249180327868852,Very Cheap
20140701T000000,417838.0,4,2.5,2530,5048,2.0,0,0,3,8,2530,0,2014,0,98038,47.3559,-122.063,2530,4359,2518,1829,82.7729793977813,0.04496236065573771,Very Cheap
20140714T000000,1750000.0,4,4.5,4650,7660,2.0,0,0,3,11,3640,1010,2008,0,98004,47.6349,-122.198,1710,8400,3010,6690,228.45953002610966,0.21967213114754097,Cheap
20140611T000000,399950.0,2,1.0,710,1131,2.0,0,0,4,7,710,0,1943,0,98102,47.6413,-122.329,1370,1173,421,-197,353.62511052166224,0.04261639344262295,Very Cheap
20140715T000000,740000.0,4,2.5,3050,8000,2.0,0,0,3,9,3050,0,2007,0,98028,47.7465,-122.231,1910,8000,4950,6090,92.5,0.08721311475409836,Very Cheap
20150223T000000,335000.0,3,2.5,1150,683,2.0,0,0,3,7,1150,0,2013,0,98027,47.5323,-122.071,1150,755,-467,-395,490.4831625183016,0.03409836065573771,Very Cheap
20150421T000000,2250000.0,5,5.25,3410,8118,2.0,0,0,3,11,3410,0,2006,0,98039,47.6295,-122.236,3410,16236,4708,12826,277.1618625277162,0.28524590163934427,Cheap
20150420T000000,667000.0,3,1.75,1370,1921,3.0,0,0,3,8,1370,0,2007,0,98103,47.6595,-122.351,1370,4000,551,2630,347.21499219156686,0.07763934426229509,Very Cheap
20150312T000000,920000.0,4,2.5,3540,7009,2.0,0,0,3,9,3540,0,2007,0,98033,47.6749,-122.176,2150,10290,3469,8140,131.25980881723498,0.11081967213114755,Cheap
20140511T000000,368000.0,3,2.5,1370,1350,2.0,0,0,3,7,1010,360,2007,0,98136,47.5534,-122.382,1450,6000,-20,4550,272.5925925925926,0.03842622950819672,Very Cheap
20140710T000000,307000.0,4,2.5,1714,3080,2.0,0,0,3,8,1714,0,2009,0,98055,47.429,-122.188,1714,3250,1366,1536,99.67532467532467,0.03042622950819672,Very Cheap
20150116T000000,550000.0,4,2.75,3650,4534,2.0,0,0,3,7,2940,710,2014,0,98028,47.7397,-122.224,2400,7682,884,5282,121.30569033965594,0.06229508196721312,Very Cheap
20150113T000000,594491.0,4,2.5,2990,6037,2.0,0,0,3,9,2990,0,2013,0,98045,47.4766,-121.735,2990,5992,3047,3002,98.47457346364088,0.06812996721311475,Very Cheap
20140929T000000,460458.0,4,2.5,3284,6516,2.0,0,0,3,8,3284,0,2014,0,98092,47.3393,-122.181,2555,5008,3232,2453,70.6657458563536,0.05055186885245902,Very Cheap
20140624T000000,859000.0,4,2.25,3550,13900,1.0,0,0,3,8,1830,1720,2010,0,98006,47.5681,-122.127,2770,12200,10350,9430,61.798561151079134,0.10281967213114754,Cheap
20141211T000000,399950.0,3,3.0,1860,2875,2.0,0,0,3,8,1710,150,2009,0,98126,47.5511,-122.373,1350,4830,1015,3480,139.11304347826086,0.04261639344262295,Very Cheap
20150401T000000,547500.0,3,3.25,1720,1977,2.0,0,0,3,8,1360,360,2007,0,98122,47.6127,-122.299,1720,3420,257,1700,276.9347496206373,0.061967213114754095,Very Cheap
20140623T000000,310000.0,3,2.5,2540,4775,2.0,0,0,3,7,2540,0,2006,0,98042,47.3341,-122.052,2270,5000,2235,2730,64.92146596858639,0.03081967213114754,Very Cheap
20140602T000000,939000.0,4,2.75,3270,12880,2.0,0,0,3,9,3270,0,2014,0,98033,47.6679,-122.172,2420,7505,9610,5085,72.90372670807453,0.11331147540983606,Cheap
20141014T000000,329900.0,2,2.5,980,1021,3.0,0,0,3,8,980,0,2008,0,98117,47.6844,-122.387,980,1023,41,43,323.1145935357493,0.03342950819672131,Very Cheap
20141222T000000,436000.0,3,2.5,1150,1193,2.0,0,0,3,8,1020,130,2006,0,98107,47.6684,-122.365,1450,1640,43,190,365.46521374685665,0.047344262295081964,Very Cheap
20140716T000000,320000.0,3,2.5,1820,1855,2.0,0,0,3,8,1570,250,2008,0,98166,47.4643,-122.346,1470,6900,35,5430,172.5067385444744,0.032131147540983604,Very Cheap
20140926T000000,375000.0,3,2.5,1580,3825,2.0,0,0,3,8,1580,0,2011,0,98126,47.5458,-122.369,1380,1500,2245,120,98.03921568627452,0.03934426229508197,Very Cheap
20150324T000000,392137.0,3,2.0,1460,3696,2.0,0,0,3,7,1460,0,2010,0,98053,47.6861,-122.013,1720,3631,2236,1911,106.09767316017316,0.04159173770491803,Very Cheap
20140826T000000,520000.0,4,2.5,2900,4950,2.0,0,0,3,8,2900,0,2004,0,98028,47.7717,-122.236,2590,4950,2050,2360,105.05050505050505,0.058360655737704915,Very Cheap
20141016T000000,535000.0,5,2.75,2620,6389,2.0,0,0,3,9,2620,0,2007,0,98028,47.77,-122.236,2620,4504,3769,1884,83.73767412740648,0.06032786885245902,Very Cheap
20150324T000000,407000.0,2,2.5,1340,999,2.0,0,0,3,8,940,400,2008,0,98116,47.5655,-122.386,1470,1436,-341,-34,407.4074074074074,0.04354098360655738,Very Cheap
20141125T000000,424950.0,4,3.25,3266,5398,2.0,0,0,3,8,3266,0,2014,0,98023,47.2975,-122.35,3087,5152,2132,2065,78.72360133382735,0.04589508196721311,Very Cheap
20140811T000000,290000.0,2,1.5,1076,1060,3.0,0,0,3,7,1076,0,2006,0,98125,47.7167,-122.298,1076,1060,-16,-16,273.58490566037733,0.02819672131147541,Very Cheap
20141029T000000,399000.0,3,3.25,1680,1478,2.0,0,0,3,8,1360,320,2009,0,98126,47.5674,-122.369,1530,2753,-202,1223,269.9594046008119,0.042491803278688525,Very Cheap
20140703T000000,439990.0,3,2.5,1930,1348,2.0,0,0,3,8,1300,630,2005,0,98199,47.6513,-122.384,1630,6000,-582,4370,326.40207715133533,0.04786754098360656,Very Cheap
20150222T000000,635000.0,4,2.5,2880,3091,2.0,0,0,3,9,1940,940,2014,0,98144,47.5711,-122.286,1560,4080,211,2520,205.43513426075702,0.07344262295081967,Very Cheap
20140717T000000,635000.0,4,2.25,2240,5000,2.0,0,0,3,8,2240,0,2013,0,98074,47.6212,-122.058,1760,7500,2760,5740,127.0,0.07344262295081967,Very Cheap
20150429T000000,351000.0,3,2.5,2594,4455,2.0,0,0,3,8,2594,0,2012,0,98001,47.3054,-122.276,2981,4950,1861,1969,78.78787878787878,0.03619672131147541,Very Cheap
20140822T000000,437500.0,2,1.5,1210,1232,3.0,0,0,3,8,1210,0,2007,0,98107,47.6712,-122.39,1330,1174,22,-156,355.1136363636364,0.047540983606557376,Very Cheap
20140530T000000,919204.0,4,3.5,3760,5000,2.0,0,0,3,9,2860,900,2014,0,98117,47.6826,-122.394,1340,5000,1240,3660,183.8408,0.11071527868852458,Cheap
20140908T000000,923990.0,4,2.5,3600,6055,2.0,0,0,3,9,3600,0,2014,0,98052,47.7053,-122.126,3590,6050,2455,2460,152.59950454170107,0.11134295081967213,Cheap
20140624T000000,639888.0,4,2.5,2050,2772,2.0,0,0,3,8,2050,0,2012,0,98029,47.5421,-122.011,2050,2934,722,884,230.83982683982683,0.07408367213114754,Very Cheap
20150114T000000,675000.0,3,3.25,1510,2064,2.0,0,0,3,8,1220,290,2008,0,98109,47.6398,-122.345,1670,2594,554,924,327.0348837209302,0.07868852459016394,Very Cheap
20140610T000000,899900.0,4,2.5,2580,3909,2.0,0,0,3,8,2580,0,2013,0,98033,47.6852,-122.21,1820,5772,1329,3952,230.2123305193144,0.10818360655737705,Cheap
20150130T000000,252000.0,3,2.5,1670,4020,2.0,0,0,3,7,1670,0,2009,0,98118,47.53,-122.268,1670,4020,2350,2350,62.6865671641791,0.02321311475409836,Very Cheap
20150317T000000,925000.0,4,2.5,3190,10034,2.0,0,0,3,9,3190,0,2007,0,98052,47.6379,-122.111,2110,9300,6844,7190,92.18656567669922,0.11147540983606558,Cheap
20141029T000000,552000.0,3,2.5,1280,1920,3.0,0,0,3,8,1280,0,2009,0,98105,47.6621,-122.324,1450,1900,640,450,287.5,0.06255737704918032,Very Cheap
20150407T000000,388500.0,4,2.5,2718,6197,2.0,0,0,3,8,2718,0,2006,0,98092,47.3255,-122.164,2667,5000,3479,2333,62.69162497982895,0.041114754098360656,Very Cheap
20140829T000000,548000.0,2,2.0,1370,1878,3.0,0,0,3,8,1370,0,2004,0,98107,47.6721,-122.387,1280,1878,508,598,291.7997870074547,0.062032786885245904,Very Cheap
20140922T000000,254950.0,3,2.5,1794,4769,2.0,0,0,3,7,1794,0,2005,0,98001,47.3052,-122.283,3557,4807,2975,1250,53.45984483120151,0.0236,Very Cheap
20141208T000000,1237500.0,4,4.5,5120,41327,2.0,0,0,3,10,3290,1830,2008,0,98053,47.7009,-122.059,3360,82764,36207,79404,29.944104338568007,0.15245901639344261,Cheap
20140930T000000,629000.0,3,2.5,2160,1912,2.0,0,0,3,9,1970,190,2014,0,98118,47.5642,-122.292,1810,2653,-248,843,328.97489539748955,0.07265573770491804,Very Cheap
20150303T000000,734000.0,4,2.5,2180,7204,2.0,0,0,3,8,2180,0,2014,0,98133,47.7221,-122.352,1500,7650,5024,6150,101.88784008883954,0.08642622950819673,Very Cheap
20140618T000000,309000.0,3,2.25,1490,1294,2.0,0,0,3,7,1220,270,2010,0,98106,47.5569,-122.363,1490,1283,-196,-207,238.79443585780527,0.030688524590163933,Very Cheap
20140703T000000,554950.0,3,2.5,2950,10254,2.0,0,0,3,9,2950,0,2006,0,98059,47.4888,-122.14,2800,9323,7304,6523,54.12034328067096,0.06294426229508197,Very Cheap
20150506T000000,785000.0,3,2.75,2990,207781,2.0,0,0,3,9,2990,0,2000,0,98014,47.662,-121.944,2590,218671,204791,216081,3.7780162767529273,0.09311475409836066,Very Cheap
20140605T000000,550000.0,4,2.5,2700,5150,2.0,0,0,3,9,2700,0,2007,0,98059,47.5071,-122.148,3160,7620,2450,4460,106.79611650485437,0.06229508196721312,Very Cheap
20140811T000000,1010000.0,4,3.5,3130,5000,3.0,0,0,3,10,3130,0,2014,0,98116,47.5656,-122.403,1950,5152,1870,3202,202.0,0.12262295081967213,Cheap
20141028T000000,1575000.0,3,2.0,3620,14250,2.0,0,0,3,8,3220,400,2007,0,98040,47.5767,-122.225,2370,14250,10630,11880,110.52631578947368,0.19672131147540983,Cheap
20140603T000000,309000.0,5,2.75,2481,4045,2.0,0,0,3,8,2481,0,2014,0,98001,47.2602,-122.284,2363,4175,1564,1812,76.39060568603213,0.030688524590163933,Very Cheap
20140625T000000,328423.0,3,2.5,1730,3600,2.0,0,0,3,8,1730,0,2014,0,98146,47.5019,-122.34,2030,3600,1870,1570,91.2286111111111,0.033235803278688525,Very Cheap
20140623T000000,345000.0,3,1.5,1420,1192,2.0,0,0,3,8,1140,280,2008,0,98144,47.5881,-122.304,1340,1213,-228,-127,289.4295302013423,0.03540983606557377,Very Cheap
20141121T000000,660000.0,5,3.5,3160,5175,2.0,0,0,3,9,3160,0,2014,0,98011,47.755,-122.216,2100,9351,2015,7251,127.53623188405797,0.07672131147540984,Very Cheap
20140502T000000,385000.0,3,3.25,1320,1327,2.0,0,0,3,8,1040,280,2008,0,98199,47.6506,-122.383,1440,1263,7,-177,290.1281085154484,0.04065573770491803,Very Cheap
20150318T000000,459000.0,2,2.25,1010,1107,2.0,0,0,3,8,710,300,2006,0,98119,47.6363,-122.371,1140,1531,97,391,414.6341463414634,0.050360655737704915,Very Cheap
20150114T000000,248000.0,3,2.5,1870,4046,2.0,0,0,3,7,1870,0,2007,0,98042,47.342,-122.059,2130,4800,2176,2670,61.29510627780524,0.022688524590163933,Very Cheap
20140820T000000,1481000.0,4,3.5,5220,15411,2.0,0,3,3,11,3550,1670,2006,0,98075,47.592,-122.085,3110,14124,10191,11014,96.10018817727597,0.18439344262295082,Cheap
20140801T000000,379000.0,4,2.5,2260,5824,2.0,0,0,3,8,2260,0,2011,0,98038,47.3496,-122.042,2240,5561,3564,3321,65.07554945054945,0.03986885245901639,Very Cheap
20150304T000000,2945000.0,5,4.5,4340,5722,3.0,0,4,3,10,4340,0,2010,0,98107,47.6715,-122.406,1770,5250,1382,3480,514.6801817546312,0.3763934426229508,Medium
20140926T000000,395000.0,2,2.25,1620,1841,2.0,0,0,3,8,1540,80,2004,0,98029,47.5483,-122.004,1530,1831,221,301,214.55730581205867,0.0419672131147541,Very Cheap
20140507T000000,535000.0,3,2.5,2280,2289,2.0,0,0,3,8,1880,400,2006,0,98027,47.5375,-122.073,2280,2425,9,145,233.72651813018786,0.06032786885245902,Very Cheap
20141022T000000,970000.0,5,3.5,3400,9804,2.0,0,0,3,9,2550,850,2008,0,98118,47.543,-122.266,2380,7440,6404,5060,98.9392084863321,0.11737704918032787,Cheap
20150201T000000,205000.0,2,1.5,830,1020,2.0,0,0,3,7,830,0,2006,0,98106,47.5604,-122.363,830,1379,190,549,200.98039215686273,0.017049180327868854,Very Cheap
20141015T000000,310000.0,4,2.5,2310,7384,2.0,0,0,3,8,2310,0,2010,0,98042,47.3737,-122.165,2310,7800,5074,5490,41.98266522210184,0.03081967213114754,Very Cheap
20140702T000000,334500.0,2,1.5,830,1858,2.0,0,0,3,7,830,0,2005,0,98144,47.5828,-122.314,1480,3030,1028,1550,180.03229278794402,0.0340327868852459,Very Cheap
20140828T000000,995000.0,5,3.25,4130,7197,2.0,0,0,3,10,4130,0,2012,0,98074,47.6022,-122.06,3730,7202,3067,3472,138.25204946505488,0.12065573770491804,Cheap
20150401T000000,370228.0,4,3.0,2050,4000,2.0,0,0,3,8,2050,0,2014,0,98001,47.3525,-122.275,2050,4000,1950,1950,92.557,0.0387184262295082,Very Cheap
20150304T000000,383000.0,4,2.5,2050,4953,2.0,0,0,3,9,2050,0,2014,0,98038,47.3448,-122.024,2340,6175,2903,3835,77.32687260246315,0.04039344262295082,Very Cheap
20140804T000000,384500.0,3,2.5,1600,2610,2.0,0,0,3,8,1600,0,2005,0,98027,47.5344,-122.068,1445,1288,1010,-157,147.31800766283524,0.04059016393442623,Very Cheap
20140718T000000,865000.0,5,2.5,3190,8160,2.0,0,0,3,9,3190,0,2014,0,98177,47.7246,-122.363,1650,8160,4970,6510,106.00490196078431,0.10360655737704919,Cheap
20140522T000000,1051000.0,4,3.75,3860,5474,2.5,0,0,3,10,3860,0,2007,0,98029,47.5396,-121.995,3040,5474,1614,2434,191.99853854585314,0.128,Cheap
20140513T000000,502000.0,4,2.5,2040,5616,2.0,0,0,3,8,2040,0,2012,0,98028,47.7737,-122.238,2380,4737,3576,2357,89.38746438746439,0.056,Very Cheap
20140924T000000,1750000.0,4,3.5,3845,8400,2.0,0,0,3,10,3845,0,2013,0,98004,47.6354,-122.198,1710,8400,4555,6690,208.33333333333334,0.21967213114754097,Cheap
20140912T000000,569995.0,4,2.5,2650,6875,2.0,0,0,3,8,2650,0,2014,0,98059,47.479,-122.124,2650,5831,4225,3181,82.90836363636363,0.06491737704918032,Very Cheap
20140519T000000,749950.0,4,2.5,3430,64441,2.0,0,0,3,8,3430,0,2013,0,98077,47.7694,-122.064,3580,64441,61011,60861,11.637777191539548,0.08851803278688525,Very Cheap
20141230T000000,550000.0,3,2.5,2430,5400,2.0,0,0,3,8,2430,0,2007,0,98074,47.6062,-122.057,2640,11990,2970,9350,101.85185185185185,0.06229508196721312,Very Cheap
20140513T000000,525000.0,3,3.5,2876,5086,2.0,0,0,3,8,2360,516,2007,0,98072,47.7511,-122.173,2390,4419,2210,2029,103.22453794730633,0.05901639344262295,Very Cheap
20140611T000000,516000.0,4,3.5,2550,8698,2.0,0,0,3,7,2550,0,2007,0,98065,47.5216,-121.869,2430,5519,6148,3089,59.323982524718325,0.05783606557377049,Very Cheap
20140805T000000,1350000.0,4,3.75,4100,61419,2.0,0,0,3,9,4100,0,2014,0,98029,47.5626,-122.005,2010,32362,57319,30352,21.980169003077222,0.16721311475409836,Cheap
20150428T000000,440000.0,4,2.5,2730,4526,2.0,0,0,3,7,2730,0,2009,0,98059,47.491,-122.153,2190,4572,1796,2382,97.21608484312858,0.04786885245901639,Very Cheap
20150414T000000,660000.0,3,2.5,1780,1729,2.0,0,0,3,8,1080,700,2008,0,98103,47.6594,-122.355,1780,1741,-51,-39,381.72353961827645,0.07672131147540984,Very Cheap
20141209T000000,261950.0,3,2.5,1880,5000,2.0,0,0,3,7,1880,0,2010,0,98042,47.3359,-122.054,2260,5000,3120,2740,52.39,0.024518032786885247,Very Cheap
20140827T000000,551000.0,5,3.75,3090,4943,2.0,0,0,3,10,3090,0,2010,0,98058,47.4594,-122.133,3191,5561,1853,2370,111.47076674084565,0.06242622950819672,Very Cheap
20150225T000000,665000.0,3,3.5,2460,14155,2.0,0,0,3,8,1900,560,2014,0,98155,47.7743,-122.279,2440,14080,11695,11640,46.97986577181208,0.07737704918032787,Very Cheap
20140604T000000,610000.0,4,3.5,2910,5260,2.0,0,0,3,9,2910,0,2012,0,98065,47.5168,-121.883,2910,5260,2350,2350,115.96958174904942,0.07016393442622951,Very Cheap
20150219T000000,645000.0,4,3.5,2910,5260,2.0,0,0,3,9,2910,0,2012,0,98065,47.5168,-121.883,2910,5260,2350,2350,122.6235741444867,0.07475409836065573,Very Cheap
20140618T000000,536751.0,3,1.75,1930,6360,1.0,0,0,3,9,1930,0,2013,0,98065,47.5181,-121.885,2770,6373,4430,3603,84.39481132075471,0.06055750819672131,Very Cheap
20150426T000000,260000.0,3,2.25,1413,3403,2.0,0,0,3,8,1413,0,2009,0,98031,47.4196,-122.193,1763,3719,1990,1956,76.40317367029093,0.024262295081967214,Very Cheap
20150121T000000,1312000.0,3,3.25,4030,6300,2.0,0,0,3,10,3630,400,2006,0,98105,47.6664,-122.276,1660,6300,2270,4640,208.25396825396825,0.1622295081967213,Cheap
20150220T000000,429900.0,4,3.25,2880,5929,2.5,0,0,3,8,2880,0,2014,0,98023,47.2752,-122.349,2880,5846,3049,2966,72.50801146905043,0.04654426229508197,Very Cheap
20140820T000000,535000.0,4,2.75,2360,15100,1.0,0,0,3,8,2360,0,2014,0,98146,47.5117,-122.365,1440,13346,12740,11906,35.43046357615894,0.06032786885245902,Very Cheap
20150414T000000,462550.0,2,1.75,1070,1276,3.0,0,0,3,8,1070,0,2006,0,98107,47.6719,-122.39,1290,2057,206,767,362.5,0.05082622950819672,Very Cheap
20150310T000000,602000.0,3,3.25,1460,1367,3.0,0,0,3,8,1460,0,2008,0,98103,47.6485,-122.334,1310,1191,-93,-119,440.3803950256035,0.06911475409836065,Very Cheap
20141208T000000,730000.0,4,2.75,3800,9606,2.0,0,0,3,9,3800,0,2008,0,98011,47.7368,-122.208,3400,9677,5806,6277,75.99417031022277,0.0859016393442623,Very Cheap
20150423T000000,300500.0,2,1.5,1190,801,3.0,0,0,3,8,1190,0,2010,0,98106,47.5212,-122.358,1190,810,-389,-380,375.1560549313358,0.029573770491803278,Very Cheap
20140516T000000,675000.0,5,2.5,3200,6455,2.0,0,0,3,9,3200,0,2009,0,98065,47.5446,-121.862,3290,7924,3255,4634,104.57010069713401,0.07868852459016394,Very Cheap
20140520T000000,415000.0,3,2.25,1970,2377,2.0,0,0,3,8,1680,290,2008,0,98108,47.5631,-122.297,1690,1936,407,246,174.58981909970552,0.04459016393442623,Very Cheap
20141117T000000,614000.0,3,2.5,2830,5831,2.0,0,0,3,9,2830,0,2010,0,98011,47.7744,-122.224,2830,6064,3001,3234,105.29926256216773,0.07068852459016393,Very Cheap
20141204T000000,385000.0,4,2.5,2630,5701,2.0,0,0,3,7,2630,0,2010,0,98042,47.375,-122.16,2770,5939,3071,3169,67.53201192773197,0.04065573770491803,Very Cheap
20140625T000000,594000.0,4,2.75,2720,4613,2.0,0,0,3,9,2720,0,2005,0,98028,47.7352,-122.223,2830,4836,1893,2006,128.76652937350966,0.0680655737704918,Very Cheap
20140520T000000,860000.0,4,2.75,3160,8097,2.0,0,0,3,9,3160,0,2014,0,98033,47.6709,-122.166,2200,8097,4937,5897,106.21217734963567,0.10295081967213114,Cheap
20140909T000000,1104500.0,4,4.0,3770,8899,2.0,0,0,3,10,2940,830,2006,0,98074,47.6476,-122.079,3300,8308,5129,5008,124.11506910888863,0.13501639344262295,Cheap
20141024T000000,775000.0,4,2.75,3500,6226,2.0,0,0,3,9,3500,0,2004,0,98053,47.6846,-122.045,3480,7222,2726,3742,124.47799550273048,0.09180327868852459,Very Cheap
20140806T000000,430760.0,5,2.75,2710,4685,2.0,0,0,3,8,2710,0,2014,0,98038,47.3555,-122.062,2710,4449,1975,1739,91.94450373532551,0.04665704918032787,Very Cheap
20150427T000000,755000.0,2,2.5,2170,6361,1.0,0,2,3,8,2170,0,2009,0,98053,47.7109,-122.017,2310,7419,4191,5109,118.6920295551014,0.08918032786885247,Very Cheap
20140519T000000,640000.0,2,2.25,1540,958,3.0,0,0,3,9,1540,0,2007,0,98122,47.6179,-122.318,1410,958,-582,-452,668.0584551148226,0.0740983606557377,Very Cheap
20150501T000000,613500.0,3,3.25,1876,1531,3.0,0,0,3,9,1876,0,2009,0,98115,47.6864,-122.265,1876,1533,-345,-343,400.7184846505552,0.07062295081967213,Very Cheap
20141017T000000,780000.0,4,3.5,3720,213073,1.0,0,2,3,10,3720,0,2007,0,98010,47.3216,-121.94,2190,59241,209353,57051,3.660717218981288,0.09245901639344262,Very Cheap
20150304T000000,550000.0,4,2.5,3148,9612,2.0,0,3,3,9,3148,0,2014,0,98198,47.3994,-122.311,3000,11475,6464,8475,57.22014148980441,0.06229508196721312,Very Cheap
20141008T000000,789500.0,4,3.25,3240,4852,2.0,0,0,3,9,3240,0,2010,0,98053,47.695,-122.022,3320,5318,1612,1998,162.7164056059357,0.09370491803278688,Very Cheap
20140710T000000,592000.0,5,3.5,3340,5000,2.0,0,0,3,8,2580,760,2012,0,98065,47.5168,-121.871,3420,5000,1660,1580,118.4,0.06780327868852459,Very Cheap
20150410T000000,454950.0,4,2.5,2413,5701,2.0,0,0,3,8,2413,0,2014,0,98042,47.3731,-122.159,2380,5725,3288,3345,79.80178915979653,0.049829508196721314,Very Cheap
20150413T000000,475000.0,4,2.5,2500,4500,2.0,0,0,3,7,2500,0,2010,0,98059,47.4928,-122.149,2230,4500,2000,2270,105.55555555555556,0.05245901639344262,Very Cheap
20141229T000000,659000.0,2,1.75,1180,904,2.0,0,0,3,10,780,400,2014,0,98102,47.6396,-122.329,1380,3610,-276,2230,728.9823008849557,0.07659016393442623,Very Cheap
20141124T000000,570000.0,4,2.5,2890,5801,2.0,0,0,3,9,2890,0,2005,0,98028,47.7349,-122.238,2890,6286,2911,3396,98.25892087571108,0.06491803278688525,Very Cheap
20150226T000000,347500.0,5,3.0,2230,6551,1.0,0,0,3,7,1330,900,2014,0,98168,47.487,-122.32,2230,9476,4321,7246,53.04533658983361,0.035737704918032784,Very Cheap
20150402T000000,205000.0,4,2.5,1767,4500,2.0,0,0,3,8,1767,0,2006,0,98001,47.2607,-122.25,1949,4636,2733,2687,45.55555555555556,0.017049180327868854,Very Cheap
20140903T000000,380000.0,3,3.25,1450,1468,2.0,0,0,3,8,1100,350,2009,0,98126,47.5664,-122.37,1450,1478,18,28,258.8555858310627,0.04,Very Cheap
20141003T000000,718000.0,5,2.75,2930,7663,2.0,0,0,3,9,2930,0,2013,0,98056,47.5308,-122.184,2750,10335,4733,7585,93.69698551481143,0.08432786885245902,Very Cheap
20140724T000000,515805.0,5,2.75,2710,4136,2.0,0,0,3,8,2710,0,2014,0,98059,47.4786,-122.123,2590,4136,1426,1546,124.71107350096712,0.057810491803278685,Very Cheap
20140714T000000,1029280.0,4,3.25,3600,18645,2.0,0,1,3,10,3000,600,2013,0,98059,47.5294,-122.154,3970,10957,15045,6987,55.204076159828375,0.12515147540983607,Cheap
20141113T000000,437718.0,3,2.5,1800,3265,2.0,0,0,3,8,1800,0,2014,0,98065,47.5338,-121.841,1800,3663,1465,1863,134.06370597243492,0.047569573770491806,Very Cheap
20140814T000000,450000.0,4,2.5,2290,5515,2.0,0,0,3,8,2290,0,2006,0,98106,47.5518,-122.357,1380,5515,3225,4135,81.59564823209429,0.04918032786885246,Very Cheap
20141028T000000,515000.0,3,2.5,1510,1178,2.0,0,0,3,8,1060,450,2007,0,98122,47.6181,-122.301,1510,1210,-332,-300,437.1816638370119,0.057704918032786885,Very Cheap
20150302T000000,204000.0,2,2.5,1090,13444,2.0,0,0,3,7,1090,0,2007,0,98198,47.4166,-122.319,1380,6000,12354,4620,15.17405534067242,0.016918032786885247,Very Cheap
20140523T000000,360000.0,3,2.0,1270,1323,3.0,0,0,3,8,1270,0,2006,0,98103,47.6934,-122.342,1330,1323,53,-7,272.10884353741494,0.037377049180327866,Very Cheap
20141203T000000,550000.0,3,2.25,1540,1005,3.0,0,0,3,8,1540,0,2008,0,98103,47.6827,-122.346,1510,1501,-535,-9,547.2636815920398,0.06229508196721312,Very Cheap
20140529T000000,650880.0,3,2.5,2930,6050,2.0,0,0,3,9,2930,0,2008,0,98065,47.5151,-121.883,2760,5765,3120,3005,107.58347107438017,0.07552524590163934,Very Cheap
20150225T000000,1789950.0,5,3.75,4360,8504,2.0,0,4,3,10,3530,830,2014,0,98033,47.6936,-122.19,2680,9000,4144,6320,210.4833019755409,0.22491147540983605,Cheap
20150225T000000,895900.0,4,3.5,3640,4983,2.0,0,3,3,9,2790,850,2014,0,98075,47.5619,-122.027,3270,14700,1343,11430,179.79129038731688,0.10765901639344262,Cheap
20140606T000000,585000.0,4,2.5,2430,4747,2.0,0,0,3,8,2430,0,2008,0,98027,47.5285,-122.031,1930,7200,2317,5270,123.23572782810196,0.06688524590163934,Very Cheap
20150508T000000,380000.0,3,2.25,1520,1464,2.0,0,0,3,8,1240,280,2010,0,98126,47.543,-122.375,1710,1464,-56,-246,259.56284153005464,0.04,Very Cheap
20141118T000000,565997.0,5,2.75,2730,5820,2.0,0,0,3,8,2730,0,2014,0,98059,47.4856,-122.154,2730,5700,3090,2970,97.25034364261168,0.06439304918032787,Very Cheap
20150504T000000,459000.0,3,3.0,2440,2076,2.0,0,0,3,8,1930,510,2006,0,98126,47.5476,-122.37,2440,2310,-364,-130,221.09826589595374,0.050360655737704915,Very Cheap
20150421T000000,550000.0,3,3.75,1580,1303,2.0,0,0,3,8,1340,240,2010,0,98144,47.5875,-122.315,1560,1294,-277,-266,422.10283960092096,0.06229508196721312,Very Cheap
20140725T000000,500000.0,3,2.25,1420,983,3.0,0,0,3,8,1420,0,2006,0,98103,47.6533,-122.346,1530,1280,-437,-250,508.646998982706,0.05573770491803279,Very Cheap
20150327T000000,461500.0,5,3.25,2820,3275,2.0,0,0,3,8,2230,590,2006,0,98118,47.5339,-122.284,2610,3275,455,665,140.91603053435114,0.05068852459016394,Very Cheap
20140522T000000,2150000.0,4,5.5,5060,10320,2.0,0,0,3,11,5060,0,2008,0,98004,47.6245,-122.21,3010,10080,5260,7070,208.33333333333334,0.2721311475409836,Cheap
20150421T000000,790000.0,4,2.5,2650,5000,2.0,0,0,3,8,2650,0,2007,0,98116,47.5605,-122.396,1110,6250,2350,5140,158.0,0.09377049180327869,Very Cheap
20140627T000000,735000.0,3,2.25,1490,1212,2.0,0,0,3,9,1040,450,2011,0,98112,47.6226,-122.313,1490,1337,-278,-153,606.4356435643564,0.08655737704918033,Very Cheap
20150330T000000,588000.0,4,2.5,3060,7710,2.0,0,0,3,9,3060,0,2009,0,98059,47.4828,-122.136,3040,7840,4650,4800,76.26459143968872,0.06727868852459017,Very Cheap
20150513T000000,724500.0,3,3.25,3240,4185,2.0,0,0,3,8,2770,470,2011,0,98075,47.5794,-122.03,2660,4692,945,2032,173.11827956989248,0.08518032786885246,Very Cheap
20140709T000000,749000.0,3,2.75,2820,5348,2.0,0,0,3,9,2820,0,2008,0,98052,47.7073,-122.118,3140,5640,2528,2500,140.0523560209424,0.08839344262295082,Very Cheap
20140918T000000,720000.0,5,3.5,4140,7642,2.0,0,0,3,8,4140,0,2003,0,98075,47.591,-122.008,3330,6953,3502,3623,94.2161737764983,0.08459016393442623,Very Cheap
20140611T000000,250000.0,2,1.5,982,846,2.0,0,0,3,8,806,176,2006,0,98133,47.7034,-122.345,1010,3844,-136,2834,295.5082742316785,0.022950819672131147,Very Cheap
20150327T000000,790000.0,3,2.75,2460,3600,2.0,0,0,3,9,2460,0,2007,0,98029,47.5409,-121.994,2570,3600,1140,1030,219.44444444444446,0.09377049180327869,Very Cheap
20150121T000000,392440.0,4,2.5,2547,4800,2.0,0,0,3,9,2547,0,2014,0,98092,47.2592,-122.194,2598,4800,2253,2202,81.75833333333334,0.04163147540983607,Very Cheap
20140725T000000,280000.0,4,2.25,1834,7460,2.0,0,0,3,8,1834,0,2012,0,98042,47.3568,-122.163,1979,9008,5626,7029,37.533512064343164,0.026885245901639345,Very Cheap
20141113T000000,1333000.0,4,4.5,3130,5126,3.0,0,0,3,10,2450,680,2014,0,98112,47.6239,-122.29,2540,7784,1996,5244,260.04682013265705,0.16498360655737704,Cheap
20141217T000000,649000.0,4,2.5,2730,4847,2.0,0,0,3,9,2730,0,2008,0,98126,47.549,-122.374,1250,4840,2117,3590,133.89725603466061,0.07527868852459016,Very Cheap
20141031T000000,457000.0,2,2.5,1380,1329,2.0,0,0,3,8,1050,330,2008,0,98117,47.6903,-122.37,1360,3750,-51,2390,343.8675696012039,0.0500983606557377,Very Cheap
20150323T000000,2225000.0,4,4.25,4700,10800,2.0,0,1,3,11,3910,790,2002,0,98033,47.6882,-122.214,2370,7680,6100,5310,206.0185185185185,0.2819672131147541,Cheap
20140823T000000,453000.0,3,3.0,2330,4284,2.0,0,0,3,9,1920,410,2004,0,98108,47.5547,-122.308,2330,3709,1954,1379,105.74229691876751,0.04957377049180328,Very Cheap
20140922T000000,329780.0,3,2.5,1730,3600,2.0,0,0,3,8,1730,0,2014,0,98146,47.5014,-122.34,2030,3600,1870,1570,91.60555555555555,0.03341377049180328,Very Cheap
20141112T000000,1050000.0,2,2.5,2350,2390,3.0,0,2,3,10,2000,350,2007,0,98144,47.5999,-122.286,1950,2390,40,440,439.3305439330544,0.12786885245901639,Cheap
20150505T000000,771005.0,5,4.5,4000,6713,2.0,0,0,3,9,4000,0,2015,0,98024,47.5254,-121.886,3690,6600,2713,2910,114.85252495158647,0.09127934426229509,Very Cheap
20140725T000000,1300000.0,3,2.5,3350,7752,1.0,0,0,3,9,2180,1170,2009,0,98008,47.6263,-122.099,2570,7988,4402,5418,167.69865841073272,0.16065573770491803,Cheap
20140619T000000,607500.0,3,3.25,1530,1612,3.0,0,0,3,8,1530,0,2006,0,98107,47.6706,-122.378,1530,1611,82,81,376.8610421836228,0.06983606557377049,Very Cheap
20150116T000000,278000.0,2,2.25,1610,1968,2.0,0,0,4,7,1610,0,1979,0,98056,47.5184,-122.196,1950,1968,358,18,141.260162601626,0.02662295081967213,Very Cheap
20140702T000000,475000.0,4,2.75,2620,6178,2.0,0,0,3,8,2620,0,2013,0,98045,47.4823,-121.771,2790,6538,3558,3748,76.88572353512464,0.05245901639344262,Very Cheap
20140814T000000,270000.0,3,2.0,1300,1920,2.0,0,0,3,8,850,450,2006,0,98126,47.5183,-122.376,1300,1344,620,44,140.625,0.025573770491803278,Very Cheap
20150423T000000,1302000.0,4,3.5,3590,5334,2.0,0,2,3,9,3140,450,2006,0,98115,47.6763,-122.267,2100,6250,1744,4150,244.09448818897638,0.16091803278688524,Cheap
20140811T000000,778983.0,4,2.5,2490,5647,2.0,0,0,3,8,2490,0,2014,0,98052,47.7043,-122.114,2970,5450,3157,2480,137.9463431910749,0.0923256393442623,Very Cheap
20141022T000000,221000.0,3,2.5,1320,1780,2.0,0,0,3,7,880,440,2005,0,98118,47.528,-122.269,3040,6000,460,2960,124.15730337078652,0.01914754098360656,Very Cheap
20140821T000000,338800.0,4,2.25,1800,2752,2.0,0,0,3,8,1800,0,2014,0,98106,47.5165,-122.346,1800,2752,952,952,123.11046511627907,0.03459672131147541,Very Cheap
20140804T000000,834995.0,5,1.5,3360,5225,2.0,0,0,3,9,3360,0,2014,0,98074,47.6072,-122.053,3230,5368,1865,2138,159.80765550239235,0.09967147540983606,Very Cheap
20150501T000000,550000.0,4,2.5,3220,9328,2.0,0,0,3,8,3220,0,2006,0,98019,47.7273,-121.958,3020,9300,6108,6280,58.9622641509434,0.06229508196721312,Very Cheap
20141031T000000,575000.0,3,3.5,2514,1559,2.0,0,0,3,8,2024,490,2007,0,98034,47.7044,-122.209,2090,10454,-955,8364,368.82617062219373,0.06557377049180328,Very Cheap
20140923T000000,649000.0,4,2.75,3130,9711,2.0,0,0,3,9,3130,0,2014,0,98059,47.4823,-122.124,1570,10500,6581,8930,66.83142827721142,0.07527868852459016,Very Cheap
20140530T000000,545000.0,4,2.5,2720,4738,2.0,0,0,3,8,2720,0,2012,0,98065,47.515,-121.869,2590,5740,2018,3150,115.02743773744196,0.06163934426229508,Very Cheap
20141120T000000,625000.0,2,2.25,1390,916,2.0,0,0,3,8,1165,225,2007,0,98122,47.6168,-122.314,1415,1488,-474,73,682.3144104803494,0.07213114754098361,Very Cheap
20141223T000000,1042000.0,4,4.5,4920,270236,2.0,0,3,3,10,3820,1100,2006,0,98045,47.4695,-121.775,4920,260924,265316,256004,3.8558889267159078,0.12681967213114753,Cheap
20140516T000000,611000.0,3,2.5,2134,1984,2.5,0,0,3,8,2134,0,2008,0,98027,47.5402,-122.027,2170,1984,-150,-186,307.96370967741933,0.07029508196721311,Very Cheap
20150317T000000,300000.0,3,2.5,1741,5701,2.0,0,0,3,8,1741,0,2012,0,98030,47.379,-122.184,2002,5700,3960,3698,52.62234695667427,0.029508196721311476,Very Cheap
20141229T000000,577000.0,3,2.5,2560,5238,2.0,0,0,3,8,2560,0,2001,0,98053,47.6887,-122.04,2560,5185,2678,2625,110.1565483008782,0.06583606557377049,Very Cheap
20141020T000000,349990.0,4,2.5,2220,3561,2.0,0,0,3,8,2220,0,2014,0,98038,47.3561,-122.063,2530,4449,1341,1919,98.28418983431621,0.036064262295081966,Very Cheap
20140714T000000,650000.0,3,2.5,1910,4363,2.0,0,0,3,9,1910,0,2006,0,98029,47.5482,-121.996,1890,3732,2453,1842,148.98005959202385,0.07540983606557378,Very Cheap
20150328T000000,378000.0,2,1.5,980,853,2.0,0,0,3,7,820,160,2009,0,98144,47.5925,-122.295,1130,1270,-127,140,443.14185228604924,0.03973770491803279,Very Cheap
20150205T000000,313200.0,3,2.5,1950,4197,2.0,0,0,3,7,1950,0,2013,0,98042,47.3613,-122.081,2300,4178,2247,1878,74.62473195139385,0.03123934426229508,Very Cheap
20140912T000000,1206690.0,5,4.25,4150,12015,2.0,0,0,3,10,4150,0,2014,0,98075,47.5816,-122.021,3230,27520,7865,24290,100.43196004993757,0.1484183606557377,Cheap
20150506T000000,252500.0,2,1.5,1110,986,2.0,0,0,3,7,950,160,2009,0,98118,47.5427,-122.272,1110,3515,-124,2405,256.0851926977688,0.023278688524590165,Very Cheap
20150305T000000,308000.0,3,2.5,1250,1150,2.0,0,0,3,8,1080,170,2009,0,98106,47.5582,-122.363,1250,1150,-100,-100,267.82608695652175,0.030557377049180327,Very Cheap
20140515T000000,803100.0,4,2.5,3310,5404,2.0,0,0,3,9,3310,0,2004,0,98052,47.6635,-122.083,2600,4730,2094,2130,148.6121391561806,0.09548852459016394,Very Cheap
20140618T000000,415000.0,4,2.5,2020,5501,2.0,0,0,3,7,2020,0,2010,0,98059,47.4937,-122.15,2020,5494,3481,3474,75.44082894019269,0.04459016393442623,Very Cheap
20140814T000000,785000.0,4,3.5,3310,4850,2.0,0,0,3,9,3310,0,2010,0,98053,47.6954,-122.022,3320,5955,1540,2635,161.8556701030928,0.09311475409836066,Very Cheap
20140528T000000,499950.0,4,2.5,2798,4473,2.0,0,0,3,9,2798,0,2012,0,98055,47.4295,-122.205,2358,4593,1675,2235,111.77062374245473,0.05573114754098361,Very Cheap
20150317T000000,216000.0,4,2.5,1847,8000,2.0,0,0,3,7,1847,0,2008,0,98001,47.2874,-122.257,1767,8000,6153,6233,27.0,0.018491803278688525,Very Cheap
20150226T000000,380000.0,4,2.5,2420,4981,2.0,0,0,3,9,2420,0,2009,0,98038,47.3785,-122.023,2420,5000,2561,2580,76.28990162617949,0.04,Very Cheap
20141106T000000,345000.0,4,2.5,2020,3600,2.0,0,0,3,7,2020,0,2012,0,98038,47.3535,-122.017,2210,3800,1580,1590,95.83333333333333,0.03540983606557377,Very Cheap
20141104T000000,456500.0,4,2.5,2400,6811,2.0,0,0,3,8,2400,0,2007,0,98059,47.4959,-122.15,2710,5314,4411,2604,67.02393187490824,0.0500327868852459,Very Cheap
20141104T000000,382495.0,3,2.5,1760,5390,1.0,0,0,3,8,1760,0,2014,0,98038,47.3482,-122.042,2310,5117,3630,2807,70.96382189239333,0.040327213114754096,Very Cheap
20150306T000000,324950.0,4,2.5,2110,4178,2.0,0,0,3,7,2110,0,2013,0,98042,47.3612,-122.081,2300,4142,2068,1842,77.77644806127334,0.03278032786885246,Very Cheap
20140811T000000,436472.0,4,2.5,2692,8392,2.0,0,0,3,9,2692,0,2014,0,98030,47.3519,-122.197,2574,14446,5700,11872,52.010486177311726,0.04740616393442623,Very Cheap
20140530T000000,365250.0,3,2.25,1490,4522,2.0,0,0,3,7,1490,0,2009,0,98028,47.7611,-122.233,1580,4667,3032,3087,80.77178239716939,0.0380655737704918,Very Cheap
20150324T000000,919990.0,5,3.25,3960,6352,2.0,0,0,3,10,3960,0,2014,0,98075,47.5806,-122.055,2930,9875,2392,6945,144.83469773299748,0.1108183606557377,Cheap
20150429T000000,316475.0,4,2.5,1740,4642,2.0,0,0,3,7,1740,0,2012,0,98042,47.3686,-122.117,1950,4642,2902,2692,68.17643257216717,0.03166885245901639,Very Cheap
20150324T000000,425000.0,4,2.5,1940,4517,1.0,0,0,3,8,1190,750,2010,0,98028,47.776,-122.26,1910,10410,2577,8500,94.08899712198362,0.04590163934426229,Very Cheap
20150311T000000,302860.0,2,1.0,970,3279,2.0,0,0,3,7,790,180,2007,0,98136,47.5469,-122.383,1150,1351,2309,201,92.36352546508081,0.02988327868852459,Very Cheap
20140722T000000,298000.0,3,2.5,1852,4000,2.0,0,0,3,7,1852,0,2014,0,98002,47.3455,-122.21,2166,4000,2148,1834,74.5,0.029245901639344263,Very Cheap
20140826T000000,3204000.0,4,4.0,4810,18851,2.0,0,3,3,11,4810,0,2007,0,98004,47.6364,-122.214,3970,19929,14041,15959,169.96445811893267,0.4103606557377049,High
20141201T000000,950000.0,4,4.0,5635,9695,2.0,0,3,3,10,4360,1275,2011,0,98003,47.3389,-122.334,3726,9765,4060,6039,97.98865394533264,0.11475409836065574,Cheap
20141121T000000,333000.0,3,2.5,1520,3041,2.0,0,0,3,7,1520,0,2009,0,98059,47.4874,-122.152,1820,3229,1521,1409,109.50345281157514,0.033836065573770495,Very Cheap
20150305T000000,289950.0,3,2.5,2099,4275,2.0,0,0,3,7,2099,0,2010,0,98002,47.3521,-122.211,2099,4275,2176,2176,67.82456140350877,0.028190163934426228,Very Cheap
20150506T000000,419950.0,3,2.25,1250,811,3.0,0,0,3,8,1250,0,2014,0,98136,47.5419,-122.388,1250,1232,-439,-18,517.8175092478422,0.04523934426229508,Very Cheap
20140715T000000,306000.0,2,1.5,1090,1183,3.0,0,0,3,8,1090,0,2008,0,98103,47.6974,-122.349,1110,1384,93,274,258.66441251056636,0.030295081967213113,Very Cheap
20141129T000000,498445.0,4,2.5,3216,5902,2.0,0,0,3,9,3216,0,2014,0,98030,47.3425,-122.179,2815,4916,2686,2101,84.45357505930193,0.05553377049180328,Very Cheap
20140620T000000,775950.0,4,2.5,2970,4400,2.0,0,0,3,8,2970,0,2014,0,98052,47.705,-122.114,3010,4892,1430,1882,176.35227272727272,0.09192786885245902,Very Cheap
20140703T000000,605000.0,3,2.5,2610,6405,2.0,0,0,3,8,2610,0,2001,0,98065,47.5373,-121.874,2580,6285,3795,3705,94.45745511319282,0.06950819672131148,Very Cheap
20140909T000000,520000.0,2,1.75,1340,1368,2.0,0,0,3,7,1060,280,2006,0,98122,47.618,-122.311,2480,1707,28,-773,380.1169590643275,0.058360655737704915,Very Cheap
20141028T000000,849990.0,4,2.75,3300,4987,2.0,0,0,3,9,3300,0,2014,0,98074,47.6175,-122.056,3520,5453,1687,1933,170.4411469821536,0.10163803278688524,Cheap
20140604T000000,767450.0,3,2.0,1630,7599,1.0,0,0,3,10,1630,0,2006,0,98117,47.6981,-122.376,2030,7599,5969,5569,100.99355178312936,0.09081311475409837,Very Cheap
20140808T000000,665000.0,3,2.25,1590,929,2.0,0,0,3,9,1060,530,2014,0,98122,47.6172,-122.31,1510,1193,-661,-317,715.8234660925726,0.07737704918032787,Very Cheap
20140918T000000,525000.0,2,2.75,1310,1268,3.5,0,0,3,8,1310,0,2007,0,98103,47.6534,-122.355,1350,1288,-42,-62,414.0378548895899,0.05901639344262295,Very Cheap
20140722T000000,870515.0,4,3.5,3600,5697,2.0,0,0,3,9,2940,660,2014,0,98075,47.5755,-122.071,3490,5911,2097,2421,152.80235211514832,0.10432983606557376,Cheap
20140721T000000,390000.0,4,2.5,2154,4153,2.0,0,0,3,9,2154,0,2012,0,98058,47.4557,-122.13,2154,4091,1999,1937,93.90801830002408,0.04131147540983607,Very Cheap
20150411T000000,500000.0,3,1.75,1530,825,3.0,0,0,3,8,1530,0,2015,0,98144,47.5929,-122.308,1580,1915,-705,335,606.060606060606,0.05573770491803279,Very Cheap
20140805T000000,399950.0,3,2.25,1360,1041,2.0,0,0,3,8,1094,266,2006,0,98117,47.6925,-122.375,1522,1382,-319,-140,384.19788664745437,0.04261639344262295,Very Cheap
20150209T000000,305000.0,3,2.5,1320,2480,2.0,0,0,3,7,1320,0,2005,0,98118,47.536,-122.284,1320,3240,1160,1920,122.98387096774194,0.03016393442622951,Very Cheap
20150123T000000,255000.0,4,2.5,1660,6724,2.0,0,0,3,7,1660,0,2009,0,98001,47.259,-122.256,1544,6054,5064,4510,37.92385484830458,0.02360655737704918,Very Cheap
20140930T000000,415000.0,4,2.5,2891,6499,2.0,0,0,3,9,2891,0,2014,0,98001,47.3359,-122.257,2550,8383,3608,5833,63.85597784274504,0.04459016393442623,Very Cheap
20150327T000000,716500.0,3,2.5,2340,2155,2.0,0,0,3,10,2120,220,2012,0,98027,47.53,-122.073,2640,2680,-185,40,332.48259860788863,0.08413114754098361,Very Cheap
20140625T000000,425000.0,3,2.5,2320,2267,3.0,0,0,3,8,2320,0,2009,0,98177,47.7027,-122.359,1240,1883,-53,643,187.4724305249228,0.04590163934426229,Very Cheap
20150217T000000,540000.0,4,2.5,2190,3855,2.0,0,0,3,8,2190,0,2010,0,98011,47.7705,-122.169,2190,3600,1665,1410,140.07782101167317,0.06098360655737705,Very Cheap
20140804T000000,324747.0,3,2.5,2060,4742,2.0,0,0,3,8,2060,0,2014,0,98038,47.3706,-122.017,2370,4725,2682,2355,68.48312948123154,0.03275370491803279,Very Cheap
20150128T000000,385000.0,3,2.5,1740,4145,2.0,0,0,3,7,1740,0,2010,0,98053,47.6875,-122.015,1740,4045,2405,2305,92.88299155609168,0.04065573770491803,Very Cheap
20140812T000000,270000.0,3,2.25,1400,3825,2.0,0,0,3,7,1400,0,2012,0,98042,47.3596,-122.082,2110,3825,2425,1715,70.58823529411765,0.025573770491803278,Very Cheap
20140612T000000,1240000.0,5,4.0,4410,14380,2.0,0,0,3,11,4410,0,2006,0,98052,47.6463,-122.121,2720,11454,9970,8734,86.23087621696801,0.15278688524590164,Cheap
20150416T000000,672000.0,3,2.5,1780,1647,2.0,0,0,3,8,1080,700,2008,0,98103,47.6597,-122.355,2000,1741,-133,-259,408.0145719489982,0.07829508196721312,Very Cheap
20150129T000000,310000.0,3,2.5,1760,10137,2.0,0,0,3,8,1760,0,2010,0,98038,47.355,-122.059,2000,6935,8377,4935,30.581039755351682,0.03081967213114754,Very Cheap
20140811T000000,3000000.0,3,3.5,4410,10756,2.0,1,4,3,11,3430,980,2014,0,98056,47.5283,-122.205,3550,5634,6346,2084,278.9140944589067,0.3836065573770492,Medium
20150225T000000,2350000.0,6,4.25,5550,11547,2.0,0,2,3,11,4270,1280,2014,0,98033,47.6547,-122.202,3480,11547,5997,8067,203.5160647787304,0.2983606557377049,Cheap
20140627T000000,427000.0,3,2.5,2432,9391,2.0,0,2,3,9,2432,0,2005,0,98001,47.3453,-122.267,2912,8932,6959,6020,45.46906612714301,0.04616393442622951,Very Cheap
20150423T000000,389950.0,3,2.5,2283,3996,2.0,0,0,3,8,2283,0,2008,0,98031,47.4221,-122.192,1760,3992,1713,2232,97.58508508508508,0.04130491803278689,Very Cheap
20140625T000000,309620.0,3,2.5,1860,3730,2.0,0,0,3,8,1860,0,2012,0,98019,47.7442,-121.984,2110,4509,1870,2399,83.00804289544236,0.03076983606557377,Very Cheap
20140701T000000,399895.0,4,2.5,2701,4500,2.0,0,0,3,9,2701,0,2014,0,98092,47.2586,-122.194,2570,4800,1799,2230,88.86555555555556,0.042609180327868854,Very Cheap
20150202T000000,442515.0,4,2.5,2930,4875,2.0,0,0,3,9,2930,0,2014,0,98030,47.3421,-122.179,2815,4900,1945,2085,90.77230769230769,0.048198688524590166,Very Cheap
20141202T000000,375000.0,3,2.25,1540,1561,3.0,0,0,3,8,1540,0,2010,0,98103,47.6991,-122.346,1540,1547,21,7,240.23062139654067,0.03934426229508197,Very Cheap
20140702T000000,309780.0,3,2.5,2242,4500,2.0,0,0,3,8,2242,0,2014,0,98092,47.2583,-122.198,2009,4500,2258,2491,68.84,0.030790819672131146,Very Cheap
20150312T000000,425000.0,3,2.5,1950,4345,2.0,0,0,3,7,1950,0,2007,0,98065,47.5202,-121.873,2260,4345,2395,2085,97.81357882623705,0.04590163934426229,Very Cheap
20150501T000000,405000.0,2,3.0,1160,1073,2.0,0,0,3,7,880,280,2007,0,98144,47.5788,-122.315,1250,4812,-87,3562,377.44641192917055,0.043278688524590166,Very Cheap
20140719T000000,356250.0,3,2.5,2060,5115,2.0,0,0,3,9,2060,0,2014,0,98092,47.3261,-122.163,2648,4500,3055,1852,69.64809384164222,0.036885245901639344,Very Cheap
20150219T000000,550000.0,3,2.25,1230,875,3.0,0,0,3,8,1230,0,2013,0,98199,47.6521,-122.4,1760,5664,-355,3904,628.5714285714286,0.06229508196721312,Very Cheap
20140505T000000,340000.0,2,1.5,1160,1438,2.0,0,0,3,7,1160,0,2001,0,98144,47.5917,-122.295,1220,1740,278,520,236.4394993045897,0.03475409836065574,Very Cheap
20140823T000000,362865.0,4,2.5,2245,4301,2.0,0,0,3,8,2245,0,2014,0,98038,47.3555,-122.063,2530,4478,2056,1948,84.36758893280633,0.0377527868852459,Very Cheap
20150323T000000,1360000.0,4,3.5,4120,12626,2.0,0,1,3,11,3970,150,2014,0,98034,47.7089,-122.245,4120,11913,8506,7793,107.7142404562015,0.16852459016393442,Cheap
20140505T000000,830000.0,4,2.5,3400,9692,2.0,0,0,3,9,3400,0,2007,0,98052,47.708,-122.109,3070,7375,6292,4305,85.63763929013619,0.09901639344262295,Very Cheap
20140801T000000,1598000.0,5,3.75,4270,7500,2.0,0,0,3,10,3210,1060,2014,0,98033,47.6845,-122.207,2410,8350,3230,5940,213.06666666666666,0.19973770491803278,Cheap
20150304T000000,855000.0,4,3.5,2890,5911,2.0,0,0,3,9,2370,520,2014,0,98075,47.5754,-122.071,3490,6093,3021,2603,144.6455760446625,0.10229508196721311,Cheap
20140819T000000,1205000.0,5,3.5,3220,8000,2.0,0,0,3,9,2900,320,2008,0,98033,47.6834,-122.2,2100,9680,4780,7580,150.625,0.1481967213114754,Cheap
20140811T000000,1385000.0,4,3.5,4010,15365,2.0,0,1,3,11,4010,0,2006,0,98027,47.5528,-122.093,3550,13429,11355,9879,90.13992840872112,0.1718032786885246,Cheap
20150326T000000,400200.0,4,3.5,2260,30250,2.0,0,0,3,7,2260,0,2013,0,98188,47.4493,-122.281,1270,16350,27990,15080,13.229752066115703,0.04264918032786885,Very Cheap
20140523T000000,235000.0,2,1.0,1140,1730,1.5,0,0,3,8,1010,130,2007,0,98126,47.5494,-122.372,1360,1730,590,370,135.83815028901734,0.02098360655737705,Very Cheap
20150507T000000,349950.0,3,2.0,1640,4714,1.0,0,0,3,8,1640,0,2009,0,98038,47.3539,-122.021,1770,4802,3074,3032,74.23631735256683,0.036059016393442625,Very Cheap
20140709T000000,659950.0,4,2.75,3510,9400,2.0,0,0,3,9,3510,0,2014,0,98059,47.4827,-122.131,3550,9429,5890,5879,70.20744680851064,0.07671475409836065,Very Cheap
20140508T000000,785000.0,3,2.75,3010,1842,2.0,0,0,3,9,3010,0,2011,0,98075,47.5836,-121.994,2950,4200,-1168,1250,426.1672095548317,0.09311475409836066,Very Cheap
20150416T000000,475000.0,2,2.25,1060,925,2.0,0,0,3,8,980,80,2006,0,98199,47.6386,-122.388,1020,4000,-135,2980,513.5135135135135,0.05245901639344262,Very Cheap
20140527T000000,263900.0,3,2.5,1658,2700,2.0,0,0,3,8,1658,0,2014,0,98198,47.3667,-122.307,1658,2700,1042,1042,97.74074074074075,0.02477377049180328,Very Cheap
20150501T000000,342000.0,3,2.5,1960,3540,2.0,0,0,3,8,1960,0,2012,0,98038,47.3568,-122.055,1840,3825,1580,1985,96.61016949152543,0.03501639344262295,Very Cheap
20140918T000000,367899.0,3,2.5,2420,4725,2.0,0,0,3,8,2420,0,2014,0,98038,47.371,-122.018,2370,4200,2305,1830,77.86222222222223,0.03841298360655738,Very Cheap
20150204T000000,657044.0,3,3.5,3420,23786,1.5,0,0,3,9,3420,0,2014,0,98059,47.4739,-122.11,1590,23774,20366,22184,27.62313966198604,0.0763336393442623,Very Cheap
20141113T000000,359950.0,2,1.5,893,965,2.0,0,0,3,8,893,0,2007,0,98122,47.6187,-122.301,1340,1436,72,96,373.00518134715026,0.037370491803278685,Very Cheap
20140723T000000,879950.0,4,2.75,3020,7203,2.0,0,0,3,9,3020,0,2014,0,98033,47.6948,-122.178,3010,7215,4183,4205,122.16437595446342,0.1055672131147541,Cheap
20140826T000000,550000.0,4,2.5,2470,5954,2.0,0,0,3,8,2470,0,2013,0,98028,47.7685,-122.236,2470,4800,3484,2330,92.37487403426267,0.06229508196721312,Very Cheap
20141209T000000,279000.0,4,2.5,2009,4800,2.0,0,0,3,8,2009,0,2012,0,98092,47.2586,-122.2,1798,4800,2791,3002,58.125,0.02675409836065574,Very Cheap
20140718T000000,255000.0,3,2.5,1530,1116,2.5,0,0,3,7,1530,0,2005,0,98028,47.7385,-122.25,1530,7780,-414,6250,228.49462365591398,0.02360655737704918,Very Cheap
20150224T000000,609500.0,3,1.75,1590,1113,3.0,0,0,3,8,1590,0,2014,0,98107,47.6691,-122.402,1520,1357,-477,-163,547.6190476190476,0.0700983606557377,Very Cheap
20140620T000000,420000.0,5,3.0,2630,3149,2.0,0,0,3,8,1670,960,2013,0,98056,47.5065,-122.171,2240,4825,519,2585,133.37567481740234,0.04524590163934426,Very Cheap
20141008T000000,570000.0,4,2.5,3230,7187,2.0,0,0,3,9,3230,0,2008,0,98059,47.4995,-122.15,2950,6537,3957,3587,79.30986503408933,0.06491803278688525,Very Cheap
20150512T000000,439000.0,3,2.25,1430,2343,2.0,0,0,3,8,1430,0,2012,0,98108,47.5648,-122.294,1270,1916,913,646,187.3666239863423,0.04773770491803279,Very Cheap
20141108T000000,310000.0,3,2.5,2242,5744,2.0,0,0,3,8,2242,0,2012,0,98092,47.2597,-122.199,2009,5712,3502,3703,53.969359331476326,0.03081967213114754,Very Cheap
20150209T000000,635000.0,4,2.5,2500,4000,2.0,0,0,3,8,2500,0,2014,0,98144,47.5902,-122.311,1480,4300,1500,2820,158.75,0.07344262295081967,Very Cheap
20141128T000000,399950.0,3,2.5,1230,922,2.0,0,0,3,8,1080,150,2009,0,98199,47.6518,-122.384,1230,1237,-308,7,433.7852494577007,0.04261639344262295,Very Cheap
20140805T000000,805000.0,4,2.5,3020,3600,2.5,0,0,3,9,3020,0,2009,0,98029,47.5407,-121.993,2570,3600,580,1030,223.61111111111111,0.09573770491803278,Very Cheap
20150407T000000,1800000.0,4,3.5,3480,4000,2.0,0,0,3,9,2460,1020,2015,0,98112,47.6356,-122.281,2620,4000,520,1380,450.0,0.2262295081967213,Cheap
20150403T000000,1205000.0,4,3.0,3330,7650,1.0,0,0,3,9,1830,1500,2008,0,98103,47.6889,-122.352,1200,3876,4320,2676,157.51633986928104,0.1481967213114754,Cheap
20141015T000000,745000.0,4,2.5,3400,4840,2.0,0,0,3,10,3190,210,2006,0,98059,47.5066,-122.146,3400,5710,1440,2310,153.92561983471074,0.08786885245901639,Very Cheap
20140624T000000,329445.0,2,1.5,830,1119,2.0,0,0,3,7,830,0,2005,0,98144,47.5828,-122.314,1480,3622,289,2142,294.4101876675603,0.03336983606557377,Very Cheap
20141015T000000,588000.0,5,3.0,3110,4464,2.0,0,0,3,8,3110,0,2007,0,98011,47.7719,-122.168,2450,4221,1354,1771,131.72043010752688,0.06727868852459017,Very Cheap
20140707T000000,494815.0,3,2.5,1910,2091,2.0,0,0,3,8,1910,0,2014,0,98029,47.5445,-122.013,1630,1546,181,-84,236.64036346245814,0.05505770491803279,Very Cheap
20141014T000000,591975.0,3,2.75,3230,5250,2.0,0,0,3,9,2680,550,2014,0,98065,47.5196,-121.878,2710,5250,2020,2540,112.75714285714285,0.0678,Very Cheap
20150108T000000,600000.0,5,2.75,3380,8179,2.0,0,0,3,9,3380,0,2011,0,98059,47.4827,-122.135,2840,8179,4799,5339,73.35860129600195,0.06885245901639345,Very Cheap
20140708T000000,673000.0,3,2.75,2830,3496,2.0,0,0,3,8,2830,0,2012,0,98029,47.5606,-122.011,2160,3501,666,1341,192.50572082379864,0.07842622950819672,Very Cheap
20150211T000000,889950.0,5,3.5,3700,7055,2.0,0,0,3,9,3700,0,2014,0,98074,47.5929,-122.057,3170,6527,3355,3357,126.144578313253,0.10687868852459016,Cheap
20150325T000000,500000.0,4,3.0,2520,4104,2.0,0,0,3,7,2520,0,2002,0,98065,47.5352,-121.88,2510,5015,1584,2505,121.83235867446393,0.05573770491803279,Very Cheap
20141001T000000,500000.0,3,2.25,1530,1396,2.0,0,0,3,8,1240,290,2007,0,98107,47.666,-122.367,1690,2500,-134,810,358.1661891117478,0.05573770491803279,Very Cheap
20140505T000000,890000.0,4,4.25,4420,5750,2.0,0,0,3,10,3410,1010,2006,0,98027,47.5404,-122.073,4420,5750,1330,1330,154.7826086956522,0.10688524590163935,Cheap
20150429T000000,437000.0,3,3.0,1460,1180,3.0,0,0,3,8,1460,0,2006,0,98117,47.6998,-122.367,1460,1224,-280,-236,370.33898305084745,0.047475409836065574,Very Cheap
20140905T000000,419700.0,3,2.25,1450,1486,2.0,0,0,3,8,1160,290,2006,0,98116,47.5694,-122.387,1370,1437,36,67,282.43606998654104,0.04520655737704918,Very Cheap
20140723T000000,394000.0,3,2.0,1160,3441,1.0,0,0,4,6,580,580,1930,0,98136,47.5314,-122.392,1160,4000,2281,2840,114.50159837256612,0.041836065573770495,Very Cheap
20140806T000000,342000.0,3,2.0,1640,4802,1.0,0,0,3,8,1640,0,2010,0,98038,47.3538,-122.021,1940,4802,3162,2862,71.22032486463974,0.03501639344262295,Very Cheap
20140626T000000,420000.0,3,1.75,1444,249126,1.5,0,0,3,7,1444,0,2008,0,98070,47.4104,-122.486,1760,224770,247682,223010,1.685893885022037,0.04524590163934426,Very Cheap
20140523T000000,580000.0,3,2.5,1620,1173,3.0,0,4,3,8,1470,150,2008,0,98103,47.6681,-122.355,1620,1505,-447,-115,494.45865302642795,0.06622950819672131,Very Cheap
20150327T000000,343000.0,2,1.5,1100,1228,2.0,0,0,3,7,900,200,2007,0,98118,47.5538,-122.282,1340,1380,128,40,279.3159609120521,0.035147540983606555,Very Cheap
20150402T000000,390000.0,2,1.5,1340,1402,2.0,0,0,3,8,1120,220,2008,0,98144,47.588,-122.304,1340,1213,62,-127,278.1740370898716,0.04131147540983607,Very Cheap
20140811T000000,274000.0,3,1.5,1450,4694,2.0,0,0,3,7,1450,0,2011,0,98038,47.3654,-122.021,1870,4198,3244,2328,58.372390285470814,0.026098360655737705,Very Cheap
20150114T000000,700000.0,4,2.5,3040,7200,2.0,0,0,3,9,3040,0,2008,0,98177,47.7747,-122.366,2360,8245,4160,5885,97.22222222222223,0.08196721311475409,Very Cheap
20150416T000000,838000.0,4,2.5,2560,7210,2.0,0,0,3,9,2560,0,2006,0,98136,47.5535,-122.395,2160,10439,4650,8279,116.22746185852982,0.1000655737704918,Cheap
20140917T000000,300000.0,6,3.0,2744,9926,2.0,0,0,3,7,2744,0,2006,0,98002,47.2773,-122.216,2470,9926,7182,7456,30.223655047350395,0.029508196721311476,Very Cheap
20140903T000000,467000.0,3,2.25,1420,990,3.0,0,0,3,8,1420,0,2008,0,98103,47.6801,-122.348,1350,1415,-430,65,471.7171717171717,0.05140983606557377,Very Cheap
20150302T000000,395000.0,2,1.0,700,7457,1.0,0,0,3,6,700,0,1943,0,98108,47.5348,-122.295,1500,7130,6757,5630,52.970363416923696,0.0419672131147541,Very Cheap
20140924T000000,734000.0,5,4.25,4110,42755,2.0,0,2,3,10,2970,1140,2000,0,98023,47.3375,-122.337,2730,12750,38645,10020,17.16758273886095,0.08642622950819673,Very Cheap
20150106T000000,480000.0,5,2.75,2670,4780,2.0,0,0,3,8,2670,0,2013,0,98059,47.4866,-122.155,2560,5380,2110,2820,100.418410041841,0.05311475409836065,Very Cheap
20150217T000000,539000.0,3,2.75,2130,1400,2.0,0,0,3,9,1080,1050,2010,0,98118,47.5661,-122.29,1520,3132,-730,1612,385.0,0.06085245901639344,Very Cheap
20150505T000000,459950.0,5,2.75,3078,6371,2.0,0,0,3,9,3078,0,2014,0,98042,47.3587,-122.163,1979,19030,3293,17051,72.19431800345315,0.050485245901639345,Very Cheap
20141030T000000,306500.0,2,1.0,840,892,2.0,0,0,3,7,840,0,2006,0,98136,47.5396,-122.387,1030,1007,52,-23,343.609865470852,0.03036065573770492,Very Cheap
20150326T000000,408474.0,3,2.5,1800,2731,2.0,0,0,3,8,1800,0,2014,0,98065,47.5342,-121.841,1800,3265,931,1465,149.5693885023801,0.04373429508196721,Very Cheap
20140514T000000,437000.0,3,2.75,2580,5200,2.0,0,0,3,8,2580,0,2008,0,98059,47.496,-122.151,2700,5602,2620,2902,84.03846153846153,0.047475409836065574,Very Cheap
20140623T000000,160797.0,3,1.5,1270,2356,2.0,0,0,3,7,1270,0,2012,0,98108,47.5671,-122.298,1490,2175,1086,685,68.25,0.011252065573770492,Very Cheap
20150107T000000,729000.0,4,3.5,3065,5440,3.0,0,0,3,9,3065,0,2014,0,98056,47.524,-122.2,2210,8400,2375,6190,134.00735294117646,0.08577049180327868,Very Cheap
20141031T000000,499000.0,3,2.5,1861,1587,2.0,0,0,3,8,1578,283,2007,0,98034,47.7043,-122.209,2090,10454,-274,8364,314.4297416509137,0.05560655737704918,Very Cheap
20141016T000000,359950.0,4,2.75,2260,5705,2.0,0,0,3,8,2260,0,2014,0,98042,47.3726,-122.159,2260,5727,3445,3467,63.093777388255916,0.037370491803278685,Very Cheap
20141210T000000,929000.0,5,3.25,4150,7100,2.0,0,0,3,10,4150,0,2013,0,98074,47.6026,-122.06,3560,7214,2950,3654,130.8450704225352,0.112,Cheap
20141006T000000,529950.0,2,2.5,1500,1174,2.0,0,0,3,8,1140,360,2014,0,98107,47.6689,-122.363,1550,1519,-326,-31,451.4054514480409,0.0596655737704918,Very Cheap
20150403T000000,461000.0,3,2.25,1620,998,2.5,0,0,3,8,1540,80,2012,0,98027,47.5394,-122.027,1620,1068,-622,-552,461.9238476953908,0.05062295081967213,Very Cheap
20141014T000000,271115.0,2,1.5,830,1325,2.0,0,0,3,7,830,0,2005,0,98136,47.5472,-122.384,1310,1485,495,175,204.61509433962263,0.02572,Very Cheap
20150106T000000,653000.0,4,2.5,3120,5137,2.0,0,0,3,7,3120,0,2003,0,98053,47.6842,-122.04,2755,5137,2017,2382,127.11699435468172,0.07580327868852459,Very Cheap
20141024T000000,565000.0,3,2.5,1870,1058,3.0,0,0,3,8,1380,490,2007,0,98103,47.6512,-122.345,1440,1136,-812,-304,534.0264650283553,0.06426229508196721,Very Cheap
20141204T000000,529950.0,3,2.25,1240,1250,3.0,0,0,3,8,1240,0,2014,0,98107,47.6748,-122.377,1470,1250,10,-220,423.96,0.0596655737704918,Very Cheap
20150326T000000,585000.0,4,2.5,2820,5612,2.0,0,0,3,9,2820,0,2007,0,98028,47.7477,-122.236,1620,14881,2792,13261,104.24091233071988,0.06688524590163934,Very Cheap
20140703T000000,609000.0,3,1.75,1630,1526,3.0,0,0,3,8,1630,0,2014,0,98103,47.6536,-122.354,1570,1274,-104,-296,399.08256880733944,0.0700327868852459,Very Cheap
20140618T000000,267000.0,3,2.25,1584,2800,2.0,0,0,3,7,1584,0,2012,0,98002,47.3454,-122.214,1584,2800,1216,1216,95.35714285714286,0.025180327868852458,Very Cheap
20140509T000000,557000.0,4,2.5,2840,4500,2.0,0,0,3,8,2840,0,2012,0,98028,47.7678,-122.237,2840,4939,1660,2099,123.77777777777777,0.06321311475409835,Very Cheap
20141117T000000,709950.0,4,3.25,3910,6293,2.0,0,0,3,9,3130,780,2006,0,98065,47.5389,-121.86,4410,6015,2383,1605,112.81582710948673,0.08327213114754098,Very Cheap
20140718T000000,625000.0,3,2.5,1730,1301,3.0,0,0,3,9,1730,0,2011,0,98103,47.653,-122.352,1330,1240,-429,-90,480.3996925441968,0.07213114754098361,Very Cheap
20141223T000000,599000.0,3,2.75,1840,2060,2.0,0,0,3,10,1700,140,2013,0,98027,47.53,-122.073,2590,2680,220,90,290.77669902912623,0.06872131147540983,Very Cheap
20150506T000000,920000.0,4,3.75,4030,503989,2.0,0,0,3,10,4030,0,2008,0,98045,47.4807,-121.795,2110,71874,499959,69764,1.8254366662764465,0.11081967213114755,Cheap
20141016T000000,1285000.0,4,3.5,3440,3800,3.0,0,0,3,9,3440,0,2014,0,98112,47.6408,-122.307,1760,3800,360,2040,338.1578947368421,0.15868852459016394,Cheap
20150330T000000,324500.0,4,2.5,2110,3825,2.0,0,0,3,7,2110,0,2012,0,98042,47.3602,-122.082,2110,3825,1715,1715,84.83660130718954,0.03272131147540984,Very Cheap
20150116T000000,471500.0,3,2.5,2430,5866,2.0,0,0,3,7,2430,0,2009,0,98065,47.5158,-121.871,2380,5866,3436,3486,80.37845209682918,0.052,Very Cheap
20140808T000000,1015000.0,4,3.75,4690,207141,2.0,0,0,3,10,4030,660,2007,0,98019,47.7072,-121.983,2890,200527,202451,197637,4.900043931428351,0.12327868852459016,Cheap
20141111T000000,998000.0,4,3.5,3500,43560,2.0,0,0,3,9,2850,650,2014,0,98006,47.5481,-122.103,3640,40545,40060,36905,22.910927456382,0.12104918032786885,Cheap
20150129T000000,262000.0,4,2.5,2070,8685,2.0,0,0,3,7,2070,0,2006,0,98188,47.4697,-122.267,2170,9715,6615,7545,30.166954519286126,0.024524590163934427,Very Cheap
20150401T000000,844000.0,4,3.5,3350,6350,2.0,0,2,3,8,2610,740,2009,0,98116,47.5602,-122.39,1820,6350,3000,4530,132.91338582677164,0.10085245901639345,Cheap
20140624T000000,745641.0,4,2.5,2440,4850,2.0,0,0,3,8,2440,0,2013,0,98052,47.7043,-122.114,2970,5450,2410,2480,153.74041237113403,0.08795291803278689,Very Cheap
20141212T000000,659950.0,5,3.0,3010,7357,2.0,0,0,3,9,3010,0,2008,0,98133,47.7226,-122.33,2370,8050,4347,5680,89.7036835666712,0.07671475409836065,Very Cheap
20140804T000000,339989.0,3,2.5,2060,4200,2.0,0,0,3,8,2060,0,2014,0,98038,47.3706,-122.018,2370,4200,2140,1830,80.9497619047619,0.03475265573770492,Very Cheap
20150504T000000,352500.0,2,2.5,1570,2399,2.0,0,0,3,7,1180,390,2009,0,98106,47.5488,-122.364,1590,2306,829,716,146.9362234264277,0.03639344262295082,Very Cheap
20140513T000000,525000.0,3,2.5,1580,1161,2.0,0,0,3,8,1010,570,2008,0,98112,47.6206,-122.299,1680,1177,-419,-503,452.1963824289406,0.05901639344262295,Very Cheap
20140929T000000,1138990.0,5,3.5,4280,6530,2.0,0,3,3,10,4280,0,2014,0,98075,47.5941,-121.973,3960,6863,2250,2903,174.42419601837673,0.13953967213114754,Cheap
20140812T000000,491000.0,5,3.5,2815,4900,2.0,0,0,3,9,2815,0,2011,0,98030,47.3424,-122.179,2798,4900,2085,2102,100.20408163265306,0.05455737704918033,Very Cheap
20140718T000000,675000.0,4,2.5,2620,6114,2.0,0,0,3,9,2620,0,2011,0,98029,47.5603,-122.013,2620,5808,3494,3188,110.40235525024534,0.07868852459016394,Very Cheap
20150106T000000,344000.0,3,2.25,1250,1033,3.0,0,0,3,8,1250,0,2007,0,98103,47.6907,-122.343,1250,1150,-217,-100,333.0106485963214,0.035278688524590165,Very Cheap
20141104T000000,530000.0,4,2.5,3250,4500,2.0,0,0,3,8,3250,0,2008,0,98059,47.4944,-122.15,3030,4598,1250,1568,117.77777777777777,0.05967213114754098,Very Cheap
20141210T000000,290500.0,4,3.25,2510,7686,2.0,0,0,3,9,2510,0,2003,0,98055,47.4785,-122.228,2510,6732,5176,4222,37.7959927140255,0.028262295081967214,Very Cheap
20150113T000000,335000.0,2,1.75,1270,1685,2.0,0,0,3,8,1270,0,2012,0,98108,47.5646,-122.295,1270,1843,415,573,198.81305637982197,0.03409836065573771,Very Cheap
20150507T000000,2998000.0,5,4.0,6670,16481,2.0,0,0,3,12,4960,1710,2007,0,98004,47.6409,-122.221,4800,16607,9811,11807,181.906437716158,0.38334426229508195,Medium
20140919T000000,379000.0,3,2.5,1580,3075,2.0,0,0,3,8,1580,0,2013,0,98126,47.545,-122.368,1710,2934,1495,1224,123.2520325203252,0.03986885245901639,Very Cheap
20140717T000000,385000.0,3,1.5,1360,2030,3.0,0,0,3,8,1360,0,2008,0,98103,47.6961,-122.349,1360,1167,670,-193,189.6551724137931,0.04065573770491803,Very Cheap
20150225T000000,500012.0,4,2.5,2400,9612,1.0,0,0,3,8,1230,1170,1962,2009,98059,47.4799,-122.127,2430,5539,7212,3109,52.019558884727424,0.05573927868852459,Very Cheap
20140505T000000,366750.0,3,3.0,1571,2017,3.0,0,0,3,8,1571,0,2008,0,98125,47.7338,-122.309,1520,1497,446,-23,181.8294496777392,0.03826229508196721,Very Cheap
20140606T000000,405000.0,2,2.0,1405,1073,2.0,0,0,3,8,1140,265,2007,0,98122,47.612,-122.295,1405,3000,-332,1595,377.44641192917055,0.043278688524590166,Very Cheap
20150212T000000,356999.0,3,1.5,1010,1546,2.0,0,0,3,8,1010,0,1971,2014,98144,47.5998,-122.311,1010,1517,536,507,230.91785252263907,0.03698347540983606,Very Cheap
20150417T000000,590000.0,2,2.5,1450,1281,2.0,0,0,3,8,1220,230,2006,0,98105,47.665,-122.285,1440,1281,-169,-159,460.57767369242777,0.06754098360655737,Very Cheap
20141104T000000,294000.0,3,1.75,1420,1361,2.0,0,0,3,7,960,460,2014,0,98108,47.5684,-122.314,1340,1343,-59,3,216.017634092579,0.028721311475409836,Very Cheap
20150426T000000,731500.0,4,2.5,2650,4644,2.0,0,0,3,8,2650,0,2013,0,98053,47.6945,-122.018,2640,5099,1994,2459,157.51507321274764,0.0860983606557377,Very Cheap
20140606T000000,837219.0,5,2.75,3030,7679,2.0,0,0,3,9,3030,0,2014,0,98074,47.593,-122.057,3080,6341,4649,3261,109.02708686026827,0.09996314754098361,Very Cheap
20150415T000000,1600000.0,4,5.5,6530,871200,2.0,0,2,3,11,6530,0,2008,0,98014,47.664,-121.878,1280,858132,864670,856852,1.8365472910927456,0.2,Cheap
20140616T000000,798800.0,3,2.75,2670,3738,1.0,0,0,3,10,1720,950,2013,0,98056,47.5299,-122.203,2610,3734,1068,1124,213.697164258962,0.09492459016393442,Very Cheap
20141008T000000,482500.0,2,2.5,1170,809,2.0,0,0,3,9,1170,0,2007,0,98103,47.6875,-122.339,1170,1121,-361,-49,596.4153275648949,0.053442622950819675,Very Cheap
20150306T000000,820000.0,4,2.5,3260,26772,2.0,0,0,3,9,3260,0,2007,0,98027,47.5115,-122.031,3260,14491,23512,11231,30.62901538921261,0.09770491803278689,Very Cheap
20140711T000000,319000.0,3,1.5,1480,1722,3.0,0,0,3,7,1480,0,2007,0,98125,47.728,-122.292,1480,5764,242,4284,185.24970963995355,0.032,Very Cheap
20140813T000000,950000.0,3,2.5,2700,6947,2.0,0,3,3,9,2700,0,2013,0,98056,47.5172,-122.208,2500,6947,4247,4447,136.74967611918814,0.11475409836065574,Cheap
20150507T000000,1267500.0,4,3.5,4640,13404,2.0,0,0,3,10,4640,0,2007,0,98059,47.531,-122.134,4690,13590,8764,8900,94.56132497761863,0.15639344262295082,Cheap
20140707T000000,378000.0,3,2.5,1601,2491,3.0,0,0,3,7,1536,65,2007,0,98125,47.719,-122.317,1420,1156,890,-264,151.74628663187474,0.03973770491803279,Very Cheap
20150402T000000,3345000.0,5,3.75,5350,15360,1.0,0,1,3,11,3040,2310,2008,0,98004,47.648,-122.218,3740,15940,10010,12200,217.7734375,0.42885245901639346,High
20141027T000000,489950.0,3,2.5,2540,5237,2.0,0,0,3,8,2540,0,2011,0,98118,47.5492,-122.276,1800,4097,2697,2297,93.55547068932594,0.05441967213114754,Very Cheap
20150427T000000,345000.0,2,1.75,1030,1106,2.0,0,0,3,7,765,265,2006,0,98136,47.5397,-122.387,1030,1066,76,36,311.9349005424955,0.03540983606557377,Very Cheap
20150226T000000,510000.0,3,2.5,2730,7136,2.0,0,0,3,8,2730,0,2012,0,98198,47.3938,-122.321,2130,8932,4406,6802,71.46860986547085,0.057049180327868855,Very Cheap
20140729T000000,432500.0,4,2.5,3172,5033,2.0,0,0,3,8,3172,0,2014,0,98023,47.2961,-122.348,2704,5232,1861,2528,85.9328432346513,0.046885245901639346,Very Cheap
20150420T000000,650000.0,4,2.5,3160,8530,2.0,0,0,3,9,3160,0,2006,0,98059,47.5075,-122.148,3160,6460,5370,3300,76.20164126611958,0.07540983606557378,Very Cheap
20141003T000000,750000.0,4,2.5,2850,12429,2.0,0,0,3,9,2850,0,2008,0,98033,47.6915,-122.177,2540,12000,9579,9460,60.34274680183442,0.08852459016393442,Very Cheap
20150427T000000,870000.0,4,3.5,2780,3100,2.0,0,0,3,8,2120,660,2014,0,98117,47.6886,-122.364,1740,3600,320,1860,280.64516129032256,0.10426229508196722,Cheap
20141215T000000,900000.0,4,3.5,3860,6543,2.0,0,0,3,10,3860,0,2014,0,98075,47.5934,-121.974,3760,6888,2683,3128,137.5515818431912,0.10819672131147541,Cheap
20141216T000000,664950.0,2,1.75,1180,900,2.0,0,0,3,10,780,400,2014,0,98102,47.6395,-122.329,1380,3610,-280,2230,738.8333333333334,0.0773704918032787,Very Cheap
20140602T000000,391000.0,3,2.25,1410,1290,2.0,0,0,3,7,1290,120,2004,0,98027,47.5345,-122.069,1490,1380,-120,-110,303.1007751937984,0.04144262295081967,Very Cheap
20150123T000000,1800000.0,4,3.5,6370,205603,2.0,0,0,3,12,6370,0,2008,0,98027,47.5016,-121.905,1490,33580,199233,32090,8.75473606902623,0.2262295081967213,Cheap
20150514T000000,479349.0,5,3.0,3223,6371,2.0,0,0,3,9,3223,0,2014,0,98042,47.3584,-122.163,1979,9008,3148,7029,75.2392089153979,0.05302937704918033,Very Cheap
20141223T000000,661000.0,4,3.25,2600,2074,2.0,0,0,3,8,2150,450,2011,0,98027,47.5402,-122.028,2510,2074,-526,-436,318.7078109932498,0.07685245901639344,Very Cheap
20141002T000000,379000.0,3,3.25,1380,1234,3.0,0,0,3,8,1380,0,2006,0,98103,47.6935,-122.342,1370,1282,-146,-88,307.13128038897895,0.03986885245901639,Very Cheap
20140505T000000,415000.0,3,2.25,1620,998,2.5,0,0,3,8,1540,80,2010,0,98027,47.5401,-122.027,1620,1299,-622,-321,415.8316633266533,0.04459016393442623,Very Cheap
20141201T000000,375000.0,3,3.25,1370,1227,3.0,0,0,3,8,1370,0,2007,0,98103,47.6964,-122.341,1370,1236,-143,-134,305.6234718826406,0.03934426229508197,Very Cheap
20140523T000000,355000.0,3,2.0,1220,1186,3.0,0,0,3,8,1220,0,2007,0,98103,47.6972,-122.341,1280,1251,-34,-29,299.3254637436762,0.036721311475409836,Very Cheap
20140905T000000,540000.0,3,2.5,1280,1889,3.0,0,0,3,8,1280,0,2009,0,98105,47.6619,-122.324,1450,1889,609,439,285.86553732133405,0.06098360655737705,Very Cheap
20140724T000000,290000.0,2,1.5,770,850,2.0,0,0,3,7,770,0,2006,0,98116,47.5644,-122.388,1350,915,80,-435,341.1764705882353,0.02819672131147541,Very Cheap
20140520T000000,500000.0,3,2.5,1210,1200,3.0,0,0,3,8,1210,0,2008,0,98103,47.6543,-122.345,1210,1200,-10,-10,416.6666666666667,0.05573770491803279,Very Cheap
20140902T000000,416000.0,4,2.5,2890,6322,2.0,0,0,3,8,2890,0,2011,0,98038,47.3494,-122.044,2380,5738,3432,3358,65.8019614046188,0.044721311475409836,Very Cheap
20140811T000000,349900.0,3,2.5,1580,2765,2.0,0,0,3,8,1580,0,2011,0,98126,47.5444,-122.369,1580,1820,1185,240,126.54611211573237,0.036052459016393444,Very Cheap
20140605T000000,465000.0,3,2.25,1530,1245,2.0,0,0,3,9,1050,480,2014,0,98122,47.6018,-122.297,1530,2307,-285,777,373.49397590361446,0.051147540983606556,Very Cheap
20140630T000000,950000.0,4,2.5,3670,7680,2.5,0,0,3,10,3670,0,2007,0,98029,47.5401,-121.993,3130,6112,4010,2982,123.69791666666667,0.11475409836065574,Cheap
20150326T000000,496800.0,4,2.25,1850,2340,2.5,0,0,3,8,1850,0,2014,0,98126,47.543,-122.372,1850,2340,490,490,212.30769230769232,0.05531803278688525,Very Cheap
20150320T000000,680000.0,4,2.5,2440,6581,2.0,0,0,3,8,2440,0,2014,0,98133,47.7321,-122.334,1480,7432,4141,5952,103.32776173833764,0.07934426229508197,Very Cheap
20150424T000000,920000.0,4,3.25,2190,4265,2.0,0,0,3,9,1540,650,2015,0,98122,47.6178,-122.29,1730,4265,2075,2535,215.7092614302462,0.11081967213114755,Cheap
20150202T000000,1289990.0,5,4.0,4360,8030,2.0,0,0,3,10,4360,0,2015,0,98075,47.5923,-121.973,3570,6185,3670,2615,160.64632627646327,0.15934295081967212,Cheap
20140701T000000,825000.0,4,2.75,3990,6637,2.0,0,0,3,9,3990,0,2003,0,98053,47.6835,-122.045,3500,7074,2647,3574,124.30314901310834,0.09836065573770492,Very Cheap
20141002T000000,292000.0,3,2.5,1270,1283,3.0,0,0,3,7,1270,0,2007,0,98125,47.7209,-122.291,1270,1512,13,242,227.59158222915042,0.028459016393442622,Very Cheap
20150409T000000,576000.0,4,2.5,3340,6924,2.0,0,0,3,8,3340,0,2009,0,98059,47.495,-122.149,3030,6119,3584,3089,83.18890814558058,0.06570491803278689,Very Cheap
20150313T000000,670000.0,2,2.0,1500,761,3.0,0,3,3,8,1500,0,2008,0,98103,47.6522,-122.346,1360,1527,-739,167,880.4204993429698,0.0780327868852459,Very Cheap
20140520T000000,953007.0,4,3.5,3120,5086,2.0,0,0,3,9,2480,640,2008,0,98115,47.6762,-122.288,1880,5092,1966,3212,187.37848997247346,0.11514845901639344,Cheap
20150223T000000,399000.0,4,2.5,2480,4334,2.0,0,0,3,8,2480,0,2012,0,98038,47.3826,-122.036,2480,5632,1854,3152,92.06275957544993,0.042491803278688525,Very Cheap
20150427T000000,399000.0,2,2.0,1110,1155,3.0,0,0,3,7,980,130,2008,0,98136,47.5496,-122.388,1110,1089,45,-21,345.45454545454544,0.042491803278688525,Very Cheap
20141117T000000,847093.0,4,2.75,2760,5670,2.0,0,0,3,10,2760,0,2014,0,98075,47.5819,-122.047,2760,6600,2910,3840,149.39911816578484,0.10125809836065573,Cheap
20150206T000000,599950.0,3,2.5,1510,1493,3.0,0,0,3,8,1510,0,2014,0,98107,47.669,-122.402,1530,1357,-17,-173,401.84192900200935,0.06884590163934426,Very Cheap
20140813T000000,499000.0,3,2.5,1460,1614,2.0,0,0,3,8,1180,280,2007,0,98117,47.6781,-122.374,1380,1402,154,22,309.1697645600991,0.05560655737704918,Very Cheap
20141015T000000,760000.0,4,2.75,3980,285318,2.0,0,2,3,9,3980,0,2006,0,98045,47.4803,-121.795,2100,105415,281338,103315,2.66369454433299,0.0898360655737705,Very Cheap
20141029T000000,1699990.0,4,3.75,3320,8234,2.0,0,0,3,10,3320,0,2014,0,98004,47.5963,-122.2,1560,8240,4914,6680,206.45980082584407,0.21311344262295082,Cheap
20140512T000000,1033890.0,4,3.25,3270,5187,2.0,0,0,3,9,3110,160,2014,0,98052,47.6966,-122.133,3600,5825,1917,2225,199.3233082706767,0.1257560655737705,Cheap
20140520T000000,515000.0,4,2.5,2670,8765,2.0,0,0,3,9,2670,0,2006,0,98059,47.4876,-122.146,2880,8765,6095,5885,58.756417569880206,0.057704918032786885,Very Cheap
20141209T000000,355000.0,3,2.25,1410,1332,2.0,0,0,3,7,1290,120,2004,0,98027,47.5345,-122.069,1445,1290,-78,-155,266.5165165165165,0.036721311475409836,Very Cheap
20140805T000000,319900.0,4,2.75,2475,4000,2.0,0,0,3,7,2475,0,2014,0,98002,47.3452,-122.21,2166,4000,1525,1834,79.975,0.03211803278688525,Very Cheap
20140527T000000,460000.0,3,3.5,1600,1431,2.0,0,0,3,8,1240,360,2006,0,98117,47.6865,-122.363,1500,4120,-169,2620,321.45352900069884,0.050491803278688525,Very Cheap
20150108T000000,305000.0,2,1.0,1290,3383,2.0,0,0,3,7,1290,0,2008,0,98053,47.6968,-122.025,1290,2828,2093,1538,90.15666568134792,0.03016393442622951,Very Cheap
20150317T000000,280000.0,3,2.5,1608,4818,2.0,0,0,3,8,1608,0,2012,0,98092,47.2583,-122.203,2009,5200,3210,3191,58.115400581154006,0.026885245901639345,Very Cheap
20150227T000000,394950.0,2,2.25,1300,2104,2.0,0,0,3,8,1010,290,2011,0,98136,47.5477,-122.388,1430,1850,804,420,187.7138783269962,0.04196065573770492,Very Cheap
20140821T000000,382000.0,4,3.5,2530,3000,2.0,0,0,3,8,1850,680,2014,0,98146,47.4919,-122.336,1470,6000,470,4530,127.33333333333333,0.040262295081967214,Very Cheap
20150422T000000,560000.0,3,2.5,1390,1411,3.0,0,0,3,8,1390,0,2008,0,98103,47.6485,-122.334,1350,1266,21,-84,396.88164422395465,0.06360655737704918,Very Cheap
20140520T000000,772000.0,3,2.25,1640,1204,3.0,0,0,3,8,1640,0,2014,0,98112,47.6196,-122.297,1630,3136,-436,1506,641.1960132890365,0.09140983606557378,Very Cheap
20140722T000000,324950.0,4,2.5,2229,5723,2.0,0,0,3,7,2229,0,2012,0,98032,47.3693,-122.286,2738,5742,3494,3004,56.779661016949156,0.03278032786885246,Very Cheap
20140709T000000,530000.0,3,2.5,1790,3078,2.0,0,0,3,8,1790,0,2010,0,98027,47.5638,-122.094,1890,3078,1288,1188,172.18973359324235,0.05967213114754098,Very Cheap
20141024T000000,384000.0,3,2.25,990,736,2.5,0,0,3,8,880,110,2009,0,98105,47.6605,-122.319,1030,1201,-254,171,521.7391304347826,0.04052459016393443,Very Cheap
20140611T000000,719950.0,5,2.75,3240,6863,2.0,0,0,3,10,3240,0,2013,0,98056,47.5033,-122.193,2360,6002,3623,3642,104.90310359900919,0.08458360655737705,Very Cheap
20140811T000000,319950.0,2,2.5,1280,819,2.0,0,0,3,8,1060,220,2006,0,98103,47.6905,-122.364,1290,2900,-461,1610,390.65934065934067,0.03212459016393442,Very Cheap
20150128T000000,292000.0,3,2.5,1610,3848,2.0,0,0,3,8,1610,0,2006,0,98055,47.4497,-122.188,1610,3049,2238,1439,75.88357588357589,0.028459016393442622,Very Cheap
20150428T000000,1500000.0,6,3.5,3670,3959,2.0,0,0,3,10,2410,1260,2008,0,98119,47.6356,-122.373,2060,3625,289,1565,378.88355645364993,0.18688524590163935,Cheap
20140507T000000,425000.0,2,2.5,1150,1027,3.0,0,0,3,8,1150,0,2008,0,98103,47.6534,-122.356,1360,1210,-123,-150,413.82667964946444,0.04590163934426229,Very Cheap
20141010T000000,799950.0,5,3.75,3760,4702,2.0,0,0,3,9,2780,980,2014,0,98034,47.7202,-122.223,2950,5981,942,3031,170.12973202892385,0.09507540983606558,Very Cheap
20140825T000000,499000.0,2,2.5,1320,1157,2.0,0,0,3,8,990,330,2014,0,98107,47.6689,-122.363,1550,1519,-163,-31,431.28781331028523,0.05560655737704918,Very Cheap
20150327T000000,572000.0,4,2.75,2700,7992,2.0,0,0,3,9,2700,0,2012,0,98059,47.4831,-122.135,2840,7992,5292,5152,71.57157157157157,0.06518032786885246,Very Cheap
20140722T000000,459000.0,2,2.0,1480,804,3.0,0,0,3,8,1480,0,2008,0,98122,47.602,-122.308,1380,1751,-676,371,570.8955223880597,0.050360655737704915,Very Cheap
20150318T000000,529500.0,3,2.25,1410,905,3.0,0,0,3,9,1410,0,2014,0,98116,47.5818,-122.402,1510,1352,-505,-158,585.0828729281768,0.05960655737704918,Very Cheap
20140909T000000,374500.0,4,2.5,3135,5811,2.0,0,0,3,9,3135,0,2005,0,98092,47.3263,-122.18,3008,5799,2676,2791,64.44673894338324,0.03927868852459016,Very Cheap
20140605T000000,584000.0,3,2.5,1480,1485,2.0,0,0,3,8,1280,200,2007,0,98102,47.6376,-122.326,1470,1277,5,-193,393.26599326599325,0.06675409836065574,Very Cheap
20150115T000000,1898000.0,4,4.5,4020,9656,2.0,0,0,3,10,4020,0,2007,0,98004,47.6358,-122.207,1960,9520,5636,7560,196.56172328086163,0.23908196721311475,Cheap
20140707T000000,505000.0,2,2.25,1060,1209,2.0,0,0,3,8,940,120,2006,0,98102,47.6369,-122.327,1300,1169,149,-131,417.7005789909016,0.05639344262295082,Very Cheap
20141114T000000,565000.0,2,2.5,1950,2457,3.0,0,0,3,8,1950,0,2009,0,98144,47.5925,-122.302,1650,1639,507,-11,229.95522995522995,0.06426229508196721,Very Cheap
20150325T000000,799000.0,4,2.75,3340,5677,2.0,0,0,3,9,3340,0,2011,0,98052,47.709,-122.118,3240,5643,2337,2403,140.74335036110622,0.09495081967213115,Very Cheap
20150429T000000,547000.0,3,2.5,1570,1452,2.5,0,0,3,9,1240,330,2007,0,98199,47.648,-122.396,1670,1596,-118,-74,376.72176308539946,0.061901639344262294,Very Cheap
20150227T000000,550000.0,3,2.5,1930,6604,2.0,0,0,3,7,1930,0,2014,0,98166,47.4692,-122.351,910,6604,4674,5694,83.28285887341005,0.06229508196721312,Very Cheap
20140918T000000,250000.0,3,2.0,1590,8100,1.0,0,0,3,7,1060,530,1996,0,98038,47.3611,-122.047,1590,8100,6510,6510,30.864197530864196,0.022950819672131147,Very Cheap
20150105T000000,960000.0,4,4.5,3720,7746,2.0,0,0,3,10,3720,0,2014,0,98034,47.7323,-122.165,3080,11067,4026,7987,123.93493415956623,0.1160655737704918,Cheap
20141030T000000,2950000.0,4,4.25,4470,5884,2.0,0,1,3,11,3230,1240,2010,0,98199,47.6387,-122.405,2570,6000,1414,3430,501.35961930659414,0.3770491803278688,Medium
20150327T000000,441000.0,2,1.0,1290,1289,2.0,0,0,3,7,1030,260,2005,0,98144,47.6006,-122.305,1290,1332,-1,42,342.12567882079134,0.048,Very Cheap
20150407T000000,265000.0,3,2.25,1489,2800,2.0,0,0,3,7,1489,0,2012,0,98002,47.3454,-122.214,1584,2800,1311,1216,94.64285714285714,0.024918032786885248,Very Cheap
20150409T000000,430000.0,3,2.5,2075,39553,1.0,0,0,3,7,2075,0,2012,0,98038,47.3601,-122.032,1960,9047,37478,7087,10.871488888327054,0.04655737704918033,Very Cheap
20140617T000000,286800.0,3,2.5,1413,3600,2.0,0,0,3,8,1413,0,2011,0,98031,47.4222,-122.193,2150,3869,2187,1719,79.66666666666667,0.02777704918032787,Very Cheap
20150416T000000,375000.0,3,2.5,1300,1362,2.0,0,0,3,8,880,420,2008,0,98144,47.5893,-122.317,1300,1251,62,-49,275.3303964757709,0.03934426229508197,Very Cheap
20141215T000000,312500.0,3,3.25,1480,983,2.0,0,0,3,8,1180,300,2013,0,98106,47.5555,-122.363,1330,1062,-497,-268,317.90437436419126,0.03114754098360656,Very Cheap
20150107T000000,850000.0,4,2.75,3320,5559,2.0,0,0,3,9,3320,0,2012,0,98075,47.5607,-122.031,3400,6854,2239,3454,152.9051987767584,0.10163934426229508,Cheap
20150325T000000,390500.0,3,2.25,1530,1279,2.0,0,0,3,7,1116,414,2007,0,98177,47.7035,-122.357,1320,1427,-251,107,305.31665363565287,0.04137704918032787,Very Cheap
20141029T000000,455000.0,3,2.5,1180,932,3.0,0,0,3,8,1180,0,2010,0,98119,47.638,-122.375,1180,2632,-248,1452,488.19742489270385,0.049836065573770495,Very Cheap
20150406T000000,455000.0,2,2.0,1190,1303,2.0,0,0,3,8,800,390,2009,0,98107,47.6675,-122.368,1670,2425,113,755,349.1941673062164,0.049836065573770495,Very Cheap
20141203T000000,515000.0,3,2.25,1300,1180,3.0,0,0,3,8,1300,0,2008,0,98103,47.6871,-122.339,1300,1174,-120,-126,436.4406779661017,0.057704918032786885,Very Cheap
20150401T000000,362500.0,3,3.5,1710,2212,2.0,0,0,3,7,1400,310,2013,0,98126,47.5459,-122.368,1580,2212,502,632,163.87884267631102,0.03770491803278689,Very Cheap
20140924T000000,460000.0,3,2.5,2390,47480,2.0,0,0,3,9,2390,0,2007,0,98058,47.4517,-122.084,1720,44866,45090,43146,9.688289806234204,0.050491803278688525,Very Cheap
20140904T000000,540000.0,4,3.5,3510,6005,2.0,0,0,3,8,2750,760,2010,0,98065,47.5168,-121.87,3090,5866,2495,2776,89.92506244796003,0.06098360655737705,Very Cheap
20140731T000000,230000.0,3,1.75,1140,1165,2.0,0,0,3,8,1140,0,2014,0,98108,47.5638,-122.295,1150,1552,25,402,197.42489270386267,0.020327868852459016,Very Cheap
20140929T000000,425000.0,2,2.5,1320,1329,2.0,0,0,3,8,1180,140,2007,0,98107,47.6728,-122.374,1490,5000,9,3510,319.7893152746426,0.04590163934426229,Very Cheap
20140519T000000,298450.0,5,3.0,2100,9752,1.0,0,0,3,8,1200,900,2007,0,98003,47.3341,-122.304,1270,10200,7652,8930,30.603978671041837,0.029304918032786884,Very Cheap
20141222T000000,344000.0,4,2.5,2400,4848,2.0,0,0,3,8,2400,0,2004,0,98038,47.3626,-122.04,1980,5199,2448,3219,70.95709570957095,0.035278688524590165,Very Cheap
20140505T000000,416286.0,3,2.5,1408,989,3.0,0,0,3,8,1408,0,2005,0,98115,47.6856,-122.315,1408,1342,-419,-66,420.9160768452983,0.04475881967213115,Very Cheap
20150223T000000,379500.0,4,2.5,2560,5102,2.0,0,0,3,8,2560,0,2013,0,98092,47.3404,-122.181,2586,5059,2542,2473,74.38259506076048,0.0399344262295082,Very Cheap
20140617T000000,350000.0,2,2.5,1260,1347,3.0,0,0,3,8,1260,0,2005,0,98103,47.6994,-122.341,1260,1356,87,96,259.83667409057165,0.036065573770491806,Very Cheap
20150408T000000,258800.0,2,1.75,1290,1624,2.0,0,0,3,8,1290,0,2014,0,98106,47.5171,-122.347,1410,1963,334,553,159.35960591133005,0.024104918032786884,Very Cheap
20141218T000000,620000.0,4,2.5,2730,9260,2.0,0,0,3,8,2730,0,2008,0,98133,47.7222,-122.331,2730,7357,6530,4627,66.95464362850971,0.07147540983606557,Very Cheap
20140502T000000,295000.0,2,2.5,1630,1368,2.0,0,0,3,7,1280,350,2009,0,98106,47.5489,-122.363,1590,2306,-262,716,215.64327485380116,0.028852459016393443,Very Cheap
20150227T000000,908990.0,4,2.75,3530,6844,2.0,0,0,3,10,3530,0,2014,0,98075,47.5975,-121.985,3530,10038,3314,6508,132.8156049094097,0.10937573770491803,Cheap
20141117T000000,485230.0,4,2.5,2714,12558,2.0,0,0,3,9,2714,0,2014,0,98031,47.3522,-122.201,2873,8269,9844,5396,38.639114508679725,0.05380065573770492,Very Cheap
20140611T000000,475000.0,3,2.25,1630,2520,2.0,0,0,3,7,1630,0,2005,0,98029,47.5493,-121.998,1630,3131,890,1501,188.4920634920635,0.05245901639344262,Very Cheap
20140804T000000,1240420.0,5,3.25,5790,13726,2.0,0,3,3,10,4430,1360,2014,0,98006,47.5388,-122.114,5790,13726,7936,7936,90.37010053912283,0.15284196721311474,Cheap
20140819T000000,635000.0,3,3.0,2230,1407,2.5,0,0,3,8,1850,380,2013,0,98027,47.5446,-122.017,2290,1407,-823,-883,451.3148542999289,0.07344262295081967,Very Cheap
20141105T000000,350000.0,3,2.5,1380,1590,2.0,0,0,3,9,1160,220,2012,0,98126,47.5444,-122.375,1380,1590,210,210,220.125786163522,0.036065573770491806,Very Cheap
20141229T000000,345000.0,3,3.5,1320,1161,3.0,0,0,3,8,1320,0,2010,0,98125,47.7162,-122.294,1320,1161,-159,-159,297.1576227390181,0.03540983606557377,Very Cheap
20140921T000000,700000.0,2,2.0,1490,713,3.0,0,0,3,9,1490,0,2014,0,98109,47.6356,-122.346,1490,1110,-777,-380,981.7671809256663,0.08196721311475409,Very Cheap
20140821T000000,490000.0,3,2.25,1280,1520,2.0,0,0,3,8,1080,200,2008,0,98107,47.6651,-122.368,1280,1681,240,401,322.36842105263156,0.05442622950819672,Very Cheap
20140805T000000,1299890.0,5,4.0,3870,5929,2.0,0,0,3,10,3870,0,2014,0,98052,47.6965,-122.134,3600,5625,2059,2025,219.24270534660144,0.16064131147540983,Cheap
20140910T000000,579000.0,2,2.5,1280,1051,2.0,0,0,3,8,1080,200,2009,0,98119,47.6273,-122.359,1580,1279,-229,-301,550.9039010466223,0.06609836065573771,Very Cheap
20150327T000000,552500.0,3,1.5,1300,1435,2.0,0,0,3,8,1120,180,2007,0,98122,47.6114,-122.31,1320,1652,135,332,385.01742160278746,0.06262295081967213,Very Cheap
20150204T000000,467000.0,4,2.75,2170,5024,2.0,0,0,3,8,2170,0,2012,0,98059,47.495,-122.145,2460,5024,2854,2564,92.95382165605096,0.05140983606557377,Very Cheap
20141113T000000,305000.0,4,2.25,1763,3717,2.0,0,0,3,8,1763,0,2012,0,98031,47.4213,-122.194,1763,3666,1954,1903,82.05542103847189,0.03016393442622951,Very Cheap
20140509T000000,212000.0,2,1.5,1020,1525,2.0,0,0,3,7,1020,0,2004,0,98133,47.704,-122.347,1020,3844,505,2824,139.01639344262296,0.017967213114754098,Very Cheap
20140821T000000,429000.0,4,2.5,1840,4593,2.0,0,0,3,7,1840,0,2010,0,98053,47.6866,-122.013,1740,3600,2753,1860,93.40300457217505,0.04642622950819672,Very Cheap
20140925T000000,479950.0,3,2.0,1820,1358,3.0,0,0,3,9,1820,0,2014,0,98126,47.5433,-122.376,1710,1367,-462,-343,353.4241531664212,0.05310819672131147,Very Cheap
20141218T000000,825000.0,3,3.5,2670,3000,2.0,0,0,3,9,1870,800,2014,0,98117,47.6813,-122.372,1750,5000,330,3250,275.0,0.09836065573770492,Very Cheap
20150328T000000,1180000.0,6,6.5,6260,10955,2.0,0,0,3,11,4840,1420,2007,0,98075,47.5947,-122.039,2710,12550,4695,9840,107.71337288909174,0.14491803278688525,Cheap
20140613T000000,250000.0,3,2.25,1400,3814,2.0,0,0,3,7,1400,0,2012,0,98042,47.3584,-122.083,1610,3814,2414,2204,65.54798112218144,0.022950819672131147,Very Cheap
20141027T000000,289000.0,2,1.5,1160,2158,2.0,0,0,3,7,1160,0,1982,0,98034,47.7178,-122.19,1150,2158,998,1008,133.92029657089898,0.028065573770491802,Very Cheap
20141002T000000,265000.0,3,2.5,1400,3368,2.0,0,0,3,7,1400,0,2013,0,98146,47.5134,-122.342,1400,4316,1968,2916,78.68171021377673,0.024918032786885248,Very Cheap
20140515T000000,344000.0,3,2.5,1232,1130,3.0,0,0,3,7,1232,0,2007,0,98125,47.7185,-122.317,1232,1202,-102,-30,304.42477876106193,0.035278688524590165,Very Cheap
20140709T000000,749000.0,4,2.75,2700,6000,2.0,0,0,4,8,2100,600,1910,0,98116,47.586,-122.383,2050,5400,3300,3350,124.83333333333333,0.08839344262295082,Very Cheap
20140908T000000,492000.0,4,2.5,2550,6382,2.0,0,0,3,7,2550,0,2007,0,98065,47.5202,-121.87,2430,5900,3832,3470,77.0918207458477,0.054688524590163934,Very Cheap
20150119T000000,552500.0,4,2.5,3260,6902,2.0,0,0,3,8,3260,0,2008,0,98059,47.4829,-122.156,3130,6588,3642,3458,80.04926108374384,0.06262295081967213,Very Cheap
20141112T000000,653500.0,2,2.5,1680,1240,2.0,0,0,3,8,1120,560,2014,0,98102,47.6372,-122.324,2060,3630,-440,1570,527.016129032258,0.0758688524590164,Very Cheap
20150402T000000,855000.0,4,3.25,2630,2550,2.0,0,0,3,10,2030,600,2006,0,98117,47.6775,-122.385,1810,2600,-80,790,335.29411764705884,0.10229508196721311,Cheap
20141119T000000,333000.0,3,1.5,1260,5758,2.0,0,0,3,7,1260,0,1999,0,98006,47.5524,-122.139,3090,10142,4498,7052,57.83258075720737,0.033836065573770495,Very Cheap
20140611T000000,415000.0,4,2.5,2550,4500,2.0,0,0,3,7,2550,0,2009,0,98059,47.4916,-122.153,2340,4526,1950,2186,92.22222222222223,0.04459016393442623,Very Cheap
20141107T000000,445000.0,4,3.25,3450,5000,2.0,0,0,3,8,3450,0,2008,0,98178,47.4925,-122.273,1420,5000,1550,3580,89.0,0.04852459016393443,Very Cheap
20140710T000000,273500.0,3,2.5,1550,3402,2.0,0,0,3,7,1550,0,2009,0,98002,47.3523,-122.212,2095,3402,1852,1307,80.39388594944151,0.026032786885245903,Very Cheap
20140606T000000,969990.0,4,2.5,4150,8436,2.0,0,0,3,10,4150,0,2014,0,98075,47.5802,-122.039,4070,8438,4286,4368,114.98221906116643,0.11737573770491803,Cheap
20141008T000000,1200000.0,5,3.5,3900,4400,2.0,0,0,3,9,2650,1250,2014,0,98107,47.6607,-122.362,1190,4400,500,3210,272.72727272727275,0.14754098360655737,Cheap
20140806T000000,430000.0,3,3.25,1550,1444,3.0,0,0,3,8,1550,0,2006,0,98115,47.6767,-122.291,1550,1444,-106,-106,297.78393351800554,0.04655737704918033,Very Cheap
20150323T000000,392000.0,4,2.5,2130,4000,2.0,0,0,3,8,2130,0,2014,0,98146,47.5108,-122.362,1830,7217,1870,5387,98.0,0.04157377049180328,Very Cheap
20140702T000000,795000.0,4,2.5,2890,7798,2.0,0,0,3,9,2890,0,2005,0,98006,47.5456,-122.129,3300,30950,4908,27650,101.94921774814055,0.09442622950819672,Very Cheap
20140630T000000,457000.0,3,2.5,1220,1330,2.0,0,0,3,8,1010,210,2008,0,98117,47.6904,-122.37,1360,3750,110,2390,343.609022556391,0.0500983606557377,Very Cheap
20150320T000000,453000.0,4,2.5,2502,8306,2.0,0,0,3,9,2502,0,2013,0,98001,47.2953,-122.265,2597,6983,5804,4386,54.53888755116783,0.04957377049180328,Very Cheap
20140509T000000,376000.0,3,2.0,1340,1384,3.0,0,0,3,8,1340,0,2008,0,98103,47.6973,-122.35,1110,1384,44,274,271.67630057803467,0.039475409836065574,Very Cheap
20140804T000000,469995.0,4,2.5,2350,3800,2.0,0,0,3,8,2350,0,2014,0,98059,47.4783,-122.123,2670,4180,1450,1510,123.6828947368421,0.05180262295081967,Very Cheap
20150504T000000,540000.0,3,2.5,1810,3930,2.0,0,0,3,8,1810,0,2008,0,98053,47.7169,-122.02,1560,5100,2120,3540,137.40458015267177,0.06098360655737705,Very Cheap
20140502T000000,555000.0,4,2.5,3310,6500,2.0,0,0,3,8,3310,0,2012,0,98065,47.515,-121.87,2380,5000,3190,2620,85.38461538461539,0.06295081967213115,Very Cheap
20140725T000000,445000.0,3,2.0,1620,5101,1.0,0,0,3,7,590,1030,2006,0,98118,47.5448,-122.288,1700,7750,3481,6050,87.23779651048814,0.04852459016393443,Very Cheap
20141215T000000,256950.0,2,2.0,1070,635,2.0,0,0,3,9,720,350,2008,0,98106,47.5212,-122.357,1070,928,-435,-142,404.6456692913386,0.023862295081967213,Very Cheap
20141006T000000,297000.0,4,2.5,2230,4952,2.0,0,0,3,8,2230,0,2011,0,98002,47.3363,-122.211,2030,3721,2722,1691,59.97576736672052,0.029114754098360656,Very Cheap
20141017T000000,320000.0,4,2.5,1970,4558,2.0,0,0,3,8,1970,0,2005,0,98038,47.3627,-122.04,1980,5123,2588,3143,70.20623080298377,0.032131147540983604,Very Cheap
20141114T000000,805000.0,5,4.5,4600,7810,2.0,0,0,3,9,3200,1400,2006,0,98065,47.5381,-121.86,4480,6324,3210,1844,103.0729833546735,0.09573770491803278,Very Cheap
20140801T000000,799990.0,4,2.75,3110,6050,2.0,0,0,3,9,3110,0,2014,0,98052,47.705,-122.126,3590,6054,2940,2464,132.2297520661157,0.09508065573770492,Very Cheap
20150409T000000,680000.0,4,2.5,3490,3677,2.0,0,0,3,9,2850,640,2007,0,98072,47.774,-122.162,3440,3600,187,160,184.93336959477836,0.07934426229508197,Very Cheap
20140624T000000,395000.0,3,2.5,1600,1936,2.0,0,0,3,7,1600,0,2007,0,98108,47.5629,-122.297,1600,1936,336,336,204.02892561983472,0.0419672131147541,Very Cheap
20141202T000000,732000.0,3,2.5,1960,3060,2.0,0,0,3,8,1960,0,2010,0,98117,47.6764,-122.389,1220,3060,1100,1840,239.2156862745098,0.08616393442622951,Very Cheap
20140802T000000,163800.0,2,2.5,1000,1092,2.0,0,0,3,7,990,10,2004,0,98118,47.5419,-122.271,1330,1466,92,136,150.0,0.011645901639344262,Very Cheap
20141201T000000,220000.0,2,2.5,1000,1092,2.0,0,0,3,7,990,10,2004,0,98118,47.5419,-122.271,1330,1466,92,136,201.46520146520146,0.01901639344262295,Very Cheap
20141106T000000,308625.0,2,2.0,1500,1408,3.0,0,0,3,7,1500,0,1999,0,98133,47.7293,-122.343,1500,1245,-92,-255,219.19389204545453,0.03063934426229508,Very Cheap
20150331T000000,375000.0,3,2.5,2424,5931,2.0,0,0,3,9,2424,0,2014,0,98042,47.3515,-122.134,2424,6036,3507,3612,63.22711178553364,0.03934426229508197,Very Cheap
20140701T000000,300000.0,4,2.5,2303,3826,2.0,0,0,3,8,2303,0,2006,0,98092,47.3258,-122.165,2516,4500,1523,1984,78.41087297438578,0.029508196721311476,Very Cheap
20140616T000000,284000.0,3,2.5,1880,6008,2.0,0,0,3,7,1880,0,2009,0,98042,47.3366,-122.052,2180,5185,4128,3005,47.270306258322236,0.027409836065573772,Very Cheap
20150220T000000,610000.0,2,2.0,1210,740,2.0,0,0,3,8,780,430,2014,0,98112,47.6206,-122.3,1480,1171,-470,-309,824.3243243243244,0.07016393442622951,Very Cheap
20150324T000000,955000.0,4,3.25,3720,6765,2.0,0,0,3,9,3720,0,2012,0,98053,47.688,-122.018,3100,6790,3045,3690,141.16777531411677,0.11540983606557377,Cheap
20140627T000000,982000.0,4,2.75,3610,8580,2.0,0,0,3,9,3610,0,2014,0,98033,47.6706,-122.173,2360,8580,4970,6220,114.45221445221445,0.11895081967213114,Cheap
20140522T000000,359000.0,3,1.5,1360,885,3.0,0,0,3,8,1360,0,2008,0,98103,47.6961,-122.349,1360,1167,-475,-193,405.6497175141243,0.03724590163934426,Very Cheap
20140718T000000,779380.0,5,2.5,2590,7084,2.0,0,0,3,8,2590,0,2014,0,98052,47.7053,-122.113,3010,4823,4494,1813,110.0197628458498,0.0923777049180328,Very Cheap
20140630T000000,1510000.0,5,3.25,4390,11250,2.0,0,0,3,10,4390,0,2007,0,98040,47.5785,-122.225,2160,9249,6860,7089,134.22222222222223,0.1881967213114754,Cheap
20150223T000000,635000.0,3,3.0,2290,1407,2.5,0,0,3,8,1890,400,2014,0,98027,47.5446,-122.017,2230,1407,-883,-823,451.3148542999289,0.07344262295081967,Very Cheap
20140826T000000,1060000.0,4,3.75,3880,9979,2.5,0,0,3,10,3880,0,2007,0,98029,47.5408,-121.992,3130,6112,6099,2982,106.22306844373183,0.12918032786885245,Cheap
20140716T000000,389500.0,3,2.5,1350,874,3.0,0,0,3,8,1270,80,2006,0,98136,47.549,-122.387,1350,886,-476,-464,445.6521739130435,0.04124590163934426,Very Cheap
20140807T000000,359800.0,5,2.5,2170,2752,2.0,0,0,3,8,2170,0,2014,0,98106,47.5165,-122.346,1800,2752,582,952,130.74127906976744,0.03735081967213115,Very Cheap
20140527T000000,399950.0,3,3.0,1296,1051,3.0,0,0,3,8,1296,0,2009,0,98125,47.7175,-122.284,1520,1939,-245,419,380.5423406279734,0.04261639344262295,Very Cheap
20140603T000000,320000.0,3,3.25,1530,1602,2.0,0,0,3,8,1140,390,2013,0,98106,47.5555,-122.362,1450,1198,72,-252,199.75031210986268,0.032131147540983604,Very Cheap
20140725T000000,255900.0,3,2.5,1489,3266,2.0,0,0,3,7,1489,0,2014,0,98002,47.3452,-122.217,1537,3273,1777,1736,78.35272504592774,0.023724590163934425,Very Cheap
20150209T000000,380000.0,4,2.5,2130,4467,2.0,0,0,3,8,2130,0,2014,0,98146,47.5108,-122.363,1830,8160,2337,6330,85.0682784866801,0.04,Very Cheap
20140918T000000,580000.0,3,2.75,1430,1521,2.0,0,0,3,9,1130,300,2009,0,98119,47.6353,-122.371,1930,2700,91,770,381.3280736357659,0.06622950819672131,Very Cheap
20150429T000000,545000.0,5,3.75,2380,7268,1.0,0,0,3,8,1430,950,2008,0,98106,47.5571,-122.357,2040,10810,4888,8770,74.98624105668685,0.06163934426229508,Very Cheap
20140725T000000,451300.0,3,2.5,1420,814,2.0,0,0,3,8,1140,280,2008,0,98136,47.5429,-122.387,1340,1382,-606,42,554.4226044226044,0.049350819672131147,Very Cheap
20140616T000000,852880.0,4,3.25,3450,6184,2.0,0,0,3,9,3450,0,2014,0,98074,47.6072,-122.054,3020,5369,2734,2349,137.91720569210867,0.10201704918032786,Cheap
20140919T000000,305000.0,4,2.5,1914,3150,2.0,0,0,3,8,1914,0,2009,0,98055,47.43,-122.188,1714,3164,1236,1450,96.82539682539682,0.03016393442622951,Very Cheap
20150430T000000,295000.0,2,1.5,988,1080,3.0,0,0,3,7,988,0,2007,0,98125,47.7123,-122.301,1128,1080,92,-48,273.14814814814815,0.028852459016393443,Very Cheap
20141016T000000,261000.0,3,2.25,1584,2800,2.0,0,0,3,7,1584,0,2012,0,98002,47.3451,-122.214,1584,2800,1216,1216,93.21428571428571,0.02439344262295082,Very Cheap
20150317T000000,560000.0,4,2.5,2630,5710,2.0,0,0,3,8,2630,0,2001,0,98065,47.5342,-121.876,2550,5500,3080,2950,98.07355516637477,0.06360655737704918,Very Cheap
20140919T000000,795000.0,4,3.25,3520,5250,2.0,0,0,3,9,3520,0,2012,0,98053,47.6869,-122.019,3220,5781,1730,2561,151.42857142857142,0.09442622950819672,Very Cheap
20140929T000000,384950.0,4,2.5,2380,4913,2.0,0,0,3,8,2380,0,2006,0,98038,47.3607,-122.038,2580,5311,2533,2731,78.35334825971911,0.04064918032786885,Very Cheap
20140508T000000,500000.0,3,1.75,1410,1197,3.0,0,0,3,8,1410,0,2012,0,98103,47.6558,-122.348,1350,2512,-213,1162,417.7109440267335,0.05573770491803279,Very Cheap
20150205T000000,640000.0,4,3.5,3220,5741,2.0,0,0,3,9,3220,0,2013,0,98065,47.5169,-121.886,2960,6534,2521,3574,111.47883643964467,0.0740983606557377,Very Cheap
20141121T000000,418000.0,4,3.25,3266,5969,2.0,0,0,3,8,3266,0,2014,0,98023,47.2975,-122.35,3087,5169,2703,2082,70.02848048249288,0.04498360655737705,Very Cheap
20141010T000000,799000.0,3,2.0,2550,4794,2.0,0,0,3,9,2550,0,2007,0,98115,47.6955,-122.29,1630,5100,2244,3470,166.66666666666666,0.09495081967213115,Very Cheap
20150320T000000,552900.0,4,3.5,3828,18900,2.5,0,0,3,9,3828,0,2014,0,98001,47.2851,-122.277,2120,18900,15072,16780,29.253968253968253,0.06267540983606558,Very Cheap
20141219T000000,539950.0,3,2.25,1670,1596,3.0,0,0,3,8,1670,0,2014,0,98136,47.5402,-122.387,1640,1310,-74,-330,338.31453634085216,0.06097704918032787,Very Cheap
20150120T000000,524225.0,4,2.5,3056,11385,2.0,0,0,3,9,3056,0,2014,0,98001,47.2905,-122.264,2849,8607,8329,5758,46.045234958278435,0.05891475409836065,Very Cheap
20150202T000000,424950.0,2,1.5,1000,1188,3.0,0,0,3,8,1000,0,2005,0,98115,47.6823,-122.327,2300,3500,188,1200,357.7020202020202,0.04589508196721311,Very Cheap
20141125T000000,560000.0,3,3.25,1530,1786,2.0,0,0,3,8,1200,330,2007,0,98117,47.6783,-122.366,1390,2900,256,1510,313.5498320268757,0.06360655737704918,Very Cheap
20150429T000000,715000.0,5,3.0,3490,6091,2.0,0,0,3,9,3490,0,2009,0,98011,47.7744,-122.225,2870,5932,2601,3062,117.38630766704975,0.0839344262295082,Very Cheap
20140522T000000,300000.0,5,2.5,2760,6000,2.0,0,0,3,8,2760,0,2006,0,98108,47.5289,-122.321,1360,6000,3240,4640,50.0,0.029508196721311476,Very Cheap
20150224T000000,405000.0,3,2.5,1440,2163,2.0,0,0,3,7,1440,0,2005,0,98029,47.554,-121.998,1440,2207,723,767,187.23994452149793,0.043278688524590166,Very Cheap
20141007T000000,327000.0,3,3.0,1370,1001,3.0,0,0,3,8,1370,0,2009,0,98133,47.7302,-122.355,1399,1151,-369,-248,326.6733266733267,0.033049180327868855,Very Cheap
20141209T000000,859950.0,6,4.0,3180,6551,2.0,0,0,3,9,3180,0,2014,0,98074,47.6236,-122.023,3230,7602,3371,4372,131.27003510914363,0.10294426229508197,Cheap
20150113T000000,560000.0,4,3.0,2720,7570,2.0,0,0,3,9,2720,0,2008,0,98133,47.7113,-122.349,1770,5705,4850,3935,73.97622192866578,0.06360655737704918,Very Cheap
20140907T000000,379900.0,3,2.5,1800,2792,2.0,0,0,3,8,1800,0,2011,0,98126,47.5442,-122.371,1580,2617,992,1037,136.067335243553,0.03998688524590164,Very Cheap
20150501T000000,625000.0,3,2.5,3220,6409,2.0,0,0,3,9,3220,0,2008,0,98059,47.4815,-122.127,3330,6231,3189,2901,97.51911374629428,0.07213114754098361,Very Cheap
20150423T000000,398096.0,3,2.5,2370,5321,2.0,0,0,3,8,2370,0,2014,0,98038,47.37,-122.019,2370,4357,2951,1987,74.81601202781432,0.04237324590163934,Very Cheap
20141120T000000,315000.0,3,2.5,1410,1325,2.0,0,0,3,7,1180,230,2007,0,98106,47.5582,-122.363,1270,1282,-85,12,237.73584905660377,0.031475409836065574,Very Cheap
20141212T000000,939000.0,4,3.5,3640,6049,2.0,0,0,3,9,3640,0,2014,0,98052,47.7049,-122.125,3590,6104,2409,2514,155.2322697966606,0.11331147540983606,Cheap
20140725T000000,674000.0,3,2.5,1920,3624,2.0,0,0,3,9,1920,0,2003,0,98052,47.6647,-122.087,1930,3533,1704,1603,185.98233995584988,0.07855737704918032,Very Cheap
20140814T000000,306000.0,4,2.5,2267,3577,2.0,0,0,3,7,2267,0,2014,0,98092,47.3384,-122.18,2056,3577,1310,1521,85.54654738607772,0.030295081967213113,Very Cheap
20140709T000000,2321000.0,5,4.75,5780,17004,2.0,0,0,3,11,4260,1520,2006,0,98040,47.5802,-122.212,3460,10855,11224,7395,136.4972947541755,0.29455737704918034,Cheap
20150202T000000,394950.0,2,1.0,1131,1304,3.0,0,0,3,7,1131,0,2011,0,98115,47.6912,-122.313,1131,1992,173,861,302.87576687116564,0.04196065573770492,Very Cheap
20140918T000000,914154.0,3,3.5,2940,6431,2.0,0,0,3,10,2940,0,2014,0,98075,47.5818,-122.047,2760,6695,3491,3935,142.1480329653242,0.11005298360655738,Cheap
20141117T000000,496000.0,3,2.5,2180,4533,2.0,0,0,3,7,2180,0,2010,0,98011,47.754,-122.215,2180,7347,2353,5167,109.41981028016765,0.05521311475409836,Very Cheap
20150417T000000,430100.0,3,2.25,1400,1078,2.0,0,0,3,8,940,460,2009,0,98144,47.5701,-122.288,1420,1230,-322,-190,398.9795918367347,0.046570491803278685,Very Cheap
20140708T000000,449990.0,4,2.5,2680,5539,2.0,0,0,3,8,2680,0,2013,0,98045,47.4759,-121.734,2680,5992,2859,3312,81.24029608232533,0.049179016393442625,Very Cheap
20150330T000000,502000.0,4,2.5,2680,5539,2.0,0,0,3,8,2680,0,2013,0,98045,47.4759,-121.734,2680,5992,2859,3312,90.6300776313414,0.056,Very Cheap
20150311T000000,310000.0,3,2.5,1300,3612,2.0,0,0,3,7,1300,0,2005,0,98118,47.5328,-122.282,1390,2943,2312,1553,85.8250276854928,0.03081967213114754,Very Cheap
20150323T000000,349950.0,4,3.5,2796,3520,2.5,0,0,3,8,2796,0,2013,0,98001,47.3427,-122.278,2040,5195,724,3155,99.41761363636364,0.036059016393442625,Very Cheap
20140919T000000,625000.0,2,1.75,1460,1500,2.0,0,0,3,8,1000,460,2008,0,98103,47.6853,-122.356,1440,4120,40,2680,416.6666666666667,0.07213114754098361,Very Cheap
20140827T000000,1054710.0,4,3.5,4210,6481,2.0,0,3,3,9,3260,950,2014,0,98075,47.5765,-122.072,3920,5331,2271,1411,162.7387748804197,0.12848655737704917,Cheap
20140707T000000,680000.0,4,2.75,2330,3920,2.0,0,0,3,9,2330,0,2005,0,98029,47.5525,-121.99,2410,4063,1590,1653,173.46938775510205,0.07934426229508197,Very Cheap
20140515T000000,828950.0,4,3.5,3930,5680,2.0,0,1,3,9,2820,1110,2013,0,98027,47.5528,-122.076,3700,5816,1750,2116,145.94190140845072,0.09887868852459017,Very Cheap
20150403T000000,274950.0,3,2.5,1608,4000,2.0,0,0,3,8,1608,0,2014,0,98092,47.2582,-122.198,2009,4983,2392,2974,68.7375,0.02622295081967213,Very Cheap
20150312T000000,293000.0,2,2.25,1610,1968,2.0,0,0,4,7,1610,0,1979,0,98056,47.5184,-122.196,1950,1968,358,18,148.8821138211382,0.02859016393442623,Very Cheap
20140613T000000,795000.0,4,3.5,3200,3250,2.0,0,0,3,9,2670,530,2007,0,98029,47.5515,-122.0,3400,3663,50,263,244.6153846153846,0.09442622950819672,Very Cheap
20140922T000000,282900.0,4,2.5,1710,3500,2.0,0,0,3,7,1710,0,2014,0,98002,47.3448,-122.217,1710,3500,1790,1790,80.82857142857142,0.027265573770491804,Very Cheap
20150416T000000,909950.0,5,3.75,3050,8972,2.0,0,0,3,9,3050,0,2014,0,98033,47.6819,-122.172,2750,8979,5922,6229,101.42108782880071,0.1095016393442623,Cheap
20141104T000000,922755.0,4,3.5,3560,4951,2.0,0,0,3,9,3560,0,2014,0,98074,47.6178,-122.055,3540,5500,1391,1960,186.3774994950515,0.11118098360655737,Cheap
20150416T000000,424000.0,4,2.5,2650,8685,2.0,0,0,3,9,2650,0,2006,0,98001,47.344,-122.269,2650,7932,6035,5282,48.81980426021877,0.04577049180327869,Very Cheap
20150423T000000,630000.0,3,2.5,3490,12410,2.0,0,0,3,8,2590,900,2009,0,98059,47.4714,-122.071,1740,14448,8920,12708,50.765511684125705,0.07278688524590164,Very Cheap
20141222T000000,810000.0,4,3.25,4140,46173,2.0,0,0,3,9,4140,0,2007,0,98011,47.7647,-122.213,2060,43103,42033,41043,17.542719771294912,0.09639344262295083,Very Cheap
20140730T000000,256703.0,3,2.0,1670,4441,1.0,0,0,3,7,1670,0,2014,0,98022,47.1948,-121.975,1670,4622,2771,2952,57.80297230353524,0.023829901639344262,Very Cheap
20140515T000000,386380.0,3,2.5,1720,3600,2.0,0,0,3,7,1720,0,2010,0,98053,47.6856,-122.013,1720,3600,1880,1880,107.32777777777778,0.04083672131147541,Very Cheap
20140916T000000,485000.0,2,2.0,1510,3961,1.0,0,0,3,8,1510,0,2010,0,98053,47.709,-122.018,1510,3962,2451,2452,122.44382731633426,0.05377049180327869,Very Cheap
20150211T000000,275000.0,3,2.25,1450,4040,2.0,0,0,3,7,1450,0,2010,0,98038,47.3665,-122.022,1610,4040,2590,2430,68.06930693069307,0.02622950819672131,Very Cheap
20150302T000000,370000.0,4,2.5,1812,5026,2.0,0,0,3,8,1812,0,2011,0,98055,47.4513,-122.202,2440,6007,3214,3567,73.61719060883406,0.038688524590163934,Very Cheap
20140610T000000,499950.0,2,2.25,1060,1208,2.0,0,0,3,8,940,120,2005,0,98102,47.6371,-122.327,1300,1169,148,-131,413.8658940397351,0.05573114754098361,Very Cheap
20150424T000000,502000.0,3,2.5,1600,3073,3.0,0,0,3,8,1600,0,2009,0,98144,47.5934,-122.298,1130,2921,1473,1791,163.35828180930687,0.056,Very Cheap
20140620T000000,654000.0,3,3.25,1530,1565,2.0,0,0,3,8,1280,250,2005,0,98122,47.6179,-122.312,1530,1381,35,-149,417.8913738019169,0.0759344262295082,Very Cheap
20140714T000000,575000.0,4,2.25,2070,1230,3.0,0,0,3,9,1500,570,2013,0,98116,47.5775,-122.41,1569,4802,-840,3233,467.479674796748,0.06557377049180328,Very Cheap
20150415T000000,500000.0,4,2.5,3630,7482,2.0,0,0,3,10,3630,0,2008,0,98188,47.4565,-122.287,1600,15716,3852,14116,66.82705159048383,0.05573770491803279,Very Cheap
20150114T000000,554000.0,3,2.5,2140,4126,2.0,0,0,3,8,1960,180,2005,0,98027,47.5368,-122.073,2280,2615,1986,335,134.27047988366456,0.06281967213114754,Very Cheap
20150508T000000,360000.0,4,1.75,2010,12188,1.0,0,0,4,7,1150,860,1960,0,98059,47.5013,-122.147,1720,8475,10178,6755,29.53724975385625,0.037377049180327866,Very Cheap
20150429T000000,619990.0,4,2.75,2630,4501,2.0,0,0,3,8,2630,0,2015,0,98028,47.7748,-122.244,2380,4599,1871,2219,137.74494556765163,0.07147409836065574,Very Cheap
20150312T000000,317500.0,4,2.5,2233,6025,2.0,0,0,3,7,2233,0,2012,0,98001,47.2599,-122.256,1544,6036,3792,4492,52.697095435684645,0.03180327868852459,Very Cheap
20140828T000000,564950.0,4,2.75,2990,4521,2.0,0,0,3,7,2990,0,2014,0,98028,47.7401,-122.226,2580,7539,1531,4959,124.96129174961291,0.06425573770491803,Very Cheap
20140611T000000,545000.0,2,1.25,1240,2150,2.0,0,0,3,8,1240,0,2014,0,98117,47.6884,-122.374,1340,5289,910,3949,253.48837209302326,0.06163934426229508,Very Cheap
20150501T000000,333700.0,3,2.5,2230,5050,2.0,0,0,3,7,2230,0,2006,0,98042,47.3359,-122.055,2260,5050,2820,2790,66.07920792079207,0.03392786885245901,Very Cheap
20140711T000000,1480000.0,3,3.25,3700,2264,2.0,0,0,3,11,2280,1420,1998,0,98033,47.6653,-122.205,3930,2567,-1436,-1363,653.7102473498234,0.1842622950819672,Cheap
20150408T000000,530000.0,4,3.0,2290,5105,2.0,0,0,3,8,2290,0,2012,0,98028,47.7727,-122.237,2450,5105,2815,2655,103.81978452497552,0.05967213114754098,Very Cheap
20150413T000000,396000.0,2,1.5,950,865,3.0,0,0,3,8,950,0,2006,0,98107,47.6714,-122.382,1290,1189,-85,-101,457.8034682080925,0.0420983606557377,Very Cheap
20141016T000000,305000.0,2,1.75,1120,758,2.0,0,0,3,7,1120,0,2012,0,98027,47.5325,-122.072,1150,758,-362,-392,402.3746701846966,0.03016393442622951,Very Cheap
20140522T000000,380000.0,5,3.5,2420,4670,2.0,0,0,3,7,2420,0,2013,0,98118,47.5241,-122.285,1430,4468,2250,3038,81.37044967880085,0.04,Very Cheap
20150303T000000,305000.0,4,2.5,1714,3250,2.0,0,0,3,8,1714,0,2010,0,98055,47.429,-122.189,1714,3250,1536,1536,93.84615384615384,0.03016393442622951,Very Cheap
20140928T000000,440000.0,4,2.5,2230,5650,2.0,0,0,3,7,2230,0,2011,0,98056,47.5073,-122.168,1590,7241,3420,5651,77.87610619469027,0.04786885245901639,Very Cheap
20140627T000000,459000.0,4,3.0,2530,10000,2.0,0,0,3,7,2530,0,2013,0,98148,47.431,-122.335,1420,9898,7470,8478,45.9,0.050360655737704915,Very Cheap
20150306T000000,530000.0,3,3.5,1550,1233,2.0,0,0,3,8,1160,390,2005,0,98122,47.6034,-122.309,1490,1539,-317,49,429.84590429845906,0.05967213114754098,Very Cheap
20150416T000000,600000.0,4,2.75,3110,11225,2.0,0,0,3,8,3110,0,2012,0,98059,47.4865,-122.143,2610,8535,8115,5925,53.4521158129176,0.06885245901639345,Very Cheap
20140718T000000,515000.0,3,3.0,2100,2409,2.0,0,0,3,8,1660,440,2008,0,98144,47.5973,-122.298,1900,2400,309,500,213.7816521378165,0.057704918032786885,Very Cheap
20150408T000000,275000.0,4,2.5,2150,3721,2.0,0,0,3,8,2150,0,2007,0,98002,47.3363,-122.215,2150,3721,1571,1571,73.90486428379468,0.02622950819672131,Very Cheap
20150112T000000,540000.0,3,1.75,1630,1404,2.0,0,0,3,8,1020,610,2014,0,98107,47.6646,-122.367,1420,1670,-226,250,384.61538461538464,0.06098360655737705,Very Cheap
20140805T000000,445000.0,3,2.5,2230,7934,2.0,0,0,3,7,2230,0,2005,0,98065,47.5439,-121.88,2310,4818,5704,2508,56.08772372069574,0.04852459016393443,Very Cheap
20150407T000000,285000.0,3,2.5,1320,955,3.0,0,0,3,7,1320,0,2009,0,98106,47.5202,-122.357,1300,1003,-365,-297,298.42931937172773,0.02754098360655738,Very Cheap
20140731T000000,480000.0,3,2.5,1590,1431,2.0,0,0,3,8,1060,530,2010,0,98144,47.5893,-122.309,1620,1548,-159,-72,335.42976939203356,0.05311475409836065,Very Cheap
20150120T000000,440000.0,5,3.25,2610,3642,2.0,0,0,3,8,2080,530,2005,0,98118,47.535,-122.284,1750,3118,1032,1368,120.81274025260846,0.04786885245901639,Very Cheap
20150211T000000,287450.0,3,2.5,1440,2500,2.0,0,0,3,7,1440,0,2008,0,98146,47.5123,-122.358,1440,5000,1060,3560,114.98,0.027862295081967213,Very Cheap
20150401T000000,507950.0,4,2.5,2630,6283,2.0,0,0,3,9,2630,0,2006,0,98059,47.5079,-122.158,2630,7210,3653,4580,80.8451376730861,0.05678032786885246,Very Cheap
20140619T000000,750000.0,3,3.5,3390,10078,2.0,0,0,3,10,3040,350,2012,0,98056,47.537,-122.185,3290,12332,6688,9042,74.41952768406429,0.08852459016393442,Very Cheap
20140703T000000,425000.0,3,1.5,1400,1022,3.0,0,0,3,8,1400,0,2007,0,98115,47.6989,-122.317,1270,1205,-378,-65,415.8512720156556,0.04590163934426229,Very Cheap
20141202T000000,420000.0,3,3.5,1900,2133,2.0,0,0,3,8,1520,380,2009,0,98126,47.5675,-122.369,1530,3264,233,1734,196.9057665260197,0.04524590163934426,Very Cheap
20140510T000000,394950.0,3,2.5,1350,1250,3.0,0,0,3,8,1270,80,2006,0,98136,47.5491,-122.387,1350,886,-100,-464,315.96,0.04196065573770492,Very Cheap
20140711T000000,635000.0,4,3.25,3420,6752,2.0,0,2,3,9,3030,390,2012,0,98065,47.517,-121.876,3010,5172,3332,2162,94.04620853080569,0.07344262295081967,Very Cheap
20150506T000000,513000.0,3,2.5,2150,161607,2.0,0,0,3,7,1330,820,1995,0,98038,47.4178,-121.937,2400,207781,159457,205381,3.1743674469546495,0.05744262295081967,Very Cheap
20150505T000000,380000.0,4,2.5,2110,5306,2.0,0,0,3,8,2110,0,2012,0,98038,47.356,-122.057,2250,5306,3196,3056,71.61703731624576,0.04,Very Cheap
20140521T000000,1130000.0,4,3.25,3810,8519,1.0,0,1,3,10,2680,1130,2007,0,98033,47.699,-122.207,3240,10748,4709,7508,132.64467660523536,0.13836065573770492,Cheap
20140608T000000,540000.0,5,3.0,2870,4369,2.0,0,0,3,8,2090,780,2007,0,98011,47.7449,-122.192,2640,4610,1499,1970,123.59807736324102,0.06098360655737705,Very Cheap
20150427T000000,352499.0,2,2.25,1240,705,2.0,0,0,3,7,1150,90,2009,0,98027,47.5321,-122.073,1240,750,-535,-490,499.9985815602837,0.036393311475409834,Very Cheap
20150505T000000,603000.0,4,3.5,3610,6345,2.0,0,0,3,9,2370,1240,2008,0,98058,47.4283,-122.102,3010,29279,2735,26269,95.0354609929078,0.06924590163934426,Very Cheap
20140530T000000,685000.0,4,2.5,2310,5100,2.0,0,0,3,9,2310,0,2013,0,98177,47.7039,-122.36,1260,5100,2790,3840,134.31372549019608,0.08,Very Cheap
20140626T000000,330675.0,4,3.0,1930,3031,1.0,0,0,3,7,1200,730,2006,0,98019,47.7457,-121.985,1930,2611,1101,681,109.09765753876609,0.03353114754098361,Very Cheap
20140605T000000,275000.0,3,3.0,1390,1080,2.0,0,0,3,7,1140,250,2006,0,98118,47.5323,-122.281,1450,1081,-310,-369,254.62962962962962,0.02622950819672131,Very Cheap
20140716T000000,259950.0,3,2.5,1578,7340,2.0,0,0,3,7,1578,0,2010,0,98030,47.3771,-122.186,1850,7200,5762,5350,35.415531335149865,0.024255737704918033,Very Cheap
20140729T000000,441000.0,3,2.0,1720,15000,1.0,0,0,3,9,1720,0,2011,0,98014,47.6927,-121.92,1900,15337,13280,13437,29.4,0.048,Very Cheap
20141203T000000,1135000.0,5,3.75,4700,11237,2.0,0,0,3,10,2930,1770,2006,0,98033,47.6624,-122.197,3180,13140,6537,9960,101.00560647859749,0.13901639344262295,Cheap
20141205T000000,590000.0,3,3.5,1970,5079,2.0,0,0,3,8,1680,290,2007,0,98144,47.5816,-122.296,1940,6000,3109,4060,116.16459933057689,0.06754098360655737,Very Cheap
20140918T000000,497000.0,3,2.25,1460,1353,2.0,0,0,3,8,1050,410,2012,0,98116,47.5774,-122.412,1690,3776,-107,2086,367.33185513673317,0.055344262295081964,Very Cheap
20141121T000000,345500.0,3,2.5,1930,4000,2.0,0,0,3,8,1930,0,2014,0,98001,47.3518,-122.275,2050,4000,2070,1950,86.375,0.03547540983606557,Very Cheap
20140623T000000,562500.0,3,2.25,1300,907,2.0,0,0,3,8,1000,300,2006,0,98102,47.6371,-122.327,1300,1169,-393,-131,620.1764057331864,0.06393442622950819,Very Cheap
20140904T000000,355000.0,3,2.25,1445,1087,2.0,0,0,3,7,1300,145,2005,0,98027,47.5339,-122.067,1410,1336,-358,-74,326.5869365225391,0.036721311475409836,Very Cheap
20140905T000000,345000.0,2,2.25,860,696,2.0,0,0,3,9,860,0,2009,0,98118,47.5663,-122.29,1100,3000,-164,1900,495.6896551724138,0.03540983606557377,Very Cheap
20140505T000000,478000.0,3,2.5,3040,4535,2.0,0,0,3,9,3040,0,2007,0,98056,47.51,-122.185,2670,4666,1495,1996,105.40242557883131,0.05285245901639344,Very Cheap
20150402T000000,391500.0,3,2.5,2424,6143,2.0,0,0,3,9,2424,0,2014,0,98030,47.3512,-122.135,2381,6036,3719,3655,63.73107602148787,0.04150819672131147,Very Cheap
20150412T000000,265000.0,2,1.5,1084,3427,2.0,0,0,3,7,1084,0,1976,0,98125,47.7117,-122.326,1084,6250,2343,5166,77.32710825795156,0.024918032786885248,Very Cheap
20141030T000000,395000.0,3,2.5,2510,5320,2.0,0,0,3,8,2510,0,2005,0,98106,47.5374,-122.357,1820,5736,2810,3916,74.24812030075188,0.0419672131147541,Very Cheap
20140727T000000,286308.0,2,1.5,1220,1036,3.0,0,0,3,7,1220,0,2006,0,98133,47.7348,-122.347,1210,659,-184,-551,276.35907335907336,0.027712524590163934,Very Cheap
20140527T000000,370000.0,2,2.25,1280,835,2.0,0,0,3,7,1080,200,2009,0,98118,47.5592,-122.284,1280,1246,-445,-34,443.1137724550898,0.038688524590163934,Very Cheap
20140923T000000,1079000.0,5,3.5,3740,5610,2.0,0,0,3,9,2860,880,2014,0,98117,47.6764,-122.392,1520,4590,1870,3070,192.33511586452764,0.13167213114754098,Cheap
20141015T000000,298900.0,3,2.5,1852,4000,2.0,0,0,3,7,1852,0,2014,0,98002,47.3451,-122.209,2475,4000,2148,1525,74.725,0.029363934426229508,Very Cheap
20150421T000000,775000.0,4,2.5,2580,5787,2.0,0,0,3,9,2580,0,2007,0,98029,47.5416,-121.994,2580,4410,3207,1830,133.9208570934854,0.09180327868852459,Very Cheap
20140624T000000,790000.0,4,3.5,3190,31450,2.0,0,0,3,9,3190,0,2010,0,98027,47.501,-121.902,3000,72745,28260,69745,25.119236883942765,0.09377049180327869,Very Cheap
20140827T000000,1050000.0,3,2.5,3400,5119,2.0,0,0,3,8,2300,1100,2014,0,98115,47.6843,-122.305,1740,5969,1719,4229,205.11818714592695,0.12786885245901639,Cheap
20140708T000000,249000.0,2,1.5,1090,2686,2.0,0,0,3,7,1090,0,1982,0,98034,47.717,-122.19,1160,2158,1596,998,92.70290394638869,0.02281967213114754,Very Cheap
20140929T000000,348000.0,3,2.0,2360,6145,1.0,0,0,3,8,2360,0,2011,0,98030,47.3564,-122.198,2304,5880,3785,3576,56.63140764849471,0.03580327868852459,Very Cheap
20141114T000000,358000.0,5,2.5,2460,5604,2.0,0,0,3,8,2460,0,2011,0,98038,47.3658,-122.037,2210,6395,3144,4185,63.88294075660243,0.03711475409836065,Very Cheap
20140625T000000,260000.0,5,2.5,2025,7760,2.0,0,0,3,7,2025,0,2007,0,98001,47.2671,-122.256,1664,9000,5735,7336,33.50515463917526,0.024262295081967214,Very Cheap
20140604T000000,765000.0,4,3.0,4410,5104,2.0,0,0,3,9,3400,1010,2006,0,98065,47.5392,-121.861,4390,5537,694,1147,149.88244514106583,0.09049180327868853,Very Cheap
20140528T000000,739000.0,3,2.5,2810,5400,2.0,0,0,3,9,2810,0,2005,0,98052,47.7065,-122.118,2870,5400,2590,2530,136.85185185185185,0.08708196721311476,Very Cheap
20140505T000000,890000.0,5,3.5,4490,6000,2.0,0,0,3,10,3200,1290,2006,0,98027,47.5396,-122.073,4530,6000,1510,1470,148.33333333333334,0.10688524590163935,Cheap
20140607T000000,462000.0,4,2.5,3070,6432,2.0,0,0,3,9,3070,0,2006,0,98055,47.4487,-122.205,2910,5106,3362,2196,71.82835820895522,0.05075409836065574,Very Cheap
20140708T000000,380000.0,4,2.5,1984,32400,1.0,0,0,3,8,1564,420,1962,0,98198,47.36,-122.318,1390,9152,30416,7762,11.728395061728396,0.04,Very Cheap
20150511T000000,770000.0,5,3.5,4750,8234,2.0,0,2,3,10,3350,1400,2013,0,98198,47.3574,-122.318,2160,14496,3484,12336,93.51469516638329,0.09114754098360656,Very Cheap
20140818T000000,641000.0,4,3.25,2760,4104,2.0,0,0,3,8,1900,860,2014,0,98056,47.5286,-122.187,2760,5186,1344,2426,156.18908382066277,0.0742295081967213,Very Cheap
20150417T000000,2300000.0,4,4.0,4360,8175,2.5,1,4,3,10,3940,420,2007,0,98008,47.5724,-122.104,2670,8525,3815,5855,281.34556574923545,0.29180327868852457,Cheap
20150504T000000,369000.0,4,2.5,3060,27251,1.5,0,0,3,8,3060,0,2008,0,98022,47.1967,-121.966,1760,27251,24191,25491,13.540787494036916,0.03855737704918033,Very Cheap
20140916T000000,1112000.0,4,3.0,2770,2650,2.0,0,0,3,9,2180,590,2014,0,98109,47.6435,-122.354,1820,2960,-120,1140,419.62264150943395,0.136,Cheap
20140828T000000,357000.0,5,2.5,2990,9240,2.0,0,0,3,8,2990,0,2015,0,98133,47.7384,-122.348,1970,18110,6250,16140,38.63636363636363,0.03698360655737705,Very Cheap
20141126T000000,650000.0,3,2.75,1540,1251,2.0,0,0,3,8,1230,310,2002,0,98102,47.6298,-122.321,1540,1287,-289,-253,519.5843325339728,0.07540983606557378,Very Cheap
20140625T000000,563500.0,3,2.5,1400,1312,3.5,0,0,3,8,1400,0,2007,0,98103,47.6534,-122.355,1350,1312,-88,-38,429.4969512195122,0.06406557377049181,Very Cheap
20140617T000000,345000.0,3,2.5,1680,2229,2.0,0,0,3,7,1680,0,2007,0,98155,47.7484,-122.322,1230,9300,549,8070,154.7779273216689,0.03540983606557377,Very Cheap
20140725T000000,479950.0,3,2.0,2260,7163,1.0,0,0,3,9,2260,0,2012,0,98058,47.4593,-122.136,2340,6730,4903,4390,67.00404858299595,0.05310819672131147,Very Cheap
20140513T000000,660000.0,4,3.5,3400,5196,2.0,0,0,3,9,3400,0,2012,0,98065,47.5169,-121.884,3170,5260,1796,2090,127.02078521939954,0.07672131147540984,Very Cheap
20140729T000000,800000.0,4,2.5,2930,5000,2.0,0,0,3,9,2760,170,2007,0,98006,47.5424,-122.12,3230,5778,2070,2548,160.0,0.09508196721311475,Very Cheap
20140724T000000,253101.0,3,2.0,1239,6036,1.0,0,0,3,7,1239,0,2009,0,98030,47.3689,-122.175,2060,5746,4797,3686,41.93190854870775,0.023357508196721312,Very Cheap
20140929T000000,555000.0,3,3.5,2100,2479,2.0,0,0,3,9,1450,650,2011,0,98118,47.562,-122.292,1800,2457,379,657,223.88059701492537,0.06295081967213115,Very Cheap
20140626T000000,240000.0,4,1.0,1200,2171,1.5,0,0,3,7,1200,0,1933,0,98133,47.7076,-122.342,1130,1598,971,468,110.5481345002303,0.021639344262295083,Very Cheap
20150504T000000,380000.0,4,1.0,1200,2171,1.5,0,0,3,7,1200,0,1933,0,98133,47.7076,-122.342,1130,1598,971,468,175.0345462920313,0.04,Very Cheap
20141117T000000,239000.0,2,1.5,680,772,2.0,0,0,3,7,680,0,2005,0,98103,47.695,-122.343,690,1059,92,369,309.5854922279793,0.021508196721311476,Very Cheap
20150318T000000,760000.0,4,3.25,2690,3995,2.0,0,0,3,9,2060,630,2014,0,98136,47.532,-122.384,1810,4590,1305,2780,190.2377972465582,0.0898360655737705,Very Cheap
20140826T000000,430000.0,4,2.5,2750,7200,2.0,0,0,3,8,2750,0,2011,0,98019,47.7327,-121.966,2750,7200,4450,4450,59.72222222222222,0.04655737704918033,Very Cheap
20140522T000000,660000.0,3,2.5,2450,4332,2.0,0,0,3,8,2450,0,2010,0,98053,47.6942,-122.016,2450,4154,1882,1704,152.3545706371191,0.07672131147540984,Very Cheap
20140820T000000,399963.0,4,2.5,2620,4050,2.0,0,0,3,8,2620,0,2014,0,98146,47.5017,-122.34,2030,3944,1430,1914,98.7562962962963,0.042618098360655735,Very Cheap
20140718T000000,411000.0,2,2.0,1130,1148,2.0,0,0,3,9,800,330,2007,0,98122,47.6023,-122.314,1350,1201,18,-149,358.01393728222996,0.044065573770491806,Very Cheap
20140627T000000,483453.0,4,2.75,2790,5527,2.0,0,0,3,8,2790,0,2014,0,98045,47.4827,-121.773,2620,5509,2737,2889,87.47114166817441,0.05356760655737705,Very Cheap
20141110T000000,469950.0,3,2.0,1820,1357,3.0,0,0,3,9,1820,0,2014,0,98126,47.5432,-122.376,1710,1372,-463,-338,346.31540162122326,0.05179672131147541,Very Cheap
20140715T000000,504058.0,4,2.75,2910,7467,2.0,0,0,3,8,2910,0,2013,0,98045,47.4841,-121.772,2790,7868,4557,5078,67.50475425204232,0.05626990163934426,Very Cheap
20150428T000000,425996.0,4,2.5,2568,5000,2.0,0,0,3,9,2568,0,2014,0,98092,47.2596,-122.194,2547,4500,2432,1953,85.1992,0.04603226229508197,Very Cheap
20140708T000000,760005.0,4,2.75,3090,5859,2.0,0,0,3,9,3090,0,2010,0,98074,47.6057,-122.047,2960,5250,2769,2290,129.715821812596,0.08983672131147541,Very Cheap
20150420T000000,699999.0,2,2.0,1460,1085,2.0,0,0,3,8,950,510,2014,0,98112,47.6205,-122.299,1580,1202,-375,-378,645.1603686635945,0.08196708196721311,Very Cheap
20140716T000000,749950.0,3,2.5,2010,2263,2.0,0,0,3,8,1340,670,2014,0,98122,47.6088,-122.311,1500,2670,253,1170,331.39637649138314,0.08851803278688525,Very Cheap
20140708T000000,674600.0,4,2.5,2610,5140,2.0,0,0,3,8,2610,0,2006,0,98103,47.6951,-122.346,1190,5101,2530,3911,131.24513618677042,0.0786360655737705,Very Cheap
20150224T000000,450000.0,2,1.5,960,1000,2.0,0,0,3,8,920,40,2008,0,98103,47.6489,-122.335,1200,1297,40,97,450.0,0.04918032786885246,Very Cheap
20150407T000000,272000.0,3,2.5,1528,7616,2.0,0,0,3,7,1528,0,2011,0,98030,47.3774,-122.186,1850,7340,6088,5490,35.714285714285715,0.02583606557377049,Very Cheap
20140714T000000,450000.0,2,1.5,1310,1264,2.0,0,0,3,8,1120,190,2006,0,98106,47.5772,-122.409,1330,1265,-46,-65,356.0126582278481,0.04918032786885246,Very Cheap
20150505T000000,643950.0,3,2.25,1760,2122,3.0,0,0,3,9,1760,0,2015,0,98116,47.5633,-122.385,1420,1618,362,198,303.46371347785106,0.07461639344262296,Very Cheap
20141110T000000,290000.0,3,2.5,1420,3542,2.0,0,0,3,8,1310,110,2007,0,98133,47.7731,-122.343,1180,1622,2122,442,81.8746470920384,0.02819672131147541,Very Cheap
20141008T000000,378000.0,3,2.5,1650,2082,3.0,0,0,3,8,1650,0,2007,0,98133,47.7108,-122.332,1650,1965,432,315,181.55619596541786,0.03973770491803279,Very Cheap
20140619T000000,728050.0,3,2.5,2320,6775,1.0,0,0,3,8,2320,0,2008,0,98053,47.7158,-122.016,1680,4750,4455,3070,107.46125461254613,0.08564590163934427,Very Cheap
20150426T000000,499160.0,4,2.5,2628,11466,2.0,0,0,3,9,2628,0,2014,0,98001,47.2904,-122.264,2849,10909,8838,8060,43.53392639106925,0.05562754098360656,Very Cheap
20141201T000000,536000.0,4,2.5,2520,4831,2.0,0,0,3,8,2520,0,2009,0,98072,47.7711,-122.168,2430,3937,2311,1507,110.95011384806459,0.06045901639344262,Very Cheap
20150205T000000,419900.0,5,3.5,2880,5000,2.0,0,0,3,8,2260,620,2012,0,98038,47.3455,-122.023,2590,4800,2120,2210,83.98,0.0452327868852459,Very Cheap
20141210T000000,469000.0,3,2.25,1440,1362,3.0,0,0,3,7,1440,0,2014,0,98117,47.6908,-122.365,1180,2603,-78,1423,344.3465491923642,0.05167213114754098,Very Cheap
20150408T000000,374000.0,3,2.5,2185,6042,2.0,0,0,3,9,2185,0,2009,0,98030,47.3573,-122.202,2297,5876,3857,3579,61.90003310162198,0.03921311475409836,Very Cheap
20140728T000000,182568.0,4,1.5,1500,2106,2.0,0,0,3,7,1500,0,2014,0,98108,47.5669,-122.297,1490,2175,606,685,86.68945868945869,0.01410727868852459,Very Cheap
20140626T000000,334888.0,3,2.5,1769,7324,2.0,0,0,3,9,1769,0,2012,0,98092,47.3307,-122.188,2502,6017,5555,3515,45.72474057891862,0.03408367213114754,Very Cheap
20140917T000000,799900.0,4,4.0,3650,18223,2.0,0,3,3,9,3330,320,2013,0,98006,47.5442,-122.116,3220,11022,14573,7802,43.89507764912473,0.09506885245901639,Very Cheap
20140512T000000,383000.0,4,2.5,2160,6223,2.0,0,0,3,8,2160,0,2010,0,98038,47.3494,-122.042,2160,5555,4063,3395,61.5458781937972,0.04039344262295082,Very Cheap
20141218T000000,580000.0,3,2.5,1820,374616,2.0,0,0,3,7,1820,0,1999,0,98014,47.6539,-121.959,1870,220654,372796,218784,1.548252076793303,0.06622950819672131,Very Cheap
20140707T000000,351999.0,3,2.5,2370,4200,2.0,0,0,3,8,2370,0,2014,0,98038,47.3706,-122.017,2370,4200,1830,1830,83.80928571428572,0.03632773770491803,Very Cheap
20150223T000000,1325000.0,3,3.0,3180,2758,2.0,0,2,3,11,2240,940,2008,0,98109,47.6377,-122.342,2420,2758,-422,338,480.4205946337926,0.16393442622950818,Cheap
20150125T000000,312000.0,3,2.5,1780,4077,2.0,0,0,3,8,1780,0,2011,0,98038,47.3568,-122.056,1970,4077,2297,2107,76.52685798381162,0.031081967213114754,Very Cheap
20140912T000000,674950.0,4,3.5,2650,3127,2.0,0,0,3,8,2230,420,2011,0,98027,47.5381,-122.046,2330,3137,477,807,215.8458586504637,0.07868196721311475,Very Cheap
20141229T000000,1105000.0,5,2.75,3300,7560,2.0,0,0,3,10,3300,0,2007,0,98052,47.6467,-122.118,3150,8580,4260,5430,146.16402116402116,0.13508196721311475,Cheap
20150313T000000,415000.0,2,2.5,1160,1219,3.0,0,0,3,8,1160,0,2007,0,98107,47.6543,-122.358,1320,2800,59,1480,340.44298605414275,0.04459016393442623,Very Cheap
20140710T000000,1250000.0,3,3.0,3460,5353,2.0,0,0,3,10,2850,610,2007,0,98116,47.5858,-122.393,2460,6325,1893,3865,233.5139174294788,0.1540983606557377,Cheap
20140919T000000,208800.0,3,2.5,1390,2450,2.0,0,0,3,7,1390,0,2009,0,98118,47.5298,-122.269,1390,2450,1060,1060,85.22448979591837,0.017547540983606558,Very Cheap
20141029T000000,452000.0,2,2.5,1260,1131,3.0,0,0,3,8,1260,0,2006,0,98107,47.6715,-122.384,1490,2500,-129,1010,399.64633068081343,0.04944262295081967,Very Cheap
20150422T000000,837000.0,5,2.75,2940,5225,2.0,0,0,3,8,2760,180,2010,0,98052,47.6879,-122.107,3090,6261,2285,3171,160.19138755980862,0.0999344262295082,Very Cheap
20150224T000000,780000.0,5,3.5,3190,4247,2.0,0,0,3,8,2430,760,2013,0,98052,47.7016,-122.103,2580,3989,1057,1409,183.65905344949377,0.09245901639344262,Very Cheap
20141002T000000,1485000.0,4,3.5,3930,6120,2.0,0,0,3,10,3310,620,2007,0,98105,47.6646,-122.28,3390,6120,2190,2730,242.64705882352942,0.18491803278688523,Cheap
20140926T000000,1600000.0,5,3.75,3570,10125,2.0,0,0,3,10,3570,0,2014,0,98040,47.5639,-122.223,1760,10125,6555,8365,158.02469135802468,0.2,Cheap
20140918T000000,369946.0,3,2.5,2420,4725,2.0,0,0,3,8,2420,0,2014,0,98038,47.371,-122.018,2370,4200,2305,1830,78.29544973544974,0.03868144262295082,Very Cheap
20140608T000000,530000.0,3,2.75,3400,7200,2.0,0,2,3,9,2470,930,2009,0,98056,47.4878,-122.191,1580,8676,3800,7096,73.61111111111111,0.05967213114754098,Very Cheap
20150320T000000,386000.0,4,2.5,2478,6079,2.0,0,0,3,8,2478,0,2012,0,98030,47.3524,-122.175,2279,6079,3601,3800,63.49728573778582,0.04078688524590164,Very Cheap
20150218T000000,1900000.0,4,2.5,3070,7830,2.0,0,2,3,11,1970,1100,2009,0,98144,47.593,-122.291,2440,4682,4760,2242,242.65644955300127,0.23934426229508196,Cheap
20140911T000000,735000.0,4,3.5,3200,7605,2.0,0,2,3,9,2500,700,2013,0,98198,47.3443,-122.327,2240,4416,4405,2176,96.64694280078895,0.08655737704918033,Very Cheap
20141002T000000,1750000.0,5,3.25,5790,12739,2.0,0,3,3,10,4430,1360,2014,0,98006,47.538,-122.114,5790,13928,6949,8138,137.37342020566763,0.21967213114754097,Cheap
20150223T000000,489950.0,3,2.25,1590,926,3.0,0,0,3,8,1590,0,2014,0,98136,47.5402,-122.387,1640,1321,-664,-319,529.1036717062635,0.05441967213114754,Very Cheap
20150413T000000,357500.0,3,3.0,1730,1442,2.0,0,0,3,8,1440,290,2008,0,98106,47.5344,-122.348,1370,1524,-288,154,247.91955617198334,0.03704918032786885,Very Cheap
20140520T000000,329995.0,4,2.5,2303,3680,2.0,0,0,3,8,2303,0,2013,0,98001,47.2599,-122.283,2303,3760,1377,1457,89.6725543478261,0.03344196721311475,Very Cheap
20140925T000000,414000.0,3,2.5,1790,3754,2.0,0,0,3,8,1790,0,2013,0,98065,47.534,-121.841,1800,3393,1964,1593,110.28236547682472,0.04445901639344262,Very Cheap
20141210T000000,533500.0,3,3.5,2490,3517,2.0,0,0,3,8,1720,770,2005,0,98027,47.5341,-122.067,1600,2378,1027,778,151.69178276940573,0.06013114754098361,Very Cheap
20150305T000000,402395.0,4,2.5,2669,5385,2.0,0,0,3,9,2669,0,2014,0,98092,47.3262,-122.165,2669,4645,2716,1976,74.72516248839369,0.04293704918032787,Very Cheap
20150410T000000,725000.0,4,3.25,2610,2552,2.0,0,0,3,10,2160,450,2008,0,98027,47.5322,-122.076,2610,2664,-58,54,284.09090909090907,0.08524590163934426,Very Cheap
20140828T000000,1275000.0,6,5.25,6160,27490,2.0,0,0,3,11,4040,2120,2007,0,98074,47.6094,-122.023,4225,9100,21330,4875,46.38050200072754,0.15737704918032788,Cheap
20140917T000000,239800.0,2,1.75,1290,1493,2.0,0,0,3,8,1290,0,2014,0,98106,47.5171,-122.346,1410,1875,203,465,160.6162089752177,0.02161311475409836,Very Cheap
20140904T000000,616950.0,5,3.5,3560,5008,2.0,0,0,3,8,2810,750,2013,0,98106,47.5542,-122.359,2910,5026,1448,2116,123.19289137380191,0.07107540983606557,Very Cheap
20141001T000000,1258000.0,4,3.25,4360,6000,2.0,0,3,3,11,3400,960,2007,0,98027,47.5408,-121.994,4310,6000,1640,1690,209.66666666666666,0.15514754098360656,Cheap
20140617T000000,435000.0,3,2.25,1230,1238,2.0,0,0,3,8,1080,150,2009,0,98199,47.6519,-122.384,1230,953,8,-277,351.37318255250403,0.04721311475409836,Very Cheap
20140815T000000,925000.0,4,3.25,3640,60086,2.0,0,0,3,10,3640,0,2005,0,98074,47.6328,-122.016,2900,51721,56446,48821,15.39460107179709,0.11147540983606558,Cheap
20150428T000000,631500.0,2,2.5,1780,2493,3.0,0,0,3,8,1780,0,1981,0,98107,47.6704,-122.358,2050,4400,713,2350,253.309265944645,0.07298360655737705,Very Cheap
20150330T000000,399995.0,3,1.5,1140,1069,3.0,0,0,3,8,1140,0,2005,0,98103,47.6907,-122.342,1230,1276,-71,46,374.17680074836295,0.042622295081967215,Very Cheap
20140506T000000,369950.0,3,2.0,1270,1320,3.0,0,0,3,8,1270,0,2006,0,98103,47.6937,-122.342,1370,1320,50,-50,280.2651515151515,0.03868196721311475,Very Cheap
20150423T000000,475000.0,5,3.5,2780,3583,2.0,0,0,3,8,2180,600,2005,0,98059,47.4879,-122.152,2640,3850,803,1210,132.57047167178342,0.05245901639344262,Very Cheap
20141125T000000,353000.0,4,2.5,1912,5000,2.0,0,0,3,8,1912,0,2012,0,98001,47.3511,-122.275,2020,5000,3088,2980,70.6,0.03645901639344262,Very Cheap
20150225T000000,329950.0,4,2.5,2300,9690,2.0,0,0,3,8,2300,0,2006,0,98023,47.2793,-122.352,1200,9085,7390,7885,34.050567595459235,0.03343606557377049,Very Cheap
20150313T000000,367000.0,3,2.5,2828,4050,2.0,0,0,3,8,2828,0,2013,0,98030,47.382,-122.197,2513,4507,1222,1994,90.61728395061728,0.03829508196721312,Very Cheap
20140905T000000,447500.0,4,2.5,2425,9017,2.0,0,0,3,9,2425,0,2013,0,98001,47.3003,-122.263,2725,7019,6592,4294,49.628479538649216,0.04885245901639344,Very Cheap
20140709T000000,595000.0,4,3.25,3730,4560,2.0,0,0,3,9,2760,970,2015,0,98103,47.6725,-122.33,1800,4560,830,2760,130.48245614035088,0.06819672131147542,Very Cheap
20140904T000000,325000.0,1,1.0,730,1942,1.0,0,0,3,7,730,0,2009,0,98144,47.5943,-122.299,1020,2044,1212,1024,167.35324407826982,0.03278688524590164,Very Cheap
20150203T000000,690000.0,2,2.5,1990,1756,3.0,0,0,3,9,1780,210,2005,0,98102,47.6264,-122.323,1955,1438,-234,-517,392.9384965831435,0.08065573770491803,Very Cheap
20141111T000000,329950.0,3,2.5,1300,812,2.0,0,0,3,8,880,420,2008,0,98144,47.5893,-122.317,1300,824,-488,-476,406.3423645320197,0.03343606557377049,Very Cheap
20150128T000000,399500.0,4,2.5,2560,7492,2.0,0,0,3,8,2560,0,2014,0,98188,47.4467,-122.287,1260,11541,4932,10281,53.323545114789106,0.04255737704918033,Very Cheap
20150121T000000,555000.0,5,2.5,2450,5047,2.0,0,0,3,8,2450,0,2007,0,98011,47.7724,-122.168,2450,4478,2597,2028,109.96631662373687,0.06295081967213115,Very Cheap
20141001T000000,427000.0,2,1.5,1440,725,2.0,0,0,3,8,1100,340,2011,0,98126,47.5607,-122.378,1440,4255,-715,2815,588.9655172413793,0.04616393442622951,Very Cheap
20141020T000000,375000.0,3,2.25,1140,1557,3.0,0,0,3,8,1140,0,2007,0,98103,47.6947,-122.342,1140,1245,417,105,240.84778420038535,0.03934426229508197,Very Cheap
20140508T000000,499000.0,2,1.5,1110,957,2.0,0,0,3,8,930,180,2005,0,98119,47.6319,-122.362,1680,1104,-153,-576,521.4211076280042,0.05560655737704918,Very Cheap
20140718T000000,750000.0,3,2.5,2620,43832,2.0,0,0,3,8,2620,0,2013,0,98053,47.655,-122.009,2620,120686,41212,118066,17.110786639897793,0.08852459016393442,Very Cheap
20141229T000000,336900.0,3,2.5,1690,1200,2.0,0,0,3,8,1410,280,2014,0,98106,47.5388,-122.367,1740,1664,-490,-76,280.75,0.03434754098360656,Very Cheap
20140919T000000,555000.0,2,2.75,1950,1610,3.0,0,0,3,8,1950,0,2009,0,98144,47.5925,-122.302,910,1745,-340,835,344.72049689440996,0.06295081967213115,Very Cheap
20141106T000000,1275000.0,4,3.5,3530,8126,2.0,0,0,3,10,3530,0,2007,0,98033,47.6847,-122.2,2660,8126,4596,5466,156.90376569037656,0.15737704918032788,Cheap
20141014T000000,999950.0,4,3.5,3310,4684,2.0,0,0,3,9,2290,1020,2014,0,98116,47.579,-122.389,1850,4750,1374,2900,213.48206660973526,0.12130491803278688,Cheap
20140625T000000,975000.0,5,3.0,2620,5477,2.0,0,0,3,10,2620,0,2009,0,98115,47.6804,-122.288,1680,5217,2857,3537,178.01716268029944,0.1180327868852459,Cheap
20150219T000000,299000.0,3,2.25,1350,3582,2.0,0,0,3,8,1350,0,2010,0,98031,47.4214,-122.191,1940,3860,2232,1920,83.47292015633724,0.02937704918032787,Very Cheap
20150417T000000,479000.0,2,2.5,1741,1439,2.0,0,0,3,8,1446,295,2007,0,98034,47.7043,-122.209,2090,10454,-302,8364,332.8700486448923,0.05298360655737705,Very Cheap
20150417T000000,428000.0,3,2.5,1650,2201,3.0,0,0,3,8,1650,0,2007,0,98133,47.7108,-122.333,1650,1965,551,315,194.45706497046797,0.04629508196721312,Very Cheap
20140829T000000,409000.0,3,2.5,1890,6500,2.0,0,0,3,7,1890,0,2012,0,98074,47.6225,-122.058,2340,7500,4610,5160,62.92307692307692,0.04380327868852459,Very Cheap
20150326T000000,798500.0,3,3.0,1950,1833,3.0,0,0,3,9,1610,340,2009,0,98004,47.6078,-122.202,2040,2131,-117,91,435.6246590289143,0.09488524590163934,Very Cheap
20141212T000000,689000.0,4,3.5,4490,5805,2.0,0,0,3,9,3390,1100,2006,0,98065,47.5389,-121.86,4410,6299,1315,1889,118.69078380706287,0.08052459016393443,Very Cheap
20140508T000000,375000.0,6,2.25,3206,5793,2.0,0,0,3,7,3206,0,2012,0,98032,47.369,-122.287,2527,5804,2587,3277,64.7332988089073,0.03934426229508197,Very Cheap
20140717T000000,775000.0,4,3.5,4130,77832,2.0,0,2,3,10,4130,0,2011,0,98042,47.3229,-122.045,4130,87476,73702,83346,9.95734402302395,0.09180327868852459,Very Cheap
20141014T000000,639983.0,5,3.0,2800,5700,2.0,0,0,3,8,2800,0,2014,0,98059,47.4969,-122.145,2910,5349,2900,2439,112.27771929824561,0.07409613114754099,Very Cheap
20150326T000000,300000.0,4,3.0,1984,4419,2.0,0,0,3,7,1984,0,2010,0,98002,47.3514,-122.213,2440,4418,2435,1978,67.88866259334691,0.029508196721311476,Very Cheap
20141222T000000,627000.0,4,2.5,2750,11830,2.0,0,0,3,9,2750,0,2014,0,98059,47.4698,-122.121,2310,11830,9080,9520,53.00084530853761,0.07239344262295082,Very Cheap
20150415T000000,275000.0,3,2.75,1740,5757,1.0,0,0,3,7,1740,0,2010,0,98022,47.1941,-121.979,2380,5647,4017,3267,47.76793468820566,0.02622950819672131,Very Cheap
20140926T000000,352800.0,4,2.25,1800,2752,2.0,0,0,3,8,1800,0,2014,0,98106,47.5167,-122.346,1650,2752,952,1102,128.19767441860466,0.0364327868852459,Very Cheap
20150312T000000,565000.0,3,2.25,1540,1005,3.0,0,0,3,8,1540,0,2008,0,98103,47.6828,-122.346,1510,1501,-535,-9,562.1890547263681,0.06426229508196721,Very Cheap
20150414T000000,765000.0,4,2.25,2030,2222,2.0,0,0,3,9,1610,420,2015,0,98117,47.679,-122.375,1420,2222,192,802,344.2844284428443,0.09049180327868853,Very Cheap
20150409T000000,644000.0,4,2.5,3310,4839,2.0,0,0,3,9,3310,0,2007,0,98072,47.773,-122.161,3240,5280,1529,2040,133.08534821244058,0.07462295081967213,Very Cheap
20150223T000000,461000.0,3,1.5,1270,1416,3.0,0,0,3,8,1270,0,2007,0,98115,47.6988,-122.317,1270,1413,146,143,325.56497175141243,0.05062295081967213,Very Cheap
20141223T000000,270500.0,5,2.5,2406,7093,2.0,0,0,3,8,2406,0,2006,0,98001,47.2615,-122.252,1767,7093,4687,5326,38.13619061046102,0.025639344262295083,Very Cheap
20140701T000000,640000.0,2,2.25,1540,965,3.0,0,0,3,9,1540,0,2007,0,98122,47.6181,-122.318,1410,964,-575,-446,663.2124352331606,0.0740983606557377,Very Cheap
20140805T000000,457000.0,4,2.5,2820,6983,2.0,0,0,3,9,2820,0,2013,0,98001,47.2958,-122.265,2597,7222,4163,4625,65.44465129600458,0.0500983606557377,Very Cheap
20141201T000000,355000.0,5,2.5,2540,5100,2.0,0,0,3,7,2540,0,2014,0,98168,47.5123,-122.316,1400,9440,2560,8040,69.6078431372549,0.036721311475409836,Very Cheap
20141215T000000,356000.0,2,2.25,1230,989,3.0,0,0,3,8,1230,0,2007,0,98103,47.6975,-122.348,1230,1223,-241,-7,359.95955510616784,0.03685245901639344,Very Cheap
20140805T000000,425000.0,4,2.5,1900,2766,2.0,0,0,3,8,1900,0,2014,0,98106,47.543,-122.368,1900,2604,866,704,153.65148228488792,0.04590163934426229,Very Cheap
20140923T000000,562500.0,5,2.75,2920,6327,2.0,0,0,3,8,2920,0,2007,0,98059,47.4935,-122.145,2520,5026,3407,2506,88.90469416785206,0.06393442622950819,Very Cheap
20140701T000000,460000.0,3,2.5,1450,1053,2.0,0,0,3,8,940,510,2008,0,98107,47.6754,-122.374,1410,1080,-397,-330,436.8471035137702,0.050491803278688525,Very Cheap
20150406T000000,790000.0,4,3.0,5370,69848,2.0,0,0,3,10,3500,1870,2005,0,98042,47.3166,-122.046,4443,94403,64478,89960,11.310273737258045,0.09377049180327869,Very Cheap
20150318T000000,401000.0,3,2.0,1270,1333,3.0,0,0,3,8,1270,0,2006,0,98103,47.6933,-122.342,1330,1333,63,3,300.8252063015754,0.04275409836065574,Very Cheap
20140828T000000,1095000.0,3,2.5,2550,5100,2.0,0,0,3,9,2550,0,2014,0,98115,47.6757,-122.326,1250,4080,2550,2830,214.7058823529412,0.13377049180327868,Cheap
20150403T000000,850000.0,4,3.0,3070,7150,2.0,0,0,3,9,3070,0,2007,0,98052,47.7079,-122.107,3200,6984,4080,3784,118.88111888111888,0.10163934426229508,Cheap
20140702T000000,274500.0,3,2.25,1450,4050,2.0,0,0,3,7,1450,0,2010,0,98038,47.367,-122.019,1660,3800,2600,2140,67.77777777777777,0.02616393442622951,Very Cheap
20150415T000000,1940000.0,5,3.5,4230,16526,2.0,0,0,3,10,4230,0,2008,0,98004,47.5933,-122.199,3000,12362,12296,9362,117.39077816773569,0.24459016393442623,Cheap
20140804T000000,808000.0,4,2.5,3480,6262,2.0,0,0,3,9,3480,0,2003,0,98053,47.6857,-122.045,3490,6629,2782,3139,129.03225806451613,0.0961311475409836,Very Cheap
20140515T000000,312000.0,3,2.25,1490,974,2.0,0,0,3,7,1220,270,2009,0,98106,47.5567,-122.363,1490,1283,-516,-207,320.3285420944558,0.031081967213114754,Very Cheap
20140616T000000,320000.0,3,2.25,1200,1400,3.0,0,0,3,8,1200,0,2005,0,98133,47.7046,-122.357,1370,6552,200,5182,228.57142857142858,0.032131147540983604,Very Cheap
20150113T000000,410000.0,3,2.5,2150,4332,2.0,0,0,3,8,2150,0,2013,0,98019,47.7373,-121.969,2140,4332,2182,2192,94.64450600184672,0.043934426229508196,Very Cheap
20140620T000000,725000.0,3,3.5,3690,8837,2.0,0,0,3,10,3690,0,2001,0,98065,47.5402,-121.876,3690,9585,5147,5895,82.04141677039719,0.08524590163934426,Very Cheap
20141015T000000,335000.0,4,2.5,1900,3301,2.0,0,0,3,7,1900,0,2007,0,98178,47.489,-122.249,1960,3379,1401,1419,101.48439866707058,0.03409836065573771,Very Cheap
20150120T000000,519990.0,4,3.25,1690,1321,2.0,0,0,3,8,1320,370,2014,0,98052,47.678,-122.117,3080,4558,-369,1478,393.6336109008327,0.05835934426229508,Very Cheap
20140610T000000,533112.0,4,2.75,2790,8853,2.0,0,0,3,8,2790,0,2013,0,98045,47.4842,-121.772,2790,8092,6063,5302,60.21823110809895,0.06008026229508197,Very Cheap
20141028T000000,274900.0,3,2.0,1936,6612,2.0,0,0,3,7,1936,0,2014,0,98001,47.2602,-122.246,1620,21600,4676,19980,41.575922565033274,0.02621639344262295,Very Cheap
20141222T000000,325000.0,2,2.25,1150,711,2.0,0,0,3,7,1150,0,2013,0,98027,47.5323,-122.07,1150,748,-439,-402,457.1026722925457,0.03278688524590164,Very Cheap
20140529T000000,350000.0,4,2.5,2040,22653,2.0,0,0,3,7,2040,0,2011,0,98168,47.4991,-122.299,2020,20502,20613,18482,15.4504922085375,0.036065573770491806,Very Cheap
20140923T000000,550000.0,4,2.5,2470,7539,2.0,0,0,3,9,2470,0,2006,0,98028,47.7407,-122.226,2580,7539,5069,4959,72.95397267542114,0.06229508196721312,Very Cheap
20150309T000000,311850.0,4,2.5,1890,4158,2.0,0,0,3,8,1890,0,2014,0,98042,47.343,-122.056,2720,4549,2268,1829,75.0,0.031062295081967214,Very Cheap
20150210T000000,526000.0,3,2.5,1626,1583,2.5,0,0,3,8,1419,207,2007,0,98122,47.6031,-122.309,1400,1583,-43,183,332.2804801010739,0.059147540983606556,Very Cheap
20141001T000000,375000.0,4,2.5,2250,5306,2.0,0,0,3,8,2250,0,2012,0,98038,47.356,-122.057,2250,5306,3056,3056,70.6747078778741,0.03934426229508197,Very Cheap
20150223T000000,299999.0,3,2.25,1350,1234,2.0,0,0,3,7,1160,190,2007,0,98106,47.5565,-122.363,1420,1234,-116,-186,243.11102106969207,0.029508065573770493,Very Cheap
20140919T000000,436000.0,3,2.5,1460,1238,2.0,0,0,3,8,1200,260,2008,0,98107,47.6719,-122.374,1280,1257,-222,-23,352.18093699515344,0.047344262295081964,Very Cheap
20141212T000000,303000.0,3,2.5,2056,3564,2.0,0,0,3,7,2056,0,2014,0,98092,47.338,-122.181,2056,3577,1508,1521,85.01683501683502,0.029901639344262296,Very Cheap
20140701T000000,525000.0,2,2.5,1160,1458,2.0,0,0,3,8,1040,120,2012,0,98119,47.6384,-122.373,1650,2311,298,661,360.082304526749,0.05901639344262295,Very Cheap
20140613T000000,575000.0,3,3.0,1384,1287,2.0,0,0,3,8,1144,240,2006,0,98102,47.6295,-122.32,1570,1288,-97,-282,446.77544677544677,0.06557377049180328,Very Cheap
20141024T000000,420000.0,2,1.5,1100,1107,3.0,0,0,3,8,1100,0,2008,0,98103,47.6584,-122.35,1110,2750,7,1640,379.4037940379404,0.04524590163934426,Very Cheap
20140611T000000,329950.0,3,2.5,2456,7566,2.0,0,0,3,8,2456,0,2012,0,98023,47.297,-122.351,2478,7212,5110,4734,43.60956912503304,0.03343606557377049,Very Cheap
20141021T000000,1830000.0,4,4.25,4500,215186,2.0,0,3,3,11,2630,1870,2009,0,98029,47.559,-122.045,3030,25447,210686,22417,8.504270723931855,0.2301639344262295,Cheap
20150408T000000,1175000.0,4,3.25,3780,10099,1.0,0,1,3,11,2240,1540,2006,0,98006,47.5508,-122.192,3120,10669,6319,7549,116.34815328250322,0.14426229508196722,Cheap
20140911T000000,499950.0,2,2.5,1320,1157,2.0,0,0,3,8,990,330,2014,0,98107,47.6689,-122.363,1550,1519,-163,-31,432.1089023336214,0.05573114754098361,Very Cheap
20140527T000000,1149000.0,4,3.0,5940,11533,2.0,0,4,3,11,4950,990,2004,0,98065,47.5443,-121.87,4240,12813,5593,8573,99.62715685424435,0.14085245901639346,Cheap
20150218T000000,400000.0,3,2.0,1650,5027,1.5,0,0,3,7,1650,0,2009,0,98065,47.515,-121.874,2430,6000,3377,3570,79.57032027053909,0.04262295081967213,Very Cheap
20140627T000000,246950.0,3,3.0,1670,4440,1.0,0,0,3,7,1670,0,2014,0,98022,47.1948,-121.975,1670,4622,2770,2952,55.619369369369366,0.02255081967213115,Very Cheap
20140806T000000,630000.0,3,3.25,1610,1275,2.0,0,0,3,8,1220,390,2005,0,98102,47.6236,-122.318,1750,3000,-335,1250,494.11764705882354,0.07278688524590164,Very Cheap
20140912T000000,561000.0,5,2.75,3370,10315,2.0,0,0,3,9,3370,0,2006,0,98059,47.4893,-122.146,3010,8296,6945,5286,54.38681531749879,0.06373770491803278,Very Cheap
20141208T000000,287000.0,4,2.5,2660,4082,2.0,0,0,3,7,2660,0,2010,0,98042,47.3414,-122.055,2390,4876,1422,2486,70.30867221950024,0.02780327868852459,Very Cheap
20150331T000000,600000.0,3,3.25,1690,1473,2.0,0,0,3,8,1380,310,2008,0,98109,47.6397,-122.345,1670,2594,-217,924,407.33197556008145,0.06885245901639345,Very Cheap
20140828T000000,490000.0,3,2.25,1620,1062,3.0,0,0,3,8,1620,0,2014,0,98122,47.6051,-122.304,1560,1728,-558,168,461.39359698681733,0.05442622950819672,Very Cheap
20150330T000000,330000.0,3,1.75,1300,958,2.0,0,0,3,7,840,460,2011,0,98108,47.5677,-122.314,1340,1254,-342,-86,344.4676409185804,0.03344262295081967,Very Cheap
20141201T000000,286950.0,4,2.5,1610,4052,2.0,0,0,3,7,1610,0,2013,0,98042,47.3603,-122.081,2110,4034,2442,1924,70.81688055281343,0.02779672131147541,Very Cheap
20150423T000000,1550000.0,3,3.25,3530,4920,2.0,0,0,3,9,2660,870,2015,0,98109,47.641,-122.357,1900,4200,1390,2300,315.0406504065041,0.19344262295081968,Cheap
20150212T000000,880000.0,4,2.5,3550,8618,2.0,0,0,3,10,3550,0,2007,0,98052,47.6776,-122.161,1310,9746,5068,8436,102.1118588999768,0.10557377049180328,Cheap
20141013T000000,577450.0,3,3.0,1730,1755,3.0,0,0,3,8,1730,0,2014,0,98117,47.6944,-122.377,1830,1804,25,-26,329.03133903133903,0.06589508196721311,Very Cheap
20150430T000000,405000.0,5,2.75,2400,4900,2.0,0,0,3,8,2400,0,2011,0,98038,47.355,-122.057,2110,5696,2500,3586,82.65306122448979,0.043278688524590166,Very Cheap
20140707T000000,510000.0,3,2.5,1420,1237,3.0,0,0,3,8,1420,0,2014,0,98107,47.674,-122.387,1510,2501,-183,991,412.287793047696,0.057049180327868855,Very Cheap
20140812T000000,465000.0,2,1.5,1220,1120,2.5,0,0,3,8,1110,110,2008,0,98199,47.6374,-122.388,2010,3175,-100,1165,415.17857142857144,0.051147540983606556,Very Cheap
20140707T000000,1300000.0,4,2.25,2360,4000,2.0,0,0,3,9,2360,0,2013,0,98112,47.6198,-122.289,3040,4400,1640,1360,325.0,0.16065573770491803,Cheap
20150408T000000,609000.0,4,3.5,3990,11270,2.0,0,3,3,9,2930,1060,2007,0,98055,47.488,-122.225,1980,11328,7280,9348,54.037267080745345,0.0700327868852459,Very Cheap
20140911T000000,336000.0,3,2.5,1260,1211,3.0,0,0,3,8,1260,0,2004,0,98103,47.6969,-122.343,1270,1211,-49,-59,277.4566473988439,0.03422950819672131,Very Cheap
20150108T000000,375000.0,3,2.5,1580,2407,2.0,0,0,3,8,1580,0,2013,0,98126,47.5455,-122.368,1580,2212,827,632,155.7955961778147,0.03934426229508197,Very Cheap
20141204T000000,294500.0,3,2.5,1760,2688,2.0,0,0,3,7,1760,0,2005,0,98059,47.4903,-122.166,1760,2329,928,569,109.5610119047619,0.02878688524590164,Very Cheap
20141125T000000,925000.0,5,3.5,3420,4216,2.0,0,0,3,9,2520,900,2008,0,98115,47.6799,-122.304,1420,4500,796,3080,219.4022770398482,0.11147540983606558,Cheap
20141215T000000,730000.0,5,2.75,2870,6593,2.0,0,0,3,9,2870,0,2006,0,98052,47.7075,-122.102,3150,6593,3723,3443,110.7234946155013,0.0859016393442623,Very Cheap
20140919T000000,280000.0,4,2.5,1934,5677,2.0,0,0,3,8,1934,0,2013,0,98001,47.2602,-122.252,1919,5049,3743,3130,49.32182490752158,0.026885245901639345,Very Cheap
20140815T000000,500000.0,3,1.5,1220,962,3.0,0,0,3,8,1220,0,2014,0,98107,47.674,-122.387,1510,2501,-258,991,519.7505197505197,0.05573770491803279,Very Cheap
20150324T000000,605000.0,3,2.75,2450,5750,2.0,0,0,3,9,2450,0,2013,0,98065,47.5439,-121.862,3200,8036,3300,4836,105.21739130434783,0.06950819672131148,Very Cheap
20140516T000000,379950.0,3,3.25,1860,1787,3.0,0,0,3,8,1860,0,2007,0,98155,47.7563,-122.316,1830,1787,-73,-43,212.61891438164523,0.03999344262295082,Very Cheap
20150323T000000,605000.0,3,2.5,1500,1119,3.0,0,2,3,7,1110,390,2008,0,98109,47.6327,-122.346,1500,1057,-381,-443,540.6613047363718,0.06950819672131148,Very Cheap
20150501T000000,720000.0,2,1.75,1570,1108,3.0,0,0,3,9,1570,0,2007,0,98004,47.6215,-122.2,1940,1160,-462,-780,649.8194945848376,0.08459016393442623,Very Cheap
20141103T000000,549900.0,3,2.0,1280,960,2.0,0,0,3,9,1040,240,2014,0,98122,47.602,-122.311,1280,1173,-320,-107,572.8125,0.062281967213114756,Very Cheap
20150121T000000,427000.0,3,2.5,3192,5653,2.0,0,0,3,8,3192,0,2014,0,98023,47.2956,-122.35,3000,5134,2461,2134,75.53511409870865,0.04616393442622951,Very Cheap
20141028T000000,492000.0,3,2.5,1690,1479,3.0,0,0,3,8,1420,270,2005,0,98122,47.6022,-122.311,1280,1253,-211,-27,332.657200811359,0.054688524590163934,Very Cheap
20140505T000000,419190.0,2,2.5,1590,1426,2.0,0,0,3,8,1590,0,2014,0,98029,47.5441,-122.013,1590,1426,-164,-164,293.96213183730714,0.04513967213114754,Very Cheap
20141112T000000,650000.0,3,2.5,2870,7288,2.0,0,0,3,9,2870,0,2012,0,98011,47.7745,-122.225,2870,5998,4418,3128,89.18770581778266,0.07540983606557378,Very Cheap
20141124T000000,379950.0,4,2.5,2580,4818,2.0,0,0,3,8,2580,0,2005,0,98038,47.3607,-122.038,2570,5386,2238,2816,78.86052303860524,0.03999344262295082,Very Cheap
20140728T000000,269800.0,4,2.75,1830,3420,2.0,0,0,3,8,1830,0,2012,0,98198,47.366,-122.308,1813,3420,1590,1607,78.88888888888889,0.025547540983606558,Very Cheap
20140813T000000,407000.0,4,2.5,2927,6000,2.0,0,0,3,7,2927,0,2011,0,98042,47.3737,-122.16,2533,6000,3073,3467,67.83333333333333,0.04354098360655738,Very Cheap
20150415T000000,580000.0,3,1.5,1320,1250,3.0,0,0,3,8,1320,0,2008,0,98103,47.6536,-122.341,1560,1694,-70,134,464.0,0.06622950819672131,Very Cheap
20150116T000000,389700.0,3,2.5,1720,3581,2.0,0,0,3,7,1720,0,2011,0,98053,47.6861,-122.013,1720,3600,1861,1880,108.82435074001675,0.04127213114754098,Very Cheap
20150311T000000,110000.0,2,1.0,828,4524,1.0,0,0,3,6,828,0,1968,2007,98001,47.2655,-122.244,828,5402,3696,4574,24.31476569407604,0.0045901639344262295,Very Cheap
20140731T000000,230000.0,3,1.5,1040,1264,2.0,0,0,3,9,900,140,2015,0,98144,47.5951,-122.301,1350,3000,224,1650,181.9620253164557,0.020327868852459016,Very Cheap
20140829T000000,533380.0,4,2.75,2790,6685,2.0,0,0,3,8,2790,0,2014,0,98045,47.4838,-121.773,2790,6444,3895,3654,79.78758414360509,0.06011540983606557,Very Cheap
20140918T000000,295500.0,3,2.5,1410,1332,2.0,0,0,3,7,960,450,2014,0,98108,47.5683,-122.314,1410,1343,-78,-67,221.84684684684686,0.028918032786885244,Very Cheap
20141007T000000,860000.0,4,4.5,4040,8400,2.0,0,0,3,9,3220,820,2006,0,98052,47.7067,-122.131,3940,8400,4360,4460,102.38095238095238,0.10295081967213114,Cheap
20140708T000000,812000.0,4,3.5,3370,3634,2.0,0,0,3,9,2750,620,2007,0,98029,47.5519,-122.001,3200,3650,264,450,223.44523940561365,0.09665573770491803,Very Cheap
20140605T000000,324500.0,3,2.5,1660,3990,2.0,0,0,3,7,1660,0,2009,0,98118,47.5298,-122.268,1670,4050,2330,2380,81.32832080200501,0.03272131147540984,Very Cheap
20150326T000000,193000.0,2,1.75,910,2550,1.0,0,0,3,6,910,0,2004,0,98038,47.3494,-122.022,1310,2550,1640,1240,75.68627450980392,0.015475409836065573,Very Cheap
20140522T000000,355000.0,3,2.25,1280,959,3.0,0,0,3,8,1280,0,2005,0,98103,47.6914,-122.343,1130,1126,-321,-4,370.17726798748697,0.036721311475409836,Very Cheap
20140614T000000,525000.0,4,2.75,2360,4924,2.0,0,0,3,8,2360,0,2008,0,98028,47.7737,-122.235,2360,4670,2564,2310,106.62063363119415,0.05901639344262295,Very Cheap
20150227T000000,370950.0,3,2.5,2529,9653,2.0,0,0,3,7,2529,0,2012,0,98042,47.3738,-122.161,2533,6125,7124,3592,38.42846783383404,0.03881311475409836,Very Cheap
20141107T000000,1242000.0,4,3.5,4700,10183,1.0,0,2,3,11,2660,2040,2002,0,98033,47.6728,-122.189,3770,9000,5483,5230,121.96798585878425,0.15304918032786885,Cheap
20150504T000000,950000.0,3,2.5,2780,275033,1.0,0,0,3,10,2780,0,2006,0,98045,47.4496,-121.766,1680,16340,272253,14660,3.454130958830395,0.11475409836065574,Cheap
20140918T000000,888990.0,4,2.75,3540,5500,2.0,0,0,3,9,3540,0,2014,0,98074,47.6181,-122.056,3540,5500,1960,1960,161.63454545454545,0.1067527868852459,Cheap
20150319T000000,705000.0,3,2.5,1580,1321,2.0,0,2,3,8,1080,500,2014,0,98107,47.6688,-122.402,1530,1357,-259,-173,533.6866010598031,0.08262295081967214,Very Cheap
20140826T000000,268000.0,3,2.5,1700,2250,2.0,0,0,3,7,1700,0,2014,0,98168,47.4914,-122.334,1520,4500,550,2980,119.11111111111111,0.025311475409836064,Very Cheap
20140507T000000,305450.0,3,2.5,1600,3573,2.0,0,0,3,7,1600,0,2013,0,98056,47.507,-122.181,1500,11089,1973,9589,85.48838511055136,0.03022295081967213,Very Cheap
20140703T000000,399900.0,2,1.75,1410,1005,1.5,0,0,3,9,900,510,2011,0,98027,47.5446,-122.018,1440,1188,-405,-252,397.910447761194,0.042609836065573774,Very Cheap
20141229T000000,495000.0,3,1.5,1580,1228,3.0,0,0,3,8,1580,0,2014,0,98115,47.6765,-122.32,1580,3605,-352,2025,403.0944625407166,0.05508196721311476,Very Cheap
20141104T000000,857326.0,3,3.5,3940,11632,2.0,0,0,3,10,3940,0,2014,0,98166,47.438,-122.344,2015,11632,7692,9617,73.70409215955983,0.10260013114754099,Cheap
20140911T000000,845950.0,5,2.75,4450,9600,2.0,0,0,3,9,3650,800,2014,0,98011,47.7336,-122.21,4000,9750,5150,5750,88.11979166666667,0.10110819672131148,Cheap
20140610T000000,303210.0,4,2.5,2009,5000,2.0,0,0,3,8,2009,0,2014,0,98092,47.2577,-122.198,2009,5182,2991,3173,60.642,0.029929180327868853,Very Cheap
20141015T000000,343000.0,6,5.0,2732,7655,2.0,0,0,3,7,2732,0,2009,0,98002,47.3045,-122.211,3078,69993,4923,66915,44.80731548007838,0.035147540983606555,Very Cheap
20140716T000000,300000.0,3,2.5,2090,4590,2.0,0,0,3,7,2090,0,2005,0,98042,47.3992,-122.163,2190,4060,2500,1870,65.359477124183,0.029508196721311476,Very Cheap
20141122T000000,334900.0,2,2.5,980,1013,3.0,0,0,3,8,980,0,2008,0,98117,47.6844,-122.387,980,1023,33,43,330.6021717670286,0.03408524590163935,Very Cheap
20150416T000000,477500.0,5,3.5,2815,5619,2.0,0,0,3,9,2815,0,2012,0,98055,47.4299,-122.207,2583,5295,2804,2712,84.97953372486208,0.05278688524590164,Very Cheap
20140618T000000,820000.0,4,2.5,3170,8523,2.0,0,0,3,9,3170,0,2008,0,98033,47.6854,-122.184,3230,8523,5353,5293,96.21025460518597,0.09770491803278689,Very Cheap
20140805T000000,580000.0,5,3.25,3030,7410,2.0,0,0,3,8,2150,880,2014,0,98106,47.553,-122.354,2020,7410,4380,5390,78.27260458839406,0.06622950819672131,Very Cheap
20140722T000000,350000.0,2,2.5,1280,940,2.0,0,0,3,8,1060,220,2006,0,98103,47.6904,-122.364,1290,2900,-340,1610,372.3404255319149,0.036065573770491806,Very Cheap
20150226T000000,910000.0,3,2.5,2030,1160,3.0,0,0,3,9,1970,60,2007,0,98004,47.6213,-122.2,1950,1160,-870,-790,784.4827586206897,0.10950819672131147,Cheap
20140626T000000,414000.0,3,2.5,2490,4540,2.5,0,0,3,8,2490,0,2012,0,98059,47.5051,-122.155,2640,3844,2050,1204,91.18942731277534,0.04445901639344262,Very Cheap
20150330T000000,525000.0,3,2.5,3030,4500,2.0,0,0,3,8,3030,0,2009,0,98059,47.4944,-122.15,3030,4501,1470,1471,116.66666666666667,0.05901639344262295,Very Cheap
20150409T000000,650000.0,2,2.5,1470,690,3.0,0,3,3,8,1470,0,2008,0,98103,47.6523,-122.346,1480,1284,-780,-196,942.0289855072464,0.07540983606557378,Very Cheap
20141210T000000,450000.0,3,2.25,1620,997,2.5,0,0,3,8,1540,80,2012,0,98027,47.5394,-122.027,1620,1068,-623,-552,451.3540621865597,0.04918032786885246,Very Cheap
20140516T000000,1270000.0,4,3.0,5520,8313,2.0,0,3,3,9,3570,1950,2008,0,98006,47.5655,-122.129,3770,8278,2793,4508,152.77276554793696,0.15672131147540982,Cheap
20150412T000000,699000.0,3,3.5,3200,10344,2.0,0,0,3,10,3200,0,2007,0,98011,47.7636,-122.216,2550,20152,7144,17602,67.5754060324826,0.08183606557377049,Very Cheap
20140723T000000,899000.0,4,2.5,2580,3943,2.0,0,0,3,8,2580,0,2013,0,98033,47.6853,-122.21,1700,5772,1363,4072,227.99898554400204,0.10806557377049181,Cheap
20140808T000000,353500.0,4,3.0,2050,4000,2.0,0,0,3,8,2050,0,2014,0,98001,47.3523,-122.275,2050,4000,1950,1950,88.375,0.036524590163934424,Very Cheap
20140908T000000,485000.0,3,2.5,2430,5867,2.0,0,0,3,7,2430,0,2011,0,98065,47.5162,-121.872,2620,5866,3437,3246,82.66575762740753,0.05377049180327869,Very Cheap
20140626T000000,782900.0,4,3.25,3060,3898,2.0,0,0,3,10,2300,760,2014,0,98027,47.5311,-122.073,2920,3448,838,528,200.846587993843,0.09283934426229508,Very Cheap
20150428T000000,529000.0,2,2.0,1540,9714,2.0,0,0,3,8,1540,0,2008,0,98177,47.7628,-122.359,1840,8179,8174,6339,54.45748404364834,0.05954098360655738,Very Cheap
20150416T000000,514700.0,3,3.25,1310,1072,2.0,0,0,3,8,1060,250,2008,0,98107,47.6744,-122.374,1160,1266,-238,106,480.1305970149254,0.0576655737704918,Very Cheap
20140520T000000,409316.0,3,2.5,1800,3168,2.0,0,0,3,8,1800,0,2014,0,98065,47.5342,-121.841,1800,3393,1368,1593,129.20328282828282,0.04384472131147541,Very Cheap
20150506T000000,388598.0,3,2.5,2370,4200,2.0,0,0,3,8,2370,0,2014,0,98038,47.3699,-122.019,2370,4370,1830,2000,92.52333333333333,0.04112760655737705,Very Cheap
20150227T000000,415000.0,3,2.25,1445,1512,2.0,0,0,3,7,1300,145,2004,0,98027,47.5341,-122.069,1445,1082,67,-363,274.4708994708995,0.04459016393442623,Very Cheap
20150407T000000,521500.0,3,2.25,1450,1619,2.0,0,0,3,8,1140,310,2006,0,98122,47.6076,-122.304,1580,3472,169,1892,322.1124150710315,0.05855737704918033,Very Cheap
20140820T000000,580000.0,3,2.5,1740,1236,3.0,0,2,3,8,1740,0,2008,0,98116,47.5891,-122.387,1740,1280,-504,-460,469.2556634304207,0.06622950819672131,Very Cheap
20140630T000000,882566.0,4,2.5,3560,5265,3.0,0,0,3,8,3560,0,2014,0,98052,47.7047,-122.113,3220,4892,1705,1672,167.62886989553655,0.10591029508196721,Cheap
20150408T000000,525000.0,3,2.75,2130,1400,2.0,0,0,3,9,1080,1050,2010,0,98118,47.5661,-122.29,1880,3132,-730,1252,375.0,0.05901639344262295,Very Cheap
20141201T000000,515000.0,5,2.75,2980,4502,2.0,0,0,3,9,2980,0,2007,0,98028,47.7698,-122.235,2850,4501,1522,1651,114.39360284318082,0.057704918032786885,Very Cheap
20140926T000000,589410.0,3,3.0,2840,7201,2.0,0,0,3,9,2840,0,2014,0,98065,47.5165,-121.883,2540,5260,4361,2720,81.85113178725177,0.06746360655737704,Very Cheap
20150324T000000,757500.0,4,2.5,3420,6845,2.0,0,0,3,9,3420,0,2009,0,98052,47.6777,-122.156,2800,5715,3425,2915,110.66471877282689,0.08950819672131148,Very Cheap
20141002T000000,284000.0,3,2.5,1660,4083,2.0,0,0,3,7,1660,0,2013,0,98038,47.3595,-122.045,1800,4087,2423,2287,69.55669850600049,0.027409836065573772,Very Cheap
20150328T000000,338500.0,2,2.25,1150,711,2.0,0,0,3,7,1150,0,2013,0,98027,47.5323,-122.071,1150,748,-439,-402,476.0900140646976,0.03455737704918033,Very Cheap
20140613T000000,379500.0,3,2.25,1410,1287,2.0,0,0,3,7,1290,120,2005,0,98027,47.5344,-122.068,1490,1435,-123,-55,294.87179487179486,0.0399344262295082,Very Cheap
20140723T000000,550000.0,3,2.0,1420,1369,2.5,0,0,3,9,1340,80,2007,0,98109,47.6472,-122.357,1540,2168,-51,628,401.75310445580715,0.06229508196721312,Very Cheap
20140902T000000,294900.0,3,2.5,1860,5025,2.0,0,0,3,8,1860,0,2010,0,98038,47.3557,-122.059,2000,5550,3165,3550,58.6865671641791,0.02883934426229508,Very Cheap
20140609T000000,345000.0,2,1.5,1340,1210,2.0,0,0,3,8,1120,220,2008,0,98144,47.588,-122.305,1340,1213,-130,-127,285.12396694214874,0.03540983606557377,Very Cheap
20150209T000000,450000.0,2,1.5,1530,1012,2.0,0,0,3,8,1200,330,2005,0,98122,47.602,-122.306,1530,1425,-518,-105,444.6640316205534,0.04918032786885246,Very Cheap
20150415T000000,420000.0,3,2.5,1509,1114,3.0,0,0,3,8,1509,0,2014,0,98133,47.7049,-122.34,1509,2431,-395,922,377.01974865350087,0.04524590163934426,Very Cheap
20150402T000000,740000.0,3,2.5,2350,3798,2.0,0,0,3,8,2350,0,2013,0,98029,47.543,-122.01,2020,3532,1448,1512,194.83938915218536,0.08721311475409836,Very Cheap
20150220T000000,286000.0,2,1.5,1010,825,3.0,0,0,3,7,1010,0,2007,0,98125,47.7124,-122.301,1128,1080,-185,-48,346.6666666666667,0.027672131147540982,Very Cheap
20150317T000000,870000.0,5,3.5,4495,10079,2.0,0,0,3,9,3580,915,2013,0,98011,47.7339,-122.209,4495,10079,5584,5584,86.31808711181665,0.10426229508196722,Cheap
20141114T000000,727000.0,3,2.5,1580,991,3.0,0,0,3,9,1580,0,2009,0,98119,47.6276,-122.359,1610,1297,-589,-313,733.6024217961655,0.08550819672131148,Very Cheap
20150204T000000,395000.0,4,3.0,2750,7965,2.0,0,0,3,9,2750,0,2012,0,98038,47.3479,-122.028,2750,6000,5215,3250,49.59196484620213,0.0419672131147541,Very Cheap
20140805T000000,535000.0,4,2.25,1890,3615,2.0,0,0,3,7,1890,0,2005,0,98029,47.5493,-121.999,1630,3280,1725,1650,147.99446749654217,0.06032786885245902,Very Cheap
20141229T000000,255000.0,3,2.25,1320,963,2.0,0,0,3,7,1040,280,2007,0,98106,47.5199,-122.357,1300,1285,-357,-15,264.79750778816197,0.02360655737704918,Very Cheap
20141015T000000,260000.0,4,2.5,2150,3721,2.0,0,0,3,8,2150,0,2006,0,98002,47.3363,-122.217,2150,3721,1571,1571,69.87368986831497,0.024262295081967214,Very Cheap
20140910T000000,810000.0,4,2.5,3340,8384,2.0,0,0,3,9,3340,0,2014,0,98052,47.6761,-122.152,1560,9429,5044,7869,96.61259541984732,0.09639344262295083,Very Cheap
20141201T000000,359782.0,3,2.5,1850,3400,2.0,0,0,3,7,1850,0,2010,0,98053,47.6871,-122.014,1850,3400,1550,1550,105.81823529411764,0.03734845901639344,Very Cheap
20150320T000000,500000.0,2,2.5,1950,2162,2.0,0,0,3,9,1500,450,2012,0,98118,47.5622,-122.292,1800,2457,212,657,231.26734505087882,0.05573770491803279,Very Cheap
20141027T000000,1049990.0,5,3.25,4240,9588,2.0,0,0,3,9,4240,0,2014,0,98053,47.6901,-122.018,4080,8425,5348,4345,109.51084689194826,0.12786754098360656,Cheap
20150225T000000,810000.0,4,3.5,2700,2868,2.0,0,0,3,11,1920,780,2006,0,98118,47.5685,-122.286,1430,3858,168,2428,282.4267782426778,0.09639344262295083,Very Cheap
20150206T000000,605000.0,5,4.0,3040,6000,2.0,0,0,3,8,2280,760,2011,0,98065,47.5189,-121.876,3070,5558,2960,2488,100.83333333333333,0.06950819672131148,Very Cheap
20150317T000000,730000.0,4,2.5,2460,7930,2.0,0,0,3,8,2460,0,2005,0,98033,47.6684,-122.175,1850,9000,5470,7150,92.05548549810845,0.0859016393442623,Very Cheap
20150317T000000,327000.0,4,2.5,2110,3825,2.0,0,0,3,7,2110,0,2013,0,98042,47.359,-122.082,1950,3825,1715,1875,85.49019607843137,0.033049180327868855,Very Cheap
20141110T000000,370000.0,2,1.0,780,1133,2.0,0,0,3,7,780,0,2009,0,98144,47.5924,-122.295,1130,1270,353,140,326.5666372462489,0.038688524590163934,Very Cheap
20140625T000000,459000.0,5,3.5,2640,6895,2.0,0,0,3,7,2640,0,2001,0,98065,47.5298,-121.879,2640,5267,4255,2627,66.56997824510515,0.050360655737704915,Very Cheap
20141113T000000,2900000.0,5,4.0,5190,14600,2.0,0,1,3,11,5190,0,2013,0,98039,47.6102,-122.225,3840,19250,9410,15410,198.63013698630138,0.3704918032786885,Medium
20141210T000000,365000.0,4,2.5,2420,8404,2.0,0,0,3,8,2420,0,2013,0,98042,47.372,-122.13,2440,4822,5984,2382,43.431699190861494,0.0380327868852459,Very Cheap
20141226T000000,255000.0,4,2.5,1987,6000,2.0,0,0,3,7,1987,0,2011,0,98001,47.2679,-122.255,1880,9589,4013,7709,42.5,0.02360655737704918,Very Cheap
20140717T000000,375000.0,1,1.0,720,3166,1.0,0,0,3,6,720,0,1920,0,98116,47.5811,-122.389,1140,6250,2446,5110,118.4459886291851,0.03934426229508197,Very Cheap
20141002T000000,375000.0,2,1.5,1130,912,2.0,0,0,3,8,1000,130,2006,0,98116,47.5638,-122.388,1500,1474,-218,-26,411.1842105263158,0.03934426229508197,Very Cheap
20140722T000000,518380.0,4,2.5,2810,4500,2.0,0,0,3,9,2810,0,2014,0,98038,47.3552,-122.023,2980,5046,1690,2066,115.19555555555556,0.058148196721311475,Very Cheap
20140721T000000,346000.0,3,3.25,1500,1442,2.0,0,0,3,8,1150,350,2007,0,98106,47.5592,-122.362,1500,1533,-58,33,239.94452149791957,0.03554098360655738,Very Cheap
20150223T000000,302059.0,4,2.0,1390,745,3.0,0,0,3,7,1390,0,2008,0,98027,47.5393,-122.026,1390,942,-645,-448,405.448322147651,0.02977822950819672,Very Cheap
20140519T000000,575000.0,4,2.5,2500,4945,2.0,0,0,3,9,2500,0,2013,0,98065,47.5185,-121.885,2760,6000,2445,3240,116.27906976744185,0.06557377049180328,Very Cheap
20140723T000000,549950.0,4,3.5,3906,9674,2.0,0,2,3,9,3906,0,2014,0,98001,47.2931,-122.264,2673,6500,5768,3827,56.84825304941079,0.062288524590163936,Very Cheap
20150219T000000,900000.0,5,6.0,7120,40806,2.0,0,4,3,12,5480,1640,2007,0,98006,47.5451,-122.114,3440,36859,33686,33419,22.055580061755624,0.10819672131147541,Cheap
20140711T000000,397500.0,3,2.5,1470,1256,2.0,0,0,3,8,930,540,2006,0,98122,47.6033,-122.309,1510,1797,-214,287,316.4808917197452,0.04229508196721311,Very Cheap
20141121T000000,1075000.0,5,3.5,3230,7560,2.0,0,0,3,10,3230,0,2007,0,98052,47.6467,-122.118,3230,8580,4330,5350,142.1957671957672,0.13114754098360656,Cheap
20150422T000000,775900.0,3,2.5,2700,5764,2.0,0,0,3,9,2700,0,2014,0,98075,47.5618,-122.027,3270,14700,3064,11430,134.6113809854268,0.09192131147540984,Very Cheap
20150508T000000,510000.0,4,2.5,4073,17334,2.0,0,0,3,8,4073,0,2008,0,98001,47.2949,-122.27,1780,9625,13261,7845,29.421945309795777,0.057049180327868855,Very Cheap
20140829T000000,471275.0,4,2.5,3361,5038,2.0,0,0,3,9,3361,0,2014,0,98092,47.3269,-122.165,2316,4105,1677,1789,93.54406510520047,0.05197049180327869,Very Cheap
20140911T000000,288000.0,4,2.25,1610,3560,2.0,0,0,3,7,1610,0,2010,0,98038,47.3669,-122.02,1760,3692,1950,1932,80.89887640449439,0.027934426229508195,Very Cheap
20141016T000000,989990.0,4,3.5,3830,7150,2.0,0,0,3,9,3830,0,2014,0,98052,47.7049,-122.126,3640,6055,3320,2415,138.46013986013986,0.11999868852459017,Cheap
20140612T000000,300000.0,3,3.25,1470,1235,2.0,0,0,3,7,1180,290,2008,0,98108,47.5537,-122.313,1470,1243,-235,-227,242.914979757085,0.029508196721311476,Very Cheap
20140623T000000,664950.0,5,3.0,3190,7081,1.0,0,2,3,9,1890,1300,2013,0,98178,47.509,-122.24,2270,7623,3891,5353,93.90622793390764,0.0773704918032787,Very Cheap
20140716T000000,699188.0,4,3.25,3250,5478,2.0,0,0,3,9,3250,0,2014,0,98065,47.5178,-121.887,3250,5482,2228,2232,127.63563344286236,0.08186072131147541,Very Cheap
20150303T000000,390000.0,3,2.25,1490,4539,2.0,0,0,3,7,1490,0,2009,0,98028,47.7607,-122.233,1750,4667,3049,2917,85.92200925313946,0.04131147540983607,Very Cheap
20150321T000000,670000.0,5,2.75,2900,5155,2.0,0,0,3,8,2900,0,2008,0,98075,47.5977,-122.008,2900,6176,2255,3276,129.9709020368574,0.0780327868852459,Very Cheap
20140709T000000,487000.0,4,2.5,2540,5001,2.0,0,0,3,9,2540,0,2005,0,98108,47.5423,-122.302,2360,6834,2461,4474,97.38052389522096,0.054032786885245904,Very Cheap
20140723T000000,769995.0,5,2.75,3360,12080,2.0,0,0,3,9,3360,0,2014,0,98011,47.7757,-122.173,3360,9724,8720,6364,63.74130794701987,0.09114688524590164,Very Cheap
20140508T000000,321950.0,2,1.25,860,1277,2.0,0,0,3,7,860,0,2007,0,98144,47.5842,-122.314,1280,1265,417,-15,252.11433046202035,0.03238688524590164,Very Cheap
20150427T000000,613500.0,4,2.5,3020,6068,2.0,0,0,3,9,3020,0,2006,0,98072,47.773,-122.16,3240,5757,3048,2517,101.10415293342123,0.07062295081967213,Very Cheap
20140806T000000,300000.0,3,2.5,1330,1200,3.0,0,0,3,7,1330,0,2002,0,98133,47.7034,-122.344,1330,1206,-130,-124,250.0,0.029508196721311476,Very Cheap
20141125T000000,400950.0,4,2.5,2578,4554,2.0,0,0,3,9,2578,0,2014,0,98092,47.2603,-122.194,2647,4554,1976,1907,88.04347826086956,0.04274754098360656,Very Cheap
20140918T000000,389517.0,4,2.5,2640,4725,2.0,0,0,3,8,2640,0,2014,0,98038,47.371,-122.017,2370,4725,2085,2355,82.43746031746032,0.04124813114754099,Very Cheap
20140821T000000,255000.0,3,1.75,1260,1133,2.0,0,0,3,7,810,450,2011,0,98106,47.5261,-122.361,1260,1172,-127,-88,225.06619593998235,0.02360655737704918,Very Cheap
20150220T000000,1080000.0,3,2.5,1990,1891,3.0,0,0,3,9,1990,0,2012,0,98102,47.6271,-122.324,1990,3600,-99,1610,571.1263881544156,0.1318032786885246,Cheap
20141121T000000,637850.0,5,3.25,3340,4900,2.0,0,2,3,9,2500,840,2014,0,98065,47.5193,-121.877,3220,5200,1560,1980,130.1734693877551,0.07381639344262295,Very Cheap
20140828T000000,636230.0,4,2.5,2840,6284,2.0,0,0,3,9,2840,0,2013,0,98056,47.5135,-122.169,2790,7168,3444,4378,101.24602164226607,0.0736039344262295,Very Cheap
20141216T000000,375000.0,3,2.5,1530,1131,3.0,0,0,3,8,1530,0,2009,0,98103,47.6993,-122.346,1530,1445,-399,-85,331.56498673740055,0.03934426229508197,Very Cheap
20140604T000000,586500.0,3,2.5,1780,1487,3.0,0,0,3,8,1600,180,2006,0,98107,47.6539,-122.351,1780,1300,-293,-480,394.41829186281103,0.06708196721311475,Very Cheap
20150120T000000,544000.0,4,2.5,2340,6973,2.0,0,0,3,8,1930,410,2005,0,98065,47.5451,-121.882,2950,6908,4633,3958,78.01520149146708,0.06150819672131148,Very Cheap
20140806T000000,425000.0,4,2.5,2390,5021,2.0,0,0,3,7,2390,0,2002,0,98065,47.5353,-121.879,2520,5333,2631,2813,84.6444931288588,0.04590163934426229,Very Cheap
20150311T000000,374950.0,4,2.5,2090,3777,2.0,0,0,3,8,2090,0,2012,0,98038,47.3595,-122.042,2160,3993,1687,1833,99.27190892242521,0.03933770491803279,Very Cheap
20150312T000000,294570.0,3,1.0,1140,8400,1.0,0,0,4,7,1140,0,1960,0,98059,47.5022,-122.144,1400,9000,7260,7600,35.06785714285714,0.028796065573770492,Very Cheap
20141013T000000,300000.0,3,2.5,1960,1477,2.0,0,0,3,7,1670,290,2012,0,98059,47.4873,-122.166,1980,1467,-483,-513,203.1144211238998,0.029508196721311476,Very Cheap
20140910T000000,395950.0,5,3.5,2738,6031,2.0,0,0,3,8,2738,0,2014,0,98023,47.2962,-122.35,2738,5201,3293,2463,65.65246227822915,0.04209180327868853,Very Cheap
20140718T000000,800000.0,4,2.5,3691,11088,2.0,0,1,3,8,3691,0,2013,0,98074,47.6122,-122.059,3190,11270,7397,8080,72.15007215007215,0.09508196721311475,Very Cheap
20140730T000000,439990.0,3,2.5,2340,5171,2.0,0,0,3,8,2340,0,2013,0,98045,47.4832,-121.772,2790,5684,2831,2894,85.08799071746277,0.04786754098360656,Very Cheap
20141106T000000,680000.0,4,3.5,2510,3763,2.0,0,0,3,8,1990,520,2013,0,98052,47.7002,-122.103,2560,3820,1253,1260,180.70688280627158,0.07934426229508197,Very Cheap
20150318T000000,677790.0,6,3.0,2800,4213,2.0,0,0,3,8,2800,0,1998,0,98117,47.6892,-122.389,1440,3960,1413,2520,160.88060764300974,0.0790544262295082,Very Cheap
20150501T000000,424950.0,3,2.5,1650,4777,2.0,0,0,3,8,1650,0,2013,0,98065,47.5336,-121.841,1800,3331,3127,1531,88.95750471006909,0.04589508196721311,Very Cheap
20150331T000000,223990.0,2,2.25,1061,2884,2.0,0,0,3,7,1061,0,2013,0,98002,47.346,-122.218,1481,2887,1823,1406,77.66643550624133,0.01953967213114754,Very Cheap
20150513T000000,498000.0,4,2.5,3402,14355,2.0,0,0,3,10,2846,556,2014,0,98023,47.3009,-122.385,3402,8487,10953,5085,34.69174503657262,0.055475409836065574,Very Cheap
20141031T000000,359950.0,4,2.5,2542,6120,2.0,0,0,3,8,2542,0,2014,0,98030,47.3751,-122.188,2419,8984,3578,6565,58.81535947712418,0.037370491803278685,Very Cheap
20140515T000000,720000.0,3,2.5,3150,151588,2.0,0,0,3,9,3150,0,2007,0,98024,47.572,-121.926,2410,208652,148438,206242,4.7497163363854655,0.08459016393442623,Very Cheap
20141112T000000,530000.0,4,2.5,3010,9000,2.0,0,0,3,8,3010,0,2008,0,98059,47.4987,-122.147,3250,5531,5990,2281,58.888888888888886,0.05967213114754098,Very Cheap
20141007T000000,295000.0,3,2.5,1660,4898,2.0,0,0,3,7,1660,0,2011,0,98038,47.3588,-122.044,1810,4462,3238,2652,60.22866476112699,0.028852459016393443,Very Cheap
20141021T000000,255500.0,3,2.5,1770,5000,2.0,0,0,3,7,1770,0,2009,0,98042,47.3358,-122.051,2230,5200,3230,2970,51.1,0.023672131147540982,Very Cheap
20140521T000000,556000.0,3,3.0,1960,1168,2.0,0,0,3,9,1600,360,2007,0,98027,47.5445,-122.014,2080,1423,-792,-657,476.027397260274,0.06308196721311475,Very Cheap
20140710T000000,277950.0,4,2.5,1889,6000,2.0,0,0,3,7,1889,0,2012,0,98001,47.2676,-122.256,1990,6350,4111,4360,46.325,0.02661639344262295,Very Cheap
20150408T000000,431000.0,4,2.5,3040,6000,2.0,0,0,3,9,3040,0,2007,0,98038,47.3473,-122.03,2640,6000,2960,3360,71.83333333333333,0.046688524590163934,Very Cheap
20141117T000000,780000.0,4,2.75,3420,6787,2.0,0,0,3,9,3420,0,2010,0,98053,47.6962,-122.023,3450,6137,3367,2687,114.92559304552822,0.09245901639344262,Very Cheap
20141014T000000,649000.0,3,3.25,1720,936,2.0,0,0,3,8,1030,690,2004,0,98112,47.6201,-122.309,1720,1527,-784,-193,693.3760683760684,0.07527868852459016,Very Cheap
20140714T000000,447000.0,3,2.5,1740,3043,2.0,0,0,3,7,1740,0,2012,0,98011,47.744,-122.181,1920,2869,1303,949,146.89451199474203,0.04878688524590164,Very Cheap
20140505T000000,712198.0,4,2.5,2450,4247,2.0,0,0,3,8,2450,0,2013,0,98052,47.7048,-122.113,2970,4685,1797,1715,167.69437249823406,0.08356695081967214,Very Cheap
20140815T000000,277140.0,3,1.5,1190,785,2.0,0,0,3,8,920,270,2014,0,98052,47.6781,-122.117,2820,5626,-405,2806,353.04458598726114,0.02651016393442623,Very Cheap
20140528T000000,363000.0,4,2.5,3753,7204,2.0,0,0,3,10,3336,417,2008,0,98023,47.3011,-122.385,3494,9375,3451,5881,50.388672959466966,0.03777049180327869,Very Cheap
20150202T000000,598992.0,5,3.5,3440,6037,2.0,0,0,3,9,3440,0,2014,0,98045,47.4765,-121.734,3270,6037,2597,2767,99.22014245486169,0.06872026229508196,Very Cheap
20141211T000000,585000.0,3,2.5,2160,1250,3.0,0,0,3,8,1830,330,2010,0,98119,47.6515,-122.375,1870,2825,-910,955,468.0,0.06688524590163934,Very Cheap
20140731T000000,1274950.0,4,2.75,3820,8850,2.0,0,0,3,10,3820,0,2014,0,98033,47.6506,-122.195,2330,12000,5030,9670,144.06214689265536,0.1573704918032787,Cheap
20150212T000000,380950.0,2,2.0,1120,1039,2.0,0,0,3,7,840,280,2007,0,98144,47.5788,-122.315,1130,5400,-81,4270,366.65062560153996,0.04012459016393442,Very Cheap
20140708T000000,333490.0,4,2.5,2250,3916,2.0,0,0,3,8,2250,0,2014,0,98003,47.3413,-122.18,2156,3920,1666,1764,85.1608784473953,0.033900327868852456,Very Cheap
20140604T000000,520000.0,3,3.25,1540,1487,2.0,0,0,3,8,1540,0,2011,0,98027,47.5397,-122.027,1620,1104,-53,-516,349.6973772696705,0.058360655737704915,Very Cheap
20141007T000000,315000.0,2,2.25,1240,705,2.0,0,0,3,7,1150,90,2009,0,98027,47.5321,-122.073,1240,750,-535,-490,446.8085106382979,0.031475409836065574,Very Cheap
20150331T000000,487000.0,2,1.5,1160,1118,2.0,0,0,3,8,1020,140,2007,0,98117,47.6754,-122.375,1210,1118,-42,-92,435.59928443649375,0.054032786885245904,Very Cheap
20140808T000000,424950.0,5,3.5,2760,3865,2.5,0,0,3,8,2760,0,2013,0,98056,47.5049,-122.17,2590,4587,1105,1997,109.94825355756792,0.04589508196721311,Very Cheap
20150210T000000,542300.0,3,2.25,1580,1487,3.0,0,0,3,9,1580,0,2013,0,98199,47.6514,-122.386,1600,1525,-93,-75,364.69401479488903,0.06128524590163934,Very Cheap
20141211T000000,320000.0,3,3.25,1480,1192,2.0,0,0,3,8,1180,300,2013,0,98106,47.5556,-122.363,1330,1094,-288,-236,268.4563758389262,0.032131147540983604,Very Cheap
20140723T000000,1139990.0,4,3.25,3740,11467,2.0,0,0,3,10,3740,0,2014,0,98029,47.581,-122.022,2510,27520,7727,25010,99.41484259178512,0.13967081967213116,Cheap
20141215T000000,425000.0,4,2.5,1950,5000,2.0,0,0,3,8,1950,0,2012,0,98065,47.515,-121.872,2710,5000,3050,2290,85.0,0.04590163934426229,Very Cheap
20141031T000000,474950.0,3,3.0,1530,1568,3.0,0,0,3,8,1530,0,2012,0,98117,47.6998,-122.367,1460,1224,38,-236,302.9017857142857,0.05245245901639344,Very Cheap
20140804T000000,307635.0,3,2.5,1820,4200,2.0,0,0,3,8,1820,0,2014,0,98038,47.3693,-122.017,2370,4200,2380,1830,73.24642857142857,0.03050950819672131,Very Cheap
20141210T000000,834538.0,3,2.5,2760,6187,2.0,0,0,3,10,2760,0,2014,0,98075,47.5821,-122.047,2760,6600,3427,3840,134.88572813964765,0.09961154098360656,Very Cheap
20140723T000000,769995.0,5,2.75,3010,5398,2.0,0,0,3,9,3010,0,2014,0,98074,47.6067,-122.053,3360,5407,2388,2047,142.64449796220822,0.09114688524590164,Very Cheap
20150424T000000,820875.0,5,3.25,3860,9387,2.0,0,2,3,9,3860,0,2006,0,98065,47.538,-121.858,3860,8979,5527,5119,87.44806647491211,0.09781967213114755,Very Cheap
20150316T000000,595500.0,4,2.5,2490,6537,2.0,0,0,3,8,2490,0,2013,0,98065,47.5185,-121.884,2520,5848,4047,3328,91.09683340982102,0.06826229508196721,Very Cheap
20140912T000000,450000.0,4,2.5,3236,9608,2.0,0,0,3,10,3236,0,2005,0,98030,47.3838,-122.195,3236,9660,6372,6424,46.83597002497918,0.04918032786885246,Very Cheap
20150421T000000,695000.0,4,2.5,2830,14538,2.0,0,0,3,8,2830,0,2003,0,98065,47.5405,-121.882,2270,6939,11708,4669,47.80575044710414,0.08131147540983606,Very Cheap
20150323T000000,300000.0,3,2.0,1451,7159,1.0,0,0,3,7,1451,0,2010,0,98042,47.3754,-122.163,2303,6126,5708,3823,41.90529403547981,0.029508196721311476,Very Cheap
20140623T000000,515000.0,5,3.25,2910,5027,2.0,0,0,3,8,2040,870,2013,0,98106,47.5543,-122.359,2910,5027,2117,2117,102.44678734831908,0.057704918032786885,Very Cheap
20140903T000000,545000.0,3,2.5,1280,1845,3.0,0,0,3,8,1280,0,2009,0,98105,47.662,-122.324,1450,1889,565,439,295.3929539295393,0.06163934426229508,Very Cheap
20150218T000000,365000.0,3,2.25,1110,979,2.0,0,0,3,7,960,150,2008,0,98144,47.5999,-122.3,1170,1400,-131,230,372.829417773238,0.0380327868852459,Very Cheap
20140714T000000,718500.0,4,2.75,2840,8800,2.0,0,0,3,9,2840,0,2008,0,98033,47.7029,-122.171,1840,7700,5960,5860,81.64772727272727,0.08439344262295082,Very Cheap
20150401T000000,279800.0,3,1.75,1410,2052,2.0,0,0,3,8,1410,0,2014,0,98106,47.5171,-122.347,1410,1988,642,578,136.35477582846005,0.02685901639344262,Very Cheap
20140925T000000,486940.0,4,2.5,3250,13360,2.0,0,0,3,9,3250,0,2014,0,98030,47.3524,-122.198,2612,14448,10110,11836,36.44760479041916,0.05402491803278688,Very Cheap
20140626T000000,525000.0,4,2.75,3030,6625,2.0,0,0,3,8,3030,0,2011,0,98059,47.4815,-122.152,3030,9620,3595,6590,79.24528301886792,0.05901639344262295,Very Cheap
20140725T000000,345000.0,4,2.5,1983,6002,2.0,0,0,3,9,1983,0,2012,0,98092,47.3281,-122.164,2502,4750,4019,2248,57.4808397200933,0.03540983606557377,Very Cheap
20141030T000000,613000.0,3,3.25,2440,2812,2.0,0,0,3,8,1710,730,2005,0,98027,47.5362,-122.072,2440,2836,372,396,217.99431009957326,0.07055737704918033,Very Cheap
20140825T000000,370000.0,3,2.5,2313,5700,2.0,0,0,3,9,2313,0,2011,0,98030,47.3572,-122.202,2323,5701,3387,3378,64.91228070175438,0.038688524590163934,Very Cheap
20141002T000000,449500.0,3,2.25,1260,2556,2.0,0,0,3,7,1260,0,2005,0,98029,47.5482,-121.998,1630,2844,1296,1214,175.86071987480437,0.049114754098360656,Very Cheap
20150416T000000,515000.0,3,2.5,2000,3837,2.0,0,0,3,8,2000,0,2011,0,98072,47.7713,-122.167,2210,4075,1837,1865,134.2194422726088,0.057704918032786885,Very Cheap
20150504T000000,346100.0,2,1.75,1150,698,2.0,0,0,3,7,1150,0,2013,0,98027,47.5323,-122.071,1150,757,-452,-393,495.8452722063037,0.03555409836065574,Very Cheap
20141209T000000,398500.0,4,2.5,2820,6666,2.0,0,0,3,9,2820,0,2007,0,98038,47.3473,-122.031,1880,7200,3846,5320,59.78097809780978,0.042426229508196724,Very Cheap
20140820T000000,310000.0,2,1.75,1160,2500,2.0,0,0,3,7,1160,0,2008,0,98014,47.6489,-121.911,970,7500,1340,6530,124.0,0.03081967213114754,Very Cheap
20150226T000000,250000.0,3,2.25,1481,2820,2.0,0,0,3,7,1481,0,2012,0,98002,47.3457,-122.217,1481,2889,1339,1408,88.65248226950355,0.022950819672131147,Very Cheap
20140806T000000,1880000.0,5,3.5,4390,6220,2.0,0,3,3,9,3170,1220,2013,0,98115,47.6789,-122.273,2740,6448,1830,3708,302.2508038585209,0.23672131147540984,Cheap
20140827T000000,695000.0,2,1.75,1570,1207,3.0,0,0,3,9,1570,0,2007,0,98004,47.6215,-122.201,1570,1206,-363,-364,575.807787903894,0.08131147540983606,Very Cheap
20140827T000000,1085000.0,4,3.0,3410,6541,2.0,0,2,3,9,2680,730,2007,0,98126,47.5416,-122.38,2300,6345,3131,4045,165.87677725118485,0.13245901639344262,Cheap
20140804T000000,864327.0,5,3.25,3480,6507,2.0,0,0,3,9,3480,0,2014,0,98074,47.607,-122.053,3360,5398,3027,2038,132.83033656062702,0.10351829508196721,Cheap
20140616T000000,749995.0,4,3.25,3430,9870,2.0,0,0,3,9,3430,0,2014,0,98011,47.776,-122.173,3360,9724,6440,6364,75.98733535967578,0.08852393442622951,Very Cheap
20140610T000000,525000.0,5,2.75,2880,8364,2.0,0,0,3,9,2880,0,2006,0,98059,47.4893,-122.147,3010,8296,5484,5286,62.769010043041604,0.05901639344262295,Very Cheap
20141121T000000,659950.0,3,2.5,2990,9413,2.0,0,0,3,10,2990,0,2006,0,98028,47.7341,-122.234,1940,9600,6423,7660,70.11048549877829,0.07671475409836065,Very Cheap
20140506T000000,1800000.0,5,5.0,4490,10279,2.0,0,0,3,10,3930,560,2013,0,98004,47.5974,-122.202,2490,10279,5789,7789,175.1143107306158,0.2262295081967213,Cheap
20141029T000000,950000.0,5,4.0,4100,8120,2.0,0,0,3,9,4100,0,2011,0,98053,47.6917,-122.02,4100,7625,4020,3525,116.99507389162562,0.11475409836065574,Cheap
20140618T000000,1399950.0,4,2.75,3870,10046,2.0,0,0,3,11,3870,0,2005,0,98033,47.6651,-122.191,3560,10046,6176,6486,139.35397173004182,0.1737639344262295,Cheap
20140702T000000,265050.0,2,1.5,800,2119,2.0,0,0,3,7,800,0,2008,0,98106,47.554,-122.362,1020,4800,1319,3780,125.08258612553091,0.024924590163934425,Very Cheap
20150306T000000,450000.0,3,2.25,1620,1057,3.0,0,0,3,8,1540,80,2009,0,98027,47.5396,-122.026,1390,942,-563,-448,425.73320719016084,0.04918032786885246,Very Cheap
20150505T000000,915000.0,4,2.5,2910,4356,3.0,0,0,3,8,2910,0,2010,0,98034,47.6705,-122.146,2840,4181,1446,1341,210.05509641873277,0.11016393442622952,Cheap
20140630T000000,963000.0,4,3.25,3530,8589,2.0,0,0,3,10,3530,0,2007,0,98033,47.6975,-122.195,2470,9019,5059,6549,112.12015368494586,0.11645901639344262,Cheap
20141008T000000,270000.0,4,2.5,2701,5821,2.0,0,0,3,7,2701,0,2013,0,98092,47.2873,-122.177,2566,5843,3120,3277,46.383782855179525,0.025573770491803278,Very Cheap
20140724T000000,294000.0,2,2.5,1380,889,2.0,0,0,3,7,1140,240,2012,0,98126,47.5441,-122.369,1580,1397,-491,-183,330.70866141732284,0.028721311475409836,Very Cheap
20140605T000000,700000.0,3,2.5,2050,4185,2.0,0,0,3,9,2050,0,2011,0,98117,47.6922,-122.371,1150,5000,2135,3850,167.26403823178018,0.08196721311475409,Very Cheap
20150316T000000,1065000.0,3,4.0,3370,8252,2.0,0,0,3,10,3370,0,2014,0,98075,47.5965,-122.013,3710,8252,4882,4542,129.05962190984005,0.1298360655737705,Cheap
20150429T000000,494900.0,3,2.5,2040,2500,2.0,0,0,3,7,1470,570,2008,0,98126,47.573,-122.372,1410,2500,460,1090,197.96,0.055068852459016396,Very Cheap
20140801T000000,415000.0,3,2.5,1610,3600,2.0,0,0,3,8,1610,0,2010,0,98072,47.771,-122.169,2210,3600,1990,1390,115.27777777777777,0.04459016393442623,Very Cheap
20140502T000000,459990.0,3,2.5,2680,5539,2.0,0,0,3,8,2680,0,2013,0,98045,47.4761,-121.734,2990,6037,2859,3047,83.04567611482217,0.050490491803278685,Very Cheap
20141003T000000,882990.0,4,3.5,3560,6562,2.0,0,0,3,10,3560,0,2014,0,98075,47.5929,-121.974,3710,6562,3002,2852,134.56110941786042,0.10596590163934426,Cheap
20141229T000000,620000.0,4,3.5,3880,8244,2.0,0,0,3,10,3060,820,2007,0,98019,47.7426,-121.976,3180,10947,4364,7767,75.20621057738961,0.07147540983606557,Very Cheap
20150212T000000,375900.0,3,2.0,1824,7120,1.0,0,0,3,9,1824,0,2010,0,98001,47.3457,-122.27,2409,6264,5296,3855,52.79494382022472,0.03946229508196721,Very Cheap
20141006T000000,654000.0,3,2.5,2220,2873,2.0,0,0,3,10,2010,210,2012,0,98027,47.5311,-122.074,2290,3213,653,923,227.63661677688827,0.0759344262295082,Very Cheap
20150325T000000,1839900.0,4,3.25,4140,11007,2.0,0,0,3,10,4140,0,2013,0,98040,47.5707,-122.217,2150,9663,6867,7513,167.157263559553,0.23146229508196722,Cheap
20141210T000000,215000.0,3,2.5,1322,6006,2.0,0,0,3,7,1322,0,2009,0,98001,47.2706,-122.254,1440,6796,4684,5356,35.7975357975358,0.018360655737704918,Very Cheap
20141124T000000,630500.0,3,2.5,1909,1300,3.0,0,0,3,8,1766,143,2006,0,98103,47.6538,-122.352,1780,1248,-609,-532,485.0,0.07285245901639344,Very Cheap
20141107T000000,855000.0,4,3.5,3460,7702,2.0,0,0,3,10,3460,0,2010,0,98075,47.5942,-121.977,3380,7464,4242,4084,111.010127239678,0.10229508196721311,Cheap
20150127T000000,235245.0,4,2.5,1954,5075,2.0,0,0,3,8,1954,0,2007,0,98001,47.2606,-122.253,1934,5000,3121,3066,46.35369458128079,0.021015737704918033,Very Cheap
20140710T000000,770000.0,5,2.5,3000,7912,1.0,0,0,3,9,1610,1390,2007,0,98033,47.6765,-122.175,2700,7205,4912,4505,97.32052578361981,0.09114754098360656,Very Cheap
20140619T000000,734990.0,4,2.5,2650,6884,2.0,0,0,3,8,2650,0,2012,0,98053,47.6901,-122.015,2520,5866,4234,3346,106.76786751888437,0.08655606557377049,Very Cheap
20150109T000000,880000.0,4,2.5,2580,3436,2.0,0,0,3,8,2580,0,2013,0,98033,47.6853,-122.21,1780,5772,856,3992,256.1117578579744,0.10557377049180328,Cheap
20150114T000000,525000.0,4,3.0,2650,4924,2.0,0,0,3,8,2650,0,2011,0,98028,47.7734,-122.238,2380,4733,2274,2353,106.62063363119415,0.05901639344262295,Very Cheap
20140807T000000,775000.0,4,3.5,3390,3960,2.0,0,0,3,10,3390,0,2008,0,98027,47.5406,-121.995,2990,3400,570,410,195.7070707070707,0.09180327868852459,Very Cheap
20150430T000000,687015.0,3,1.75,1470,873,3.0,0,0,3,10,1470,0,2009,0,98119,47.6256,-122.362,1410,967,-597,-443,786.9587628865979,0.08026426229508196,Very Cheap
20141112T000000,663000.0,3,2.5,1910,5125,2.0,0,0,3,9,1910,0,2006,0,98029,47.5481,-121.995,1910,3215,3215,1305,129.3658536585366,0.07711475409836066,Very Cheap
20150330T000000,815000.0,4,2.5,3030,7187,2.0,0,0,3,9,3030,0,2005,0,98033,47.6934,-122.166,3030,7187,4157,4157,113.39919298733825,0.09704918032786886,Very Cheap
20150427T000000,1050000.0,4,3.25,2930,25020,2.0,0,0,3,9,2930,0,2013,0,98029,47.5514,-122.023,2400,32374,22090,29974,41.96642685851319,0.12786885245901639,Cheap
20150423T000000,433190.0,3,2.5,1650,2787,2.0,0,0,3,8,1650,0,2014,0,98065,47.5336,-121.838,1760,2787,1137,1027,155.43236454969502,0.04697573770491803,Very Cheap
20141210T000000,725000.0,4,2.5,2870,5118,2.0,0,0,3,9,2870,0,2006,0,98029,47.5544,-121.99,2940,4800,2248,1860,141.6568972254787,0.08524590163934426,Very Cheap
20150408T000000,279950.0,3,2.5,1608,4800,2.0,0,0,3,8,1608,0,2013,0,98092,47.2585,-122.201,2009,4800,3192,2791,58.322916666666664,0.026878688524590164,Very Cheap
20150327T000000,272167.0,2,2.5,1620,3795,2.0,0,0,3,7,1620,0,2014,0,98027,47.5321,-122.034,1620,6000,2175,4380,71.71725955204217,0.025857967213114754,Very Cheap
20140616T000000,468500.0,3,2.5,1350,1186,2.0,0,0,3,8,1120,230,2007,0,98117,47.6786,-122.375,1500,1605,-164,105,395.02529510961216,0.05160655737704918,Very Cheap
20140602T000000,298000.0,3,2.5,1950,3600,2.0,0,0,3,7,1950,0,2010,0,98038,47.3658,-122.021,1870,4184,1650,2314,82.77777777777777,0.029245901639344263,Very Cheap
20150114T000000,303500.0,6,4.5,3390,7200,2.0,0,0,3,8,2440,950,2007,0,98118,47.5205,-122.288,2040,7214,3810,5174,42.15277777777778,0.029967213114754098,Very Cheap
20150410T000000,308000.0,3,1.75,1300,1237,2.0,0,0,3,7,1060,240,2008,0,98027,47.539,-122.026,1350,942,-63,-408,248.98949070331446,0.030557377049180327,Very Cheap
20150415T000000,646800.0,3,3.0,2230,1407,2.5,0,0,3,8,1850,380,2014,0,98027,47.5446,-122.017,2230,1407,-823,-823,459.7014925373134,0.07499016393442623,Very Cheap
20150102T000000,530200.0,4,2.5,1880,3853,2.0,0,0,3,8,1880,0,2010,0,98027,47.5636,-122.094,1890,3078,1973,1188,137.60705943420712,0.059698360655737706,Very Cheap
20141112T000000,405000.0,5,2.5,3370,5092,2.0,0,0,3,7,3370,0,2006,0,98038,47.3594,-122.036,2910,5092,1722,2182,79.53652788688139,0.043278688524590166,Very Cheap
20140724T000000,529000.0,2,2.5,1320,1395,2.0,0,0,3,8,990,330,2014,0,98107,47.6689,-122.362,1550,1519,75,-31,379.2114695340502,0.05954098360655738,Very Cheap
20140908T000000,675900.0,3,2.5,2920,9096,2.0,0,0,3,9,2920,0,2013,0,98059,47.4855,-122.149,2930,7995,6176,5065,74.30738786279683,0.07880655737704918,Very Cheap
20150402T000000,570000.0,3,3.25,1550,1280,2.0,0,0,3,9,1220,330,2013,0,98199,47.6493,-122.384,1550,1579,-270,29,445.3125,0.06491803278688525,Very Cheap
20141226T000000,375500.0,4,2.5,2301,6452,2.0,0,0,3,9,2301,0,2010,0,98001,47.346,-122.269,2650,6054,4151,3404,58.19900805951643,0.03940983606557377,Very Cheap
20141021T000000,445000.0,3,3.25,1710,1960,2.0,0,0,3,8,1360,350,2004,0,98029,47.5479,-122.003,1420,955,250,-465,227.0408163265306,0.04852459016393443,Very Cheap
20150105T000000,1100000.0,4,3.75,2890,4164,2.0,0,0,3,9,2240,650,2013,0,98033,47.676,-122.197,2354,3207,1274,853,264.16906820365034,0.13442622950819672,Cheap
20140825T000000,477000.0,3,2.5,2100,5060,2.0,0,0,3,7,2100,0,2006,0,98108,47.563,-122.298,1520,2468,2960,948,94.26877470355731,0.052721311475409836,Very Cheap
20141121T000000,450000.0,3,2.75,2240,3360,2.0,0,0,3,8,2100,140,2014,0,98178,47.4999,-122.232,1790,5873,1120,4083,133.92857142857142,0.04918032786885246,Very Cheap
20150326T000000,427005.0,3,3.0,1460,1200,3.0,0,0,3,8,1460,0,2006,0,98117,47.7,-122.367,1460,1245,-260,-215,355.8375,0.04616459016393443,Very Cheap
20150224T000000,720000.0,3,1.75,1370,1990,3.0,0,0,3,9,1370,0,2014,0,98102,47.6434,-122.324,1730,1990,620,260,361.80904522613065,0.08459016393442623,Very Cheap
20141008T000000,2230000.0,3,3.5,3760,5634,2.0,1,4,3,11,2830,930,2014,0,98056,47.5285,-122.205,3560,5762,1874,2202,395.8111466098687,0.28262295081967215,Cheap
20140527T000000,450800.0,4,3.25,2510,5311,2.0,0,0,3,9,2510,0,2009,0,98056,47.5028,-122.17,1590,9583,2801,7993,84.88043682922238,0.049285245901639345,Very Cheap
20140829T000000,461100.0,2,2.25,1210,1267,2.0,0,0,3,8,1120,90,2010,0,98117,47.6783,-122.376,1360,1349,57,-11,363.930544593528,0.05063606557377049,Very Cheap
20141001T000000,1061600.0,4,3.0,2990,6695,2.0,0,0,3,10,2990,0,2014,0,98075,47.5817,-122.047,2760,6600,3705,3840,158.56609410007468,0.12939016393442623,Cheap
20150408T000000,590000.0,3,2.5,1710,2875,2.0,0,0,3,8,1710,0,2006,0,98116,47.5787,-122.392,1640,5750,1165,4110,205.2173913043478,0.06754098360655737,Very Cheap
20140716T000000,478830.0,4,2.5,3274,4950,2.0,0,0,3,9,3274,0,2014,0,98092,47.2603,-122.195,2578,4200,1676,1622,96.73333333333333,0.052961311475409834,Very Cheap
20140709T000000,760000.0,4,2.25,3300,8365,3.0,0,0,3,9,3300,0,2014,0,98126,47.5363,-122.377,1290,8369,5065,7079,90.85475194261805,0.0898360655737705,Very Cheap
20140703T000000,1025000.0,4,3.5,4370,10860,2.0,0,0,3,11,4370,0,2008,0,98059,47.5066,-122.148,3560,8070,6490,4510,94.3830570902394,0.12459016393442623,Cheap
20140613T000000,385000.0,4,2.5,2050,5276,2.0,0,0,3,7,2050,0,2006,0,98059,47.491,-122.15,2480,5447,3226,2967,72.97194844579226,0.04065573770491803,Very Cheap
20140516T000000,500000.0,2,2.5,1310,1500,2.0,0,0,3,8,1160,150,2006,0,98122,47.6112,-122.309,1320,1581,190,261,333.3333333333333,0.05573770491803279,Very Cheap
20150415T000000,425000.0,3,1.5,1680,8000,1.5,0,0,3,7,1680,0,2012,0,98014,47.6923,-121.869,1990,26336,6320,24346,53.125,0.04590163934426229,Very Cheap
20140905T000000,552100.0,3,3.0,1330,1379,2.0,0,0,4,8,1120,210,2005,0,98122,47.6126,-122.313,1810,1770,49,-40,400.3625815808557,0.06257049180327869,Very Cheap
20141229T000000,785000.0,3,3.0,1950,1983,3.0,0,0,3,9,1610,340,2009,0,98004,47.6078,-122.202,2040,2131,33,91,395.86485123550176,0.09311475409836066,Very Cheap
20150323T000000,615000.0,5,3.25,3090,7069,2.0,0,0,3,9,3090,0,2012,0,98056,47.5114,-122.196,2480,8000,3979,5520,86.99957561182629,0.07081967213114754,Very Cheap
20150423T000000,309000.0,3,2.5,1950,3825,2.0,0,0,3,7,1950,0,2013,0,98042,47.3588,-122.082,1950,3825,1875,1875,80.7843137254902,0.030688524590163933,Very Cheap
20150220T000000,369500.0,3,2.0,1108,1128,3.0,0,0,3,7,1108,0,2009,0,98115,47.6961,-122.318,1285,1253,20,-32,327.57092198581563,0.03862295081967213,Very Cheap
20150211T000000,391000.0,4,2.25,2190,3850,2.0,0,0,3,7,2190,0,2006,0,98059,47.4861,-122.161,2190,3980,1660,1790,101.55844155844156,0.04144262295081967,Very Cheap
20141029T000000,465000.0,3,1.75,1590,1322,2.0,0,0,3,8,1060,530,2014,0,98144,47.5753,-122.294,1530,5400,-268,3870,351.73978819969744,0.051147540983606556,Very Cheap
20140606T000000,879950.0,4,2.75,3010,7215,2.0,0,0,3,9,3010,0,2014,0,98033,47.6952,-122.178,3010,7215,4205,4205,121.96119196119196,0.1055672131147541,Cheap
20141023T000000,372000.0,3,2.0,1330,1042,2.0,0,0,3,8,1060,270,2014,0,98136,47.5522,-122.382,1440,2428,-288,988,357.0057581573896,0.03895081967213115,Very Cheap
20140522T000000,259000.0,3,2.5,1550,3569,2.0,0,0,3,7,1550,0,2011,0,98002,47.3528,-122.211,2095,3402,2019,1307,72.56934715606613,0.024131147540983607,Very Cheap
20140707T000000,374000.0,2,1.5,1260,1575,2.0,0,0,3,7,1260,0,2001,0,98144,47.5914,-122.295,1220,1740,315,520,237.46031746031747,0.03921311475409836,Very Cheap
20150305T000000,561000.0,4,2.5,2550,5395,2.0,0,0,3,8,2550,0,2001,0,98065,47.5355,-121.874,2850,6109,2845,3259,103.98517145505097,0.06373770491803278,Very Cheap
20150403T000000,610000.0,3,2.5,1300,1331,3.0,0,0,3,8,1300,0,2007,0,98103,47.6607,-122.352,1450,5270,31,3820,458.3020285499624,0.07016393442622951,Very Cheap
20150108T000000,635000.0,3,3.0,2230,1407,2.5,0,0,3,8,1850,380,2014,0,98027,47.5446,-122.017,2290,1407,-823,-883,451.3148542999289,0.07344262295081967,Very Cheap
20140627T000000,235000.0,1,1.5,1170,1456,2.0,0,0,3,8,1070,100,2007,0,98126,47.5493,-122.372,1360,1730,286,370,161.4010989010989,0.02098360655737705,Very Cheap
20140716T000000,623300.0,4,3.5,4170,4524,2.0,0,0,3,9,3500,670,2007,0,98072,47.7726,-122.162,3510,5001,354,1491,137.7763041556145,0.07190819672131148,Very Cheap
20141023T000000,412500.0,3,2.0,1680,5246,1.0,0,0,3,7,1680,0,2007,0,98065,47.5206,-121.868,2430,6883,3566,4453,78.63133816240945,0.04426229508196721,Very Cheap
20141121T000000,380000.0,4,3.25,2864,8035,3.0,0,0,3,8,2864,0,2014,0,98030,47.3746,-122.189,2419,8984,5171,6565,47.293092719352835,0.04,Very Cheap
20140623T000000,497000.0,3,2.25,1630,3817,2.0,0,0,3,7,1630,0,2005,0,98029,47.5485,-121.999,1630,3348,2187,1718,130.20696882368352,0.055344262295081964,Very Cheap
20141111T000000,452000.0,4,2.5,2716,7850,2.0,0,0,3,9,2716,0,2014,0,98030,47.352,-122.197,2580,14448,5134,11868,57.5796178343949,0.04944262295081967,Very Cheap
20141025T000000,312000.0,3,2.5,1750,4076,2.0,0,0,3,7,1750,0,2013,0,98038,47.3597,-122.045,1810,4090,2326,2280,76.54563297350343,0.031081967213114754,Very Cheap
20140919T000000,469950.0,5,3.0,3223,6371,2.0,0,0,3,9,3223,0,2014,0,98042,47.3588,-122.163,1979,19030,3148,17051,73.76393030921362,0.05179672131147541,Very Cheap
20140805T000000,775000.0,5,2.5,2600,4284,2.0,0,0,3,9,2600,0,2014,0,98136,47.5409,-122.39,1620,5000,1684,3380,180.90569561157795,0.09180327868852459,Very Cheap
20150427T000000,679990.0,4,2.75,3320,8653,2.0,0,0,3,8,3320,0,2014,0,98133,47.7521,-122.334,2140,8727,5333,6587,78.58430602103317,0.07934295081967213,Very Cheap
20140627T000000,288790.0,4,2.0,1350,942,3.0,0,0,3,7,1350,0,2008,0,98027,47.5401,-122.026,1390,942,-408,-448,306.57112526539277,0.028038032786885245,Very Cheap
20150408T000000,800000.0,5,2.5,3410,4726,2.0,0,0,3,9,3410,0,2007,0,98006,47.5459,-122.184,2810,5129,1316,2319,169.27634363097758,0.09508196721311475,Very Cheap
20150427T000000,299000.0,3,2.5,1572,4000,2.0,0,0,3,8,1572,0,2013,0,98092,47.2615,-122.198,1608,5175,2428,3567,74.75,0.02937704918032787,Very Cheap
20150129T000000,332000.0,4,2.5,2300,4482,2.0,0,0,3,7,2300,0,2013,0,98042,47.3599,-122.082,2300,3825,2182,1525,74.07407407407408,0.033704918032786885,Very Cheap
20150420T000000,525000.0,1,1.5,1030,5923,1.0,0,0,3,8,1030,0,1940,0,98105,47.6653,-122.305,2650,5000,4893,2350,88.63751477291913,0.05901639344262295,Very Cheap
20140903T000000,620000.0,3,1.75,1458,858,2.0,0,0,3,8,950,508,2014,0,98144,47.592,-122.293,1458,3000,-600,1542,722.6107226107226,0.07147540983606557,Very Cheap
20141103T000000,452000.0,4,2.5,2190,6896,2.0,0,0,3,7,2190,0,2007,0,98065,47.5191,-121.869,2190,5900,4706,3710,65.54524361948955,0.04944262295081967,Very Cheap
20141028T000000,630000.0,4,3.0,3640,5096,2.0,0,0,3,8,2740,900,2010,0,98118,47.5428,-122.27,1910,9189,1456,7279,123.62637362637362,0.07278688524590164,Very Cheap
20140724T000000,485000.0,4,2.75,2790,7803,2.0,0,0,3,8,2790,0,2013,0,98045,47.4823,-121.772,2620,6178,5013,3558,62.155581186723055,0.05377049180327869,Very Cheap
20141013T000000,349950.0,4,2.5,2632,4117,2.0,0,0,3,8,2632,0,2013,0,98001,47.3428,-122.278,2040,5195,1485,3155,85.0012144765606,0.036059016393442625,Very Cheap
20140701T000000,499990.0,4,2.75,2910,6334,2.0,0,0,3,8,2910,0,2013,0,98045,47.4826,-121.771,2790,6352,3424,3562,78.93748026523524,0.05573639344262295,Very Cheap
20141205T000000,510000.0,2,2.25,1470,1101,2.0,0,0,3,8,1340,130,2005,0,98115,47.6768,-122.301,1470,1582,-369,112,463.21525885558583,0.057049180327868855,Very Cheap
20150303T000000,1080000.0,3,2.5,2240,21477,2.0,0,2,3,8,2240,0,1995,0,98006,47.5745,-122.18,2930,21569,19237,18639,50.28635284257578,0.1318032786885246,Cheap
20140508T000000,494000.0,3,2.5,2310,4729,2.0,0,0,3,8,2310,0,2011,0,98028,47.7734,-122.237,2440,4711,2419,2271,104.4618312539649,0.05495081967213115,Very Cheap
20140626T000000,429900.0,3,2.5,2370,5353,2.0,0,0,3,8,2370,0,2009,0,98019,47.7333,-121.975,2130,6850,2983,4720,80.31010648234634,0.04654426229508197,Very Cheap
20141015T000000,505000.0,4,2.75,2980,9825,1.0,0,0,3,8,1910,1070,2007,0,98056,47.5073,-122.172,2580,12231,6845,9651,51.399491094147585,0.05639344262295082,Very Cheap
20140715T000000,272000.0,4,2.0,1870,6551,1.0,0,3,3,7,1870,0,2009,0,98022,47.1934,-121.977,2280,5331,4681,3051,41.52037856815753,0.02583606557377049,Very Cheap
20150210T000000,671500.0,3,2.5,1770,1714,3.0,0,0,3,8,1770,0,2012,0,98103,47.6532,-122.348,1720,3360,-56,1640,391.7736289381564,0.07822950819672131,Very Cheap
20150311T000000,729950.0,4,3.5,3510,10010,2.0,0,0,3,10,3510,0,2001,0,98065,47.5412,-121.876,4200,9935,6500,5735,72.92207792207792,0.08589508196721311,Very Cheap
20140721T000000,471835.0,4,2.5,3281,5354,2.0,0,0,3,9,3281,0,2014,0,98092,47.3273,-122.163,2598,4815,2073,2217,88.12756817332836,0.05204393442622951,Very Cheap
20141103T000000,249950.0,3,2.0,1670,4438,1.0,0,0,3,7,1670,0,2014,0,98022,47.1948,-121.974,1670,4558,2768,2888,56.3204146011717,0.022944262295081966,Very Cheap
20140808T000000,424950.0,5,3.5,2760,3846,2.5,0,0,3,8,2760,0,2013,0,98056,47.5047,-122.17,2760,4587,1086,1827,110.49141965678628,0.04589508196721311,Very Cheap
20140709T000000,1240000.0,5,3.5,5430,10327,2.0,0,2,3,10,4010,1420,2007,0,98006,47.5476,-122.116,4340,10324,4897,5984,120.0735934927859,0.15278688524590164,Cheap
20140911T000000,440000.0,4,2.5,2990,7928,2.0,0,0,3,9,2990,0,2011,0,98010,47.3139,-122.024,2810,7401,4938,4591,55.49949545913219,0.04786885245901639,Very Cheap
20150408T000000,495000.0,4,3.5,3170,3858,2.0,0,0,3,8,2530,640,2008,0,98059,47.5049,-122.155,2640,3844,688,1204,128.30482115085536,0.05508196721311476,Very Cheap
20140513T000000,870000.0,4,2.5,3520,6773,2.5,0,0,3,9,2650,870,2006,0,98136,47.5317,-122.391,2930,6458,3253,3528,128.4512033072494,0.10426229508196722,Cheap
20141125T000000,559000.0,2,3.0,1650,960,3.0,0,0,3,8,1350,300,2015,0,98103,47.6611,-122.346,1650,3000,-690,1350,582.2916666666666,0.06347540983606557,Very Cheap
20140507T000000,495000.0,4,2.75,2656,21195,2.0,0,0,3,9,2656,0,2014,0,98001,47.3162,-122.272,1860,16510,18539,14650,23.35456475583864,0.05508196721311476,Very Cheap
20150213T000000,722000.0,3,2.5,2230,4850,2.0,0,0,3,8,2230,0,2014,0,98133,47.7295,-122.334,2230,4513,2620,2283,148.8659793814433,0.08485245901639345,Very Cheap
20140702T000000,567500.0,3,2.5,2280,2502,2.0,0,0,3,8,1880,400,2006,0,98027,47.5364,-122.073,2280,2812,222,532,226.81854516386892,0.06459016393442622,Very Cheap
20141217T000000,440000.0,4,2.5,2798,5085,2.0,0,0,3,9,2798,0,2011,0,98092,47.3308,-122.187,2502,5707,2287,3205,86.52900688298918,0.04786885245901639,Very Cheap
20140829T000000,400000.0,4,2.5,2398,5988,2.0,0,0,3,8,2398,0,2008,0,98055,47.452,-122.204,2370,5988,3590,3618,66.8002672010688,0.04262295081967213,Very Cheap
20141006T000000,459995.0,4,2.5,2350,3760,2.0,0,0,3,8,2350,0,2014,0,98059,47.4786,-122.123,2590,4136,1410,1546,122.33909574468085,0.050491147540983605,Very Cheap
20140507T000000,365000.0,5,2.75,2410,5003,1.0,0,0,3,7,1410,1000,2008,0,98118,47.5298,-122.274,1590,5003,2593,3413,72.95622626424145,0.0380327868852459,Very Cheap
20150417T000000,389950.0,3,2.25,1580,920,3.0,0,0,3,8,1580,0,2015,0,98106,47.5578,-122.363,1250,1150,-660,-100,423.85869565217394,0.04130491803278689,Very Cheap
20140708T000000,320000.0,3,3.25,1450,1387,2.0,0,0,3,8,1180,270,2013,0,98106,47.5556,-122.362,1450,1198,-63,-252,230.71377072819033,0.032131147540983604,Very Cheap
20140613T000000,415500.0,4,2.5,1750,4779,2.0,0,0,3,7,1750,0,2009,0,98028,47.7608,-122.232,1580,4687,3029,3107,86.9428750784683,0.044655737704918035,Very Cheap
20150309T000000,775000.0,3,2.5,3020,4120,2.0,0,0,3,9,2360,660,2008,0,98126,47.5714,-122.373,2280,4120,1100,1840,188.10679611650485,0.09180327868852459,Very Cheap
20150311T000000,590000.0,3,3.0,1740,1100,3.0,0,0,3,8,1740,0,2007,0,98107,47.67,-122.391,1370,1180,-640,-190,536.3636363636364,0.06754098360655737,Very Cheap
20150123T000000,950000.0,2,2.25,2200,2043,2.0,0,0,3,9,1760,440,2007,0,98004,47.6213,-122.2,2020,1957,-157,-63,465.00244738130203,0.11475409836065574,Cheap
20140806T000000,378950.0,4,2.5,1867,15314,2.0,0,0,3,9,1867,0,2013,0,98030,47.3524,-122.198,2616,8048,13447,5432,24.745331069609506,0.03986229508196721,Very Cheap
20140508T000000,441750.0,2,1.5,1020,1060,3.0,0,0,3,8,1020,0,2008,0,98103,47.6801,-122.348,1340,1415,40,75,416.74528301886795,0.04809836065573771,Very Cheap
20141031T000000,335900.0,4,2.75,2475,4000,2.0,0,0,3,7,2475,0,2014,0,98002,47.345,-122.209,2475,4000,1525,1525,83.975,0.03421639344262295,Very Cheap
20140627T000000,229800.0,2,1.75,1110,1773,2.0,0,0,3,8,1110,0,2014,0,98108,47.5647,-122.293,1420,2855,663,1435,129.61082910321488,0.020301639344262296,Very Cheap
20150310T000000,645000.0,3,2.5,1900,1258,2.5,0,0,3,7,1700,200,2007,0,98119,47.6465,-122.358,1780,1877,-642,97,512.718600953895,0.07475409836065573,Very Cheap
20150423T000000,448000.0,3,3.25,1560,1345,2.0,0,0,3,8,1260,300,2009,0,98126,47.5637,-122.375,1560,4800,-215,3240,333.08550185873605,0.048918032786885245,Very Cheap
20141216T000000,706000.0,4,2.5,2510,5436,2.0,0,0,3,8,2510,0,2011,0,98053,47.6894,-122.016,2520,5436,2926,2916,129.87490802060339,0.08275409836065574,Very Cheap
20150227T000000,988990.0,4,4.75,4150,6303,3.0,0,0,3,9,4150,0,2014,0,98052,47.7047,-122.123,3570,6285,2153,2715,156.90782167221957,0.11986754098360655,Cheap
20140716T000000,716000.0,3,3.0,1660,1849,3.0,0,0,3,9,1660,0,2013,0,98103,47.6649,-122.353,1660,3300,189,1640,387.23634396971335,0.0840655737704918,Very Cheap
20150421T000000,319000.0,2,1.5,1090,847,3.0,0,0,3,8,1090,0,2009,0,98133,47.7235,-122.352,1090,1118,-243,28,376.6233766233766,0.032,Very Cheap
20141014T000000,300000.0,4,2.5,1914,3272,2.0,0,0,3,8,1914,0,2009,0,98055,47.4297,-122.189,1714,3250,1358,1536,91.68704156479218,0.029508196721311476,Very Cheap
20140502T000000,625000.0,4,3.25,2730,54014,1.0,0,0,3,9,1560,1170,2007,0,98059,47.5133,-122.11,2730,111274,51284,108544,11.571074165956974,0.07213114754098361,Very Cheap
20140514T000000,773000.0,3,2.75,2470,3600,2.0,0,0,3,9,2470,0,2007,0,98029,47.5406,-121.994,2570,3600,1130,1030,214.72222222222223,0.09154098360655738,Very Cheap
20140925T000000,392000.0,5,2.5,2340,5670,2.0,0,0,3,7,2340,0,2009,0,98059,47.4913,-122.152,2190,4869,3330,2679,69.1358024691358,0.04157377049180328,Very Cheap
20140911T000000,549995.0,4,3.5,2660,5690,2.0,0,0,3,8,1920,740,2014,0,98059,47.4775,-122.122,2970,5690,3030,2720,96.65992970123023,0.0622944262295082,Very Cheap
20140920T000000,480000.0,3,2.5,2410,4656,2.0,0,0,3,7,2410,0,2009,0,98065,47.5203,-121.874,2410,4840,2246,2430,103.09278350515464,0.05311475409836065,Very Cheap
20141020T000000,355000.0,3,2.25,1430,4777,2.0,0,0,3,7,1430,0,2010,0,98059,47.4867,-122.152,1639,3854,3347,2215,74.31442327820808,0.036721311475409836,Very Cheap
20141230T000000,208400.0,2,2.5,1570,1268,3.0,0,0,3,7,1570,0,2007,0,98106,47.534,-122.365,1570,1300,-302,-270,164.35331230283913,0.017495081967213114,Very Cheap
20140822T000000,831548.0,5,2.75,3010,4919,2.0,0,0,3,9,3010,0,2014,0,98074,47.6067,-122.052,3230,5415,1909,2185,169.04818052449684,0.09921940983606557,Very Cheap
20141117T000000,279500.0,4,2.5,1613,4338,2.0,0,0,3,7,1613,0,2009,0,98042,47.3859,-122.162,1427,4341,2725,2914,64.43061318579991,0.02681967213114754,Very Cheap
20150227T000000,445000.0,3,2.5,2380,5269,2.0,0,0,3,8,2380,0,2008,0,98056,47.5066,-122.192,2150,7600,2889,5450,84.45625355855,0.04852459016393443,Very Cheap
20140616T000000,492500.0,5,2.5,2570,9962,2.0,0,0,3,8,2570,0,2006,0,98019,47.7275,-121.957,2890,9075,7392,6185,49.43786388275447,0.054754098360655735,Very Cheap
20140709T000000,435000.0,4,2.5,2550,5200,2.0,0,0,3,7,2550,0,2009,0,98059,47.4919,-122.153,2550,4660,2650,2110,83.65384615384616,0.04721311475409836,Very Cheap
20150512T000000,325000.0,3,2.25,1330,969,3.0,0,0,3,7,1330,0,2007,0,98125,47.7177,-122.292,1310,1941,-361,631,335.39731682146544,0.03278688524590164,Very Cheap
20141117T000000,453000.0,2,1.5,1160,1269,2.0,0,0,3,7,970,190,2005,0,98103,47.6608,-122.335,1700,3150,109,1450,356.97399527186764,0.04957377049180328,Very Cheap
20140822T000000,612995.0,5,3.5,3240,6919,2.0,0,0,3,8,2760,480,2014,0,98059,47.4779,-122.122,2970,5690,3679,2720,88.59589536060125,0.0705567213114754,Very Cheap
20140904T000000,540000.0,4,2.5,2710,9248,2.0,0,0,3,7,2710,0,2011,0,98065,47.5164,-121.875,2710,5000,6538,2290,58.391003460207614,0.06098360655737705,Very Cheap
20150429T000000,465000.0,3,1.0,1150,18200,1.0,0,0,5,7,1150,0,1959,0,98058,47.4262,-122.187,1714,18200,17050,16486,25.54945054945055,0.051147540983606556,Very Cheap
20140812T000000,799950.0,3,2.25,1860,1386,3.0,0,0,3,9,1860,0,2014,0,98112,47.6368,-122.279,1680,3080,-474,1400,577.1645021645022,0.09507540983606558,Very Cheap
20141124T000000,495000.0,3,2.25,1280,1517,2.0,0,0,3,8,1080,200,2008,0,98107,47.6651,-122.368,1280,1681,237,401,326.30191166776535,0.05508196721311476,Very Cheap
20150228T000000,579950.0,3,2.5,1810,1585,3.0,0,0,3,7,1810,0,2014,0,98117,47.6957,-122.376,1560,1586,-225,26,365.8990536277602,0.06622295081967212,Very Cheap
20150220T000000,331000.0,2,2.25,1240,720,2.0,0,0,3,7,1150,90,2008,0,98027,47.5322,-122.072,1260,810,-520,-450,459.72222222222223,0.03357377049180328,Very Cheap
20140825T000000,580000.0,4,3.5,1460,951,3.0,0,0,3,8,1460,0,2008,0,98115,47.6821,-122.326,1430,1282,-509,-148,609.8843322818086,0.06622950819672131,Very Cheap
20150414T000000,669000.0,2,2.5,1640,1953,2.0,0,0,3,10,1640,0,2014,0,98118,47.5639,-122.292,1820,2653,313,833,342.5499231950845,0.0779016393442623,Very Cheap
20140703T000000,2351960.0,4,4.25,5010,19412,2.0,0,1,3,11,4000,1010,2014,0,98040,47.5455,-122.211,3820,17064,14402,13244,121.16010715021636,0.2986177049180328,Cheap
20150116T000000,539900.0,3,3.25,1300,1325,2.0,0,0,3,8,1080,220,2005,0,98103,47.6584,-122.346,1290,1323,25,33,407.47169811320754,0.06097049180327869,Very Cheap
20140723T000000,490000.0,4,2.5,2510,4349,2.0,0,0,3,8,2510,0,2010,0,98059,47.4927,-122.147,2510,4314,1839,1804,112.66957921361232,0.05442622950819672,Very Cheap
20140527T000000,627000.0,3,3.5,2710,3475,2.0,0,0,3,8,1650,1060,2005,0,98027,47.5359,-122.072,2440,2867,765,427,180.431654676259,0.07239344262295082,Very Cheap
20140728T000000,458000.0,4,3.5,3217,4000,2.0,0,0,3,8,2587,630,2008,0,98055,47.4483,-122.203,2996,5418,783,2422,114.5,0.05022950819672131,Very Cheap
20141110T000000,440000.0,3,2.5,1650,4929,2.0,0,0,3,7,1520,130,2007,0,98108,47.5634,-122.298,1520,2287,3279,767,89.26759991884764,0.04786885245901639,Very Cheap
20150310T000000,1698000.0,4,3.5,3950,6240,2.0,0,0,3,11,3950,0,2015,0,98112,47.6221,-122.29,2040,6240,2290,4200,272.11538461538464,0.21285245901639344,Cheap
20150511T000000,935000.0,2,2.5,1680,977,3.0,0,0,3,9,1680,0,2009,0,98119,47.632,-122.361,1680,977,-703,-703,957.0112589559877,0.11278688524590164,Cheap
20150417T000000,641000.0,5,3.5,3420,6403,2.0,0,2,3,8,2700,720,2013,0,98065,47.5162,-121.874,2710,6038,2983,3328,100.10932375449008,0.0742295081967213,Very Cheap
20140911T000000,452000.0,3,2.75,2300,5090,2.0,0,0,3,8,1700,600,2007,0,98106,47.545,-122.36,1530,9100,2790,7570,88.8015717092338,0.04944262295081967,Very Cheap
20141223T000000,625000.0,4,2.75,3010,6854,2.0,0,2,3,9,2570,440,2012,0,98065,47.5171,-121.876,1830,2952,3844,1122,91.18762766267872,0.07213114754098361,Very Cheap
20150303T000000,1350000.0,4,3.5,4680,12495,2.0,0,0,3,10,3040,1640,2008,0,98033,47.6984,-122.206,3240,10749,7815,7509,108.04321728691477,0.16721311475409836,Cheap
20140908T000000,834950.0,5,3.5,3630,4911,2.0,0,0,3,9,2790,840,2014,0,98034,47.718,-122.156,3600,4992,1281,1392,170.01628996131134,0.0996655737704918,Very Cheap
20141028T000000,1500000.0,3,3.5,3530,3610,2.0,0,0,3,10,2370,1160,2008,0,98103,47.6857,-122.339,1780,3610,80,1830,415.5124653739612,0.18688524590163935,Cheap
20140825T000000,305000.0,4,2.5,2280,3800,2.0,0,0,3,7,2280,0,2006,0,98038,47.3586,-122.036,2630,4045,1520,1415,80.26315789473684,0.03016393442622951,Very Cheap
20141112T000000,659000.0,3,2.5,3090,384634,2.0,0,0,3,8,3090,0,2007,0,98019,47.7072,-121.927,2200,292645,381544,290445,1.713317075453548,0.07659016393442623,Very Cheap
20140522T000000,353000.0,1,1.0,550,1279,2.0,0,0,3,7,550,0,2008,0,98122,47.616,-122.314,1460,1385,729,-75,275.99687255668493,0.03645901639344262,Very Cheap
20150304T000000,535000.0,4,3.25,2840,4000,2.0,0,3,3,9,2330,510,2014,0,98108,47.5529,-122.293,2160,4867,1160,2707,133.75,0.06032786885245902,Very Cheap
20140708T000000,999000.0,4,2.5,3130,10849,2.0,0,0,3,10,3130,0,2013,0,98033,47.6828,-122.186,2470,9131,7719,6661,92.0822195594064,0.12118032786885245,Cheap
20150129T000000,375000.0,3,2.5,1440,1102,3.0,0,0,3,8,1440,0,2009,0,98103,47.6995,-122.346,1440,1434,-338,-6,340.2903811252269,0.03934426229508197,Very Cheap
20140616T000000,685000.0,4,3.5,2840,4637,3.0,0,0,3,8,2840,0,2008,0,98125,47.7033,-122.321,1730,5279,1797,3549,147.72482208324348,0.08,Very Cheap
20140808T000000,333000.0,4,2.5,2623,7184,2.0,0,0,3,8,2623,0,2012,0,98092,47.259,-122.202,2010,4939,4561,2929,46.35300668151448,0.033836065573770495,Very Cheap
20150511T000000,245000.0,1,1.0,390,2000,1.0,0,0,4,6,390,0,1920,0,98103,47.6938,-122.347,1340,5100,1610,3760,122.5,0.022295081967213116,Very Cheap
20150508T000000,1999950.0,4,3.25,5640,35006,2.0,0,2,3,11,4900,740,2015,0,98006,47.5491,-122.104,4920,35033,29366,30113,57.13163457692967,0.25245245901639346,Cheap
20141015T000000,329950.0,2,2.25,1260,1032,2.0,0,0,3,7,1170,90,2008,0,98027,47.5323,-122.072,1240,809,-228,-431,319.718992248062,0.03343606557377049,Very Cheap
20150420T000000,403000.0,2,1.0,894,1552,2.0,0,0,3,7,894,0,2011,0,98115,47.6911,-122.313,1131,1992,658,861,259.66494845360825,0.04301639344262295,Very Cheap
20141111T000000,559630.0,4,2.5,3370,4934,2.0,0,0,3,9,3370,0,2014,0,98038,47.3562,-122.022,2980,5046,1564,2066,113.42318605593839,0.06355803278688525,Very Cheap
20140818T000000,344000.0,3,2.25,1250,871,3.0,0,0,3,8,1250,0,2007,0,98103,47.6907,-122.343,1250,1158,-379,-92,394.9483352468427,0.035278688524590165,Very Cheap
20150402T000000,435000.0,3,1.5,1180,1231,3.0,0,0,3,7,1180,0,2008,0,98115,47.6845,-122.315,1280,3360,51,2080,353.37124289195776,0.04721311475409836,Very Cheap
20140522T000000,430000.0,2,2.5,1520,1588,2.0,0,0,3,8,1240,280,2007,0,98144,47.5825,-122.313,1660,6000,68,4340,270.7808564231738,0.04655737704918033,Very Cheap
20141117T000000,417000.0,3,2.5,2000,4500,2.0,0,0,3,7,2000,0,2010,0,98059,47.4937,-122.149,2230,4501,2500,2271,92.66666666666667,0.04485245901639344,Very Cheap
20150409T000000,895950.0,5,2.75,3180,9255,2.0,0,0,3,9,3180,0,2014,0,98074,47.6232,-122.023,3180,7782,6075,4602,96.80713128038897,0.10766557377049181,Cheap
20150319T000000,563950.0,4,2.75,3050,4750,2.0,0,0,3,8,3050,0,2014,0,98059,47.4857,-122.153,2730,5480,1700,2750,118.72631578947369,0.06412459016393443,Very Cheap
20140925T000000,332220.0,3,1.5,2580,47480,1.0,0,0,3,7,1360,1220,1953,0,98024,47.5333,-121.933,1760,48181,44900,46421,6.997051390058973,0.03373377049180328,Very Cheap
20140822T000000,1488000.0,5,6.0,6880,279968,2.0,0,3,3,12,4070,2810,2007,0,98045,47.4624,-121.779,4690,256803,273088,252113,5.314893130643502,0.18531147540983606,Cheap
20140612T000000,680000.0,3,2.5,2570,3600,2.5,0,0,3,9,2570,0,2007,0,98027,47.5412,-121.994,2570,3600,1030,1030,188.88888888888889,0.07934426229508197,Very Cheap
20150209T000000,825750.0,4,3.5,2950,3737,2.0,0,0,3,10,2270,680,2012,0,98027,47.5313,-122.074,2580,3581,787,1001,220.96601552047096,0.09845901639344262,Very Cheap
20141209T000000,338000.0,3,2.5,1690,1760,2.0,0,0,3,8,1410,280,2014,0,98106,47.5387,-122.367,1740,1760,70,20,192.04545454545453,0.034491803278688525,Very Cheap
20140718T000000,535365.0,4,2.75,2790,6969,2.0,0,0,3,8,2790,0,2012,0,98045,47.4836,-121.769,2620,6307,4179,3687,76.82092122255703,0.06037573770491803,Very Cheap
20141211T000000,608000.0,3,2.25,1720,5234,2.0,0,0,3,9,1240,480,2011,0,98118,47.5547,-122.278,1720,5825,3514,4105,116.1635460450898,0.0699016393442623,Very Cheap
20141016T000000,930000.0,3,2.25,2890,5000,3.0,0,0,3,9,2890,0,2014,0,98117,47.6983,-122.389,2020,5000,2110,2980,186.0,0.1121311475409836,Cheap
20141021T000000,565000.0,2,1.75,1130,276170,1.0,0,0,3,8,1130,0,2006,0,98022,47.2673,-122.027,2092,217800,275040,215708,2.045841329615816,0.06426229508196721,Very Cheap
20141219T000000,495000.0,2,2.25,1460,1623,2.0,0,0,3,8,1260,200,2005,0,98115,47.6764,-122.301,1460,1137,163,-323,304.99075785582255,0.05508196721311476,Very Cheap
20140722T000000,667000.0,3,2.5,2510,3819,2.0,0,0,3,8,2510,0,2007,0,98052,47.6987,-122.096,2520,3990,1309,1470,174.65305053678975,0.07763934426229509,Very Cheap
20141112T000000,495000.0,4,2.5,3390,7870,2.0,0,0,3,8,3390,0,2014,0,98188,47.4536,-122.274,1960,10069,4480,8109,62.89707750952986,0.05508196721311476,Very Cheap
20140929T000000,928990.0,4,2.5,3570,6054,2.0,0,0,3,9,3570,0,2014,0,98052,47.7053,-122.126,3600,6050,2484,2450,153.45061116617111,0.11199868852459016,Cheap
20140630T000000,345000.0,4,2.5,2280,5000,2.0,0,0,3,7,2280,0,2006,0,98038,47.3593,-122.037,2910,5000,2720,2090,69.0,0.03540983606557377,Very Cheap
20141216T000000,1065000.0,5,3.5,2920,3000,2.0,0,0,3,9,2260,660,2014,0,98103,47.6846,-122.349,1580,4000,80,2420,355.0,0.1298360655737705,Cheap
20140703T000000,519995.0,4,3.0,2590,6160,2.0,0,0,3,8,2590,0,2014,0,98059,47.4784,-122.122,2670,5600,3570,2930,84.41477272727273,0.05836,Very Cheap
20141105T000000,924000.0,5,2.75,3210,8001,2.0,0,0,3,9,3210,0,2014,0,98074,47.5935,-122.061,3190,6624,4791,3434,115.48556430446195,0.11134426229508197,Cheap
20150424T000000,295000.0,3,2.0,1230,3405,1.0,0,0,3,7,1230,0,2010,0,98058,47.438,-122.179,1440,4066,2175,2626,86.63729809104258,0.028852459016393443,Very Cheap
20140721T000000,472000.0,3,2.5,3800,104979,2.0,0,0,3,8,3210,590,2005,0,98045,47.4304,-121.841,2040,109771,101179,107731,4.496137322702635,0.052065573770491806,Very Cheap
20140801T000000,405000.0,3,2.5,1500,2314,2.0,0,0,3,7,1500,0,2005,0,98029,47.5537,-121.998,1440,2170,814,730,175.02160760587728,0.043278688524590166,Very Cheap
20140718T000000,410000.0,4,2.25,2510,4090,2.0,0,0,3,8,1840,670,2012,0,98019,47.7345,-121.967,2070,4090,1580,2020,100.24449877750611,0.043934426229508196,Very Cheap
20141125T000000,419500.0,3,1.5,1400,1091,3.0,0,0,3,8,1400,0,2007,0,98115,47.6989,-122.317,1270,1413,-309,143,384.5096241979835,0.04518032786885246,Very Cheap
20140903T000000,382000.0,3,2.25,1450,4667,2.0,0,0,3,7,1450,0,2009,0,98028,47.7611,-122.233,1490,4667,3217,3177,81.851296335976,0.040262295081967214,Very Cheap
20150224T000000,370000.0,2,2.5,1390,1821,2.0,0,0,3,7,1180,210,2007,0,98118,47.5537,-122.282,1350,1821,431,471,203.18506315211422,0.038688524590163934,Very Cheap
20141006T000000,553000.0,3,2.75,3160,9072,2.0,0,0,3,9,3160,0,2005,0,98056,47.5147,-122.177,3160,9072,5912,5912,60.95679012345679,0.06268852459016394,Very Cheap
20140630T000000,2065000.0,4,3.75,4350,7965,2.0,0,0,3,10,4350,0,2013,0,98004,47.6289,-122.205,2190,8557,3615,6367,259.25925925925924,0.26098360655737707,Cheap
20150401T000000,455950.0,4,2.5,2720,5771,2.0,0,0,3,8,2720,0,2015,0,98056,47.4917,-122.17,1940,4184,3051,2244,79.00710448795702,0.04996065573770492,Very Cheap
20141027T000000,331000.0,3,3.25,1290,1153,3.0,0,0,3,7,1290,0,2008,0,98103,47.6904,-122.346,1290,1200,-137,-90,287.0771899392888,0.03357377049180328,Very Cheap
20140507T000000,417250.0,3,2.25,1606,1452,3.0,0,0,3,8,1606,0,2009,0,98125,47.7175,-122.284,1516,1939,-154,423,287.36225895316807,0.044885245901639344,Very Cheap
20140520T000000,490000.0,5,3.5,4460,2975,3.0,0,2,3,10,3280,1180,2015,0,98119,47.6313,-122.37,2490,4231,-1485,1741,164.7058823529412,0.05442622950819672,Very Cheap
20140804T000000,325000.0,4,3.25,2800,5291,2.0,0,0,3,7,2800,0,2011,0,98022,47.1937,-121.977,2380,5291,2491,2911,61.42506142506142,0.03278688524590164,Very Cheap
20150223T000000,705000.0,5,3.5,3250,4800,2.0,0,0,3,9,2410,840,2010,0,98106,47.5618,-122.362,1330,4920,1550,3590,146.875,0.08262295081967214,Very Cheap
20140717T000000,1174660.0,6,3.5,4310,7760,2.0,0,0,3,10,3260,1050,2013,0,98059,47.5297,-122.155,4620,10217,3450,5597,151.3737113402062,0.1442177049180328,Cheap
20150222T000000,365000.0,3,2.25,1310,915,2.0,0,0,3,7,1060,250,2007,0,98144,47.5738,-122.293,1500,1215,-395,-285,398.90710382513663,0.0380327868852459,Very Cheap
20141117T000000,403000.0,2,1.5,1240,1101,2.0,0,0,3,8,1080,160,2009,0,98144,47.5758,-122.309,1530,1209,-139,-321,366.03088101725706,0.04301639344262295,Very Cheap
20140813T000000,409000.0,3,2.5,1950,7263,2.0,0,0,3,7,1950,0,2007,0,98065,47.5194,-121.869,2190,5900,5313,3710,56.31281839460278,0.04380327868852459,Very Cheap
20150407T000000,391000.0,3,2.5,1800,1120,2.0,0,0,3,8,1800,0,2011,0,98126,47.5436,-122.369,1800,2380,-680,580,349.10714285714283,0.04144262295081967,Very Cheap
20140616T000000,542525.0,4,2.5,2650,5600,2.0,0,0,3,8,2650,0,2014,0,98059,47.4786,-122.122,2650,5600,2950,2950,96.87946428571429,0.06131475409836066,Very Cheap
20140507T000000,339950.0,2,1.0,820,681,3.0,0,0,3,8,820,0,2006,0,98103,47.6619,-122.352,820,1156,-139,336,499.1923641703377,0.03474754098360656,Very Cheap
20140819T000000,499990.0,4,2.75,2620,7001,2.0,0,0,3,8,2620,0,2012,0,98045,47.4838,-121.769,2620,6543,4381,3923,71.41694043708041,0.05573639344262295,Very Cheap
20140923T000000,1765000.0,4,3.25,3980,10249,2.0,0,0,3,10,3980,0,2011,0,98004,47.5873,-122.196,2450,10912,6269,8462,172.2119231144502,0.2216393442622951,Cheap
20150323T000000,608000.0,3,3.5,1660,2298,2.0,0,0,3,8,1260,400,2009,0,98116,47.5809,-122.403,1500,2198,638,698,264.57789382071365,0.0699016393442623,Very Cheap
20150312T000000,392000.0,4,2.5,2130,4028,2.0,0,0,3,8,2130,0,2014,0,98146,47.5108,-122.363,1830,7817,1898,5987,97.31876861966236,0.04157377049180328,Very Cheap
20150417T000000,320000.0,3,1.75,1790,66250,1.5,0,0,3,7,1790,0,2003,0,98014,47.7179,-121.403,1440,59346,64460,57906,4.830188679245283,0.032131147540983604,Very Cheap
20150417T000000,274800.0,3,1.75,1410,1988,2.0,0,0,3,8,1410,0,2014,0,98106,47.5171,-122.347,1410,1899,578,489,138.22937625754528,0.02620327868852459,Very Cheap
20150427T000000,325000.0,3,2.25,1330,1198,2.0,0,0,3,8,1080,250,2007,0,98106,47.555,-122.362,1260,1062,-132,-198,271.28547579298834,0.03278688524590164,Very Cheap
20150429T000000,418500.0,4,2.5,2190,4866,2.0,0,0,3,7,2190,0,2009,0,98059,47.4907,-122.152,2190,5670,2676,3480,86.00493218249075,0.04504918032786885,Very Cheap
20140502T000000,300000.0,3,2.5,2540,5050,2.0,0,0,3,7,2540,0,2006,0,98042,47.3358,-122.055,2280,5050,2510,2770,59.40594059405941,0.029508196721311476,Very Cheap
20150105T000000,269950.0,3,2.5,2244,4079,2.0,0,0,3,7,2244,0,2012,0,98001,47.2606,-122.254,2077,4078,1835,2001,66.18043638146605,0.025567213114754097,Very Cheap
20150506T000000,358000.0,3,2.5,2026,7611,2.0,0,0,3,8,2026,0,2010,0,98042,47.3733,-122.162,2270,7611,5585,5341,47.0371830245697,0.03711475409836065,Very Cheap
20150504T000000,350000.0,3,2.5,1730,4086,2.0,0,0,3,8,1730,0,2013,0,98146,47.5016,-122.341,2030,4086,2356,2056,85.65834557023985,0.036065573770491806,Very Cheap
20140528T000000,782000.0,4,3.5,3910,8095,2.0,0,0,3,9,3130,780,2007,0,98029,47.5588,-122.036,3770,7021,4185,3251,96.60284126003705,0.09272131147540984,Very Cheap
20140915T000000,779000.0,3,2.5,1580,1487,3.0,0,1,3,9,1580,0,2009,0,98119,47.6276,-122.359,1610,1297,-93,-313,523.8735709482179,0.09232786885245901,Very Cheap
20141217T000000,685000.0,4,2.5,2510,3479,2.0,0,0,3,8,2510,0,2007,0,98052,47.6981,-122.099,2540,4171,969,1631,196.89565967231962,0.08,Very Cheap
20140529T000000,305000.0,2,2.25,1000,905,3.0,0,0,3,8,1000,0,2006,0,98117,47.6842,-122.387,980,1023,-95,43,337.01657458563534,0.03016393442622951,Very Cheap
20150417T000000,350000.0,4,2.5,1660,2500,2.0,0,0,3,7,1660,0,2007,0,98118,47.5437,-122.283,1030,5000,840,3970,140.0,0.036065573770491806,Very Cheap
20140923T000000,775000.0,4,3.5,3060,4573,2.0,0,0,3,9,2410,650,2012,0,98029,47.5522,-122.001,3170,3634,1513,464,169.4729936584299,0.09180327868852459,Very Cheap
20140828T000000,317750.0,3,2.5,1980,4500,2.0,0,0,3,7,1980,0,2012,0,98042,47.3682,-122.117,1980,4500,2520,2520,70.61111111111111,0.03183606557377049,Very Cheap
20140508T000000,438000.0,2,1.0,980,1179,2.0,0,0,3,8,980,0,2010,0,98119,47.6381,-122.375,1190,1600,199,410,371.50127226463104,0.04760655737704918,Very Cheap
20140528T000000,325000.0,2,2.5,1050,1609,2.0,0,0,3,7,1050,0,2005,0,98144,47.5854,-122.313,1120,1693,559,573,201.98881292728402,0.03278688524590164,Very Cheap
20150428T000000,830000.0,4,3.25,3080,4287,2.0,0,0,3,10,2230,850,2012,0,98027,47.5313,-122.076,2250,2520,1207,270,193.60858409143924,0.09901639344262295,Very Cheap
20140922T000000,353000.0,3,2.25,1900,3800,2.0,0,0,3,7,1900,0,2006,0,98059,47.4866,-122.16,1950,3800,1900,1850,92.89473684210526,0.03645901639344262,Very Cheap
20140725T000000,460000.0,4,2.5,2200,6400,2.0,0,0,3,8,2200,0,2010,0,98059,47.4856,-122.156,2600,5870,4200,3270,71.875,0.050491803278688525,Very Cheap
20150316T000000,370000.0,3,1.5,1360,1167,3.0,0,0,3,8,1360,0,2008,0,98103,47.6962,-122.349,1360,1167,-193,-193,317.0522707797772,0.038688524590163934,Very Cheap
20140619T000000,330000.0,3,2.5,2238,7209,2.0,0,0,3,8,2238,0,2011,0,98023,47.2966,-122.353,2456,7212,4971,4756,45.77611319184353,0.03344262295081967,Very Cheap
20150128T000000,569888.0,4,2.5,2590,6474,2.0,0,0,3,8,2590,0,2014,0,98056,47.5164,-122.19,1960,8679,3884,6719,88.02718566573988,0.06490334426229508,Very Cheap
20140918T000000,353900.0,3,2.5,2517,3900,2.0,0,0,3,8,2517,0,2014,0,98092,47.3211,-122.182,2390,7108,1383,4718,90.74358974358974,0.03657704918032787,Very Cheap
20150304T000000,695000.0,4,3.5,3510,9084,2.0,0,0,3,10,3510,0,2001,0,98065,47.5402,-121.875,3690,9568,5574,5878,76.50814619110524,0.08131147540983606,Very Cheap
20140718T000000,288790.0,3,1.75,1290,1237,2.0,0,0,3,7,1060,230,2008,0,98027,47.54,-122.026,1370,942,-53,-428,233.45998383185125,0.028038032786885245,Very Cheap
20150213T000000,334950.0,5,3.0,2230,8642,1.0,0,0,3,7,1330,900,2014,0,98168,47.487,-122.32,2100,11056,6412,8956,38.758389261744966,0.03409180327868853,Very Cheap
20141215T000000,869950.0,4,2.75,3140,7928,2.0,0,0,3,9,3140,0,2013,0,98074,47.5923,-122.058,3500,7055,4788,3555,109.73133198789102,0.10425573770491803,Cheap
20141008T000000,557500.0,3,3.5,3350,5025,2.0,0,2,3,8,2670,680,2014,0,98144,47.5699,-122.296,2030,5117,1675,3087,110.94527363184079,0.06327868852459016,Very Cheap
20140919T000000,389990.0,4,2.5,2245,4330,2.0,0,0,3,8,2245,0,2014,0,98038,47.3557,-122.063,2530,4478,2085,1948,90.06697459584295,0.04131016393442623,Very Cheap
20140604T000000,455000.0,3,1.75,1420,1189,3.0,0,0,3,8,1420,0,2006,0,98103,47.6625,-122.352,1380,1196,-231,-184,382.6745164003364,0.049836065573770495,Very Cheap
20141030T000000,598500.0,3,3.0,1560,2091,3.0,0,0,3,8,1560,0,2006,0,98103,47.6604,-122.352,1530,2091,531,561,286.22668579626975,0.06865573770491804,Very Cheap
20150302T000000,750000.0,4,2.75,2810,5497,2.0,0,0,3,9,2810,0,2011,0,98052,47.7081,-122.116,2990,5842,2687,2852,136.4380571220666,0.08852459016393442,Very Cheap
20141113T000000,729999.0,2,2.25,1630,1686,2.0,0,0,3,10,1330,300,2014,0,98122,47.6113,-122.314,1570,2580,56,1010,432.97686832740214,0.08590150819672131,Very Cheap
20150303T000000,299950.0,3,2.5,1740,4497,2.0,0,0,3,7,1740,0,2012,0,98042,47.3697,-122.117,1950,4486,2757,2536,66.70002223704692,0.029501639344262295,Very Cheap
20140709T000000,374950.0,3,2.25,1390,1484,3.0,0,0,3,8,1390,0,2007,0,98103,47.6912,-122.343,1250,1087,94,-163,252.66172506738545,0.03933770491803279,Very Cheap
20150219T000000,386950.0,3,2.5,1070,1089,2.0,0,0,3,7,900,170,2009,0,98116,47.5902,-122.387,1450,1437,19,-13,355.32598714416895,0.040911475409836064,Very Cheap
20140710T000000,535000.0,5,3.25,2850,4551,2.0,0,0,3,8,2370,480,2006,0,98059,47.4916,-122.144,2850,4849,1701,1999,117.55658097121511,0.06032786885245902,Very Cheap
20140831T000000,890000.0,5,3.25,4100,7578,2.0,0,2,3,10,4100,0,2011,0,98075,47.5955,-121.974,3710,8156,3478,4446,117.44523621008182,0.10688524590163935,Cheap
20150203T000000,1050000.0,4,2.5,3260,5974,2.0,0,1,3,9,2820,440,2007,0,98115,47.6772,-122.267,2260,6780,2714,4520,175.76163374623368,0.12786885245901639,Cheap
20141015T000000,1107460.0,4,3.5,3660,4760,2.0,0,0,3,9,2840,820,2014,0,98199,47.6482,-122.409,3210,4640,1100,1430,232.6596638655462,0.1354045901639344,Cheap
20141003T000000,436952.0,4,2.5,2708,4772,2.0,0,0,3,9,2708,0,2014,0,98092,47.3413,-122.178,2502,4900,2064,2398,91.56580050293378,0.04746911475409836,Very Cheap
20140609T000000,365000.0,3,2.5,1800,2700,2.0,0,0,3,8,1800,0,2011,0,98126,47.5458,-122.369,1580,2036,900,456,135.1851851851852,0.0380327868852459,Very Cheap
20140625T000000,288000.0,3,2.5,1150,887,3.0,0,0,3,7,1150,0,2007,0,98133,47.7072,-122.356,1180,915,-263,-265,324.68996617812854,0.027934426229508195,Very Cheap
20150220T000000,700000.0,3,2.5,2230,4006,2.0,0,0,3,8,2230,0,2014,0,98133,47.73,-122.335,2230,4180,1776,1950,174.7378931602596,0.08196721311475409,Very Cheap
20140509T000000,800000.0,4,3.25,3540,159430,2.0,0,0,3,9,3540,0,2007,0,98014,47.6285,-121.899,1940,392040,155890,390100,5.017876183905162,0.09508196721311475,Very Cheap
20150511T000000,899000.0,4,3.5,2490,5500,2.0,0,0,3,9,1780,710,2015,0,98136,47.5499,-122.393,1710,5500,3010,3790,163.45454545454547,0.10806557377049181,Cheap
20141218T000000,465750.0,3,2.5,2670,4534,2.0,0,0,3,9,2670,0,2007,0,98056,47.51,-122.184,3040,5079,1864,2039,102.72386413762682,0.05124590163934426,Very Cheap
20140618T000000,485000.0,2,2.5,1430,923,3.0,0,0,3,8,1410,20,2008,0,98103,47.6683,-122.355,1620,1505,-507,-115,525.4604550379198,0.05377049180327869,Very Cheap
20140603T000000,494995.0,5,2.75,2670,3800,2.0,0,0,3,8,2670,0,2014,0,98059,47.4783,-122.123,2670,3800,1130,1130,130.26184210526316,0.05508131147540984,Very Cheap
20150202T000000,255000.0,3,2.5,2555,5720,2.0,0,0,3,8,2555,0,2006,0,98031,47.386,-122.184,2844,5769,3165,2925,44.58041958041958,0.02360655737704918,Very Cheap
20140729T000000,530000.0,3,2.5,1970,6295,2.0,0,0,3,7,1970,0,2011,0,98065,47.5158,-121.874,2710,6009,4325,3299,84.19380460683082,0.05967213114754098,Very Cheap
20140616T000000,435000.0,3,2.0,1980,2674,3.0,0,0,3,8,1980,0,2007,0,98136,47.5524,-122.382,1440,2674,694,1234,162.67763649962603,0.04721311475409836,Very Cheap
20140811T000000,639000.0,3,2.5,2010,3300,2.0,0,0,3,9,1610,400,2014,0,98118,47.5573,-122.287,1660,4950,1290,3290,193.63636363636363,0.0739672131147541,Very Cheap
20140709T000000,440000.0,3,1.5,1270,1413,3.0,0,0,3,8,1270,0,2007,0,98115,47.6989,-122.317,1270,1413,143,143,311.3941967445152,0.04786885245901639,Very Cheap
20140515T000000,914500.0,4,2.5,3950,10856,3.0,0,0,3,10,3950,0,2013,0,98075,47.5818,-121.996,3200,10856,6906,7656,84.23913043478261,0.1100983606557377,Cheap
20141105T000000,580000.0,3,2.0,1870,5300,1.0,0,0,3,8,1870,0,2009,0,98053,47.7106,-122.02,1870,5050,3430,3180,109.43396226415095,0.06622950819672131,Very Cheap
20150407T000000,250000.0,1,1.5,1180,1688,2.0,0,0,3,8,1070,110,2007,0,98126,47.549,-122.372,1380,2059,508,679,148.1042654028436,0.022950819672131147,Very Cheap
20150316T000000,410000.0,3,2.5,1420,1269,3.0,0,0,3,7,1420,0,2007,0,98103,47.6904,-122.342,1420,1300,-151,-120,323.0890464933018,0.043934426229508196,Very Cheap
20140928T000000,531155.0,4,2.75,2810,5046,2.0,0,0,3,9,2810,0,2014,0,98038,47.3559,-122.022,3060,4934,2236,1874,105.26258422512882,0.05982360655737705,Very Cheap
20140919T000000,358000.0,3,2.5,1400,1529,2.0,0,0,3,7,1400,0,2005,0,98029,47.5535,-121.997,1440,1536,129,96,234.1399607586658,0.03711475409836065,Very Cheap
20140701T000000,425000.0,3,2.5,1950,5689,2.0,0,0,3,7,1950,0,2009,0,98065,47.5158,-121.873,2190,5653,3739,3463,74.7055721567938,0.04590163934426229,Very Cheap
20140711T000000,326000.0,3,2.25,1930,3462,2.0,0,0,3,7,1930,0,2004,0,98019,47.7453,-121.985,1930,2952,1532,1022,94.16522241478914,0.032918032786885244,Very Cheap
20140513T000000,650000.0,4,2.5,2210,4861,2.0,0,0,3,9,2210,0,2013,0,98117,47.6959,-122.364,1590,5080,2651,3490,133.7173421106768,0.07540983606557378,Very Cheap
20150514T000000,749950.0,4,3.5,2630,3757,2.0,0,0,3,10,2200,430,2008,0,98027,47.5322,-122.075,2620,2699,1127,79,199.6140537663029,0.08851803278688525,Very Cheap
20150312T000000,239950.0,3,1.75,1600,4888,1.0,0,0,3,6,1600,0,2014,0,98042,47.383,-122.097,2520,5700,3288,3180,49.08960720130933,0.021632786885245902,Very Cheap
20140609T000000,315000.0,3,2.5,1480,1590,2.0,0,0,3,8,1150,330,2010,0,98106,47.5302,-122.362,1480,5761,110,4281,198.11320754716982,0.031475409836065574,Very Cheap
20140523T000000,375000.0,2,2.5,750,1430,2.0,0,0,3,8,750,0,2006,0,98122,47.6093,-122.31,1320,2790,680,1470,262.23776223776224,0.03934426229508197,Very Cheap
20150427T000000,375000.0,3,1.5,1290,1213,3.0,0,0,3,8,1290,0,2007,0,98103,47.6965,-122.34,1360,1227,-77,-133,309.15086562242374,0.03934426229508197,Very Cheap
20140922T000000,349000.0,3,3.25,1340,1151,3.0,0,0,3,7,1340,0,2008,0,98103,47.6904,-122.346,1290,1200,-189,-90,303.21459600347526,0.035934426229508196,Very Cheap
20150225T000000,450000.0,2,1.5,1020,1049,3.0,0,0,3,8,1020,0,2008,0,98103,47.68,-122.348,1350,1395,29,45,428.9799809342231,0.04918032786885246,Very Cheap
20141014T000000,669950.0,3,3.0,2330,1944,2.5,0,0,3,8,1950,380,2014,0,98027,47.5446,-122.016,2290,1407,-386,-883,344.6244855967078,0.07802622950819672,Very Cheap
20140711T000000,504600.0,5,3.0,2360,5000,1.0,0,0,3,7,1390,970,2008,0,98103,47.6931,-122.33,2180,5009,2640,2829,100.92,0.05634098360655738,Very Cheap
20140602T000000,400000.0,3,2.5,1495,936,3.0,0,0,3,8,1405,90,2006,0,98144,47.593,-122.295,1495,1186,-559,-309,427.35042735042737,0.04262295081967213,Very Cheap
20140701T000000,1020000.0,4,3.5,3770,8501,2.0,0,0,3,10,3770,0,2008,0,98033,47.6744,-122.196,1520,9660,4731,8140,119.98588401364546,0.12393442622950819,Cheap
20150408T000000,518000.0,5,2.5,2890,13104,2.0,0,0,3,8,2890,0,2006,0,98019,47.7277,-121.958,3020,9300,10214,6280,39.52991452991453,0.0580983606557377,Very Cheap
20140813T000000,535000.0,3,2.75,1320,1125,3.0,0,0,3,8,1320,0,2008,0,98103,47.6598,-122.348,1320,1266,-195,-54,475.55555555555554,0.06032786885245902,Very Cheap
20140721T000000,337500.0,4,2.5,2330,4907,2.0,0,0,3,7,2330,0,2013,0,98042,47.359,-122.081,2300,3836,2577,1536,68.77929488485836,0.03442622950819672,Very Cheap
20150310T000000,380000.0,4,2.5,3120,5001,2.0,0,0,3,9,3120,0,2005,0,98023,47.2779,-122.349,3120,5244,1881,2124,75.98480303939212,0.04,Very Cheap
20140710T000000,875000.0,5,3.0,2960,15152,2.0,0,0,3,9,2960,0,2004,0,98033,47.6689,-122.179,1850,9453,12192,7603,57.74815205913411,0.10491803278688525,Cheap
20140902T000000,385000.0,3,2.25,1630,1598,3.0,0,0,3,8,1630,0,2008,0,98103,47.6904,-122.347,1320,1605,-32,285,240.9261576971214,0.04065573770491803,Very Cheap
20141201T000000,1987500.0,5,3.5,5230,8960,2.0,0,0,3,11,4450,780,2014,0,98004,47.5964,-122.201,2310,9603,3730,7293,221.81919642857142,0.25081967213114753,Cheap
20150508T000000,649500.0,4,3.0,3150,6599,2.0,0,0,3,9,3150,0,2008,0,98056,47.5279,-122.199,2680,9430,3449,6750,98.42400363691469,0.07534426229508197,Very Cheap
20140512T000000,1050000.0,4,3.75,3280,11000,2.0,0,0,3,10,2320,960,2008,0,98033,47.6855,-122.201,2400,8351,7720,5951,95.45454545454545,0.12786885245901639,Cheap
20150109T000000,249000.0,3,1.0,1030,24750,1.0,0,2,3,5,1030,0,1943,0,98023,47.3343,-122.362,2810,28800,23720,25990,10.06060606060606,0.02281967213114754,Very Cheap
20141003T000000,525000.0,4,2.5,3130,5795,2.0,0,0,3,9,3130,0,2008,0,98059,47.4997,-122.151,2950,5259,2665,2309,90.595340811044,0.05901639344262295,Very Cheap
20140612T000000,402000.0,3,3.5,1240,1666,2.0,0,0,3,7,1000,240,2008,0,98136,47.5496,-122.388,1110,1027,426,-83,241.29651860744298,0.04288524590163934,Very Cheap
20141101T000000,1750000.0,4,2.75,3560,8975,2.0,0,0,3,10,3560,0,2014,0,98004,47.6322,-122.209,3440,12825,5415,9385,194.98607242339833,0.21967213114754097,Cheap
20141020T000000,359800.0,5,2.5,2170,2752,2.0,0,0,3,8,2170,0,2014,0,98106,47.5167,-122.347,1800,2752,582,952,130.74127906976744,0.03735081967213115,Very Cheap
20140925T000000,330000.0,3,2.5,1520,3003,2.0,0,0,3,7,1520,0,2009,0,98059,47.4876,-122.153,1820,3030,1483,1210,109.89010989010988,0.03344262295081967,Very Cheap
20150325T000000,433000.0,3,2.5,1270,1062,2.0,0,0,3,8,1060,210,2008,0,98105,47.6568,-122.321,1260,1112,-208,-148,407.7212806026365,0.04695081967213115,Very Cheap
20141112T000000,1010800.0,4,3.25,3610,4000,2.0,0,0,3,9,2640,970,2007,0,98199,47.658,-122.396,1980,4000,390,2020,252.7,0.12272786885245901,Cheap
20150406T000000,599832.0,3,2.75,3230,5200,2.0,0,0,3,9,2680,550,2014,0,98065,47.519,-121.878,3100,4900,1970,1800,115.35230769230769,0.06883042622950819,Very Cheap
20140623T000000,312891.0,5,3.0,2300,8214,2.0,0,0,3,8,2300,0,2013,0,98001,47.3052,-122.276,2594,4950,5914,2356,38.092403214024834,0.03119881967213115,Very Cheap
20140912T000000,449000.0,2,2.5,1460,1296,2.0,0,0,3,8,1160,300,2008,0,98144,47.5923,-122.296,1460,1296,-164,-164,346.45061728395063,0.049049180327868855,Very Cheap
20140527T000000,495000.0,3,2.5,1750,1548,3.0,0,0,3,9,1750,0,2013,0,98118,47.5532,-122.282,1750,3960,-202,2210,319.7674418604651,0.05508196721311476,Very Cheap
20140515T000000,819995.0,5,2.75,3030,10335,2.0,0,0,3,9,3030,0,2013,0,98056,47.5305,-122.184,2720,11213,7305,8493,79.34155781325593,0.09770426229508197,Very Cheap
20141113T000000,407500.0,3,3.5,1522,1465,2.0,0,0,3,8,1248,274,2006,0,98117,47.6922,-122.375,1522,1341,-57,-181,278.15699658703073,0.04360655737704918,Very Cheap
20150105T000000,850000.0,4,3.75,3890,22000,2.0,0,0,3,10,3890,0,2007,0,98027,47.5052,-121.906,1610,23142,18110,21532,38.63636363636363,0.10163934426229508,Cheap
20140725T000000,1720000.0,5,4.0,4590,35046,2.0,0,0,3,10,4590,0,2008,0,98033,47.6647,-122.16,3350,35857,30456,32507,49.078354163099924,0.2157377049180328,Cheap
20150428T000000,1459000.0,4,4.0,4620,130208,2.0,0,0,3,10,4620,0,2014,0,98024,47.5885,-121.939,4620,131007,125588,126387,11.205148685180633,0.18150819672131147,Cheap
20140917T000000,579000.0,4,2.75,3220,9825,2.0,0,0,3,8,3220,0,2012,0,98059,47.4863,-122.143,2820,8566,6605,5746,58.93129770992366,0.06609836065573771,Very Cheap
20140811T000000,890776.0,5,2.75,3170,8093,2.0,0,0,3,9,3170,0,2014,0,98075,47.5933,-122.06,3210,7062,4923,3852,110.06746571110837,0.10698701639344262,Cheap
20150120T000000,352500.0,2,2.5,980,1010,3.0,0,0,3,8,980,0,2008,0,98117,47.6844,-122.387,980,1023,30,43,349.009900990099,0.03639344262295082,Very Cheap
20150501T000000,529000.0,3,1.75,2340,7724,1.0,0,0,3,10,2340,0,2010,0,98058,47.4593,-122.134,3040,5787,5384,2747,68.48783013982393,0.05954098360655738,Very Cheap
20150327T000000,484000.0,3,2.25,1620,1425,3.0,0,0,3,8,1540,80,2009,0,98027,47.5405,-122.026,1620,1237,-195,-383,339.64912280701753,0.05363934426229508,Very Cheap
20150417T000000,400000.0,3,2.5,1910,4408,3.0,0,0,3,8,1910,0,2007,0,98133,47.7634,-122.35,1910,8154,2498,6244,90.74410163339383,0.04262295081967213,Very Cheap
20150417T000000,649950.0,3,2.5,2420,6847,2.0,0,0,3,9,2420,0,2009,0,98133,47.7329,-122.356,1180,8100,4427,6920,94.92478457718708,0.07540327868852459,Very Cheap
20140702T000000,915000.0,3,4.5,3850,62726,2.0,0,0,3,10,3120,730,2013,0,98053,47.6735,-122.058,2630,46609,58876,43979,14.58725249497816,0.11016393442622952,Cheap
20150504T000000,534950.0,5,2.5,3220,10572,2.0,0,0,3,8,3220,0,2006,0,98019,47.7268,-121.957,2890,9090,7352,6200,50.60064320847522,0.06032131147540984,Very Cheap
20140506T000000,776000.0,4,2.5,3040,6425,2.0,0,0,3,8,3040,0,2008,0,98052,47.6788,-122.117,3040,7800,3385,4760,120.77821011673151,0.09193442622950819,Very Cheap
20150501T000000,370000.0,3,1.75,1496,1423,2.0,0,0,3,8,1248,248,2006,0,98133,47.715,-122.355,1460,1423,-73,-37,260.0140548137737,0.038688524590163934,Very Cheap
20140714T000000,610000.0,3,1.75,1630,1500,3.0,0,0,3,8,1630,0,2014,0,98103,47.6536,-122.354,1570,1335,-130,-235,406.6666666666667,0.07016393442622951,Very Cheap
20141014T000000,850000.0,5,3.5,4200,5400,2.0,0,0,3,9,3140,1060,2012,0,98052,47.7077,-122.12,3300,5564,1200,2264,157.40740740740742,0.10163934426229508,Cheap
20141105T000000,443000.0,3,2.5,2430,7049,2.0,0,0,3,8,2430,0,2007,0,98106,47.5399,-122.352,1770,7049,4619,5279,62.84579372960704,0.048262295081967214,Very Cheap
20150203T000000,1150000.0,5,4.25,4010,8252,2.0,0,0,3,10,4010,0,2015,0,98075,47.5974,-122.013,3370,8252,4242,4882,139.3601551139118,0.14098360655737704,Cheap
20140801T000000,453000.0,3,2.5,1510,1618,2.5,0,0,3,8,1330,180,2011,0,98199,47.6515,-122.384,1350,1397,108,47,279.9752781211372,0.04957377049180328,Very Cheap
20150410T000000,735000.0,4,3.5,2340,2810,2.0,0,2,3,8,1730,610,2011,0,98027,47.5403,-122.028,2600,2843,470,243,261.56583629893237,0.08655737704918033,Very Cheap
20140708T000000,810000.0,2,2.75,2700,8572,1.0,0,0,3,9,2700,0,2007,0,98053,47.7236,-122.033,2680,8569,5872,5889,94.493700419972,0.09639344262295083,Very Cheap
20140617T000000,1555000.0,3,3.5,4360,6240,2.0,0,3,3,10,2960,1400,2008,0,98103,47.6791,-122.354,1920,3910,1880,1990,249.19871794871796,0.1940983606557377,Cheap
20140509T000000,2238890.0,5,6.5,7270,130017,2.0,0,0,3,12,6420,850,2010,0,98027,47.5371,-121.982,1800,44890,122747,43090,17.219978925832777,0.2837888524590164,Cheap
20140808T000000,377500.0,3,2.5,1350,886,3.0,0,0,3,8,1270,80,2006,0,98136,47.5491,-122.387,1350,886,-464,-464,426.0722347629797,0.039672131147540986,Very Cheap
20140618T000000,482000.0,3,3.25,1380,1120,3.0,0,0,3,8,1380,0,2008,0,98103,47.6617,-122.349,1310,1405,-260,95,430.35714285714283,0.05337704918032787,Very Cheap
20140818T000000,600000.0,2,2.5,1830,1988,2.0,0,0,3,9,1530,300,2011,0,98116,47.5779,-122.409,1800,2467,158,667,301.8108651911469,0.06885245901639345,Very Cheap
20140807T000000,420000.0,3,2.5,1470,1571,2.0,0,0,3,8,1180,290,2007,0,98116,47.5722,-122.387,1580,4329,101,2749,267.3456397199236,0.04524590163934426,Very Cheap
20150421T000000,480000.0,4,2.5,2940,9172,2.0,0,0,3,9,2940,0,2006,0,98001,47.3444,-122.269,2660,7955,6232,5295,52.33318796336677,0.05311475409836065,Very Cheap
20150331T000000,406000.0,2,2.0,1110,1095,3.0,0,0,3,7,980,130,2008,0,98136,47.5494,-122.388,1110,1083,-15,-27,370.7762557077626,0.04340983606557377,Very Cheap
20140513T000000,505000.0,4,2.5,2790,5602,2.0,0,0,3,8,2790,0,2009,0,98059,47.4959,-122.15,2790,5309,2812,2519,90.14637629418066,0.05639344262295082,Very Cheap
20150227T000000,1865000.0,4,3.75,3790,8797,2.0,0,0,3,11,3290,500,2006,0,98039,47.6351,-122.236,2660,12150,5007,9490,212.00409230419461,0.23475409836065575,Cheap
20141215T000000,942990.0,4,2.5,3570,6218,2.0,0,0,3,9,3570,0,2014,0,98052,47.7046,-122.123,3230,5972,2648,2742,151.65487294950145,0.11383475409836065,Cheap
20141001T000000,440000.0,3,2.25,1230,1097,3.0,0,0,3,8,1230,0,2009,0,98107,47.6697,-122.372,1420,1437,-133,17,401.09389243391064,0.04786885245901639,Very Cheap
20140626T000000,390000.0,3,3.25,1370,913,2.0,0,0,3,8,1100,270,2006,0,98116,47.5636,-122.388,1370,915,-457,-455,427.1631982475356,0.04131147540983607,Very Cheap
20140711T000000,475000.0,3,3.25,1380,1121,3.0,0,0,3,8,1380,0,2008,0,98103,47.6617,-122.349,1310,1405,-259,95,423.728813559322,0.05245901639344262,Very Cheap
20150407T000000,420000.0,1,2.0,1070,675,2.0,0,0,3,8,880,190,2007,0,98118,47.5574,-122.284,1220,788,-395,-432,622.2222222222222,0.04524590163934426,Very Cheap
20140825T000000,1408760.0,4,4.0,4920,50621,2.0,0,0,3,10,4280,640,2012,0,98053,47.6575,-122.006,4920,74052,45701,69132,27.82955690326149,0.17491934426229508,Cheap
20141209T000000,1378000.0,5,3.5,5150,12230,2.0,0,2,3,10,3700,1450,2007,0,98008,47.6249,-122.09,2940,13462,7080,10522,112.67375306623057,0.17088524590163934,Cheap
20150302T000000,462500.0,6,3.0,2390,4000,2.0,0,0,3,7,2390,0,2014,0,98118,47.5173,-122.286,1680,5000,1610,3320,115.625,0.05081967213114754,Very Cheap
20150507T000000,579950.0,4,2.75,2460,8643,2.0,0,0,3,9,2460,0,2011,0,98059,47.4828,-122.133,3110,8626,6183,5516,67.10054379266458,0.06622295081967212,Very Cheap
20150505T000000,861111.0,4,2.5,3650,7090,2.0,0,0,3,10,3650,0,2008,0,98074,47.606,-122.052,3860,7272,3440,3412,121.45430183356841,0.10309652459016394,Cheap
20141124T000000,1450000.0,4,3.5,4300,108865,2.0,0,0,3,11,4300,0,2014,0,98074,47.6258,-122.005,4650,107498,104565,102848,13.319248610664584,0.18032786885245902,Cheap
20150428T000000,290000.0,3,2.25,1610,3764,2.0,0,0,3,7,1610,0,2012,0,98042,47.3589,-122.083,1610,3825,2154,2215,77.04569606801276,0.02819672131147541,Very Cheap
20140618T000000,535000.0,4,2.5,2610,4595,2.0,0,0,3,8,2610,0,2008,0,98028,47.7728,-122.235,2440,4588,1985,2148,116.43090315560391,0.06032786885245902,Very Cheap
20150217T000000,585000.0,3,2.5,1750,1381,3.0,0,0,3,8,1750,0,2008,0,98122,47.6021,-122.294,1940,4800,-369,2860,423.6060825488776,0.06688524590163934,Very Cheap
20140623T000000,670000.0,3,2.5,3310,5300,2.0,0,2,3,8,2440,870,2008,0,98136,47.5178,-122.389,2140,7500,1990,5360,126.41509433962264,0.0780327868852459,Very Cheap
20150407T000000,3000000.0,4,3.75,5090,14823,1.0,0,0,3,11,4180,910,2013,0,98004,47.62,-122.207,3030,12752,9733,9722,202.38818053025705,0.3836065573770492,Medium
20141203T000000,346000.0,3,2.0,1060,1184,2.0,0,0,3,7,730,330,2006,0,98136,47.5443,-122.385,1270,1601,124,331,292.22972972972974,0.03554098360655738,Very Cheap
20140617T000000,1325000.0,4,4.0,4420,16526,2.0,0,0,3,11,4420,0,2013,0,98075,47.5914,-122.027,3510,50447,12106,46937,80.17669127435556,0.16393442622950818,Cheap
20150226T000000,999999.0,3,2.5,2100,4097,2.0,0,0,3,9,2100,0,2008,0,98004,47.5983,-122.2,1780,4764,1997,2984,244.0807908225531,0.12131134426229508,Cheap
20140811T000000,599000.0,3,1.75,1650,1180,3.0,0,0,3,8,1650,0,2014,0,98105,47.6636,-122.319,1720,1960,-470,240,507.6271186440678,0.06872131147540983,Very Cheap
20141015T000000,332000.0,4,2.5,2380,5737,2.0,0,0,3,7,2380,0,2010,0,98023,47.2815,-122.356,2380,5396,3357,3016,57.86996688164546,0.033704918032786885,Very Cheap
20140612T000000,336750.0,2,2.25,1170,1011,2.0,0,0,3,7,1170,0,2009,0,98027,47.5321,-122.073,1240,750,-159,-490,333.0860534124629,0.03432786885245902,Very Cheap
20141211T000000,370000.0,4,2.5,2531,6843,2.0,0,0,3,8,2531,0,2013,0,98030,47.385,-122.189,2604,6238,4312,3634,54.069852403916414,0.038688524590163934,Very Cheap
20140509T000000,324000.0,3,2.25,998,904,2.0,0,0,3,7,798,200,2007,0,98117,47.6983,-122.367,998,1110,-94,112,358.4070796460177,0.03265573770491803,Very Cheap
20150219T000000,338500.0,3,2.25,1333,1470,3.0,0,3,3,7,1333,0,2009,0,98125,47.7058,-122.302,1360,1680,137,320,230.2721088435374,0.03455737704918033,Very Cheap
20150113T000000,1881580.0,5,3.5,4410,13000,2.0,0,3,3,10,2920,1490,2014,0,98006,47.5382,-122.111,5790,12969,8590,7179,144.7369230769231,0.23692852459016395,Cheap
20150410T000000,402723.0,3,2.75,1160,1073,2.0,0,0,3,7,880,280,2007,0,98144,47.5788,-122.315,1250,5400,-87,4150,375.3243243243243,0.042980065573770494,Very Cheap
20150227T000000,715000.0,4,3.25,2630,7770,2.0,0,0,3,9,2630,0,2014,0,98126,47.5459,-122.377,1370,7770,5140,6400,92.02059202059202,0.0839344262295082,Very Cheap
20141007T000000,459000.0,3,1.5,1160,1031,3.0,0,0,3,8,1160,0,2008,0,98103,47.6538,-122.357,1268,1688,-129,420,445.19883608147427,0.050360655737704915,Very Cheap
20150423T000000,589999.0,3,2.5,2140,3628,2.0,0,0,3,8,1960,180,2006,0,98027,47.537,-122.074,2280,2812,1488,532,162.62375964718854,0.06754085245901639,Very Cheap
20141215T000000,405000.0,4,2.5,1980,5020,2.0,0,0,3,7,1980,0,2007,0,98056,47.5147,-122.19,1980,5064,3040,3084,80.67729083665338,0.043278688524590166,Very Cheap
20140707T000000,509900.0,3,2.5,3030,9053,2.0,0,0,3,8,3030,0,2009,0,98059,47.4945,-122.149,3010,6026,6023,3016,56.323870540152434,0.05703606557377049,Very Cheap
20140820T000000,327000.0,2,2.0,1490,1627,2.0,0,0,3,8,1190,300,2009,0,98126,47.5455,-122.375,1400,1498,137,98,200.98340503995084,0.033049180327868855,Very Cheap
20140819T000000,1057000.0,2,1.5,2370,184231,2.0,0,0,3,11,2370,0,2005,0,98045,47.4543,-121.778,3860,151081,181861,147221,5.737362333157829,0.12878688524590165,Cheap
20141231T000000,327500.0,3,2.5,1820,1866,2.0,0,0,3,8,1570,250,2008,0,98166,47.4643,-122.346,1660,6900,46,5240,175.5091103965702,0.033114754098360656,Very Cheap
20140729T000000,249000.0,3,2.0,1260,1125,2.0,0,0,3,7,810,450,2011,0,98106,47.5262,-122.361,1260,1172,-135,-88,221.33333333333334,0.02281967213114754,Very Cheap
20141224T000000,1375000.0,5,4.5,4350,13405,2.0,0,0,3,11,4350,0,2014,0,98074,47.6018,-122.06,3990,7208,9055,3218,102.57366654233495,0.17049180327868851,Cheap
20140627T000000,516500.0,1,1.25,1100,638,3.0,0,0,3,9,1100,0,2014,0,98112,47.6228,-122.307,1110,1933,-462,823,809.5611285266458,0.0579016393442623,Very Cheap
20150409T000000,465000.0,3,2.5,2050,15035,2.0,0,0,3,9,2050,0,2006,0,98042,47.3619,-122.122,1300,15836,12985,14536,30.927835051546392,0.051147540983606556,Very Cheap
20140808T000000,388000.0,3,2.5,2198,6222,2.0,0,2,3,8,2198,0,2010,0,98198,47.3906,-122.304,2198,7621,4024,5423,62.3593699774992,0.041049180327868855,Very Cheap
20140930T000000,549000.0,3,2.25,1230,1380,3.0,0,0,3,8,1230,0,2013,0,98199,47.6521,-122.4,1760,5664,150,3904,397.82608695652175,0.06216393442622951,Very Cheap
20141003T000000,553000.0,2,2.0,1400,1512,2.0,0,0,3,8,940,460,2006,0,98107,47.6719,-122.392,1400,3500,112,2100,365.74074074074076,0.06268852459016394,Very Cheap
20150422T000000,530000.0,3,2.5,1410,1250,2.0,0,0,3,8,1140,270,2010,0,98119,47.6515,-122.375,1720,2825,-160,1105,424.0,0.05967213114754098,Very Cheap
20140820T000000,747450.0,3,2.5,2110,1339,2.0,0,0,3,8,1410,700,2014,0,98122,47.6088,-122.311,1630,2670,-771,1040,558.2150858849888,0.08819016393442623,Very Cheap
20140520T000000,305000.0,2,2.5,1590,2656,2.0,0,0,3,7,1220,370,2009,0,98106,47.5489,-122.364,1590,2306,1066,716,114.83433734939759,0.03016393442622951,Very Cheap
20141118T000000,540000.0,5,2.5,3370,4850,2.0,0,0,3,9,3370,0,2007,0,98056,47.5078,-122.169,2900,5570,1480,2670,111.34020618556701,0.06098360655737705,Very Cheap
20150115T000000,750000.0,5,4.0,4500,8130,2.0,0,0,3,10,4500,0,2007,0,98059,47.4832,-122.145,2840,8402,3630,5562,92.25092250922509,0.08852459016393442,Very Cheap
20150414T000000,422000.0,4,2.5,2930,5973,2.0,0,0,3,10,2930,0,2008,0,98030,47.3846,-122.186,3038,7095,3043,4057,70.65126402142977,0.04550819672131148,Very Cheap
20141020T000000,337000.0,4,2.5,2470,5100,2.0,0,0,3,8,2470,0,2005,0,98038,47.3622,-122.041,2240,5123,2630,2883,66.07843137254902,0.034360655737704915,Very Cheap
20141009T000000,579950.0,5,2.75,3080,5752,2.0,0,0,3,9,3080,0,2014,0,98059,47.4922,-122.153,3000,4650,2672,1650,100.82579972183588,0.06622295081967212,Very Cheap
20150226T000000,341780.0,4,2.75,2260,4440,2.0,0,0,3,7,2260,0,2014,0,98001,47.3507,-122.291,2260,4563,2180,2303,76.97747747747748,0.034987540983606555,Very Cheap
20150423T000000,710200.0,4,3.0,1670,2642,2.0,0,0,3,8,1350,320,2008,0,98109,47.6397,-122.345,1670,2594,972,924,268.8115064345193,0.08330491803278689,Very Cheap
20140618T000000,690000.0,3,3.25,1540,1428,3.0,0,0,3,9,1540,0,2013,0,98103,47.6648,-122.353,1660,3300,-112,1640,483.1932773109244,0.08065573770491803,Very Cheap
20150130T000000,1700000.0,4,3.5,3830,8963,2.0,0,0,3,10,3120,710,2014,0,98004,47.599,-122.197,2190,10777,5133,8587,189.66863773290194,0.21311475409836064,Cheap
20141015T000000,329000.0,2,2.5,980,1020,3.0,0,0,3,8,980,0,2008,0,98117,47.6844,-122.387,980,1023,40,43,322.54901960784315,0.03331147540983607,Very Cheap
20140513T000000,330000.0,3,2.5,1450,5008,1.0,0,0,3,7,840,610,2007,0,98106,47.5435,-122.357,2120,5019,3558,2899,65.89456869009585,0.03344262295081967,Very Cheap
20150502T000000,608500.0,4,3.5,2850,5577,2.0,0,0,3,8,1950,900,2014,0,98056,47.5252,-122.192,2850,5708,2727,2858,109.10883987807065,0.0699672131147541,Very Cheap
20140707T000000,230000.0,3,1.75,1140,1201,2.0,0,0,3,8,1140,0,2014,0,98108,47.5637,-122.295,1210,1552,61,342,191.50707743547045,0.020327868852459016,Very Cheap
20140520T000000,785000.0,4,3.5,3070,4684,2.0,0,0,3,10,2190,880,2009,0,98027,47.5316,-122.076,2290,2664,1614,374,167.59180187873613,0.09311475409836066,Very Cheap
20140507T000000,610950.0,3,3.0,1680,1570,3.0,0,0,3,8,1680,0,2014,0,98103,47.6572,-122.346,1640,4800,-110,3160,389.140127388535,0.07028852459016394,Very Cheap
20141111T000000,399950.0,3,2.5,3087,5002,2.0,0,0,3,8,3087,0,2014,0,98023,47.2974,-122.349,2927,5183,1915,2256,79.95801679328268,0.04261639344262295,Very Cheap
20150107T000000,3567000.0,5,4.5,4850,10584,2.0,1,4,3,10,3540,1310,2007,0,98008,47.5943,-122.11,3470,18270,5734,14800,337.01814058956916,0.4579672131147541,High
20150123T000000,579000.0,4,3.25,1900,2631,2.0,0,0,3,9,1250,650,2014,0,98144,47.5869,-122.311,1710,4502,731,2792,220.0684150513113,0.06609836065573771,Very Cheap
20140623T000000,362500.0,2,1.5,940,1768,2.0,0,0,3,7,940,0,2009,0,98144,47.5925,-122.295,1130,1159,828,29,205.0339366515837,0.03770491803278689,Very Cheap
20140529T000000,645000.0,3,3.25,1730,1229,2.0,0,2,3,9,1320,410,2008,0,98119,47.6374,-122.369,1710,1686,-501,-24,524.8169243287225,0.07475409836065573,Very Cheap
20141003T000000,594866.0,3,3.0,2780,6000,2.0,0,0,3,9,2780,0,2013,0,98065,47.5184,-121.886,2850,6000,3220,3150,99.14433333333334,0.0681791475409836,Very Cheap
20150504T000000,625000.0,3,3.0,2780,6000,2.0,0,0,3,9,2780,0,2013,0,98065,47.5184,-121.886,2850,6000,3220,3150,104.16666666666667,0.07213114754098361,Very Cheap
20141112T000000,490000.0,3,2.25,1500,1290,2.0,0,0,3,8,1220,280,2006,0,98117,47.6785,-122.375,1460,1375,-210,-85,379.84496124031006,0.05442622950819672,Very Cheap
20140610T000000,399950.0,2,1.0,710,1157,2.0,0,0,4,7,710,0,1943,0,98102,47.6413,-122.329,1370,1173,447,-197,345.67847882454623,0.04261639344262295,Very Cheap
20141202T000000,380000.0,3,2.5,1260,900,2.0,0,0,3,7,940,320,2007,0,98116,47.5621,-122.384,1310,1415,-360,105,422.22222222222223,0.04,Very Cheap
20140828T000000,270000.0,3,2.5,1870,5000,2.0,0,0,3,7,1870,0,2009,0,98042,47.3339,-122.055,2170,5399,3130,3229,54.0,0.025573770491803278,Very Cheap
20141015T000000,505000.0,2,2.5,1430,1201,3.0,0,0,3,8,1430,0,2009,0,98107,47.6707,-122.381,1430,1249,-229,-181,420.48293089092425,0.05639344262295082,Very Cheap
20150305T000000,385000.0,3,2.5,1520,1488,3.0,0,0,3,8,1520,0,2006,0,98125,47.7337,-122.309,1520,1497,-32,-23,258.73655913978496,0.04065573770491803,Very Cheap
20141113T000000,414500.0,2,1.5,1210,1278,2.0,0,0,3,8,1020,190,2007,0,98117,47.6756,-122.375,1210,1118,68,-92,324.3348982785603,0.044524590163934424,Very Cheap
20140910T000000,347500.0,3,2.5,2540,4760,2.0,0,0,3,8,2540,0,2010,0,98038,47.3452,-122.022,2540,4571,2220,2031,73.00420168067227,0.035737704918032784,Very Cheap
20140514T000000,1222500.0,4,3.5,4910,9444,1.5,0,0,3,11,3110,1800,2007,0,98074,47.6502,-122.066,4560,11063,4534,6503,129.44726810673444,0.15049180327868852,Cheap
20141002T000000,572000.0,4,2.75,2770,3852,2.0,0,0,3,8,2770,0,2014,0,98178,47.5001,-122.232,1810,5641,1082,3831,148.49428868120458,0.06518032786885246,Very Cheap
20150416T000000,475000.0,3,2.25,1190,1200,3.0,0,0,3,8,1190,0,2008,0,98103,47.6542,-122.346,1180,1224,10,44,395.8333333333333,0.05245901639344262,Very Cheap
20150317T000000,1088000.0,5,3.75,4170,8142,2.0,0,2,3,10,4170,0,2006,0,98056,47.5354,-122.181,3030,7980,3972,4950,133.62810120363548,0.13285245901639345,Cheap
20141017T000000,350000.0,4,2.75,2500,5995,2.0,0,0,3,8,2500,0,2008,0,98042,47.3749,-122.107,2530,5988,3495,3458,58.381984987489574,0.036065573770491806,Very Cheap
20141031T000000,520000.0,2,2.25,1530,981,3.0,0,0,3,8,1480,50,2006,0,98103,47.6533,-122.346,1530,1282,-549,-248,530.0713557594291,0.058360655737704915,Very Cheap
20140813T000000,679950.0,5,2.75,3600,9437,2.0,0,0,3,9,3600,0,2014,0,98059,47.4822,-122.131,3550,9421,5837,5871,72.05149941718767,0.07933770491803278,Very Cheap
20150421T000000,1575000.0,4,3.25,3410,10125,2.0,0,0,3,10,3410,0,2007,0,98040,47.5653,-122.223,2290,10125,6715,7835,155.55555555555554,0.19672131147540983,Cheap
20141013T000000,541800.0,4,2.5,3118,7866,2.0,0,2,3,9,3118,0,2014,0,98001,47.2931,-122.264,2673,6500,4748,3827,68.8787185354691,0.06121967213114754,Very Cheap
20140915T000000,810000.0,4,3.0,3990,7838,2.0,0,0,3,9,3990,0,2003,0,98053,47.6857,-122.046,3370,6814,3848,3444,103.34268946159735,0.09639344262295083,Very Cheap
20141015T000000,1537000.0,5,3.75,4470,8088,2.0,0,0,3,11,4470,0,2008,0,98004,47.6321,-122.2,2780,8964,3618,6184,190.03461918892185,0.1917377049180328,Cheap
20150407T000000,467000.0,3,2.5,1425,1179,3.0,0,0,3,8,1425,0,2008,0,98125,47.6963,-122.318,1285,1253,-246,-32,396.0983884648007,0.05140983606557377,Very Cheap
20140626T000000,224000.0,3,1.75,1500,11968,1.0,0,0,3,6,1500,0,2014,0,98010,47.3095,-122.002,1320,11303,10468,9983,18.71657754010695,0.01954098360655738,Very Cheap
20140825T000000,507250.0,3,2.5,2270,5536,2.0,0,0,3,8,2270,0,2003,0,98065,47.5389,-121.881,2270,5731,3266,3461,91.62752890173411,0.056688524590163936,Very Cheap
20150126T000000,429000.0,3,2.0,1490,1126,3.0,0,0,3,8,1490,0,2014,0,98144,47.5699,-122.288,1400,1230,-364,-170,380.9946714031972,0.04642622950819672,Very Cheap
20141014T000000,610685.0,4,2.5,2520,6023,2.0,0,0,3,9,2520,0,2014,0,98056,47.5137,-122.167,2520,6023,3503,3503,101.39216337373402,0.07025377049180327,Very Cheap
20150326T000000,1007500.0,4,3.5,3510,7200,2.0,0,0,3,9,2600,910,2009,0,98136,47.5537,-122.398,2050,6200,3690,4150,139.93055555555554,0.12229508196721312,Cheap
20150219T000000,475000.0,3,2.5,1310,1294,2.0,0,0,3,8,1180,130,2008,0,98116,47.5773,-122.409,1330,1265,-16,-65,367.0788253477589,0.05245901639344262,Very Cheap
20140521T000000,360000.0,3,2.5,1530,1131,3.0,0,0,3,8,1530,0,2009,0,98103,47.6993,-122.346,1530,1509,-399,-21,318.3023872679045,0.037377049180327866,Very Cheap
20150223T000000,400000.0,4,2.5,2310,5813,2.0,0,0,3,8,2310,0,2014,0,98146,47.5107,-122.362,1830,7200,3503,5370,68.81128505074832,0.04262295081967213,Very Cheap
20140623T000000,402101.0,2,0.75,1020,1350,2.0,0,0,3,7,1020,0,2009,0,98144,47.5944,-122.299,1020,2007,330,987,297.8525925925926,0.04289849180327869,Very Cheap
20150116T000000,400000.0,3,2.5,1600,2388,2.0,0,0,3,8,1600,0,2004,0,98027,47.5345,-122.069,1410,1287,788,-123,167.50418760469012,0.04262295081967213,Very Cheap
20141015T000000,325000.0,2,0.75,1020,1076,2.0,0,0,3,7,1020,0,2008,0,98144,47.5941,-122.299,1020,1357,56,337,302.0446096654275,0.03278688524590164,Very Cheap
